PokerStars Hand #237402223062:  Hold'em No Limit ($0.01/$0.02 USD) - 2022/07/16 16:01:16 PT [2022/07/16 19:01:16 ET]
Table 'Kalypso IV' 9-max Seat #8 is the button
Seat 1: viilu ($1.52 in chips) 
Seat 2: goodmax3121 ($3.41 in chips) 
Seat 3: Admiral1812 ($2.93 in chips) 
Seat 4: Dorex2007 ($2 in chips) 
Seat 5: frosa9397 ($0.89 in chips) 
Seat 6: Juagonzalez ($2.67 in chips) 
Seat 7: alexiscarel7 ($4.14 in chips) 
Seat 8: English_Ian ($1.79 in chips) 
Seat 9: kkksky ($1.40 in chips) 
kkksky: posts small blind $0.01
viilu: posts big blind $0.02
Dorex2007: posts big blind $0.02
*** HOLE CARDS ***
Dealt to Dorex2007 [As Qd]
goodmax3121: folds 
Admiral1812: folds 
Dorex2007: raises $0.10 to $0.12
frosa9397: folds 
Juagonzalez: folds 
alexiscarel7: folds 
English_Ian: folds 
kkksky: folds 
viilu: folds 
Uncalled bet ($0.10) returned to Dorex2007
Dorex2007 collected $0.05 from pot
*** SUMMARY ***
Total pot $0.05 | Rake $0 
Seat 1: viilu (big blind) folded before Flop
Seat 2: goodmax3121 folded before Flop (didn't bet)
Seat 3: Admiral1812 folded before Flop (didn't bet)
Seat 4: Dorex2007 collected ($0.05)
Seat 5: frosa9397 folded before Flop (didn't bet)
Seat 6: Juagonzalez folded before Flop (didn't bet)
Seat 7: alexiscarel7 folded before Flop (didn't bet)
Seat 8: English_Ian (button) folded before Flop (didn't bet)
Seat 9: kkksky (small blind) folded before Flop



PokerStars Hand #237402232340:  Hold'em No Limit ($0.01/$0.02 USD) - 2022/07/16 16:01:49 PT [2022/07/16 19:01:49 ET]
Table 'Kalypso IV' 9-max Seat #9 is the button
Seat 1: viilu ($1.50 in chips) 
Seat 2: goodmax3121 ($3.41 in chips) 
Seat 3: Admiral1812 ($2.93 in chips) 
Seat 4: Dorex2007 ($2.03 in chips) 
Seat 5: frosa9397 ($0.89 in chips) 
Seat 6: Juagonzalez ($2.67 in chips) 
Seat 7: alexiscarel7 ($4.14 in chips) 
Seat 8: English_Ian ($1.79 in chips) 
Seat 9: kkksky ($1.39 in chips) 
viilu: posts small blind $0.01
goodmax3121: posts big blind $0.02
*** HOLE CARDS ***
Dealt to Dorex2007 [2d 7h]
Admiral1812: folds 
Dorex2007: folds 
frosa9397: folds 
Juagonzalez: folds 
alexiscarel7: folds 
English_Ian: folds 
kkksky: raises $0.04 to $0.06
viilu: calls $0.05
goodmax3121: calls $0.04
*** FLOP *** [8c Kd 4c]
viilu: bets $0.08
goodmax3121: calls $0.08
kkksky: calls $0.08
*** TURN *** [8c Kd 4c] [3d]
viilu: bets $0.20
goodmax3121: folds 
kkksky: folds 
Uncalled bet ($0.20) returned to viilu
viilu collected $0.41 from pot
*** SUMMARY ***
Total pot $0.42 | Rake $0.01 
Board [8c Kd 4c 3d]
Seat 1: viilu (small blind) collected ($0.41)
Seat 2: goodmax3121 (big blind) folded on the Turn
Seat 3: Admiral1812 folded before Flop (didn't bet)
Seat 4: Dorex2007 folded before Flop (didn't bet)
Seat 5: frosa9397 folded before Flop (didn't bet)
Seat 6: Juagonzalez folded before Flop (didn't bet)
Seat 7: alexiscarel7 folded before Flop (didn't bet)
Seat 8: English_Ian folded before Flop (didn't bet)
Seat 9: kkksky (button) folded on the Turn



PokerStars Hand #237402249535:  Hold'em No Limit ($0.01/$0.02 USD) - 2022/07/16 16:02:32 PT [2022/07/16 19:02:32 ET]
Table 'Kalypso IV' 9-max Seat #1 is the button
Seat 1: viilu ($1.77 in chips) 
Seat 2: goodmax3121 ($3.27 in chips) 
Seat 3: Admiral1812 ($2.93 in chips) 
Seat 4: Dorex2007 ($2.03 in chips) 
Seat 5: frosa9397 ($0.89 in chips) 
Seat 6: Juagonzalez ($2.67 in chips) 
Seat 7: alexiscarel7 ($4.14 in chips) 
Seat 8: English_Ian ($1.79 in chips) 
Seat 9: kkksky ($1.25 in chips) 
goodmax3121: posts small blind $0.01
Admiral1812: posts big blind $0.02
*** HOLE CARDS ***
Dealt to Dorex2007 [Ad 2c]
Dorex2007: folds 
frosa9397: folds 
Juagonzalez: folds 
alexiscarel7: folds 
English_Ian: folds 
kkksky: folds 
viilu: calls $0.02
goodmax3121: calls $0.01
Admiral1812: checks 
*** FLOP *** [Js 9h 5c]
goodmax3121: checks 
Admiral1812: checks 
viilu: bets $0.04
goodmax3121: calls $0.04
Admiral1812: folds 
*** TURN *** [Js 9h 5c] [6s]
goodmax3121: bets $0.02
viilu: calls $0.02
*** RIVER *** [Js 9h 5c 6s] [7h]
goodmax3121: checks 
viilu: bets $0.17
goodmax3121: folds 
Uncalled bet ($0.17) returned to viilu
viilu collected $0.17 from pot
*** SUMMARY ***
Total pot $0.18 | Rake $0.01 
Board [Js 9h 5c 6s 7h]
Seat 1: viilu (button) collected ($0.17)
Seat 2: goodmax3121 (small blind) folded on the River
Seat 3: Admiral1812 (big blind) folded on the Flop
Seat 4: Dorex2007 folded before Flop (didn't bet)
Seat 5: frosa9397 folded before Flop (didn't bet)
Seat 6: Juagonzalez folded before Flop (didn't bet)
Seat 7: alexiscarel7 folded before Flop (didn't bet)
Seat 8: English_Ian folded before Flop (didn't bet)
Seat 9: kkksky folded before Flop (didn't bet)



PokerStars Hand #237402270473:  Hold'em No Limit ($0.01/$0.02 USD) - 2022/07/16 16:03:30 PT [2022/07/16 19:03:30 ET]
Table 'Kalypso IV' 9-max Seat #2 is the button
Seat 1: viilu ($1.86 in chips) 
Seat 2: goodmax3121 ($3.19 in chips) 
Seat 3: Admiral1812 ($2.91 in chips) 
Seat 4: Dorex2007 ($2.03 in chips) 
Seat 5: frosa9397 ($0.89 in chips) 
Seat 6: Juagonzalez ($2.67 in chips) 
Seat 7: alexiscarel7 ($4.14 in chips) 
Seat 8: English_Ian ($1.79 in chips) 
Seat 9: kkksky ($1.25 in chips) 
Admiral1812: posts small blind $0.01
Dorex2007: posts big blind $0.02
*** HOLE CARDS ***
Dealt to Dorex2007 [9s Th]
frosa9397: folds 
Juagonzalez: folds 
alexiscarel7: folds 
English_Ian: folds 
kkksky: folds 
viilu: folds 
goodmax3121: calls $0.02
Admiral1812: calls $0.01
Dorex2007: checks 
*** FLOP *** [Qc Ad 8h]
Admiral1812: checks 
Dorex2007: checks 
goodmax3121: checks 
*** TURN *** [Qc Ad 8h] [Kd]
Admiral1812: checks 
Dorex2007: checks 
goodmax3121: checks 
*** RIVER *** [Qc Ad 8h Kd] [3s]
Admiral1812: bets $0.04
Dorex2007: folds 
goodmax3121: folds 
Uncalled bet ($0.04) returned to Admiral1812
Admiral1812 collected $0.06 from pot
*** SUMMARY ***
Total pot $0.06 | Rake $0 
Board [Qc Ad 8h Kd 3s]
Seat 1: viilu folded before Flop (didn't bet)
Seat 2: goodmax3121 (button) folded on the River
Seat 3: Admiral1812 (small blind) collected ($0.06)
Seat 4: Dorex2007 (big blind) folded on the River
Seat 5: frosa9397 folded before Flop (didn't bet)
Seat 6: Juagonzalez folded before Flop (didn't bet)
Seat 7: alexiscarel7 folded before Flop (didn't bet)
Seat 8: English_Ian folded before Flop (didn't bet)
Seat 9: kkksky folded before Flop (didn't bet)



PokerStars Hand #237402284547:  Hold'em No Limit ($0.01/$0.02 USD) - 2022/07/16 16:04:19 PT [2022/07/16 19:04:19 ET]
Table 'Kalypso IV' 9-max Seat #3 is the button
Seat 1: viilu ($1.86 in chips) 
Seat 2: goodmax3121 ($3.17 in chips) 
Seat 3: Admiral1812 ($2.95 in chips) 
Seat 4: Dorex2007 ($2.01 in chips) 
Seat 5: frosa9397 ($0.89 in chips) 
Seat 6: Juagonzalez ($2.67 in chips) 
Seat 7: alexiscarel7 ($4.14 in chips) 
Seat 8: English_Ian ($1.79 in chips) 
Seat 9: kkksky ($1.25 in chips) 
Dorex2007: posts small blind $0.01
frosa9397: posts big blind $0.02
*** HOLE CARDS ***
Dealt to Dorex2007 [Kd Qd]
Juagonzalez: folds 
alexiscarel7: folds 
English_Ian: folds 
kkksky: folds 
viilu: calls $0.02
goodmax3121: folds 
Admiral1812: folds 
Dorex2007: raises $0.08 to $0.10
frosa9397: folds 
viilu: calls $0.08
*** FLOP *** [Tc 9c 8d]
Dorex2007: checks 
viilu: bets $0.06
Dorex2007: folds 
Uncalled bet ($0.06) returned to viilu
viilu collected $0.21 from pot
*** SUMMARY ***
Total pot $0.22 | Rake $0.01 
Board [Tc 9c 8d]
Seat 1: viilu collected ($0.21)
Seat 2: goodmax3121 folded before Flop (didn't bet)
Seat 3: Admiral1812 (button) folded before Flop (didn't bet)
Seat 4: Dorex2007 (small blind) folded on the Flop
Seat 5: frosa9397 (big blind) folded before Flop
Seat 6: Juagonzalez folded before Flop (didn't bet)
Seat 7: alexiscarel7 folded before Flop (didn't bet)
Seat 8: English_Ian folded before Flop (didn't bet)
Seat 9: kkksky folded before Flop (didn't bet)



PokerStars Hand #237402297397:  Hold'em No Limit ($0.01/$0.02 USD) - 2022/07/16 16:05:04 PT [2022/07/16 19:05:04 ET]
Table 'Kalypso IV' 9-max Seat #4 is the button
Seat 1: viilu ($1.97 in chips) 
Seat 2: goodmax3121 ($3.17 in chips) 
Seat 3: Admiral1812 ($2.95 in chips) 
Seat 4: Dorex2007 ($2 in chips) 
Seat 5: frosa9397 ($0.87 in chips) 
Seat 6: Juagonzalez ($2.67 in chips) 
Seat 7: alexiscarel7 ($4.14 in chips) 
Seat 8: English_Ian ($1.79 in chips) 
Seat 9: kkksky ($1.25 in chips) 
frosa9397: posts small blind $0.01
Juagonzalez: posts big blind $0.02
*** HOLE CARDS ***
Dealt to Dorex2007 [2c 5c]
alexiscarel7: folds 
English_Ian: folds 
kkksky: folds 
viilu: folds 
goodmax3121: folds 
Admiral1812: folds 
Dorex2007: folds 
frosa9397: folds 
Uncalled bet ($0.01) returned to Juagonzalez
Juagonzalez collected $0.02 from pot
*** SUMMARY ***
Total pot $0.02 | Rake $0 
Seat 1: viilu folded before Flop (didn't bet)
Seat 2: goodmax3121 folded before Flop (didn't bet)
Seat 3: Admiral1812 folded before Flop (didn't bet)
Seat 4: Dorex2007 (button) folded before Flop (didn't bet)
Seat 5: frosa9397 (small blind) folded before Flop
Seat 6: Juagonzalez (big blind) collected ($0.02)
Seat 7: alexiscarel7 folded before Flop (didn't bet)
Seat 8: English_Ian folded before Flop (didn't bet)
Seat 9: kkksky folded before Flop (didn't bet)



PokerStars Hand #237402305087:  Hold'em No Limit ($0.01/$0.02 USD) - 2022/07/16 16:05:31 PT [2022/07/16 19:05:31 ET]
Table 'Kalypso IV' 9-max Seat #5 is the button
Seat 1: viilu ($1.97 in chips) 
Seat 2: goodmax3121 ($3.17 in chips) 
Seat 3: Admiral1812 ($2.95 in chips) 
Seat 4: Dorex2007 ($2 in chips) 
Seat 5: frosa9397 ($0.86 in chips) 
Seat 6: Juagonzalez ($2.68 in chips) 
Seat 7: alexiscarel7 ($4.14 in chips) 
Seat 8: English_Ian ($1.79 in chips) 
Seat 9: kkksky ($1.25 in chips) 
Juagonzalez: posts small blind $0.01
alexiscarel7: posts big blind $0.02
*** HOLE CARDS ***
Dealt to Dorex2007 [9h Td]
English_Ian: folds 
kkksky: folds 
viilu: calls $0.02
goodmax3121: folds 
Admiral1812: folds 
Dorex2007: folds 
frosa9397: folds 
Juagonzalez: folds 
alexiscarel7: checks 
*** FLOP *** [3c Ad Js]
alexiscarel7: checks 
viilu: checks 
*** TURN *** [3c Ad Js] [Ts]
alexiscarel7: bets $0.04
viilu: folds 
Uncalled bet ($0.04) returned to alexiscarel7
alexiscarel7 collected $0.05 from pot
*** SUMMARY ***
Total pot $0.05 | Rake $0 
Board [3c Ad Js Ts]
Seat 1: viilu folded on the Turn
Seat 2: goodmax3121 folded before Flop (didn't bet)
Seat 3: Admiral1812 folded before Flop (didn't bet)
Seat 4: Dorex2007 folded before Flop (didn't bet)
Seat 5: frosa9397 (button) folded before Flop (didn't bet)
Seat 6: Juagonzalez (small blind) folded before Flop
Seat 7: alexiscarel7 (big blind) collected ($0.05)
Seat 8: English_Ian folded before Flop (didn't bet)
Seat 9: kkksky folded before Flop (didn't bet)



PokerStars Hand #237402318050:  Hold'em No Limit ($0.01/$0.02 USD) - 2022/07/16 16:06:17 PT [2022/07/16 19:06:17 ET]
Table 'Kalypso IV' 9-max Seat #6 is the button
Seat 1: viilu ($1.95 in chips) 
Seat 2: goodmax3121 ($3.17 in chips) 
Seat 3: Admiral1812 ($2.95 in chips) 
Seat 4: Dorex2007 ($2 in chips) 
Seat 5: frosa9397 ($0.86 in chips) 
Seat 6: Juagonzalez ($2.67 in chips) 
Seat 7: alexiscarel7 ($4.17 in chips) 
Seat 8: English_Ian ($1.79 in chips) 
Seat 9: kkksky ($1.25 in chips) 
alexiscarel7: posts small blind $0.01
English_Ian: posts big blind $0.02
*** HOLE CARDS ***
Dealt to Dorex2007 [Ad 6c]
kkksky: folds 
viilu: folds 
goodmax3121: raises $0.02 to $0.04
Admiral1812: folds 
Dorex2007: folds 
frosa9397: folds 
Juagonzalez: calls $0.04
alexiscarel7: folds 
English_Ian: calls $0.02
*** FLOP *** [Ah Kh 2h]
English_Ian: checks 
goodmax3121: bets $0.10
Juagonzalez: folds 
English_Ian: folds 
Uncalled bet ($0.10) returned to goodmax3121
goodmax3121 collected $0.13 from pot
*** SUMMARY ***
Total pot $0.13 | Rake $0 
Board [Ah Kh 2h]
Seat 1: viilu folded before Flop (didn't bet)
Seat 2: goodmax3121 collected ($0.13)
Seat 3: Admiral1812 folded before Flop (didn't bet)
Seat 4: Dorex2007 folded before Flop (didn't bet)
Seat 5: frosa9397 folded before Flop (didn't bet)
Seat 6: Juagonzalez (button) folded on the Flop
Seat 7: alexiscarel7 (small blind) folded before Flop
Seat 8: English_Ian (big blind) folded on the Flop
Seat 9: kkksky folded before Flop (didn't bet)



PokerStars Hand #237402336319:  Hold'em No Limit ($0.01/$0.02 USD) - 2022/07/16 16:07:23 PT [2022/07/16 19:07:23 ET]
Table 'Kalypso IV' 9-max Seat #7 is the button
Seat 1: viilu ($1.95 in chips) 
Seat 2: goodmax3121 ($3.26 in chips) 
Seat 3: Admiral1812 ($2.95 in chips) 
Seat 4: Dorex2007 ($2 in chips) 
Seat 5: frosa9397 ($0.86 in chips) 
Seat 6: Juagonzalez ($2.63 in chips) 
Seat 7: alexiscarel7 ($4.16 in chips) 
Seat 8: English_Ian ($1.75 in chips) 
Seat 9: kkksky ($1.25 in chips) 
English_Ian: posts small blind $0.01
kkksky: posts big blind $0.02
*** HOLE CARDS ***
Dealt to Dorex2007 [6d Jh]
viilu: calls $0.02
goodmax3121: folds 
Admiral1812: folds 
Dorex2007: folds 
frosa9397 has timed out
frosa9397: folds 
Juagonzalez: folds 
alexiscarel7: calls $0.02
English_Ian: calls $0.01
kkksky: checks 
*** FLOP *** [2h Tc 4h]
English_Ian: checks 
kkksky: bets $0.04
viilu: folds 
alexiscarel7: folds 
English_Ian: calls $0.04
*** TURN *** [2h Tc 4h] [5d]
English_Ian: checks 
kkksky: bets $0.10
English_Ian: calls $0.10
*** RIVER *** [2h Tc 4h 5d] [5h]
English_Ian: checks 
kkksky: bets $0.20
English_Ian: calls $0.20
*** SHOW DOWN ***
kkksky: shows [2d 2s] (a full house, Deuces full of Fives)
English_Ian: mucks hand 
kkksky collected $0.73 from pot
*** SUMMARY ***
Total pot $0.76 | Rake $0.03 
Board [2h Tc 4h 5d 5h]
Seat 1: viilu folded on the Flop
Seat 2: goodmax3121 folded before Flop (didn't bet)
Seat 3: Admiral1812 folded before Flop (didn't bet)
Seat 4: Dorex2007 folded before Flop (didn't bet)
Seat 5: frosa9397 folded before Flop (didn't bet)
Seat 6: Juagonzalez folded before Flop (didn't bet)
Seat 7: alexiscarel7 (button) folded on the Flop
Seat 8: English_Ian (small blind) mucked [Qs Td]
Seat 9: kkksky (big blind) showed [2d 2s] and won ($0.73) with a full house, Deuces full of Fives



PokerStars Hand #237402366267:  Hold'em No Limit ($0.01/$0.02 USD) - 2022/07/16 16:09:10 PT [2022/07/16 19:09:10 ET]
Table 'Kalypso IV' 9-max Seat #8 is the button
Seat 1: viilu ($1.93 in chips) 
Seat 2: goodmax3121 ($3.26 in chips) 
Seat 3: Admiral1812 ($2.95 in chips) 
Seat 4: Dorex2007 ($2 in chips) 
Seat 6: Juagonzalez ($2.63 in chips) 
Seat 7: alexiscarel7 ($4.14 in chips) 
Seat 8: English_Ian ($1.39 in chips) 
Seat 9: kkksky ($1.62 in chips) 
kkksky: posts small blind $0.01
viilu: posts big blind $0.02
*** HOLE CARDS ***
Dealt to Dorex2007 [4d 5c]
goodmax3121: raises $0.02 to $0.04
Admiral1812: folds 
Dorex2007: folds 
Juagonzalez: folds 
alexiscarel7: folds 
English_Ian: calls $0.04
kkksky: calls $0.03
viilu: folds 
*** FLOP *** [8d Jd 2s]
kkksky: checks 
goodmax3121: checks 
English_Ian: checks 
*** TURN *** [8d Jd 2s] [Js]
kkksky: bets $0.06
goodmax3121: calls $0.06
English_Ian: calls $0.06
*** RIVER *** [8d Jd 2s Js] [As]
kkksky: bets $0.10
goodmax3121: folds 
English_Ian: calls $0.10
*** SHOW DOWN ***
kkksky: shows [Qs Ks] (a flush, Ace high)
English_Ian: mucks hand 
kkksky collected $0.50 from pot
*** SUMMARY ***
Total pot $0.52 | Rake $0.02 
Board [8d Jd 2s Js As]
Seat 1: viilu (big blind) folded before Flop
Seat 2: goodmax3121 folded on the River
Seat 3: Admiral1812 folded before Flop (didn't bet)
Seat 4: Dorex2007 folded before Flop (didn't bet)
Seat 6: Juagonzalez folded before Flop (didn't bet)
Seat 7: alexiscarel7 folded before Flop (didn't bet)
Seat 8: English_Ian (button) mucked [Tc Td]
Seat 9: kkksky (small blind) showed [Qs Ks] and won ($0.50) with a flush, Ace high



PokerStars Hand #237402388184:  Hold'em No Limit ($0.01/$0.02 USD) - 2022/07/16 16:10:24 PT [2022/07/16 19:10:24 ET]
Table 'Kalypso IV' 9-max Seat #9 is the button
Seat 1: viilu ($1.91 in chips) 
Seat 2: goodmax3121 ($3.16 in chips) 
Seat 3: Admiral1812 ($2.95 in chips) 
Seat 4: Dorex2007 ($2 in chips) 
Seat 5: frosa9397 ($0.86 in chips) 
Seat 6: Juagonzalez ($2.63 in chips) 
Seat 7: alexiscarel7 ($4.14 in chips) 
Seat 8: English_Ian ($1.19 in chips) 
Seat 9: kkksky ($1.92 in chips) 
viilu: posts small blind $0.01
goodmax3121: posts big blind $0.02
*** HOLE CARDS ***
Dealt to Dorex2007 [2c Js]
Admiral1812: calls $0.02
Dorex2007: folds 
frosa9397: folds 
Juagonzalez: folds 
alexiscarel7: calls $0.02
English_Ian: folds 
kkksky: raises $0.04 to $0.06
viilu: folds 
goodmax3121: folds 
Admiral1812: calls $0.04
alexiscarel7: calls $0.04
*** FLOP *** [5h 5s 6c]
Admiral1812: checks 
alexiscarel7: checks 
kkksky: checks 
*** TURN *** [5h 5s 6c] [7d]
Admiral1812: checks 
alexiscarel7: bets $0.08
kkksky: folds 
Admiral1812: calls $0.08
*** RIVER *** [5h 5s 6c 7d] [Ks]
Admiral1812: checks 
alexiscarel7: bets $0.18
Admiral1812: calls $0.18
*** SHOW DOWN ***
alexiscarel7: shows [6s 5c] (a full house, Fives full of Sixes)
Admiral1812: mucks hand 
alexiscarel7 collected $0.70 from pot
*** SUMMARY ***
Total pot $0.73 | Rake $0.03 
Board [5h 5s 6c 7d Ks]
Seat 1: viilu (small blind) folded before Flop
Seat 2: goodmax3121 (big blind) folded before Flop
Seat 3: Admiral1812 mucked [7c Ad]
Seat 4: Dorex2007 folded before Flop (didn't bet)
Seat 5: frosa9397 folded before Flop (didn't bet)
Seat 6: Juagonzalez folded before Flop (didn't bet)
Seat 7: alexiscarel7 showed [6s 5c] and won ($0.70) with a full house, Fives full of Sixes
Seat 8: English_Ian folded before Flop (didn't bet)
Seat 9: kkksky (button) folded on the Turn



PokerStars Hand #237402410930:  Hold'em No Limit ($0.01/$0.02 USD) - 2022/07/16 16:11:46 PT [2022/07/16 19:11:46 ET]
Table 'Kalypso IV' 9-max Seat #1 is the button
Seat 1: viilu ($1.90 in chips) 
Seat 2: goodmax3121 ($3.14 in chips) 
Seat 3: Admiral1812 ($2.63 in chips) 
Seat 4: Dorex2007 ($2 in chips) 
Seat 5: frosa9397 ($0.86 in chips) 
Seat 6: Juagonzalez ($2.63 in chips) 
Seat 7: alexiscarel7 ($4.52 in chips) 
Seat 8: English_Ian ($2 in chips) 
Seat 9: kkksky ($1.86 in chips) 
goodmax3121: posts small blind $0.01
Admiral1812: posts big blind $0.02
*** HOLE CARDS ***
Dealt to Dorex2007 [9d Kd]
Dorex2007: calls $0.02
frosa9397: raises $0.07 to $0.09
Juagonzalez has timed out
Juagonzalez: folds 
alexiscarel7: folds 
English_Ian: folds 
kkksky: folds 
viilu: calls $0.09
goodmax3121: folds 
Admiral1812: folds 
Dorex2007: folds 
*** FLOP *** [6c Qc Jd]
frosa9397: bets $0.11
viilu: raises $1.70 to $1.81 and is all-in
frosa9397: calls $0.66 and is all-in
Uncalled bet ($1.04) returned to viilu
*** TURN *** [6c Qc Jd] [5d]
*** RIVER *** [6c Qc Jd 5d] [6s]
*** SHOW DOWN ***
frosa9397: shows [Qs Qh] (a full house, Queens full of Sixes)
viilu: shows [Ac Qd] (two pair, Queens and Sixes)
frosa9397 cashed out the hand for $1.60 | Cash Out Fee $0.02
*** SUMMARY ***
Total pot $1.77 | Rake $0.06 
Board [6c Qc Jd 5d 6s]
Seat 1: viilu (button) showed [Ac Qd] and lost with two pair, Queens and Sixes
Seat 2: goodmax3121 (small blind) folded before Flop
Seat 3: Admiral1812 (big blind) folded before Flop
Seat 4: Dorex2007 folded before Flop
Seat 5: frosa9397 showed [Qs Qh] and won ($1.71) with a full house, Queens full of Sixes (pot not awarded as player cashed out)
Seat 6: Juagonzalez folded before Flop (didn't bet)
Seat 7: alexiscarel7 folded before Flop (didn't bet)
Seat 8: English_Ian folded before Flop (didn't bet)
Seat 9: kkksky folded before Flop (didn't bet)



PokerStars Hand #237402427733:  Hold'em No Limit ($0.01/$0.02 USD) - 2022/07/16 16:12:46 PT [2022/07/16 19:12:46 ET]
Table 'Kalypso IV' 9-max Seat #2 is the button
Seat 1: viilu ($1.04 in chips) 
Seat 2: goodmax3121 ($3.13 in chips) 
Seat 3: Admiral1812 ($2.61 in chips) 
Seat 4: Dorex2007 ($2 in chips) 
Seat 5: frosa9397 ($1.60 in chips) 
Seat 7: alexiscarel7 ($4.52 in chips) 
Seat 8: English_Ian ($2 in chips) 
Seat 9: kkksky ($1.86 in chips) 
Admiral1812: posts small blind $0.01
Dorex2007: posts big blind $0.02
*** HOLE CARDS ***
Dealt to Dorex2007 [Qd Kh]
frosa9397: folds 
alexiscarel7: folds 
English_Ian: calls $0.02
kkksky: calls $0.02
viilu: calls $0.02
goodmax3121: folds 
Admiral1812: folds 
Dorex2007: checks 
*** FLOP *** [5d Th Jh]
Dorex2007: checks 
English_Ian: checks 
kkksky: checks 
viilu: bets $0.02
Dorex2007: raises $0.07 to $0.09
English_Ian: folds 
kkksky: folds 
viilu: folds 
Uncalled bet ($0.07) returned to Dorex2007
Dorex2007 collected $0.13 from pot
*** SUMMARY ***
Total pot $0.13 | Rake $0 
Board [5d Th Jh]
Seat 1: viilu folded on the Flop
Seat 2: goodmax3121 (button) folded before Flop (didn't bet)
Seat 3: Admiral1812 (small blind) folded before Flop
Seat 4: Dorex2007 (big blind) collected ($0.13)
Seat 5: frosa9397 folded before Flop (didn't bet)
Seat 7: alexiscarel7 folded before Flop (didn't bet)
Seat 8: English_Ian folded on the Flop
Seat 9: kkksky folded on the Flop



PokerStars Hand #237402441263:  Hold'em No Limit ($0.01/$0.02 USD) - 2022/07/16 16:13:34 PT [2022/07/16 19:13:34 ET]
Table 'Kalypso IV' 9-max Seat #3 is the button
Seat 1: viilu ($1 in chips) 
Seat 2: goodmax3121 ($3.13 in chips) 
Seat 3: Admiral1812 ($2.60 in chips) 
Seat 4: Dorex2007 ($2.09 in chips) 
Seat 5: frosa9397 ($1.60 in chips) 
Seat 7: alexiscarel7 ($4.52 in chips) 
Seat 8: English_Ian ($1.98 in chips) 
Seat 9: kkksky ($1.84 in chips) 
Dorex2007: posts small blind $0.01
frosa9397: posts big blind $0.02
*** HOLE CARDS ***
Dealt to Dorex2007 [Tc Kd]
alexiscarel7: calls $0.02
English_Ian: folds 
kkksky: folds 
viilu: calls $0.02
goodmax3121: folds 
Admiral1812: folds 
Dorex2007: calls $0.01
frosa9397: checks 
*** FLOP *** [Jd 8h Ks]
Dorex2007: bets $0.08
frosa9397: folds 
alexiscarel7: folds 
viilu: folds 
Uncalled bet ($0.08) returned to Dorex2007
Dorex2007 collected $0.08 from pot
*** SUMMARY ***
Total pot $0.08 | Rake $0 
Board [Jd 8h Ks]
Seat 1: viilu folded on the Flop
Seat 2: goodmax3121 folded before Flop (didn't bet)
Seat 3: Admiral1812 (button) folded before Flop (didn't bet)
Seat 4: Dorex2007 (small blind) collected ($0.08)
Seat 5: frosa9397 (big blind) folded on the Flop
Seat 7: alexiscarel7 folded on the Flop
Seat 8: English_Ian folded before Flop (didn't bet)
Seat 9: kkksky folded before Flop (didn't bet)



PokerStars Hand #237402453277:  Hold'em No Limit ($0.01/$0.02 USD) - 2022/07/16 16:14:18 PT [2022/07/16 19:14:18 ET]
Table 'Kalypso IV' 9-max Seat #4 is the button
Seat 2: goodmax3121 ($3.13 in chips) 
Seat 3: Admiral1812 ($2.60 in chips) 
Seat 4: Dorex2007 ($2.15 in chips) 
Seat 5: frosa9397 ($1.58 in chips) 
Seat 7: alexiscarel7 ($4.50 in chips) 
Seat 8: English_Ian ($1.98 in chips) 
Seat 9: kkksky ($1.84 in chips) 
frosa9397: posts small blind $0.01
alexiscarel7: posts big blind $0.02
*** HOLE CARDS ***
Dealt to Dorex2007 [7c 5d]
viilu leaves the table
English_Ian: folds 
kkksky: folds 
goodmax3121: raises $0.02 to $0.04
Admiral1812: calls $0.04
Wesley-tche joins the table at seat #1 
Dorex2007: folds 
frosa9397: folds 
alexiscarel7: calls $0.02
*** FLOP *** [7d Kh Ks]
alexiscarel7: bets $0.06
goodmax3121: calls $0.06
Admiral1812: folds 
*** TURN *** [7d Kh Ks] [7s]
alexiscarel7: checks 
goodmax3121: checks 
*** RIVER *** [7d Kh Ks 7s] [Js]
alexiscarel7: bets $0.16
goodmax3121: folds 
Uncalled bet ($0.16) returned to alexiscarel7
alexiscarel7 collected $0.24 from pot
*** SUMMARY ***
Total pot $0.25 | Rake $0.01 
Board [7d Kh Ks 7s Js]
Seat 2: goodmax3121 folded on the River
Seat 3: Admiral1812 folded on the Flop
Seat 4: Dorex2007 (button) folded before Flop (didn't bet)
Seat 5: frosa9397 (small blind) folded before Flop
Seat 7: alexiscarel7 (big blind) collected ($0.24)
Seat 8: English_Ian folded before Flop (didn't bet)
Seat 9: kkksky folded before Flop (didn't bet)



PokerStars Hand #237402475001:  Hold'em No Limit ($0.01/$0.02 USD) - 2022/07/16 16:15:37 PT [2022/07/16 19:15:37 ET]
Table 'Kalypso IV' 9-max Seat #5 is the button
Seat 1: Wesley-tche ($1.60 in chips) 
Seat 2: goodmax3121 ($3.03 in chips) 
Seat 3: Admiral1812 ($2.56 in chips) 
Seat 4: Dorex2007 ($2.15 in chips) 
Seat 5: frosa9397 ($1.57 in chips) 
Seat 7: alexiscarel7 ($4.64 in chips) 
Seat 8: English_Ian ($1.98 in chips) 
Seat 9: kkksky ($1.84 in chips) 
alexiscarel7: posts small blind $0.01
English_Ian: posts big blind $0.02
Wesley-tche: posts big blind $0.02
*** HOLE CARDS ***
Dealt to Dorex2007 [3h 5h]
kkksky: folds 
Wesley-tche: checks 
kkksky leaves the table
goodmax3121: raises $0.02 to $0.04
Admiral1812: calls $0.04
Dorex2007: folds 
frosa9397: folds 
alexiscarel7: folds 
English_Ian: folds 
izzu007 joins the table at seat #9 
Wesley-tche: calls $0.02
*** FLOP *** [5d 3d 9s]
Wesley-tche: checks 
goodmax3121: checks 
Admiral1812: checks 
*** TURN *** [5d 3d 9s] [4h]
Wesley-tche: checks 
goodmax3121: checks 
Admiral1812: checks 
*** RIVER *** [5d 3d 9s 4h] [Qc]
Wesley-tche: checks 
goodmax3121: checks 
Admiral1812: checks 
*** SHOW DOWN ***
Wesley-tche: shows [Ts 7c] (high card Queen)
goodmax3121: shows [Jc Ac] (high card Ace)
Admiral1812: shows [Kd Qs] (a pair of Queens)
Admiral1812 collected $0.14 from pot
*** SUMMARY ***
Total pot $0.15 | Rake $0.01 
Board [5d 3d 9s 4h Qc]
Seat 1: Wesley-tche showed [Ts 7c] and lost with high card Queen
Seat 2: goodmax3121 showed [Jc Ac] and lost with high card Ace
Seat 3: Admiral1812 showed [Kd Qs] and won ($0.14) with a pair of Queens
Seat 4: Dorex2007 folded before Flop (didn't bet)
Seat 5: frosa9397 (button) folded before Flop (didn't bet)
Seat 7: alexiscarel7 (small blind) folded before Flop
Seat 8: English_Ian (big blind) folded before Flop
Seat 9: kkksky folded before Flop (didn't bet)



PokerStars Hand #237402501706:  Hold'em No Limit ($0.01/$0.02 USD) - 2022/07/16 16:17:14 PT [2022/07/16 19:17:14 ET]
Table 'Kalypso IV' 9-max Seat #7 is the button
Seat 1: Wesley-tche ($1.56 in chips) 
Seat 2: goodmax3121 ($2.99 in chips) 
Seat 3: Admiral1812 ($2.66 in chips) 
Seat 4: Dorex2007 ($2.15 in chips) 
Seat 5: frosa9397 ($1.57 in chips) 
Seat 7: alexiscarel7 ($4.63 in chips) 
Seat 8: English_Ian ($1.96 in chips) 
Seat 9: izzu007 ($0.80 in chips) 
English_Ian: posts small blind $0.01
izzu007: posts big blind $0.02
*** HOLE CARDS ***
Dealt to Dorex2007 [Th Qd]
Wesley-tche: calls $0.02
goodmax3121: raises $0.02 to $0.04
Admiral1812: folds 
Dorex2007: folds 
frosa9397: folds 
alexiscarel7: calls $0.04
English_Ian: folds 
izzu007: folds 
Wesley-tche: calls $0.02
*** FLOP *** [Kd 2h Td]
Wesley-tche: checks 
goodmax3121: checks 
alexiscarel7: bets $0.07
Wesley-tche: folds 
goodmax3121: calls $0.07
*** TURN *** [Kd 2h Td] [6s]
goodmax3121: checks 
alexiscarel7: checks 
*** RIVER *** [Kd 2h Td 6s] [Jh]
goodmax3121: checks 
alexiscarel7: checks 
*** SHOW DOWN ***
goodmax3121: shows [7s Ad] (high card Ace)
alexiscarel7: mucks hand 
goodmax3121 collected $0.28 from pot
*** SUMMARY ***
Total pot $0.29 | Rake $0.01 
Board [Kd 2h Td 6s Jh]
Seat 1: Wesley-tche folded on the Flop
Seat 2: goodmax3121 showed [7s Ad] and won ($0.28) with high card Ace
Seat 3: Admiral1812 folded before Flop (didn't bet)
Seat 4: Dorex2007 folded before Flop (didn't bet)
Seat 5: frosa9397 folded before Flop (didn't bet)
Seat 7: alexiscarel7 (button) mucked [7c 9h]
Seat 8: English_Ian (small blind) folded before Flop
Seat 9: izzu007 (big blind) folded before Flop



PokerStars Hand #237402539678:  Hold'em No Limit ($0.01/$0.02 USD) - 2022/07/16 16:18:46 PT [2022/07/16 19:18:46 ET]
Table 'Kalypso IV' 9-max Seat #8 is the button
Seat 1: Wesley-tche ($1.52 in chips) 
Seat 2: goodmax3121 ($3.16 in chips) 
Seat 3: Admiral1812 ($2.66 in chips) 
Seat 4: Dorex2007 ($2.15 in chips) 
Seat 5: frosa9397 ($1.57 in chips) 
Seat 7: alexiscarel7 ($4.52 in chips) 
Seat 8: English_Ian ($1.95 in chips) 
Seat 9: izzu007 ($0.78 in chips) 
izzu007: posts small blind $0.01
Wesley-tche: posts big blind $0.02
*** HOLE CARDS ***
Dealt to Dorex2007 [2d Jd]
goodmax3121: calls $0.02
Admiral1812: folds 
Dorex2007: folds 
frosa9397 has timed out
frosa9397: folds 
alexiscarel7: calls $0.02
English_Ian: folds 
izzu007: folds 
Wesley-tche: checks 
*** FLOP *** [6d Td 4h]
Wesley-tche: checks 
goodmax3121: checks 
frosa9397 leaves the table
alexiscarel7: bets $0.07
Wesley-tche: calls $0.07
goodmax3121: calls $0.07
*** TURN *** [6d Td 4h] [Qs]
Wesley-tche: checks 
goodmax3121: checks 
alexiscarel7: checks 
*** RIVER *** [6d Td 4h Qs] [Qh]
Wesley-tche: checks 
goodmax3121: checks 
moiguca joins the table at seat #5 
alexiscarel7: bets $0.13
Wesley-tche: folds 
goodmax3121: folds 
Uncalled bet ($0.13) returned to alexiscarel7
alexiscarel7 collected $0.27 from pot
*** SUMMARY ***
Total pot $0.28 | Rake $0.01 
Board [6d Td 4h Qs Qh]
Seat 1: Wesley-tche (big blind) folded on the River
Seat 2: goodmax3121 folded on the River
Seat 3: Admiral1812 folded before Flop (didn't bet)
Seat 4: Dorex2007 folded before Flop (didn't bet)
Seat 5: frosa9397 folded before Flop (didn't bet)
Seat 7: alexiscarel7 collected ($0.27)
Seat 8: English_Ian (button) folded before Flop (didn't bet)
Seat 9: izzu007 (small blind) folded before Flop



PokerStars Hand #237402561891:  Hold'em No Limit ($0.01/$0.02 USD) - 2022/07/16 16:20:09 PT [2022/07/16 19:20:09 ET]
Table 'Kalypso IV' 9-max Seat #9 is the button
Seat 1: Wesley-tche ($1.43 in chips) 
Seat 2: goodmax3121 ($3.07 in chips) 
Seat 3: Admiral1812 ($2.66 in chips) 
Seat 4: Dorex2007 ($2.15 in chips) 
Seat 7: alexiscarel7 ($4.70 in chips) 
Seat 8: English_Ian ($1.95 in chips) 
Seat 9: izzu007 ($0.77 in chips) 
Wesley-tche: posts small blind $0.01
goodmax3121: posts big blind $0.02
moiguca: sits out 
*** HOLE CARDS ***
Dealt to Dorex2007 [6s Ac]
Admiral1812: folds 
Dorex2007: folds 
alexiscarel7: folds 
English_Ian: folds 
izzu007: folds 
Wesley-tche: raises $0.04 to $0.06
goodmax3121: calls $0.04
*** FLOP *** [8c 5c 4s]
Wesley-tche: bets $0.06
goodmax3121: calls $0.06
*** TURN *** [8c 5c 4s] [Qs]
Wesley-tche: bets $0.23
goodmax3121: folds 
Uncalled bet ($0.23) returned to Wesley-tche
Wesley-tche collected $0.23 from pot
*** SUMMARY ***
Total pot $0.24 | Rake $0.01 
Board [8c 5c 4s Qs]
Seat 1: Wesley-tche (small blind) collected ($0.23)
Seat 2: goodmax3121 (big blind) folded on the Turn
Seat 3: Admiral1812 folded before Flop (didn't bet)
Seat 4: Dorex2007 folded before Flop (didn't bet)
Seat 7: alexiscarel7 folded before Flop (didn't bet)
Seat 8: English_Ian folded before Flop (didn't bet)
Seat 9: izzu007 (button) folded before Flop (didn't bet)



PokerStars Hand #237402576583:  Hold'em No Limit ($0.01/$0.02 USD) - 2022/07/16 16:21:03 PT [2022/07/16 19:21:03 ET]
Table 'Kalypso IV' 9-max Seat #1 is the button
Seat 1: Wesley-tche ($1.54 in chips) 
Seat 2: goodmax3121 ($2.95 in chips) 
Seat 3: Admiral1812 ($2.66 in chips) 
Seat 4: Dorex2007 ($2.15 in chips) 
Seat 5: moiguca ($0.80 in chips) 
Seat 7: alexiscarel7 ($4.70 in chips) 
Seat 8: English_Ian ($1.95 in chips) 
Seat 9: izzu007 ($0.77 in chips) 
goodmax3121: posts small blind $0.01
Admiral1812: posts big blind $0.02
moiguca: posts big blind $0.02
*** HOLE CARDS ***
Dealt to Dorex2007 [6s Kd]
Dorex2007: folds 
Juagonzalez leaves the table
moiguca: checks 
alexiscarel7: folds 
English_Ian: folds 
izzu007: folds 
Wesley-tche: folds 
goodmax3121: calls $0.01
Admiral1812: checks 
*** FLOP *** [As Jc 2c]
goodmax3121: bets $0.02
Admiral1812: calls $0.02
moiguca: calls $0.02
*** TURN *** [As Jc 2c] [Td]
goodmax3121: checks 
Admiral1812: checks 
moiguca: checks 
*** RIVER *** [As Jc 2c Td] [4d]
goodmax3121: checks 
Admiral1812: checks 
moiguca: bets $0.06
goodmax3121: calls $0.06
Admiral1812: folds 
*** SHOW DOWN ***
moiguca: shows [4s 4h] (three of a kind, Fours)
goodmax3121: mucks hand 
moiguca collected $0.23 from pot
*** SUMMARY ***
Total pot $0.24 | Rake $0.01 
Board [As Jc 2c Td 4d]
Seat 1: Wesley-tche (button) folded before Flop (didn't bet)
Seat 2: goodmax3121 (small blind) mucked [Jd 8h]
Seat 3: Admiral1812 (big blind) folded on the River
Seat 4: Dorex2007 folded before Flop (didn't bet)
Seat 5: moiguca showed [4s 4h] and won ($0.23) with three of a kind, Fours
Seat 7: alexiscarel7 folded before Flop (didn't bet)
Seat 8: English_Ian folded before Flop (didn't bet)
Seat 9: izzu007 folded before Flop (didn't bet)



PokerStars Hand #237402591723:  Hold'em No Limit ($0.01/$0.02 USD) - 2022/07/16 16:21:59 PT [2022/07/16 19:21:59 ET]
Table 'Kalypso IV' 9-max Seat #2 is the button
Seat 1: Wesley-tche ($1.54 in chips) 
Seat 2: goodmax3121 ($2.85 in chips) 
Seat 3: Admiral1812 ($2.62 in chips) 
Seat 4: Dorex2007 ($2.15 in chips) 
Seat 5: moiguca ($0.93 in chips) 
Seat 7: alexiscarel7 ($4.70 in chips) 
Seat 8: English_Ian ($1.95 in chips) 
Seat 9: izzu007 ($0.77 in chips) 
Admiral1812: posts small blind $0.01
Dorex2007: posts big blind $0.02
*** HOLE CARDS ***
Dealt to Dorex2007 [5c 5s]
moiguca: folds 
alexiscarel7: folds 
English_Ian: folds 
izzu007: folds 
Wesley-tche: folds 
goodmax3121: calls $0.02
Admiral1812: folds 
Dorex2007: checks 
*** FLOP *** [Kd 5d 8d]
Dorex2007: bets $0.08
goodmax3121: folds 
Uncalled bet ($0.08) returned to Dorex2007
Dorex2007 collected $0.05 from pot
*** SUMMARY ***
Total pot $0.05 | Rake $0 
Board [Kd 5d 8d]
Seat 1: Wesley-tche folded before Flop (didn't bet)
Seat 2: goodmax3121 (button) folded on the Flop
Seat 3: Admiral1812 (small blind) folded before Flop
Seat 4: Dorex2007 (big blind) collected ($0.05)
Seat 5: moiguca folded before Flop (didn't bet)
Seat 7: alexiscarel7 folded before Flop (didn't bet)
Seat 8: English_Ian folded before Flop (didn't bet)
Seat 9: izzu007 folded before Flop (didn't bet)



PokerStars Hand #237402600735:  Hold'em No Limit ($0.01/$0.02 USD) - 2022/07/16 16:22:33 PT [2022/07/16 19:22:33 ET]
Table 'Kalypso IV' 9-max Seat #3 is the button
Seat 1: Wesley-tche ($1.54 in chips) 
Seat 2: goodmax3121 ($2.83 in chips) 
Seat 3: Admiral1812 ($2.61 in chips) 
Seat 4: Dorex2007 ($2.18 in chips) 
Seat 5: moiguca ($0.93 in chips) 
Seat 7: alexiscarel7 ($4.70 in chips) 
Seat 8: English_Ian ($1.95 in chips) 
Seat 9: izzu007 ($0.77 in chips) 
Dorex2007: posts small blind $0.01
moiguca: posts big blind $0.02
*** HOLE CARDS ***
Dealt to Dorex2007 [Td 7c]
alexiscarel7: folds 
English_Ian: folds 
izzu007: folds 
Wesley-tche: calls $0.02
goodmax3121: raises $0.02 to $0.04
Admiral1812: folds 
Dorex2007: folds 
moiguca: folds 
Wesley-tche: calls $0.02
*** FLOP *** [Jc 8d 8h]
Wesley-tche: checks 
goodmax3121: checks 
*** TURN *** [Jc 8d 8h] [6c]
Wesley-tche: checks 
goodmax3121: checks 
*** RIVER *** [Jc 8d 8h 6c] [9h]
Wesley-tche: checks 
goodmax3121: checks 
*** SHOW DOWN ***
Wesley-tche: shows [Ah 7d] (a pair of Eights)
goodmax3121: mucks hand 
Wesley-tche collected $0.11 from pot
*** SUMMARY ***
Total pot $0.11 | Rake $0 
Board [Jc 8d 8h 6c 9h]
Seat 1: Wesley-tche showed [Ah 7d] and won ($0.11) with a pair of Eights
Seat 2: goodmax3121 mucked [Kd 4h]
Seat 3: Admiral1812 (button) folded before Flop (didn't bet)
Seat 4: Dorex2007 (small blind) folded before Flop
Seat 5: moiguca (big blind) folded before Flop
Seat 7: alexiscarel7 folded before Flop (didn't bet)
Seat 8: English_Ian folded before Flop (didn't bet)
Seat 9: izzu007 folded before Flop (didn't bet)



PokerStars Hand #237402614292:  Hold'em No Limit ($0.01/$0.02 USD) - 2022/07/16 16:23:23 PT [2022/07/16 19:23:23 ET]
Table 'Kalypso IV' 9-max Seat #4 is the button
Seat 1: Wesley-tche ($1.61 in chips) 
Seat 2: goodmax3121 ($2.79 in chips) 
Seat 3: Admiral1812 ($2.61 in chips) 
Seat 4: Dorex2007 ($2.17 in chips) 
Seat 5: moiguca ($0.91 in chips) 
Seat 7: alexiscarel7 ($4.70 in chips) 
Seat 8: English_Ian ($1.95 in chips) 
Seat 9: izzu007 ($0.77 in chips) 
moiguca: posts small blind $0.01
alexiscarel7: posts big blind $0.02
*** HOLE CARDS ***
Dealt to Dorex2007 [4c Qd]
English_Ian: folds 
izzu007: calls $0.02
Wesley-tche: calls $0.02
goodmax3121: folds 
Admiral1812: folds 
Dorex2007: folds 
moiguca: folds 
alexiscarel7: checks 
*** FLOP *** [7h 7c 2h]
alexiscarel7: checks 
izzu007: checks 
Wesley-tche: checks 
*** TURN *** [7h 7c 2h] [Tc]
alexiscarel7: checks 
izzu007: checks 
Funky0Monkey joins the table at seat #6 
Wesley-tche: checks 
*** RIVER *** [7h 7c 2h Tc] [Jd]
alexiscarel7: checks 
izzu007: checks 
Wesley-tche: checks 
*** SHOW DOWN ***
alexiscarel7: shows [3d Ad] (a pair of Sevens)
izzu007: shows [Ah 3h] (a pair of Sevens)
Wesley-tche: shows [Td 8c] (two pair, Tens and Sevens)
Wesley-tche collected $0.07 from pot
*** SUMMARY ***
Total pot $0.07 | Rake $0 
Board [7h 7c 2h Tc Jd]
Seat 1: Wesley-tche showed [Td 8c] and won ($0.07) with two pair, Tens and Sevens
Seat 2: goodmax3121 folded before Flop (didn't bet)
Seat 3: Admiral1812 folded before Flop (didn't bet)
Seat 4: Dorex2007 (button) folded before Flop (didn't bet)
Seat 5: moiguca (small blind) folded before Flop
Seat 7: alexiscarel7 (big blind) showed [3d Ad] and lost with a pair of Sevens
Seat 8: English_Ian folded before Flop (didn't bet)
Seat 9: izzu007 showed [Ah 3h] and lost with a pair of Sevens



PokerStars Hand #237402625993:  Hold'em No Limit ($0.01/$0.02 USD) - 2022/07/16 16:24:07 PT [2022/07/16 19:24:07 ET]
Table 'Kalypso IV' 9-max Seat #5 is the button
Seat 1: Wesley-tche ($1.66 in chips) 
Seat 2: goodmax3121 ($2.79 in chips) 
Seat 3: Admiral1812 ($2.61 in chips) 
Seat 4: Dorex2007 ($2.17 in chips) 
Seat 5: moiguca ($0.90 in chips) 
Seat 7: alexiscarel7 ($4.68 in chips) 
Seat 8: English_Ian ($1.95 in chips) 
Seat 9: izzu007 ($0.75 in chips) 
alexiscarel7: posts small blind $0.01
English_Ian: posts big blind $0.02
*** HOLE CARDS ***
Dealt to Dorex2007 [Kc 9d]
izzu007: calls $0.02
Wesley-tche: folds 
goodmax3121: raises $0.02 to $0.04
Admiral1812: folds 
Dorex2007: folds 
moiguca: folds 
alexiscarel7: folds 
English_Ian: calls $0.02
izzu007: calls $0.02
*** FLOP *** [3c 2h 5h]
English_Ian: checks 
izzu007: checks 
goodmax3121: checks 
*** TURN *** [3c 2h 5h] [5c]
English_Ian: checks 
izzu007: bets $0.04
goodmax3121: calls $0.04
English_Ian: folds 
*** RIVER *** [3c 2h 5h 5c] [3h]
izzu007: checks 
goodmax3121: checks 
*** SHOW DOWN ***
izzu007: shows [2d 4d] (two pair, Fives and Threes)
goodmax3121: shows [As Kh] (two pair, Fives and Threes - Ace kicker)
goodmax3121 collected $0.20 from pot
*** SUMMARY ***
Total pot $0.21 | Rake $0.01 
Board [3c 2h 5h 5c 3h]
Seat 1: Wesley-tche folded before Flop (didn't bet)
Seat 2: goodmax3121 showed [As Kh] and won ($0.20) with two pair, Fives and Threes
Seat 3: Admiral1812 folded before Flop (didn't bet)
Seat 4: Dorex2007 folded before Flop (didn't bet)
Seat 5: moiguca (button) folded before Flop (didn't bet)
Seat 7: alexiscarel7 (small blind) folded before Flop
Seat 8: English_Ian (big blind) folded on the Turn
Seat 9: izzu007 showed [2d 4d] and lost with two pair, Fives and Threes



PokerStars Hand #237402639667:  Hold'em No Limit ($0.01/$0.02 USD) - 2022/07/16 16:24:57 PT [2022/07/16 19:24:57 ET]
Table 'Kalypso IV' 9-max Seat #7 is the button
Seat 1: Wesley-tche ($1.66 in chips) 
Seat 2: goodmax3121 ($2.91 in chips) 
Seat 3: Admiral1812 ($2.61 in chips) 
Seat 4: Dorex2007 ($2.17 in chips) 
Seat 5: moiguca ($0.90 in chips) 
Seat 7: alexiscarel7 ($4.67 in chips) 
Seat 8: English_Ian ($1.91 in chips) 
Seat 9: izzu007 ($0.67 in chips) 
English_Ian: posts small blind $0.01
izzu007: posts big blind $0.02
Funky0Monkey: sits out 
*** HOLE CARDS ***
Dealt to Dorex2007 [Ah Ks]
Wesley-tche: folds 
goodmax3121: raises $0.02 to $0.04
Admiral1812: folds 
Dorex2007: raises $0.06 to $0.10
moiguca: folds 
alexiscarel7: folds 
English_Ian: folds 
izzu007: folds 
goodmax3121: calls $0.06
*** FLOP *** [6d Qd Js]
goodmax3121: checks 
Dorex2007: bets $0.22
goodmax3121: folds 
Uncalled bet ($0.22) returned to Dorex2007
Dorex2007 collected $0.22 from pot
*** SUMMARY ***
Total pot $0.23 | Rake $0.01 
Board [6d Qd Js]
Seat 1: Wesley-tche folded before Flop (didn't bet)
Seat 2: goodmax3121 folded on the Flop
Seat 3: Admiral1812 folded before Flop (didn't bet)
Seat 4: Dorex2007 collected ($0.22)
Seat 5: moiguca folded before Flop (didn't bet)
Seat 7: alexiscarel7 (button) folded before Flop (didn't bet)
Seat 8: English_Ian (small blind) folded before Flop
Seat 9: izzu007 (big blind) folded before Flop



PokerStars Hand #237402647194:  Hold'em No Limit ($0.01/$0.02 USD) - 2022/07/16 16:25:26 PT [2022/07/16 19:25:26 ET]
Table 'Kalypso IV' 9-max Seat #8 is the button
Seat 1: Wesley-tche ($1.66 in chips) 
Seat 2: goodmax3121 ($2.81 in chips) 
Seat 3: Admiral1812 ($2.61 in chips) 
Seat 4: Dorex2007 ($2.29 in chips) 
Seat 5: moiguca ($0.90 in chips) 
Seat 7: alexiscarel7 ($4.67 in chips) 
Seat 8: English_Ian ($1.90 in chips) 
Seat 9: izzu007 ($0.65 in chips) 
izzu007: posts small blind $0.01
Wesley-tche: posts big blind $0.02
Funky0Monkey: sits out 
*** HOLE CARDS ***
Dealt to Dorex2007 [Tc Kh]
goodmax3121: folds 
Admiral1812: folds 
Dorex2007: calls $0.02
moiguca: calls $0.02
alexiscarel7: raises $0.10 to $0.12
English_Ian: folds 
izzu007: folds 
Wesley-tche: calls $0.10
Dorex2007: folds 
moiguca: folds 
*** FLOP *** [7h 3c Ad]
Wesley-tche: checks 
alexiscarel7: bets $0.14
Wesley-tche: folds 
Uncalled bet ($0.14) returned to alexiscarel7
alexiscarel7 collected $0.28 from pot
*** SUMMARY ***
Total pot $0.29 | Rake $0.01 
Board [7h 3c Ad]
Seat 1: Wesley-tche (big blind) folded on the Flop
Seat 2: goodmax3121 folded before Flop (didn't bet)
Seat 3: Admiral1812 folded before Flop (didn't bet)
Seat 4: Dorex2007 folded before Flop
Seat 5: moiguca folded before Flop
Seat 7: alexiscarel7 collected ($0.28)
Seat 8: English_Ian (button) folded before Flop (didn't bet)
Seat 9: izzu007 (small blind) folded before Flop



PokerStars Hand #237402663022:  Hold'em No Limit ($0.01/$0.02 USD) - 2022/07/16 16:26:26 PT [2022/07/16 19:26:26 ET]
Table 'Kalypso IV' 9-max Seat #9 is the button
Seat 1: Wesley-tche ($1.54 in chips) 
Seat 2: goodmax3121 ($2.81 in chips) 
Seat 3: Admiral1812 ($2.61 in chips) 
Seat 4: Dorex2007 ($2.27 in chips) 
Seat 5: moiguca ($0.88 in chips) 
Seat 7: alexiscarel7 ($4.83 in chips) 
Seat 8: English_Ian ($1.90 in chips) 
Seat 9: izzu007 ($0.64 in chips) 
Wesley-tche: posts small blind $0.01
goodmax3121: posts big blind $0.02
Funky0Monkey: sits out 
*** HOLE CARDS ***
Dealt to Dorex2007 [3s Jd]
Admiral1812: calls $0.02
Dorex2007: folds 
moiguca: folds 
alexiscarel7: folds 
English_Ian: folds 
izzu007 has timed out
izzu007: folds 
Wesley-tche: calls $0.01
goodmax3121: raises $0.02 to $0.04
Admiral1812: calls $0.02
Wesley-tche: calls $0.02
*** FLOP *** [Qh 8h 7c]
Wesley-tche: checks 
goodmax3121: checks 
Admiral1812: checks 
*** TURN *** [Qh 8h 7c] [Qc]
Wesley-tche: checks 
goodmax3121: bets $0.30
Admiral1812: folds 
Wesley-tche: folds 
Uncalled bet ($0.30) returned to goodmax3121
goodmax3121 collected $0.12 from pot
*** SUMMARY ***
Total pot $0.12 | Rake $0 
Board [Qh 8h 7c Qc]
Seat 1: Wesley-tche (small blind) folded on the Turn
Seat 2: goodmax3121 (big blind) collected ($0.12)
Seat 3: Admiral1812 folded on the Turn
Seat 4: Dorex2007 folded before Flop (didn't bet)
Seat 5: moiguca folded before Flop (didn't bet)
Seat 7: alexiscarel7 folded before Flop (didn't bet)
Seat 8: English_Ian folded before Flop (didn't bet)
Seat 9: izzu007 (button) folded before Flop (didn't bet)



PokerStars Hand #237402681134:  Hold'em No Limit ($0.01/$0.02 USD) - 2022/07/16 16:27:34 PT [2022/07/16 19:27:34 ET]
Table 'Kalypso IV' 9-max Seat #1 is the button
Seat 1: Wesley-tche ($1.50 in chips) 
Seat 2: goodmax3121 ($2.89 in chips) 
Seat 3: Admiral1812 ($2.57 in chips) 
Seat 4: Dorex2007 ($2.27 in chips) 
Seat 5: moiguca ($0.88 in chips) 
Seat 7: alexiscarel7 ($4.83 in chips) 
Seat 8: English_Ian ($1.90 in chips) 
Seat 9: izzu007 ($0.64 in chips) 
goodmax3121: posts small blind $0.01
Admiral1812: posts big blind $0.02
Funky0Monkey: sits out 
*** HOLE CARDS ***
Dealt to Dorex2007 [8s Qh]
Dorex2007: folds 
moiguca: folds 
alexiscarel7: folds 
English_Ian: folds 
izzu007: calls $0.02
Wesley-tche: folds 
goodmax3121: calls $0.01
Admiral1812: checks 
*** FLOP *** [Qs 4h Kd]
goodmax3121: checks 
Admiral1812: checks 
izzu007: checks 
*** TURN *** [Qs 4h Kd] [Jd]
goodmax3121: checks 
Admiral1812: checks 
izzu007: checks 
*** RIVER *** [Qs 4h Kd Jd] [9h]
goodmax3121: checks 
Admiral1812: checks 
izzu007: checks 
*** SHOW DOWN ***
goodmax3121: shows [8c 4c] (a pair of Fours)
Admiral1812: mucks hand 
izzu007: shows [9c Ad] (a pair of Nines)
izzu007 collected $0.06 from pot
*** SUMMARY ***
Total pot $0.06 | Rake $0 
Board [Qs 4h Kd Jd 9h]
Seat 1: Wesley-tche (button) folded before Flop (didn't bet)
Seat 2: goodmax3121 (small blind) showed [8c 4c] and lost with a pair of Fours
Seat 3: Admiral1812 (big blind) mucked [As 3s]
Seat 4: Dorex2007 folded before Flop (didn't bet)
Seat 5: moiguca folded before Flop (didn't bet)
Seat 7: alexiscarel7 folded before Flop (didn't bet)
Seat 8: English_Ian folded before Flop (didn't bet)
Seat 9: izzu007 showed [9c Ad] and won ($0.06) with a pair of Nines



PokerStars Hand #237402702014:  Hold'em No Limit ($0.01/$0.02 USD) - 2022/07/16 16:28:25 PT [2022/07/16 19:28:25 ET]
Table 'Kalypso IV' 9-max Seat #2 is the button
Seat 1: Wesley-tche ($1.50 in chips) 
Seat 2: goodmax3121 ($2.87 in chips) 
Seat 3: Admiral1812 ($2.55 in chips) 
Seat 4: Dorex2007 ($2.27 in chips) 
Seat 5: moiguca ($0.88 in chips) 
Seat 7: alexiscarel7 ($4.83 in chips) 
Seat 8: English_Ian ($1.90 in chips) 
Seat 9: izzu007 ($0.68 in chips) 
Admiral1812: posts small blind $0.01
Dorex2007: posts big blind $0.02
Funky0Monkey: sits out 
*** HOLE CARDS ***
Dealt to Dorex2007 [7s Js]
moiguca: folds 
alexiscarel7: raises $0.06 to $0.08
English_Ian: folds 
izzu007: folds 
Wesley-tche: folds 
goodmax3121: folds 
Admiral1812: folds 
Dorex2007: calls $0.06
*** FLOP *** [8c 7d 7h]
Dorex2007: bets $0.11
alexiscarel7: calls $0.11
*** TURN *** [8c 7d 7h] [Qc]
Dorex2007: bets $0.25
alexiscarel7: calls $0.25
*** RIVER *** [8c 7d 7h Qc] [5d]
Dorex2007: bets $0.57
alexiscarel7: folds 
Uncalled bet ($0.57) returned to Dorex2007
Dorex2007 collected $0.86 from pot
*** SUMMARY ***
Total pot $0.89 | Rake $0.03 
Board [8c 7d 7h Qc 5d]
Seat 1: Wesley-tche folded before Flop (didn't bet)
Seat 2: goodmax3121 (button) folded before Flop (didn't bet)
Seat 3: Admiral1812 (small blind) folded before Flop
Seat 4: Dorex2007 (big blind) collected ($0.86)
Seat 5: moiguca folded before Flop (didn't bet)
Seat 7: alexiscarel7 folded on the River
Seat 8: English_Ian folded before Flop (didn't bet)
Seat 9: izzu007 folded before Flop (didn't bet)



PokerStars Hand #237402724239:  Hold'em No Limit ($0.01/$0.02 USD) - 2022/07/16 16:29:50 PT [2022/07/16 19:29:50 ET]
Table 'Kalypso IV' 9-max Seat #3 is the button
Seat 1: Wesley-tche ($1.50 in chips) 
Seat 2: goodmax3121 ($2.87 in chips) 
Seat 3: Admiral1812 ($2.54 in chips) 
Seat 4: Dorex2007 ($2.69 in chips) 
Seat 5: moiguca ($0.88 in chips) 
Seat 7: alexiscarel7 ($4.39 in chips) 
Seat 8: English_Ian ($1.90 in chips) 
Seat 9: izzu007 ($0.68 in chips) 
Dorex2007: posts small blind $0.01
moiguca: posts big blind $0.02
Funky0Monkey: sits out 
*** HOLE CARDS ***
Dealt to Dorex2007 [Ac 7s]
alexiscarel7: folds 
English_Ian: folds 
izzu007: calls $0.02
Wesley-tche: folds 
goodmax3121: folds 
Admiral1812: folds 
Dorex2007: calls $0.01
moiguca: checks 
*** FLOP *** [3d 5c 2s]
Dorex2007: checks 
moiguca: bets $0.02
izzu007: calls $0.02
Dorex2007: calls $0.02
*** TURN *** [3d 5c 2s] [4c]
Dorex2007: checks 
moiguca: checks 
izzu007: bets $0.12
Dorex2007: raises $0.36 to $0.48
moiguca: folds 
izzu007: raises $0.16 to $0.64 and is all-in
Dorex2007: calls $0.16
*** RIVER *** [3d 5c 2s 4c] [Ks]
*** SHOW DOWN ***
Dorex2007: shows [Ac 7s] (a straight, Ace to Five)
izzu007: shows [6c 7c] (a straight, Three to Seven)
izzu007 cashed out the hand for $1.29 | Cash Out Fee $0.01
*** SUMMARY ***
Total pot $1.40 | Rake $0.05 
Board [3d 5c 2s 4c Ks]
Seat 1: Wesley-tche folded before Flop (didn't bet)
Seat 2: goodmax3121 folded before Flop (didn't bet)
Seat 3: Admiral1812 (button) folded before Flop (didn't bet)
Seat 4: Dorex2007 (small blind) showed [Ac 7s] and lost with a straight, Ace to Five
Seat 5: moiguca (big blind) folded on the Turn
Seat 7: alexiscarel7 folded before Flop (didn't bet)
Seat 8: English_Ian folded before Flop (didn't bet)
Seat 9: izzu007 showed [6c 7c] and won ($1.35) with a straight, Three to Seven (pot not awarded as player cashed out)



PokerStars Hand #237402741089:  Hold'em No Limit ($0.01/$0.02 USD) - 2022/07/16 16:30:53 PT [2022/07/16 19:30:53 ET]
Table 'Kalypso IV' 9-max Seat #4 is the button
Seat 1: Wesley-tche ($1.50 in chips) 
Seat 2: goodmax3121 ($2.87 in chips) 
Seat 3: Admiral1812 ($2.54 in chips) 
Seat 4: Dorex2007 ($2.01 in chips) 
Seat 5: moiguca ($0.84 in chips) 
Seat 6: Funky0Monkey ($2 in chips) 
Seat 7: alexiscarel7 ($4.39 in chips) 
Seat 8: English_Ian ($1.90 in chips) 
Seat 9: izzu007 ($1.29 in chips) 
moiguca: posts small blind $0.01
Funky0Monkey: posts big blind $0.02
*** HOLE CARDS ***
Dealt to Dorex2007 [6h Jh]
alexiscarel7: folds 
English_Ian: calls $0.02
izzu007: folds 
Wesley-tche: folds 
goodmax3121: folds 
Admiral1812: calls $0.02
Wesley-tche leaves the table
Dorex2007: folds 
moiguca: calls $0.01
Funky0Monkey: raises $0.08 to $0.10
English_Ian: calls $0.08
Agetro joins the table at seat #1 
Admiral1812: calls $0.08
moiguca: folds 
*** FLOP *** [2h Kh 9c]
Funky0Monkey: bets $0.20
English_Ian: folds 
Admiral1812: folds 
Uncalled bet ($0.20) returned to Funky0Monkey
Funky0Monkey collected $0.31 from pot
*** SUMMARY ***
Total pot $0.32 | Rake $0.01 
Board [2h Kh 9c]
Seat 1: Wesley-tche folded before Flop (didn't bet)
Seat 2: goodmax3121 folded before Flop (didn't bet)
Seat 3: Admiral1812 folded on the Flop
Seat 4: Dorex2007 (button) folded before Flop (didn't bet)
Seat 5: moiguca (small blind) folded before Flop
Seat 6: Funky0Monkey (big blind) collected ($0.31)
Seat 7: alexiscarel7 folded before Flop (didn't bet)
Seat 8: English_Ian folded on the Flop
Seat 9: izzu007 folded before Flop (didn't bet)



PokerStars Hand #237402754484:  Hold'em No Limit ($0.01/$0.02 USD) - 2022/07/16 16:31:44 PT [2022/07/16 19:31:44 ET]
Table 'Kalypso IV' 9-max Seat #5 is the button
Seat 2: goodmax3121 ($2.87 in chips) 
Seat 3: Admiral1812 ($2.44 in chips) 
Seat 4: Dorex2007 ($2.01 in chips) 
Seat 5: moiguca ($0.82 in chips) 
Seat 6: Funky0Monkey ($2.21 in chips) 
Seat 7: alexiscarel7 ($4.39 in chips) 
Seat 8: English_Ian ($1.80 in chips) 
Seat 9: izzu007 ($1.29 in chips) 
Funky0Monkey: posts small blind $0.01
alexiscarel7: posts big blind $0.02
Agetro: sits out 
*** HOLE CARDS ***
Dealt to Dorex2007 [6s 9d]
English_Ian: folds 
izzu007: folds 
goodmax3121: folds 
Admiral1812: calls $0.02
Dorex2007: folds 
moiguca: folds 
Funky0Monkey: folds 
alexiscarel7: checks 
*** FLOP *** [Ks Tc 2s]
alexiscarel7: checks 
Admiral1812: checks 
*** TURN *** [Ks Tc 2s] [Ts]
alexiscarel7: checks 
Admiral1812: checks 
*** RIVER *** [Ks Tc 2s Ts] [2h]
alexiscarel7: checks 
Admiral1812: bets $0.02
alexiscarel7: folds 
Uncalled bet ($0.02) returned to Admiral1812
Admiral1812 collected $0.05 from pot
*** SUMMARY ***
Total pot $0.05 | Rake $0 
Board [Ks Tc 2s Ts 2h]
Seat 2: goodmax3121 folded before Flop (didn't bet)
Seat 3: Admiral1812 collected ($0.05)
Seat 4: Dorex2007 folded before Flop (didn't bet)
Seat 5: moiguca (button) folded before Flop (didn't bet)
Seat 6: Funky0Monkey (small blind) folded before Flop
Seat 7: alexiscarel7 (big blind) folded on the River
Seat 8: English_Ian folded before Flop (didn't bet)
Seat 9: izzu007 folded before Flop (didn't bet)



PokerStars Hand #237402766153:  Hold'em No Limit ($0.01/$0.02 USD) - 2022/07/16 16:32:29 PT [2022/07/16 19:32:29 ET]
Table 'Kalypso IV' 9-max Seat #6 is the button
Seat 2: goodmax3121 ($2.87 in chips) 
Seat 3: Admiral1812 ($2.47 in chips) 
Seat 4: Dorex2007 ($2.01 in chips) 
Seat 5: moiguca ($0.82 in chips) 
Seat 6: Funky0Monkey ($2.20 in chips) 
Seat 7: alexiscarel7 ($4.37 in chips) 
Seat 8: English_Ian ($1.80 in chips) 
Seat 9: izzu007 ($1.29 in chips) 
alexiscarel7: posts small blind $0.01
English_Ian: posts big blind $0.02
Agetro: sits out 
*** HOLE CARDS ***
Dealt to Dorex2007 [3c Ac]
izzu007 has timed out
izzu007: folds 
goodmax3121: folds 
Admiral1812: calls $0.02
Dorex2007: calls $0.02
moiguca: calls $0.02
Funky0Monkey: folds 
alexiscarel7: raises $0.12 to $0.14
English_Ian: folds 
Admiral1812: folds 
Dorex2007: folds 
moiguca: calls $0.12
*** FLOP *** [7d 4s 6h]
alexiscarel7: bets $0.22
moiguca: folds 
Uncalled bet ($0.22) returned to alexiscarel7
alexiscarel7 collected $0.33 from pot
*** SUMMARY ***
Total pot $0.34 | Rake $0.01 
Board [7d 4s 6h]
Seat 2: goodmax3121 folded before Flop (didn't bet)
Seat 3: Admiral1812 folded before Flop
Seat 4: Dorex2007 folded before Flop
Seat 5: moiguca folded on the Flop
Seat 6: Funky0Monkey (button) folded before Flop (didn't bet)
Seat 7: alexiscarel7 (small blind) collected ($0.33)
Seat 8: English_Ian (big blind) folded before Flop
Seat 9: izzu007 folded before Flop (didn't bet)



PokerStars Hand #237402781038:  Hold'em No Limit ($0.01/$0.02 USD) - 2022/07/16 16:33:27 PT [2022/07/16 19:33:27 ET]
Table 'Kalypso IV' 9-max Seat #7 is the button
Seat 2: goodmax3121 ($2.87 in chips) 
Seat 3: Admiral1812 ($2.45 in chips) 
Seat 4: Dorex2007 ($2 in chips) 
Seat 5: moiguca ($0.68 in chips) 
Seat 6: Funky0Monkey ($2.20 in chips) 
Seat 7: alexiscarel7 ($4.56 in chips) 
Seat 8: English_Ian ($1.78 in chips) 
Seat 9: izzu007 ($1.29 in chips) 
English_Ian: posts small blind $0.01
izzu007: posts big blind $0.02
Agetro: sits out 
*** HOLE CARDS ***
Dealt to Dorex2007 [Qh 2c]
goodmax3121: folds 
Admiral1812: calls $0.02
Dorex2007: folds 
moiguca: folds 
Funky0Monkey: folds 
alexiscarel7: folds 
English_Ian: folds 
izzu007: checks 
*** FLOP *** [Jc 9h 7s]
izzu007: checks 
Admiral1812: checks 
*** TURN *** [Jc 9h 7s] [Ah]
izzu007: checks 
Admiral1812: checks 
*** RIVER *** [Jc 9h 7s Ah] [6c]
izzu007: checks 
Admiral1812: bets $0.02
izzu007: folds 
Uncalled bet ($0.02) returned to Admiral1812
Admiral1812 collected $0.05 from pot
*** SUMMARY ***
Total pot $0.05 | Rake $0 
Board [Jc 9h 7s Ah 6c]
Seat 2: goodmax3121 folded before Flop (didn't bet)
Seat 3: Admiral1812 collected ($0.05)
Seat 4: Dorex2007 folded before Flop (didn't bet)
Seat 5: moiguca folded before Flop (didn't bet)
Seat 6: Funky0Monkey folded before Flop (didn't bet)
Seat 7: alexiscarel7 (button) folded before Flop (didn't bet)
Seat 8: English_Ian (small blind) folded before Flop
Seat 9: izzu007 (big blind) folded on the River



PokerStars Hand #237402791771:  Hold'em No Limit ($0.01/$0.02 USD) - 2022/07/16 16:34:09 PT [2022/07/16 19:34:09 ET]
Table 'Kalypso IV' 9-max Seat #8 is the button
Seat 1: Agetro ($2 in chips) 
Seat 2: goodmax3121 ($2.87 in chips) 
Seat 3: Admiral1812 ($2.48 in chips) 
Seat 4: Dorex2007 ($2 in chips) 
Seat 5: moiguca ($0.68 in chips) 
Seat 6: Funky0Monkey ($2.20 in chips) 
Seat 7: alexiscarel7 ($4.56 in chips) 
Seat 8: English_Ian ($1.77 in chips) 
Seat 9: izzu007 ($1.27 in chips) 
izzu007: posts small blind $0.01
Agetro: posts big blind $0.02
*** HOLE CARDS ***
Dealt to Dorex2007 [6h 9c]
goodmax3121: folds 
Admiral1812: calls $0.02
Dorex2007: folds 
moiguca: raises $0.08 to $0.10
Funky0Monkey: raises $0.20 to $0.30
alexiscarel7: folds 
English_Ian: folds 
izzu007: folds 
Agetro: folds 
Admiral1812: folds 
moiguca: raises $0.38 to $0.68 and is all-in
Funky0Monkey: calls $0.38
Admiral1812 leaves the table
Agetro leaves the table
*** FLOP *** [Tc 2d 3s]
*** TURN *** [Tc 2d 3s] [Ah]
*** RIVER *** [Tc 2d 3s Ah] [8s]
*** SHOW DOWN ***
moiguca: shows [Jc Kc] (high card Ace)
Funky0Monkey: shows [Kd Kh] (a pair of Kings)
Funky0Monkey collected $1.36 from pot
moiguca cashed out the hand for $0.20
*** SUMMARY ***
Total pot $1.41 | Rake $0.05 
Board [Tc 2d 3s Ah 8s]
Seat 1: Agetro (big blind) folded before Flop
Seat 2: goodmax3121 folded before Flop (didn't bet)
Seat 3: Admiral1812 folded before Flop
Seat 4: Dorex2007 folded before Flop (didn't bet)
Seat 5: moiguca showed [Jc Kc] and lost with high card Ace (cashed out).
Seat 6: Funky0Monkey showed [Kd Kh] and won ($1.36) with a pair of Kings
Seat 7: alexiscarel7 folded before Flop (didn't bet)
Seat 8: English_Ian (button) folded before Flop (didn't bet)
Seat 9: izzu007 (small blind) folded before Flop



PokerStars Hand #237402805352:  Hold'em No Limit ($0.01/$0.02 USD) - 2022/07/16 16:35:03 PT [2022/07/16 19:35:03 ET]
Table 'Kalypso IV' 9-max Seat #9 is the button
Seat 2: goodmax3121 ($2.87 in chips) 
Seat 4: Dorex2007 ($2 in chips) 
Seat 5: moiguca ($0.20 in chips) 
Seat 6: Funky0Monkey ($2.88 in chips) 
Seat 7: alexiscarel7 ($4.56 in chips) 
Seat 8: English_Ian ($1.77 in chips) 
Seat 9: izzu007 ($1.26 in chips) 
goodmax3121: posts small blind $0.01
Dorex2007: posts big blind $0.02
*** HOLE CARDS ***
Dealt to Dorex2007 [Jc Ah]
moiguca: folds 
Funky0Monkey: folds 
alexiscarel7: calls $0.02
English_Ian: folds 
izzu007: folds 
goodmax3121: raises $0.02 to $0.04
Dorex2007: raises $0.10 to $0.14
alexiscarel7: folds 
goodmax3121: calls $0.10
*** FLOP *** [4d 4s 7d]
goodmax3121: checks 
Dorex2007: bets $0.29
goodmax3121: calls $0.29
*** TURN *** [4d 4s 7d] [7c]
goodmax3121: checks 
Dorex2007: bets $0.85
goodmax3121: calls $0.85
*** RIVER *** [4d 4s 7d 7c] [9h]
goodmax3121: checks 
Dorex2007: checks 
*** SHOW DOWN ***
goodmax3121: shows [Qh Kd] (two pair, Sevens and Fours)
Dorex2007: shows [Jc Ah] (two pair, Sevens and Fours - Ace kicker)
Dorex2007 collected $2.49 from pot
*** SUMMARY ***
Total pot $2.58 | Rake $0.09 
Board [4d 4s 7d 7c 9h]
Seat 2: goodmax3121 (small blind) showed [Qh Kd] and lost with two pair, Sevens and Fours
Seat 4: Dorex2007 (big blind) showed [Jc Ah] and won ($2.49) with two pair, Sevens and Fours
Seat 5: moiguca folded before Flop (didn't bet)
Seat 6: Funky0Monkey folded before Flop (didn't bet)
Seat 7: alexiscarel7 folded before Flop
Seat 8: English_Ian folded before Flop (didn't bet)
Seat 9: izzu007 (button) folded before Flop (didn't bet)



PokerStars Hand #237402819266:  Hold'em No Limit ($0.01/$0.02 USD) - 2022/07/16 16:35:57 PT [2022/07/16 19:35:57 ET]
Table 'Kalypso IV' 9-max Seat #2 is the button
Seat 2: goodmax3121 ($1.59 in chips) 
Seat 4: Dorex2007 ($3.21 in chips) 
Seat 5: moiguca ($0.20 in chips) 
Seat 6: Funky0Monkey ($2.88 in chips) 
Seat 7: alexiscarel7 ($4.54 in chips) 
Seat 8: English_Ian ($1.77 in chips) 
Seat 9: izzu007 ($1.26 in chips) 
Dorex2007: posts small blind $0.01
moiguca: posts big blind $0.02
*** HOLE CARDS ***
Dealt to Dorex2007 [Qd Jh]
Funky0Monkey: folds 
alexiscarel7: folds 
English_Ian: folds 
weverson315 joins the table at seat #3 
izzu007: calls $0.02
goodmax3121: folds 
CasObserver joins the table at seat #1 
Dorex2007: raises $0.08 to $0.10
moiguca: calls $0.08
izzu007: folds 
*** FLOP *** [3c 5c Kd]
Dorex2007: checks 
moiguca: bets $0.10 and is all-in
Dorex2007: folds 
Uncalled bet ($0.10) returned to moiguca
moiguca collected $0.21 from pot
*** SUMMARY ***
Total pot $0.22 | Rake $0.01 
Board [3c 5c Kd]
Seat 2: goodmax3121 (button) folded before Flop (didn't bet)
Seat 4: Dorex2007 (small blind) folded on the Flop
Seat 5: moiguca (big blind) collected ($0.21)
Seat 6: Funky0Monkey folded before Flop (didn't bet)
Seat 7: alexiscarel7 folded before Flop (didn't bet)
Seat 8: English_Ian folded before Flop (didn't bet)
Seat 9: izzu007 folded before Flop



PokerStars Hand #237402836751:  Hold'em No Limit ($0.01/$0.02 USD) - 2022/07/16 16:37:06 PT [2022/07/16 19:37:06 ET]
Table 'Kalypso IV' 9-max Seat #4 is the button
Seat 2: goodmax3121 ($1.59 in chips) 
Seat 3: weverson315 ($2 in chips) 
Seat 4: Dorex2007 ($3.11 in chips) 
Seat 5: moiguca ($0.31 in chips) 
Seat 6: Funky0Monkey ($2.88 in chips) 
Seat 7: alexiscarel7 ($4.54 in chips) 
Seat 8: English_Ian ($1.77 in chips) 
Seat 9: izzu007 ($1.24 in chips) 
moiguca: posts small blind $0.01
Funky0Monkey: posts big blind $0.02
CasObserver: sits out 
weverson315: posts big blind $0.02
*** HOLE CARDS ***
Dealt to Dorex2007 [5h Qd]
alexiscarel7: folds 
English_Ian: folds 
izzu007: raises $0.02 to $0.04
goodmax3121: calls $0.04
weverson315: folds 
Dorex2007: folds 
moiguca: folds 
Funky0Monkey: folds 
*** FLOP *** [9c 8s 2s]
izzu007: checks 
goodmax3121: checks 
*** TURN *** [9c 8s 2s] [Ac]
izzu007: bets $0.04
goodmax3121: calls $0.04
*** RIVER *** [9c 8s 2s Ac] [3d]
izzu007: bets $0.20
goodmax3121: folds 
Uncalled bet ($0.20) returned to izzu007
izzu007 collected $0.20 from pot
*** SUMMARY ***
Total pot $0.21 | Rake $0.01 
Board [9c 8s 2s Ac 3d]
Seat 2: goodmax3121 folded on the River
Seat 3: weverson315 folded before Flop (didn't bet)
Seat 4: Dorex2007 (button) folded before Flop (didn't bet)
Seat 5: moiguca (small blind) folded before Flop
Seat 6: Funky0Monkey (big blind) folded before Flop
Seat 7: alexiscarel7 folded before Flop (didn't bet)
Seat 8: English_Ian folded before Flop (didn't bet)
Seat 9: izzu007 collected ($0.20)



PokerStars Hand #237402847114:  Hold'em No Limit ($0.01/$0.02 USD) - 2022/07/16 16:37:46 PT [2022/07/16 19:37:46 ET]
Table 'Kalypso IV' 9-max Seat #5 is the button
Seat 2: goodmax3121 ($1.51 in chips) 
Seat 3: weverson315 ($2 in chips) 
Seat 4: Dorex2007 ($3.11 in chips) 
Seat 5: moiguca ($0.30 in chips) 
Seat 6: Funky0Monkey ($2.86 in chips) 
Seat 7: alexiscarel7 ($4.54 in chips) 
Seat 8: English_Ian ($1.77 in chips) 
Seat 9: izzu007 ($1.36 in chips) 
Funky0Monkey: posts small blind $0.01
alexiscarel7: posts big blind $0.02
CasObserver: sits out 
*** HOLE CARDS ***
Dealt to Dorex2007 [9s 3h]
English_Ian: calls $0.02
izzu007: folds 
goodmax3121: raises $0.02 to $0.04
weverson315: calls $0.04
Dorex2007: folds 
moiguca: raises $0.09 to $0.13
Funky0Monkey: folds 
alexiscarel7: folds 
English_Ian: folds 
goodmax3121: folds 
weverson315: calls $0.09
*** FLOP *** [6h Tc Qs]
weverson315: checks 
moiguca: bets $0.17 and is all-in
weverson315: calls $0.17
*** TURN *** [6h Tc Qs] [5d]
*** RIVER *** [6h Tc Qs 5d] [7s]
*** SHOW DOWN ***
weverson315: shows [Jc 7c] (a pair of Sevens)
moiguca: shows [4c 4h] (a pair of Fours)
weverson315 collected $0.67 from pot
*** SUMMARY ***
Total pot $0.69 | Rake $0.02 
Board [6h Tc Qs 5d 7s]
Seat 2: goodmax3121 folded before Flop
Seat 3: weverson315 showed [Jc 7c] and won ($0.67) with a pair of Sevens
Seat 4: Dorex2007 folded before Flop (didn't bet)
Seat 5: moiguca (button) showed [4c 4h] and lost with a pair of Fours
Seat 6: Funky0Monkey (small blind) folded before Flop
Seat 7: alexiscarel7 (big blind) folded before Flop
Seat 8: English_Ian folded before Flop
Seat 9: izzu007 folded before Flop (didn't bet)



PokerStars Hand #237402862251:  Hold'em No Limit ($0.01/$0.02 USD) - 2022/07/16 16:38:46 PT [2022/07/16 19:38:46 ET]
Table 'Kalypso IV' 9-max Seat #6 is the button
Seat 2: goodmax3121 ($1.47 in chips) 
Seat 3: weverson315 ($2.37 in chips) 
Seat 4: Dorex2007 ($3.11 in chips) 
Seat 6: Funky0Monkey ($2.85 in chips) 
Seat 7: alexiscarel7 ($4.52 in chips) 
Seat 8: English_Ian ($1.75 in chips) 
Seat 9: izzu007 ($1.36 in chips) 
alexiscarel7: posts small blind $0.01
English_Ian: posts big blind $0.02
CasObserver: sits out 
*** HOLE CARDS ***
Dealt to Dorex2007 [5d Tc]
izzu007: raises $0.02 to $0.04
goodmax3121: calls $0.04
weverson315: folds 
Dorex2007: folds 
Funky0Monkey: folds 
alexiscarel7: folds 
English_Ian: calls $0.02
*** FLOP *** [Qh As Th]
English_Ian: checks 
izzu007: bets $0.06
goodmax3121: calls $0.06
English_Ian: folds 
*** TURN *** [Qh As Th] [7c]
izzu007: checks 
goodmax3121: checks 
*** RIVER *** [Qh As Th 7c] [4s]
izzu007: bets $0.12
goodmax3121: folds 
Uncalled bet ($0.12) returned to izzu007
izzu007 collected $0.24 from pot
*** SUMMARY ***
Total pot $0.25 | Rake $0.01 
Board [Qh As Th 7c 4s]
Seat 2: goodmax3121 folded on the River
Seat 3: weverson315 folded before Flop (didn't bet)
Seat 4: Dorex2007 folded before Flop (didn't bet)
Seat 6: Funky0Monkey (button) folded before Flop (didn't bet)
Seat 7: alexiscarel7 (small blind) folded before Flop
Seat 8: English_Ian (big blind) folded on the Flop
Seat 9: izzu007 collected ($0.24)



PokerStars Hand #237402874095:  Hold'em No Limit ($0.01/$0.02 USD) - 2022/07/16 16:39:33 PT [2022/07/16 19:39:33 ET]
Table 'Kalypso IV' 9-max Seat #7 is the button
Seat 2: goodmax3121 ($1.37 in chips) 
Seat 3: weverson315 ($2.37 in chips) 
Seat 4: Dorex2007 ($3.11 in chips) 
Seat 5: moiguca ($0.80 in chips) 
Seat 6: Funky0Monkey ($2.85 in chips) 
Seat 7: alexiscarel7 ($4.51 in chips) 
Seat 8: English_Ian ($1.71 in chips) 
Seat 9: izzu007 ($1.50 in chips) 
English_Ian: posts small blind $0.01
izzu007: posts big blind $0.02
CasObserver: sits out 
*** HOLE CARDS ***
Dealt to Dorex2007 [Kc 9s]
goodmax3121: folds 
weverson315: folds 
Dorex2007: folds 
moiguca: folds 
Funky0Monkey: raises $0.04 to $0.06
alexiscarel7: folds 
English_Ian: folds 
izzu007: folds 
Uncalled bet ($0.04) returned to Funky0Monkey
Funky0Monkey collected $0.05 from pot
*** SUMMARY ***
Total pot $0.05 | Rake $0 
Seat 2: goodmax3121 folded before Flop (didn't bet)
Seat 3: weverson315 folded before Flop (didn't bet)
Seat 4: Dorex2007 folded before Flop (didn't bet)
Seat 5: moiguca folded before Flop (didn't bet)
Seat 6: Funky0Monkey collected ($0.05)
Seat 7: alexiscarel7 (button) folded before Flop (didn't bet)
Seat 8: English_Ian (small blind) folded before Flop
Seat 9: izzu007 (big blind) folded before Flop



PokerStars Hand #237402877641:  Hold'em No Limit ($0.01/$0.02 USD) - 2022/07/16 16:39:47 PT [2022/07/16 19:39:47 ET]
Table 'Kalypso IV' 9-max Seat #8 is the button
Seat 1: CasObserver ($1 in chips) 
Seat 2: goodmax3121 ($1.37 in chips) 
Seat 3: weverson315 ($2.37 in chips) 
Seat 4: Dorex2007 ($3.11 in chips) 
Seat 5: moiguca ($0.80 in chips) 
Seat 6: Funky0Monkey ($2.88 in chips) 
Seat 7: alexiscarel7 ($4.51 in chips) 
Seat 8: English_Ian ($1.70 in chips) 
Seat 9: izzu007 ($1.48 in chips) 
izzu007: posts small blind $0.01
CasObserver: posts big blind $0.02
*** HOLE CARDS ***
Dealt to Dorex2007 [7c As]
goodmax3121: raises $0.02 to $0.04
weverson315: calls $0.04
Dorex2007: folds 
moiguca: folds 
Funky0Monkey: folds 
alexiscarel7: calls $0.04
English_Ian: folds 
izzu007: folds 
CasObserver: calls $0.02
*** FLOP *** [Js Jd 7s]
CasObserver: checks 
goodmax3121: checks 
weverson315: checks 
alexiscarel7: bets $0.10
CasObserver: folds 
goodmax3121: calls $0.10
weverson315: folds 
*** TURN *** [Js Jd 7s] [6s]
goodmax3121: checks 
alexiscarel7: checks 
*** RIVER *** [Js Jd 7s 6s] [6h]
goodmax3121: bets $1.23 and is all-in
alexiscarel7: folds 
Uncalled bet ($1.23) returned to goodmax3121
goodmax3121 collected $0.36 from pot
*** SUMMARY ***
Total pot $0.37 | Rake $0.01 
Board [Js Jd 7s 6s 6h]
Seat 1: CasObserver (big blind) folded on the Flop
Seat 2: goodmax3121 collected ($0.36)
Seat 3: weverson315 folded on the Flop
Seat 4: Dorex2007 folded before Flop (didn't bet)
Seat 5: moiguca folded before Flop (didn't bet)
Seat 6: Funky0Monkey folded before Flop (didn't bet)
Seat 7: alexiscarel7 folded on the River
Seat 8: English_Ian (button) folded before Flop (didn't bet)
Seat 9: izzu007 (small blind) folded before Flop



PokerStars Hand #237402891072:  Hold'em No Limit ($0.01/$0.02 USD) - 2022/07/16 16:40:40 PT [2022/07/16 19:40:40 ET]
Table 'Kalypso IV' 9-max Seat #9 is the button
Seat 1: CasObserver ($0.96 in chips) 
Seat 2: goodmax3121 ($1.59 in chips) 
Seat 3: weverson315 ($2.33 in chips) 
Seat 4: Dorex2007 ($3.11 in chips) 
Seat 5: moiguca ($0.80 in chips) 
Seat 6: Funky0Monkey ($2.88 in chips) 
Seat 7: alexiscarel7 ($4.37 in chips) 
Seat 8: English_Ian ($1.70 in chips) 
Seat 9: izzu007 ($1.47 in chips) 
CasObserver: posts small blind $0.01
goodmax3121: posts big blind $0.02
*** HOLE CARDS ***
Dealt to Dorex2007 [Jd 4s]
weverson315: folds 
Dorex2007: folds 
moiguca: folds 
Funky0Monkey: folds 
alexiscarel7: calls $0.02
English_Ian: folds 
izzu007: folds 
CasObserver: calls $0.01
goodmax3121: checks 
*** FLOP *** [2c 3s 7h]
CasObserver: checks 
goodmax3121: checks 
alexiscarel7: bets $0.06
CasObserver: folds 
goodmax3121: folds 
Uncalled bet ($0.06) returned to alexiscarel7
alexiscarel7 collected $0.06 from pot
*** SUMMARY ***
Total pot $0.06 | Rake $0 
Board [2c 3s 7h]
Seat 1: CasObserver (small blind) folded on the Flop
Seat 2: goodmax3121 (big blind) folded on the Flop
Seat 3: weverson315 folded before Flop (didn't bet)
Seat 4: Dorex2007 folded before Flop (didn't bet)
Seat 5: moiguca folded before Flop (didn't bet)
Seat 6: Funky0Monkey folded before Flop (didn't bet)
Seat 7: alexiscarel7 collected ($0.06)
Seat 8: English_Ian folded before Flop (didn't bet)
Seat 9: izzu007 (button) folded before Flop (didn't bet)



PokerStars Hand #237402898597:  Hold'em No Limit ($0.01/$0.02 USD) - 2022/07/16 16:41:10 PT [2022/07/16 19:41:10 ET]
Table 'Kalypso IV' 9-max Seat #1 is the button
Seat 1: CasObserver ($0.94 in chips) 
Seat 2: goodmax3121 ($1.57 in chips) 
Seat 3: weverson315 ($2.33 in chips) 
Seat 4: Dorex2007 ($3.11 in chips) 
Seat 5: moiguca ($0.80 in chips) 
Seat 6: Funky0Monkey ($2.88 in chips) 
Seat 7: alexiscarel7 ($4.41 in chips) 
Seat 8: English_Ian ($1.70 in chips) 
Seat 9: izzu007 ($1.47 in chips) 
goodmax3121: posts small blind $0.01
weverson315: posts big blind $0.02
*** HOLE CARDS ***
Dealt to Dorex2007 [3h 2h]
Dorex2007: folds 
moiguca: calls $0.02
Funky0Monkey: folds 
alexiscarel7: folds 
English_Ian: folds 
izzu007: calls $0.02
CasObserver: folds 
goodmax3121: calls $0.01
weverson315: checks 
*** FLOP *** [4d Kh 3s]
goodmax3121: checks 
weverson315: checks 
moiguca: checks 
izzu007: checks 
*** TURN *** [4d Kh 3s] [Jd]
goodmax3121: checks 
weverson315: checks 
moiguca: bets $0.06
izzu007: calls $0.06
goodmax3121: folds 
weverson315: calls $0.06
*** RIVER *** [4d Kh 3s Jd] [Th]
weverson315: checks 
moiguca: checks 
izzu007: bets $0.30
weverson315: folds 
moiguca: calls $0.30
*** SHOW DOWN ***
izzu007: shows [Ad Qh] (a straight, Ten to Ace)
moiguca: mucks hand 
izzu007 collected $0.83 from pot
*** SUMMARY ***
Total pot $0.86 | Rake $0.03 
Board [4d Kh 3s Jd Th]
Seat 1: CasObserver (button) folded before Flop (didn't bet)
Seat 2: goodmax3121 (small blind) folded on the Turn
Seat 3: weverson315 (big blind) folded on the River
Seat 4: Dorex2007 folded before Flop (didn't bet)
Seat 5: moiguca mucked [Jh 8h]
Seat 6: Funky0Monkey folded before Flop (didn't bet)
Seat 7: alexiscarel7 folded before Flop (didn't bet)
Seat 8: English_Ian folded before Flop (didn't bet)
Seat 9: izzu007 showed [Ad Qh] and won ($0.83) with a straight, Ten to Ace



PokerStars Hand #237402916154:  Hold'em No Limit ($0.01/$0.02 USD) - 2022/07/16 16:42:20 PT [2022/07/16 19:42:20 ET]
Table 'Kalypso IV' 9-max Seat #2 is the button
Seat 1: CasObserver ($0.94 in chips) 
Seat 2: goodmax3121 ($1.55 in chips) 
Seat 3: weverson315 ($2.25 in chips) 
Seat 4: Dorex2007 ($3.11 in chips) 
Seat 5: moiguca ($0.42 in chips) 
Seat 6: Funky0Monkey ($2.88 in chips) 
Seat 7: alexiscarel7 ($4.41 in chips) 
Seat 8: English_Ian ($1.70 in chips) 
Seat 9: izzu007 ($1.92 in chips) 
weverson315: posts small blind $0.01
Dorex2007: posts big blind $0.02
*** HOLE CARDS ***
Dealt to Dorex2007 [Th 2s]
moiguca: folds 
Funky0Monkey: raises $0.04 to $0.06
alexiscarel7: folds 
English_Ian: folds 
izzu007: folds 
CasObserver: folds 
goodmax3121: folds 
weverson315: calls $0.05
Dorex2007: folds 
*** FLOP *** [Ac Qd 3d]
weverson315: checks 
Funky0Monkey: bets $0.08
weverson315: calls $0.08
*** TURN *** [Ac Qd 3d] [Jd]
weverson315: checks 
Funky0Monkey: bets $0.15
weverson315: raises $1.96 to $2.11 and is all-in
Funky0Monkey: folds 
Uncalled bet ($1.96) returned to weverson315
weverson315 collected $0.58 from pot
*** SUMMARY ***
Total pot $0.60 | Rake $0.02 
Board [Ac Qd 3d Jd]
Seat 1: CasObserver folded before Flop (didn't bet)
Seat 2: goodmax3121 (button) folded before Flop (didn't bet)
Seat 3: weverson315 (small blind) collected ($0.58)
Seat 4: Dorex2007 (big blind) folded before Flop
Seat 5: moiguca folded before Flop (didn't bet)
Seat 6: Funky0Monkey folded on the Turn
Seat 7: alexiscarel7 folded before Flop (didn't bet)
Seat 8: English_Ian folded before Flop (didn't bet)
Seat 9: izzu007 folded before Flop (didn't bet)



PokerStars Hand #237402928944:  Hold'em No Limit ($0.01/$0.02 USD) - 2022/07/16 16:43:11 PT [2022/07/16 19:43:11 ET]
Table 'Kalypso IV' 9-max Seat #3 is the button
Seat 1: CasObserver ($0.94 in chips) 
Seat 2: goodmax3121 ($1.55 in chips) 
Seat 3: weverson315 ($2.54 in chips) 
Seat 4: Dorex2007 ($3.09 in chips) 
Seat 5: moiguca ($0.42 in chips) 
Seat 6: Funky0Monkey ($2.59 in chips) 
Seat 7: alexiscarel7 ($4.41 in chips) 
Seat 8: English_Ian ($1.70 in chips) 
Seat 9: izzu007 ($1.92 in chips) 
Dorex2007: posts small blind $0.01
moiguca: posts big blind $0.02
*** HOLE CARDS ***
Dealt to Dorex2007 [4s 5c]
Funky0Monkey: folds 
alexiscarel7: calls $0.02
English_Ian: folds 
izzu007: raises $0.04 to $0.06
CasObserver: folds 
goodmax3121: folds 
weverson315: calls $0.06
Dorex2007: folds 
moiguca: calls $0.04
alexiscarel7: calls $0.04
*** FLOP *** [6c Qs Kd]
moiguca: bets $0.12
alexiscarel7: folds 
izzu007: folds 
weverson315: folds 
Uncalled bet ($0.12) returned to moiguca
moiguca collected $0.24 from pot
*** SUMMARY ***
Total pot $0.25 | Rake $0.01 
Board [6c Qs Kd]
Seat 1: CasObserver folded before Flop (didn't bet)
Seat 2: goodmax3121 folded before Flop (didn't bet)
Seat 3: weverson315 (button) folded on the Flop
Seat 4: Dorex2007 (small blind) folded before Flop
Seat 5: moiguca (big blind) collected ($0.24)
Seat 6: Funky0Monkey folded before Flop (didn't bet)
Seat 7: alexiscarel7 folded on the Flop
Seat 8: English_Ian folded before Flop (didn't bet)
Seat 9: izzu007 folded on the Flop



PokerStars Hand #237402938375:  Hold'em No Limit ($0.01/$0.02 USD) - 2022/07/16 16:43:49 PT [2022/07/16 19:43:49 ET]
Table 'Kalypso IV' 9-max Seat #4 is the button
Seat 1: CasObserver ($0.94 in chips) 
Seat 2: goodmax3121 ($1.55 in chips) 
Seat 3: weverson315 ($2.48 in chips) 
Seat 4: Dorex2007 ($3.08 in chips) 
Seat 5: moiguca ($0.60 in chips) 
Seat 7: alexiscarel7 ($4.35 in chips) 
Seat 8: English_Ian ($1.70 in chips) 
Seat 9: izzu007 ($1.86 in chips) 
moiguca: posts small blind $0.01
Funky0Monkey: is sitting out 
alexiscarel7: posts big blind $0.02
*** HOLE CARDS ***
Dealt to Dorex2007 [Ad Td]
English_Ian: folds 
Funky0Monkey leaves the table
izzu007: calls $0.02
CasObserver: raises $0.06 to $0.08
goodmax3121: folds 
weverson315: folds 
Dorex2007: calls $0.08
moiguca: folds 
alexiscarel7: folds 
izzu007: calls $0.06
*** FLOP *** [Jh 2d 6h]
signaturefro joins the table at seat #6 
izzu007: checks 
CasObserver: bets $0.16
Dorex2007: folds 
izzu007: folds 
Uncalled bet ($0.16) returned to CasObserver
CasObserver collected $0.26 from pot
*** SUMMARY ***
Total pot $0.27 | Rake $0.01 
Board [Jh 2d 6h]
Seat 1: CasObserver collected ($0.26)
Seat 2: goodmax3121 folded before Flop (didn't bet)
Seat 3: weverson315 folded before Flop (didn't bet)
Seat 4: Dorex2007 (button) folded on the Flop
Seat 5: moiguca (small blind) folded before Flop
Seat 7: alexiscarel7 (big blind) folded before Flop
Seat 8: English_Ian folded before Flop (didn't bet)
Seat 9: izzu007 folded on the Flop



PokerStars Hand #237402953798:  Hold'em No Limit ($0.01/$0.02 USD) - 2022/07/16 16:44:52 PT [2022/07/16 19:44:52 ET]
Table 'Kalypso IV' 9-max Seat #5 is the button
Seat 1: CasObserver ($1.12 in chips) 
Seat 2: goodmax3121 ($1.55 in chips) 
Seat 3: weverson315 ($2.48 in chips) 
Seat 4: Dorex2007 ($3 in chips) 
Seat 5: moiguca ($0.59 in chips) 
Seat 7: alexiscarel7 ($4.33 in chips) 
Seat 8: English_Ian ($1.70 in chips) 
Seat 9: izzu007 ($1.78 in chips) 
alexiscarel7: posts small blind $0.01
English_Ian: posts big blind $0.02
*** HOLE CARDS ***
Dealt to Dorex2007 [5h Ks]
izzu007: raises $0.04 to $0.06
CasObserver: folds 
goodmax3121: folds 
weverson315: calls $0.06
Dorex2007: folds 
moiguca: folds 
alexiscarel7: folds 
English_Ian: folds 
*** FLOP *** [6d Kh Ad]
izzu007: checks 
weverson315: checks 
*** TURN *** [6d Kh Ad] [9d]
izzu007: checks 
weverson315: checks 
*** RIVER *** [6d Kh Ad 9d] [2h]
izzu007: checks 
weverson315: bets $0.08
izzu007: folds 
Uncalled bet ($0.08) returned to weverson315
weverson315 collected $0.14 from pot
*** SUMMARY ***
Total pot $0.15 | Rake $0.01 
Board [6d Kh Ad 9d 2h]
Seat 1: CasObserver folded before Flop (didn't bet)
Seat 2: goodmax3121 folded before Flop (didn't bet)
Seat 3: weverson315 collected ($0.14)
Seat 4: Dorex2007 folded before Flop (didn't bet)
Seat 5: moiguca (button) folded before Flop (didn't bet)
Seat 7: alexiscarel7 (small blind) folded before Flop
Seat 8: English_Ian (big blind) folded before Flop
Seat 9: izzu007 folded on the River



PokerStars Hand #237402966458:  Hold'em No Limit ($0.01/$0.02 USD) - 2022/07/16 16:45:42 PT [2022/07/16 19:45:42 ET]
Table 'Kalypso IV' 9-max Seat #7 is the button
Seat 1: CasObserver ($1.12 in chips) 
Seat 2: goodmax3121 ($1.55 in chips) 
Seat 3: weverson315 ($2.56 in chips) 
Seat 4: Dorex2007 ($3 in chips) 
Seat 5: moiguca ($0.59 in chips) 
Seat 6: signaturefro ($1.60 in chips) 
Seat 7: alexiscarel7 ($4.32 in chips) 
Seat 8: English_Ian ($1.68 in chips) 
Seat 9: izzu007 ($1.72 in chips) 
English_Ian: posts small blind $0.01
izzu007: posts big blind $0.02
signaturefro: posts big blind $0.02
*** HOLE CARDS ***
Dealt to Dorex2007 [Qd 2c]
CasObserver: folds 
goodmax3121: raises $0.02 to $0.04
weverson315: calls $0.04
Dorex2007: folds 
moiguca: folds 
signaturefro: folds 
alexiscarel7: folds 
English_Ian: folds 
izzu007: calls $0.02
*** FLOP *** [9h 9s 2d]
izzu007: checks 
goodmax3121: bets $0.10
weverson315: folds 
izzu007: folds 
Uncalled bet ($0.10) returned to goodmax3121
goodmax3121 collected $0.14 from pot
*** SUMMARY ***
Total pot $0.15 | Rake $0.01 
Board [9h 9s 2d]
Seat 1: CasObserver folded before Flop (didn't bet)
Seat 2: goodmax3121 collected ($0.14)
Seat 3: weverson315 folded on the Flop
Seat 4: Dorex2007 folded before Flop (didn't bet)
Seat 5: moiguca folded before Flop (didn't bet)
Seat 6: signaturefro folded before Flop (didn't bet)
Seat 7: alexiscarel7 (button) folded before Flop (didn't bet)
Seat 8: English_Ian (small blind) folded before Flop
Seat 9: izzu007 (big blind) folded on the Flop



PokerStars Hand #237402979379:  Hold'em No Limit ($0.01/$0.02 USD) - 2022/07/16 16:46:34 PT [2022/07/16 19:46:34 ET]
Table 'Kalypso IV' 9-max Seat #8 is the button
Seat 1: CasObserver ($1.12 in chips) 
Seat 2: goodmax3121 ($1.65 in chips) 
Seat 3: weverson315 ($2.52 in chips) 
Seat 4: Dorex2007 ($3 in chips) 
Seat 5: moiguca ($0.59 in chips) 
Seat 6: signaturefro ($1.58 in chips) 
Seat 7: alexiscarel7 ($4.32 in chips) 
Seat 8: English_Ian ($1.67 in chips) 
Seat 9: izzu007 ($1.68 in chips) 
izzu007: posts small blind $0.01
CasObserver: posts big blind $0.02
*** HOLE CARDS ***
Dealt to Dorex2007 [7c Kc]
goodmax3121: folds 
weverson315: folds 
Dorex2007: folds 
moiguca: folds 
signaturefro has timed out
signaturefro: folds 
alexiscarel7: folds 
English_Ian: raises $0.05 to $0.07
izzu007: calls $0.06
CasObserver: calls $0.05
*** FLOP *** [7s 7d 2d]
izzu007: checks 
CasObserver: bets $0.12
English_Ian: folds 
izzu007: folds 
Uncalled bet ($0.12) returned to CasObserver
CasObserver collected $0.20 from pot
*** SUMMARY ***
Total pot $0.21 | Rake $0.01 
Board [7s 7d 2d]
Seat 1: CasObserver (big blind) collected ($0.20)
Seat 2: goodmax3121 folded before Flop (didn't bet)
Seat 3: weverson315 folded before Flop (didn't bet)
Seat 4: Dorex2007 folded before Flop (didn't bet)
Seat 5: moiguca folded before Flop (didn't bet)
Seat 6: signaturefro folded before Flop (didn't bet)
Seat 7: alexiscarel7 folded before Flop (didn't bet)
Seat 8: English_Ian (button) folded on the Flop
Seat 9: izzu007 (small blind) folded on the Flop



PokerStars Hand #237402995860:  Hold'em No Limit ($0.01/$0.02 USD) - 2022/07/16 16:47:41 PT [2022/07/16 19:47:41 ET]
Table 'Kalypso IV' 9-max Seat #9 is the button
Seat 1: CasObserver ($1.25 in chips) 
Seat 2: goodmax3121 ($1.65 in chips) 
Seat 3: weverson315 ($2.52 in chips) 
Seat 4: Dorex2007 ($3 in chips) 
Seat 5: moiguca ($0.59 in chips) 
Seat 6: signaturefro ($1.58 in chips) 
Seat 7: alexiscarel7 ($4.32 in chips) 
Seat 8: English_Ian ($1.60 in chips) 
Seat 9: izzu007 ($1.61 in chips) 
CasObserver: posts small blind $0.01
goodmax3121: posts big blind $0.02
*** HOLE CARDS ***
Dealt to Dorex2007 [9d 4d]
weverson315: folds 
Dorex2007: folds 
moiguca: folds 
signaturefro: calls $0.02
alexiscarel7: folds 
English_Ian: calls $0.02
izzu007: folds 
CasObserver: calls $0.01
goodmax3121: checks 
*** FLOP *** [4s Kh 6c]
CasObserver: checks 
goodmax3121: checks 
signaturefro: checks 
English_Ian: checks 
*** TURN *** [4s Kh 6c] [3c]
CasObserver: checks 
goodmax3121: checks 
signaturefro: bets $0.02
English_Ian: folds 
CasObserver: calls $0.02
goodmax3121: folds 
*** RIVER *** [4s Kh 6c 3c] [Ks]
CasObserver: checks 
signaturefro: bets $0.09
CasObserver: folds 
Uncalled bet ($0.09) returned to signaturefro
signaturefro collected $0.12 from pot
*** SUMMARY ***
Total pot $0.12 | Rake $0 
Board [4s Kh 6c 3c Ks]
Seat 1: CasObserver (small blind) folded on the River
Seat 2: goodmax3121 (big blind) folded on the Turn
Seat 3: weverson315 folded before Flop (didn't bet)
Seat 4: Dorex2007 folded before Flop (didn't bet)
Seat 5: moiguca folded before Flop (didn't bet)
Seat 6: signaturefro collected ($0.12)
Seat 7: alexiscarel7 folded before Flop (didn't bet)
Seat 8: English_Ian folded on the Turn
Seat 9: izzu007 (button) folded before Flop (didn't bet)



PokerStars Hand #237403021485:  Hold'em No Limit ($0.01/$0.02 USD) - 2022/07/16 16:48:55 PT [2022/07/16 19:48:55 ET]
Table 'Kalypso IV' 9-max Seat #1 is the button
Seat 1: CasObserver ($1.21 in chips) 
Seat 2: goodmax3121 ($1.63 in chips) 
Seat 3: weverson315 ($2.52 in chips) 
Seat 4: Dorex2007 ($3 in chips) 
Seat 5: moiguca ($0.59 in chips) 
Seat 6: signaturefro ($1.66 in chips) 
Seat 7: alexiscarel7 ($4.32 in chips) 
Seat 8: English_Ian ($1.58 in chips) 
Seat 9: izzu007 ($1.61 in chips) 
goodmax3121: posts small blind $0.01
weverson315: posts big blind $0.02
*** HOLE CARDS ***
Dealt to Dorex2007 [Th Kh]
Dorex2007: raises $0.04 to $0.06
moiguca: folds 
signaturefro: calls $0.06
alexiscarel7: calls $0.06
English_Ian: folds 
izzu007: folds 
CasObserver: folds 
goodmax3121: calls $0.05
weverson315: folds 
*** FLOP *** [2s Kc Qs]
goodmax3121: checks 
Dorex2007: bets $0.25
signaturefro: folds 
alexiscarel7: folds 
goodmax3121: calls $0.25
*** TURN *** [2s Kc Qs] [4h]
goodmax3121: checks 
Dorex2007: checks 
*** RIVER *** [2s Kc Qs 4h] [Ah]
goodmax3121: bets $0.30
Dorex2007: folds 
Uncalled bet ($0.30) returned to goodmax3121
goodmax3121 collected $0.73 from pot
*** SUMMARY ***
Total pot $0.76 | Rake $0.03 
Board [2s Kc Qs 4h Ah]
Seat 1: CasObserver (button) folded before Flop (didn't bet)
Seat 2: goodmax3121 (small blind) collected ($0.73)
Seat 3: weverson315 (big blind) folded before Flop
Seat 4: Dorex2007 folded on the River
Seat 5: moiguca folded before Flop (didn't bet)
Seat 6: signaturefro folded on the Flop
Seat 7: alexiscarel7 folded on the Flop
Seat 8: English_Ian folded before Flop (didn't bet)
Seat 9: izzu007 folded before Flop (didn't bet)



PokerStars Hand #237403054877:  Hold'em No Limit ($0.01/$0.02 USD) - 2022/07/16 16:50:44 PT [2022/07/16 19:50:44 ET]
Table 'Kalypso IV' 9-max Seat #2 is the button
Seat 1: CasObserver ($1.21 in chips) 
Seat 2: goodmax3121 ($2.05 in chips) 
Seat 3: weverson315 ($2.50 in chips) 
Seat 4: Dorex2007 ($2.69 in chips) 
Seat 5: moiguca ($0.59 in chips) 
Seat 6: signaturefro ($1.60 in chips) 
Seat 7: alexiscarel7 ($4.26 in chips) 
Seat 8: English_Ian ($1.58 in chips) 
Seat 9: izzu007 ($1.61 in chips) 
weverson315: posts small blind $0.01
Dorex2007: posts big blind $0.02
*** HOLE CARDS ***
Dealt to Dorex2007 [7c 7d]
moiguca: calls $0.02
signaturefro: folds 
alexiscarel7: calls $0.02
English_Ian: calls $0.02
izzu007: folds 
CasObserver: calls $0.02
goodmax3121: raises $0.02 to $0.04
weverson315: calls $0.03
Dorex2007: raises $0.20 to $0.24
moiguca: calls $0.22
alexiscarel7: folds 
English_Ian: folds 
CasObserver: folds 
goodmax3121: calls $0.20
weverson315: folds 
*** FLOP *** [2h 9d 6d]
Dorex2007: bets $0.53
moiguca: calls $0.35 and is all-in
goodmax3121: folds 
Uncalled bet ($0.18) returned to Dorex2007
*** TURN *** [2h 9d 6d] [5h]
*** RIVER *** [2h 9d 6d 5h] [6s]
*** SHOW DOWN ***
Dorex2007: shows [7c 7d] (two pair, Sevens and Sixes)
moiguca: shows [Ts Ks] (a pair of Sixes)
Dorex2007 cashed out the hand for $1.12 | Cash Out Fee $0.01
*** SUMMARY ***
Total pot $1.52 | Rake $0.05 
Board [2h 9d 6d 5h 6s]
Seat 1: CasObserver folded before Flop
Seat 2: goodmax3121 (button) folded on the Flop
Seat 3: weverson315 (small blind) folded before Flop
Seat 4: Dorex2007 (big blind) showed [7c 7d] and won ($1.47) with two pair, Sevens and Sixes (pot not awarded as player cashed out)
Seat 5: moiguca showed [Ts Ks] and lost with a pair of Sixes
Seat 6: signaturefro folded before Flop (didn't bet)
Seat 7: alexiscarel7 folded before Flop
Seat 8: English_Ian folded before Flop
Seat 9: izzu007 folded before Flop (didn't bet)



PokerStars Hand #237403078353:  Hold'em No Limit ($0.01/$0.02 USD) - 2022/07/16 16:52:20 PT [2022/07/16 19:52:20 ET]
Table 'Kalypso IV' 9-max Seat #3 is the button
Seat 1: CasObserver ($1.19 in chips) 
Seat 2: goodmax3121 ($1.81 in chips) 
Seat 3: weverson315 ($2.46 in chips) 
Seat 4: Dorex2007 ($3.22 in chips) 
Seat 6: signaturefro ($1.60 in chips) 
Seat 7: alexiscarel7 ($4.24 in chips) 
Seat 8: English_Ian ($1.56 in chips) 
Seat 9: izzu007 ($1.61 in chips) 
Dorex2007: posts small blind $0.01
signaturefro: posts big blind $0.02
*** HOLE CARDS ***
Dealt to Dorex2007 [Qh Td]
alexiscarel7: calls $0.02
English_Ian: folds 
izzu007: folds 
CasObserver: folds 
goodmax3121: calls $0.02
weverson315: calls $0.02
Dorex2007: calls $0.01
signaturefro: checks 
*** FLOP *** [8s Qc Ts]
Dorex2007: bets $0.22
signaturefro: folds 
alexiscarel7: raises $0.28 to $0.50
goodmax3121: calls $0.50
weverson315: folds 
Dorex2007: raises $2.70 to $3.20 and is all-in
alexiscarel7: folds 
goodmax3121: folds 
Uncalled bet ($2.70) returned to Dorex2007
Dorex2007 collected $1.54 from pot
*** SUMMARY ***
Total pot $1.60 | Rake $0.06 
Board [8s Qc Ts]
Seat 1: CasObserver folded before Flop (didn't bet)
Seat 2: goodmax3121 folded on the Flop
Seat 3: weverson315 (button) folded on the Flop
Seat 4: Dorex2007 (small blind) collected ($1.54)
Seat 6: signaturefro (big blind) folded on the Flop
Seat 7: alexiscarel7 folded on the Flop
Seat 8: English_Ian folded before Flop (didn't bet)
Seat 9: izzu007 folded before Flop (didn't bet)



PokerStars Hand #237403100555:  Hold'em No Limit ($0.01/$0.02 USD) - 2022/07/16 16:53:52 PT [2022/07/16 19:53:52 ET]
Table 'Kalypso IV' 9-max Seat #4 is the button
Seat 1: CasObserver ($1.19 in chips) 
Seat 2: goodmax3121 ($1.29 in chips) 
Seat 3: weverson315 ($2.44 in chips) 
Seat 4: Dorex2007 ($4.24 in chips) 
Seat 6: signaturefro ($1.58 in chips) 
Seat 7: alexiscarel7 ($3.72 in chips) 
Seat 8: English_Ian ($2 in chips) 
Seat 9: izzu007 ($1.61 in chips) 
signaturefro: posts small blind $0.01
alexiscarel7: posts big blind $0.02
*** HOLE CARDS ***
Dealt to Dorex2007 [3c 8c]
English_Ian: calls $0.02
izzu007: calls $0.02
CasObserver: calls $0.02
goodmax3121: folds 
weverson315: folds 
Dorex2007: folds 
signaturefro: calls $0.01
alexiscarel7: checks 
*** FLOP *** [Tc As 6s]
signaturefro: checks 
alexiscarel7: checks 
English_Ian: checks 
izzu007: checks 
CasObserver: checks 
*** TURN *** [Tc As 6s] [Qs]
signaturefro: checks 
alexiscarel7: checks 
English_Ian: checks 
izzu007: bets $0.04
CasObserver: folds 
signaturefro: folds 
alexiscarel7: folds 
English_Ian: folds 
Uncalled bet ($0.04) returned to izzu007
izzu007 collected $0.10 from pot
*** SUMMARY ***
Total pot $0.10 | Rake $0 
Board [Tc As 6s Qs]
Seat 1: CasObserver folded on the Turn
Seat 2: goodmax3121 folded before Flop (didn't bet)
Seat 3: weverson315 folded before Flop (didn't bet)
Seat 4: Dorex2007 (button) folded before Flop (didn't bet)
Seat 6: signaturefro (small blind) folded on the Turn
Seat 7: alexiscarel7 (big blind) folded on the Turn
Seat 8: English_Ian folded on the Turn
Seat 9: izzu007 collected ($0.10)



PokerStars Hand #237403116480:  Hold'em No Limit ($0.01/$0.02 USD) - 2022/07/16 16:54:58 PT [2022/07/16 19:54:58 ET]
Table 'Kalypso IV' 9-max Seat #6 is the button
Seat 1: CasObserver ($1.17 in chips) 
Seat 2: goodmax3121 ($1.29 in chips) 
Seat 3: weverson315 ($2.44 in chips) 
Seat 4: Dorex2007 ($4.24 in chips) 
Seat 5: moiguca ($0.80 in chips) 
Seat 6: signaturefro ($1.56 in chips) 
Seat 7: alexiscarel7 ($3.70 in chips) 
Seat 8: English_Ian ($1.98 in chips) 
Seat 9: izzu007 ($1.69 in chips) 
alexiscarel7: posts small blind $0.01
English_Ian: posts big blind $0.02
moiguca: posts small & big blinds $0.03
*** HOLE CARDS ***
Dealt to Dorex2007 [4c Ts]
izzu007: folds 
CasObserver: folds 
goodmax3121: raises $0.04 to $0.06
weverson315: calls $0.06
Dorex2007: folds 
moiguca: folds 
signaturefro: calls $0.06
alexiscarel7: folds 
English_Ian: folds 
*** FLOP *** [9s Ks 5s]
goodmax3121: checks 
weverson315: checks 
signaturefro: checks 
*** TURN *** [9s Ks 5s] [Jd]
goodmax3121: checks 
weverson315: checks 
signaturefro: bets $0.04
goodmax3121: calls $0.04
weverson315: folds 
*** RIVER *** [9s Ks 5s Jd] [5c]
goodmax3121: bets $0.02
signaturefro: calls $0.02
*** SHOW DOWN ***
goodmax3121: shows [Ac Jc] (two pair, Jacks and Fives)
signaturefro: shows [9h Jh] (two pair, Jacks and Nines)
signaturefro collected $0.35 from pot
*** SUMMARY ***
Total pot $0.36 | Rake $0.01 
Board [9s Ks 5s Jd 5c]
Seat 1: CasObserver folded before Flop (didn't bet)
Seat 2: goodmax3121 showed [Ac Jc] and lost with two pair, Jacks and Fives
Seat 3: weverson315 folded on the Turn
Seat 4: Dorex2007 folded before Flop (didn't bet)
Seat 5: moiguca folded before Flop (didn't bet)
Seat 6: signaturefro (button) showed [9h Jh] and won ($0.35) with two pair, Jacks and Nines
Seat 7: alexiscarel7 (small blind) folded before Flop
Seat 8: English_Ian (big blind) folded before Flop
Seat 9: izzu007 folded before Flop (didn't bet)



PokerStars Hand #237403133576:  Hold'em No Limit ($0.01/$0.02 USD) - 2022/07/16 16:56:19 PT [2022/07/16 19:56:19 ET]
Table 'Kalypso IV' 9-max Seat #7 is the button
Seat 1: CasObserver ($1.17 in chips) 
Seat 2: goodmax3121 ($1.17 in chips) 
Seat 3: weverson315 ($2.38 in chips) 
Seat 4: Dorex2007 ($4.24 in chips) 
Seat 5: moiguca ($0.77 in chips) 
Seat 6: signaturefro ($1.79 in chips) 
Seat 7: alexiscarel7 ($3.69 in chips) 
Seat 8: English_Ian ($1.96 in chips) 
Seat 9: izzu007 ($1.69 in chips) 
English_Ian: posts small blind $0.01
izzu007: posts big blind $0.02
*** HOLE CARDS ***
Dealt to Dorex2007 [Qs 4d]
CasObserver: folds 
goodmax3121: folds 
weverson315: folds 
Dorex2007: folds 
moiguca: folds 
signaturefro: folds 
alexiscarel7: raises $0.06 to $0.08
English_Ian: folds 
izzu007: calls $0.06
*** FLOP *** [Jd 7d 8c]
izzu007: checks 
alexiscarel7: bets $0.12
izzu007: calls $0.12
*** TURN *** [Jd 7d 8c] [5d]
izzu007: checks 
alexiscarel7: checks 
*** RIVER *** [Jd 7d 8c 5d] [8d]
izzu007: checks 
alexiscarel7: bets $0.20
izzu007: calls $0.20
*** SHOW DOWN ***
alexiscarel7: shows [Ts Jh] (two pair, Jacks and Eights)
izzu007: shows [2s 8s] (three of a kind, Eights)
izzu007 collected $0.78 from pot
*** SUMMARY ***
Total pot $0.81 | Rake $0.03 
Board [Jd 7d 8c 5d 8d]
Seat 1: CasObserver folded before Flop (didn't bet)
Seat 2: goodmax3121 folded before Flop (didn't bet)
Seat 3: weverson315 folded before Flop (didn't bet)
Seat 4: Dorex2007 folded before Flop (didn't bet)
Seat 5: moiguca folded before Flop (didn't bet)
Seat 6: signaturefro folded before Flop (didn't bet)
Seat 7: alexiscarel7 (button) showed [Ts Jh] and lost with two pair, Jacks and Eights
Seat 8: English_Ian (small blind) folded before Flop
Seat 9: izzu007 (big blind) showed [2s 8s] and won ($0.78) with three of a kind, Eights



PokerStars Hand #237403150527:  Hold'em No Limit ($0.01/$0.02 USD) - 2022/07/16 16:57:42 PT [2022/07/16 19:57:42 ET]
Table 'Kalypso IV' 9-max Seat #8 is the button
Seat 1: CasObserver ($1.17 in chips) 
Seat 2: goodmax3121 ($1.17 in chips) 
Seat 3: weverson315 ($2.38 in chips) 
Seat 4: Dorex2007 ($4.24 in chips) 
Seat 5: moiguca ($0.77 in chips) 
Seat 6: signaturefro ($1.79 in chips) 
Seat 7: alexiscarel7 ($3.29 in chips) 
Seat 8: English_Ian ($1.95 in chips) 
Seat 9: izzu007 ($2.07 in chips) 
izzu007: posts small blind $0.01
CasObserver: posts big blind $0.02
*** HOLE CARDS ***
Dealt to Dorex2007 [5d 7d]
goodmax3121: raises $0.02 to $0.04
weverson315: calls $0.04
Dorex2007: folds 
moiguca: folds 
signaturefro: folds 
alexiscarel7: calls $0.04
English_Ian: folds 
izzu007: folds 
CasObserver: calls $0.02
*** FLOP *** [6h Ad Th]
CasObserver: checks 
goodmax3121: checks 
weverson315: checks 
alexiscarel7: bets $0.10
CasObserver: folds 
goodmax3121: raises $1.03 to $1.13 and is all-in
weverson315: folds 
alexiscarel7: folds 
Uncalled bet ($1.03) returned to goodmax3121
goodmax3121 collected $0.36 from pot
*** SUMMARY ***
Total pot $0.37 | Rake $0.01 
Board [6h Ad Th]
Seat 1: CasObserver (big blind) folded on the Flop
Seat 2: goodmax3121 collected ($0.36)
Seat 3: weverson315 folded on the Flop
Seat 4: Dorex2007 folded before Flop (didn't bet)
Seat 5: moiguca folded before Flop (didn't bet)
Seat 6: signaturefro folded before Flop (didn't bet)
Seat 7: alexiscarel7 folded on the Flop
Seat 8: English_Ian (button) folded before Flop (didn't bet)
Seat 9: izzu007 (small blind) folded before Flop



PokerStars Hand #237403159077:  Hold'em No Limit ($0.01/$0.02 USD) - 2022/07/16 16:58:25 PT [2022/07/16 19:58:25 ET]
Table 'Kalypso IV' 9-max Seat #9 is the button
Seat 1: CasObserver ($1.13 in chips) 
Seat 2: goodmax3121 ($1.39 in chips) 
Seat 3: weverson315 ($2.34 in chips) 
Seat 4: Dorex2007 ($4.24 in chips) 
Seat 5: moiguca ($0.77 in chips) 
Seat 6: signaturefro ($1.79 in chips) 
Seat 7: alexiscarel7 ($3.15 in chips) 
Seat 8: English_Ian ($1.95 in chips) 
Seat 9: izzu007 ($2.06 in chips) 
CasObserver: posts small blind $0.01
goodmax3121: posts big blind $0.02
*** HOLE CARDS ***
Dealt to Dorex2007 [5s Ad]
weverson315: calls $0.02
Dorex2007: folds 
moiguca: calls $0.02
signaturefro: folds 
alexiscarel7: folds 
English_Ian: folds 
izzu007: folds 
CasObserver: calls $0.01
goodmax3121: raises $0.02 to $0.04
weverson315: calls $0.02
moiguca: calls $0.02
CasObserver: calls $0.02
*** FLOP *** [7h 9c 7c]
CasObserver: checks 
goodmax3121: bets $1.35 and is all-in
weverson315: folds 
moiguca: folds 
CasObserver: calls $1.09 and is all-in
Uncalled bet ($0.26) returned to goodmax3121
*** TURN *** [7h 9c 7c] [2h]
*** RIVER *** [7h 9c 7c 2h] [Jh]
*** SHOW DOWN ***
CasObserver: shows [8s 7d] (three of a kind, Sevens)
goodmax3121: shows [Kh Kc] (two pair, Kings and Sevens)
CasObserver collected $2.26 from pot
*** SUMMARY ***
Total pot $2.34 | Rake $0.08 
Board [7h 9c 7c 2h Jh]
Seat 1: CasObserver (small blind) showed [8s 7d] and won ($2.26) with three of a kind, Sevens
Seat 2: goodmax3121 (big blind) showed [Kh Kc] and lost with two pair, Kings and Sevens
Seat 3: weverson315 folded on the Flop
Seat 4: Dorex2007 folded before Flop (didn't bet)
Seat 5: moiguca folded on the Flop
Seat 6: signaturefro folded before Flop (didn't bet)
Seat 7: alexiscarel7 folded before Flop (didn't bet)
Seat 8: English_Ian folded before Flop (didn't bet)
Seat 9: izzu007 (button) folded before Flop (didn't bet)



PokerStars Hand #237403171973:  Hold'em No Limit ($0.01/$0.02 USD) - 2022/07/16 16:59:29 PT [2022/07/16 19:59:29 ET]
Table 'Kalypso IV' 9-max Seat #1 is the button
Seat 1: CasObserver ($2.26 in chips) 
Seat 3: weverson315 ($2.30 in chips) 
Seat 4: Dorex2007 ($4.24 in chips) 
Seat 5: moiguca ($0.73 in chips) 
Seat 6: signaturefro ($1.79 in chips) 
Seat 7: alexiscarel7 ($3.15 in chips) 
Seat 8: English_Ian ($1.95 in chips) 
Seat 9: izzu007 ($2.06 in chips) 
goodmax3121: is sitting out 
goodmax3121 leaves the table
weverson315: posts small blind $0.01
Dorex2007: posts big blind $0.02
*** HOLE CARDS ***
Dealt to Dorex2007 [Ah Td]
moiguca: folds 
signaturefro: raises $0.02 to $0.04
alexiscarel7: calls $0.04
English_Ian: folds 
izzu007: folds 
CasObserver: folds 
weverson315: folds 
Dorex2007: calls $0.02
*** FLOP *** [Qc 4s 5h]
Dorex2007: checks 
signaturefro: bets $0.03
alexiscarel7: raises $0.09 to $0.12
Dorex2007: folds 
pedroboladooo joins the table at seat #2 
CasObserver leaves the table
signaturefro: calls $0.09
*** TURN *** [Qc 4s 5h] [2h]
signaturefro: checks 
alexiscarel7: bets $0.18
signaturefro: folds 
Uncalled bet ($0.18) returned to alexiscarel7
alexiscarel7 collected $0.36 from pot
*** SUMMARY ***
Total pot $0.37 | Rake $0.01 
Board [Qc 4s 5h 2h]
Seat 1: CasObserver (button) folded before Flop (didn't bet)
Seat 3: weverson315 (small blind) folded before Flop
Seat 4: Dorex2007 (big blind) folded on the Flop
Seat 5: moiguca folded before Flop (didn't bet)
Seat 6: signaturefro folded on the Turn
Seat 7: alexiscarel7 collected ($0.36)
Seat 8: English_Ian folded before Flop (didn't bet)
Seat 9: izzu007 folded before Flop (didn't bet)



PokerStars Hand #237403187373:  Hold'em No Limit ($0.01/$0.02 USD) - 2022/07/16 17:00:45 PT [2022/07/16 20:00:45 ET]
Table 'Kalypso IV' 9-max Seat #3 is the button
Seat 3: weverson315 ($2.29 in chips) 
Seat 4: Dorex2007 ($4.20 in chips) 
Seat 5: moiguca ($0.73 in chips) 
Seat 6: signaturefro ($1.63 in chips) 
Seat 7: alexiscarel7 ($3.35 in chips) 
Seat 8: English_Ian ($1.95 in chips) 
Seat 9: izzu007 ($2.06 in chips) 
Dorex2007: posts small blind $0.01
moiguca: posts big blind $0.02
pedroboladooo: sits out 
*** HOLE CARDS ***
Dealt to Dorex2007 [9d Qs]
pedroboladooo leaves the table
signaturefro has timed out
signaturefro: folds 
alexiscarel7: folds 
English_Ian: folds 
izzu007: folds 
weverson315: calls $0.02
Dorex2007: folds 
moiguca: checks 
*** FLOP *** [8c 5s 8s]
moiguca: checks 
weverson315: checks 
*** TURN *** [8c 5s 8s] [6d]
moiguca: checks 
weverson315: checks 
*** RIVER *** [8c 5s 8s 6d] [2d]
moiguca: checks 
weverson315: checks 
*** SHOW DOWN ***
moiguca: shows [Ad 6c] (two pair, Eights and Sixes)
weverson315: mucks hand 
moiguca collected $0.05 from pot
*** SUMMARY ***
Total pot $0.05 | Rake $0 
Board [8c 5s 8s 6d 2d]
Seat 3: weverson315 (button) mucked [3h Th]
Seat 4: Dorex2007 (small blind) folded before Flop
Seat 5: moiguca (big blind) showed [Ad 6c] and won ($0.05) with two pair, Eights and Sixes
Seat 6: signaturefro folded before Flop (didn't bet)
Seat 7: alexiscarel7 folded before Flop (didn't bet)
Seat 8: English_Ian folded before Flop (didn't bet)
Seat 9: izzu007 folded before Flop (didn't bet)



PokerStars Hand #237403196714:  Hold'em No Limit ($0.01/$0.02 USD) - 2022/07/16 17:01:26 PT [2022/07/16 20:01:26 ET]
Table 'Kalypso IV' 9-max Seat #4 is the button
Seat 3: weverson315 ($2.27 in chips) 
Seat 4: Dorex2007 ($4.19 in chips) 
Seat 5: moiguca ($0.76 in chips) 
Seat 7: alexiscarel7 ($3.35 in chips) 
Seat 8: English_Ian ($1.95 in chips) 
Seat 9: izzu007 ($2.06 in chips) 
moiguca: posts small blind $0.01
alexiscarel7: posts big blind $0.02
*** HOLE CARDS ***
Dealt to Dorex2007 [As 9c]
English_Ian: folds 
izzu007: raises $0.02 to $0.04
weverson315: folds 
Dorex2007: folds 
moiguca: folds 
alexiscarel7: calls $0.02
*** FLOP *** [9h 7s 9d]
alexiscarel7: checks 
izzu007: checks 
*** TURN *** [9h 7s 9d] [5c]
alexiscarel7: checks 
izzu007: checks 
*** RIVER *** [9h 7s 9d 5c] [Kh]
alexiscarel7: checks 
izzu007: checks 
*** SHOW DOWN ***
alexiscarel7: shows [Ac 4d] (a pair of Nines)
izzu007: mucks hand 
alexiscarel7 collected $0.09 from pot
*** SUMMARY ***
Total pot $0.09 | Rake $0 
Board [9h 7s 9d 5c Kh]
Seat 3: weverson315 folded before Flop (didn't bet)
Seat 4: Dorex2007 (button) folded before Flop (didn't bet)
Seat 5: moiguca (small blind) folded before Flop
Seat 7: alexiscarel7 (big blind) showed [Ac 4d] and won ($0.09) with a pair of Nines
Seat 8: English_Ian folded before Flop (didn't bet)
Seat 9: izzu007 mucked [Jh Qh]



PokerStars Hand #237403204224:  Hold'em No Limit ($0.01/$0.02 USD) - 2022/07/16 17:01:59 PT [2022/07/16 20:01:59 ET]
Table 'Kalypso IV' 9-max Seat #5 is the button
Seat 3: weverson315 ($2.27 in chips) 
Seat 4: Dorex2007 ($4.19 in chips) 
Seat 5: moiguca ($0.75 in chips) 
Seat 7: alexiscarel7 ($3.40 in chips) 
Seat 8: English_Ian ($1.95 in chips) 
Seat 9: izzu007 ($2.02 in chips) 
alexiscarel7: posts small blind $0.01
English_Ian: posts big blind $0.02
*** HOLE CARDS ***
Dealt to Dorex2007 [4d Qs]
izzu007: raises $0.06 to $0.08
weverson315: folds 
Dorex2007: folds 
moiguca: folds 
alexiscarel7: folds 
English_Ian: folds 
Uncalled bet ($0.06) returned to izzu007
izzu007 collected $0.05 from pot
*** SUMMARY ***
Total pot $0.05 | Rake $0 
Seat 3: weverson315 folded before Flop (didn't bet)
Seat 4: Dorex2007 folded before Flop (didn't bet)
Seat 5: moiguca (button) folded before Flop (didn't bet)
Seat 7: alexiscarel7 (small blind) folded before Flop
Seat 8: English_Ian (big blind) folded before Flop
Seat 9: izzu007 collected ($0.05)



PokerStars Hand #237403208787:  Hold'em No Limit ($0.01/$0.02 USD) - 2022/07/16 17:02:19 PT [2022/07/16 20:02:19 ET]
Table 'Kalypso IV' 9-max Seat #7 is the button
Seat 3: weverson315 ($2.27 in chips) 
Seat 4: Dorex2007 ($4.19 in chips) 
Seat 5: moiguca ($0.75 in chips) 
Seat 7: alexiscarel7 ($3.39 in chips) 
Seat 8: English_Ian ($1.93 in chips) 
Seat 9: izzu007 ($2.05 in chips) 
English_Ian: posts small blind $0.01
izzu007: posts big blind $0.02
signaturefro: sits out 
*** HOLE CARDS ***
Dealt to Dorex2007 [2c 8s]
weverson315: folds 
Dorex2007: folds 
moiguca: folds 
alexiscarel7: raises $0.06 to $0.08
English_Ian: folds 
izzu007: calls $0.06
*** FLOP *** [Ac 2s Ad]
izzu007: checks 
alexiscarel7: bets $0.08
izzu007: calls $0.08
*** TURN *** [Ac 2s Ad] [Td]
izzu007: checks 
Dr G Homer joins the table at seat #1 
alexiscarel7: bets $0.16
izzu007: calls $0.16
*** RIVER *** [Ac 2s Ad Td] [Kc]
izzu007: checks 
alexiscarel7: checks 
*** SHOW DOWN ***
izzu007: shows [4d 5d] (a pair of Aces)
alexiscarel7: shows [Qh Th] (two pair, Aces and Tens)
alexiscarel7 collected $0.63 from pot
*** SUMMARY ***
Total pot $0.65 | Rake $0.02 
Board [Ac 2s Ad Td Kc]
Seat 3: weverson315 folded before Flop (didn't bet)
Seat 4: Dorex2007 folded before Flop (didn't bet)
Seat 5: moiguca folded before Flop (didn't bet)
Seat 7: alexiscarel7 (button) showed [Qh Th] and won ($0.63) with two pair, Aces and Tens
Seat 8: English_Ian (small blind) folded before Flop
Seat 9: izzu007 (big blind) showed [4d 5d] and lost with a pair of Aces



PokerStars Hand #237403223012:  Hold'em No Limit ($0.01/$0.02 USD) - 2022/07/16 17:03:19 PT [2022/07/16 20:03:19 ET]
Table 'Kalypso IV' 9-max Seat #8 is the button
Seat 1: Dr G Homer ($2 in chips) 
Seat 3: weverson315 ($2.27 in chips) 
Seat 4: Dorex2007 ($4.19 in chips) 
Seat 5: moiguca ($0.75 in chips) 
Seat 6: signaturefro ($1.63 in chips) 
Seat 7: alexiscarel7 ($3.70 in chips) 
Seat 8: English_Ian ($1.92 in chips) 
Seat 9: izzu007 ($1.73 in chips) 
izzu007: posts small blind $0.01
Dr G Homer: posts big blind $0.02
signaturefro: posts small & big blinds $0.03
*** HOLE CARDS ***
Dealt to Dorex2007 [9h Ac]
weverson315: calls $0.02
Roody_Tha joins the table at seat #2 
Dorex2007 has timed out
Dorex2007: folds 
moiguca: folds 
signaturefro: raises $0.05 to $0.07
alexiscarel7: folds 
English_Ian: folds 
izzu007: folds 
Dr G Homer: folds 
weverson315: calls $0.05
*** FLOP *** [6h Ah 5d]
weverson315: checks 
signaturefro: checks 
*** TURN *** [6h Ah 5d] [7s]
weverson315: checks 
signaturefro: bets $0.12
weverson315: folds 
Uncalled bet ($0.12) returned to signaturefro
signaturefro collected $0.17 from pot
*** SUMMARY ***
Total pot $0.18 | Rake $0.01 
Board [6h Ah 5d 7s]
Seat 1: Dr G Homer (big blind) folded before Flop
Seat 3: weverson315 folded on the Turn
Seat 4: Dorex2007 folded before Flop (didn't bet)
Seat 5: moiguca folded before Flop (didn't bet)
Seat 6: signaturefro collected ($0.17)
Seat 7: alexiscarel7 folded before Flop (didn't bet)
Seat 8: English_Ian (button) folded before Flop (didn't bet)
Seat 9: izzu007 (small blind) folded before Flop



PokerStars Hand #237403235157:  Hold'em No Limit ($0.01/$0.02 USD) - 2022/07/16 17:04:11 PT [2022/07/16 20:04:11 ET]
Table 'Kalypso IV' 9-max Seat #9 is the button
Seat 1: Dr G Homer ($2 in chips) 
Seat 2: Roody_Tha ($2 in chips) 
Seat 3: weverson315 ($2.20 in chips) 
Seat 4: Dorex2007 ($4.19 in chips) 
Seat 5: moiguca ($0.75 in chips) 
Seat 6: signaturefro ($1.72 in chips) 
Seat 7: alexiscarel7 ($3.70 in chips) 
Seat 8: English_Ian ($1.92 in chips) 
Seat 9: izzu007 ($1.72 in chips) 
Dr G Homer: posts small blind $0.01
Roody_Tha: posts big blind $0.02
*** HOLE CARDS ***
Dealt to Dorex2007 [Qs Ac]
weverson315: calls $0.02
Dorex2007: calls $0.02
moiguca: folds 
signaturefro: folds 
alexiscarel7: calls $0.02
English_Ian: folds 
izzu007: folds 
Dr G Homer: folds 
Roody_Tha: checks 
*** FLOP *** [4h Qd 9d]
Roody_Tha: checks 
weverson315: checks 
moiguca leaves the table
Dorex2007: bets $0.14
alexiscarel7: folds 
Roody_Tha: folds 
weverson315: folds 
Uncalled bet ($0.14) returned to Dorex2007
Dorex2007 collected $0.09 from pot
*** SUMMARY ***
Total pot $0.09 | Rake $0 
Board [4h Qd 9d]
Seat 1: Dr G Homer (small blind) folded before Flop
Seat 2: Roody_Tha (big blind) folded on the Flop
Seat 3: weverson315 folded on the Flop
Seat 4: Dorex2007 collected ($0.09)
Seat 5: moiguca folded before Flop (didn't bet)
Seat 6: signaturefro folded before Flop (didn't bet)
Seat 7: alexiscarel7 folded on the Flop
Seat 8: English_Ian folded before Flop (didn't bet)
Seat 9: izzu007 (button) folded before Flop (didn't bet)



PokerStars Hand #237403247471:  Hold'em No Limit ($0.01/$0.02 USD) - 2022/07/16 17:05:03 PT [2022/07/16 20:05:03 ET]
Table 'Kalypso IV' 9-max Seat #1 is the button
Seat 1: Dr G Homer ($2 in chips) 
Seat 2: Roody_Tha ($1.98 in chips) 
Seat 3: weverson315 ($2.18 in chips) 
Seat 4: Dorex2007 ($4.26 in chips) 
Seat 6: signaturefro ($1.72 in chips) 
Seat 7: alexiscarel7 ($3.68 in chips) 
Seat 8: English_Ian ($1.92 in chips) 
Seat 9: izzu007 ($1.72 in chips) 
Roody_Tha: posts small blind $0.01
weverson315: posts big blind $0.02
*** HOLE CARDS ***
Dealt to Dorex2007 [Qh 8s]
Dorex2007: folds 
signaturefro: folds 
alexiscarel7: folds 
English_Ian: folds 
izzu007: calls $0.02
Dr G Homer: raises $0.06 to $0.08
Roody_Tha: folds 
weverson315: calls $0.06
izzu007: calls $0.06
*** FLOP *** [8d 4s Kh]
weverson315: checks 
izzu007: checks 
Dr G Homer: bets $0.12
weverson315: calls $0.12
izzu007: folds 
*** TURN *** [8d 4s Kh] [Jc]
weverson315: checks 
Dr G Homer: bets $0.33
weverson315: folds 
Uncalled bet ($0.33) returned to Dr G Homer
Dr G Homer collected $0.47 from pot
*** SUMMARY ***
Total pot $0.49 | Rake $0.02 
Board [8d 4s Kh Jc]
Seat 1: Dr G Homer (button) collected ($0.47)
Seat 2: Roody_Tha (small blind) folded before Flop
Seat 3: weverson315 (big blind) folded on the Turn
Seat 4: Dorex2007 folded before Flop (didn't bet)
Seat 6: signaturefro folded before Flop (didn't bet)
Seat 7: alexiscarel7 folded before Flop (didn't bet)
Seat 8: English_Ian folded before Flop (didn't bet)
Seat 9: izzu007 folded on the Flop



PokerStars Hand #237403267553:  Hold'em No Limit ($0.01/$0.02 USD) - 2022/07/16 17:06:27 PT [2022/07/16 20:06:27 ET]
Table 'Kalypso IV' 9-max Seat #2 is the button
Seat 1: Dr G Homer ($2.27 in chips) 
Seat 2: Roody_Tha ($1.97 in chips) 
Seat 3: weverson315 ($2 in chips) 
Seat 4: Dorex2007 ($4.26 in chips) 
Seat 6: signaturefro ($1.72 in chips) 
Seat 7: alexiscarel7 ($3.68 in chips) 
Seat 8: English_Ian ($1.92 in chips) 
Seat 9: izzu007 ($1.64 in chips) 
weverson315: posts small blind $0.01
Dorex2007: posts big blind $0.02
*** HOLE CARDS ***
Dealt to Dorex2007 [9d Jh]
signaturefro: folds 
alexiscarel7: calls $0.02
English_Ian: folds 
Jumbaliah123 joins the table at seat #5 
izzu007 has timed out
izzu007: folds 
Dr G Homer: folds 
Roody_Tha: folds 
weverson315: calls $0.01
Dorex2007: checks 
*** FLOP *** [9c 9s 4d]
weverson315: checks 
Dorex2007: bets $0.06
alexiscarel7: folds 
weverson315: folds 
Uncalled bet ($0.06) returned to Dorex2007
Dorex2007 collected $0.06 from pot
*** SUMMARY ***
Total pot $0.06 | Rake $0 
Board [9c 9s 4d]
Seat 1: Dr G Homer folded before Flop (didn't bet)
Seat 2: Roody_Tha (button) folded before Flop (didn't bet)
Seat 3: weverson315 (small blind) folded on the Flop
Seat 4: Dorex2007 (big blind) collected ($0.06)
Seat 6: signaturefro folded before Flop (didn't bet)
Seat 7: alexiscarel7 folded on the Flop
Seat 8: English_Ian folded before Flop (didn't bet)
Seat 9: izzu007 folded before Flop (didn't bet)



PokerStars Hand #237403277378:  Hold'em No Limit ($0.01/$0.02 USD) - 2022/07/16 17:07:08 PT [2022/07/16 20:07:08 ET]
Table 'Kalypso IV' 9-max Seat #3 is the button
Seat 1: Dr G Homer ($2.27 in chips) 
Seat 2: Roody_Tha ($1.97 in chips) 
Seat 3: weverson315 ($2 in chips) 
Seat 4: Dorex2007 ($4.30 in chips) 
Seat 5: Jumbaliah123 ($2 in chips) 
Seat 6: signaturefro ($1.72 in chips) 
Seat 7: alexiscarel7 ($3.66 in chips) 
Seat 8: English_Ian ($1.92 in chips) 
Seat 9: izzu007 ($1.64 in chips) 
Dorex2007: posts small blind $0.01
Jumbaliah123: posts big blind $0.02
*** HOLE CARDS ***
Dealt to Dorex2007 [8c Jc]
signaturefro: folds 
alexiscarel7: folds 
English_Ian: folds 
izzu007 has timed out
izzu007: folds 
Dr G Homer: folds 
Roody_Tha: calls $0.02
weverson315: calls $0.02
Dorex2007: folds 
Jumbaliah123: checks 
*** FLOP *** [3d Th Kd]
Jumbaliah123: checks 
Roody_Tha: checks 
weverson315: checks 
*** TURN *** [3d Th Kd] [Jd]
Jumbaliah123: checks 
Roody_Tha: checks 
weverson315: checks 
*** RIVER *** [3d Th Kd Jd] [5s]
Jumbaliah123: checks 
Roody_Tha: checks 
weverson315: checks 
*** SHOW DOWN ***
Jumbaliah123: shows [Ks 2d] (a pair of Kings)
Roody_Tha: mucks hand 
weverson315: mucks hand 
Jumbaliah123 collected $0.07 from pot
*** SUMMARY ***
Total pot $0.07 | Rake $0 
Board [3d Th Kd Jd 5s]
Seat 1: Dr G Homer folded before Flop (didn't bet)
Seat 2: Roody_Tha mucked [Tc Qh]
Seat 3: weverson315 (button) mucked [2c 2h]
Seat 4: Dorex2007 (small blind) folded before Flop
Seat 5: Jumbaliah123 (big blind) showed [Ks 2d] and won ($0.07) with a pair of Kings
Seat 6: signaturefro folded before Flop (didn't bet)
Seat 7: alexiscarel7 folded before Flop (didn't bet)
Seat 8: English_Ian folded before Flop (didn't bet)
Seat 9: izzu007 folded before Flop (didn't bet)



PokerStars Hand #237403300955:  Hold'em No Limit ($0.01/$0.02 USD) - 2022/07/16 17:08:23 PT [2022/07/16 20:08:23 ET]
Table 'Kalypso IV' 9-max Seat #4 is the button
Seat 1: Dr G Homer ($2.27 in chips) 
Seat 2: Roody_Tha ($1.95 in chips) 
Seat 3: weverson315 ($2 in chips) 
Seat 4: Dorex2007 ($4.29 in chips) 
Seat 5: Jumbaliah123 ($2.05 in chips) 
Seat 6: signaturefro ($1.72 in chips) 
Seat 7: alexiscarel7 ($3.66 in chips) 
Seat 8: English_Ian ($1.92 in chips) 
Seat 9: izzu007 ($1.64 in chips) 
Jumbaliah123: posts small blind $0.01
signaturefro: posts big blind $0.02
*** HOLE CARDS ***
Dealt to Dorex2007 [5d 2h]
alexiscarel7: raises $0.06 to $0.08
English_Ian: folds 
izzu007: calls $0.08
Dr G Homer: folds 
Roody_Tha: folds 
weverson315: folds 
Dorex2007: folds 
Jumbaliah123: calls $0.07
signaturefro: folds 
*** FLOP *** [Ac 4c 8s]
Jumbaliah123: checks 
alexiscarel7: bets $0.12
izzu007: calls $0.12
Jumbaliah123: folds 
*** TURN *** [Ac 4c 8s] [2d]
alexiscarel7: checks 
izzu007: checks 
*** RIVER *** [Ac 4c 8s 2d] [9s]
alexiscarel7: checks 
izzu007: checks 
*** SHOW DOWN ***
alexiscarel7: shows [Jc Jd] (a pair of Jacks)
izzu007: mucks hand 
alexiscarel7 collected $0.48 from pot
*** SUMMARY ***
Total pot $0.50 | Rake $0.02 
Board [Ac 4c 8s 2d 9s]
Seat 1: Dr G Homer folded before Flop (didn't bet)
Seat 2: Roody_Tha folded before Flop (didn't bet)
Seat 3: weverson315 folded before Flop (didn't bet)
Seat 4: Dorex2007 (button) folded before Flop (didn't bet)
Seat 5: Jumbaliah123 (small blind) folded on the Flop
Seat 6: signaturefro (big blind) folded before Flop
Seat 7: alexiscarel7 showed [Jc Jd] and won ($0.48) with a pair of Jacks
Seat 8: English_Ian folded before Flop (didn't bet)
Seat 9: izzu007 mucked [9c Kc]



PokerStars Hand #237403312944:  Hold'em No Limit ($0.01/$0.02 USD) - 2022/07/16 17:09:15 PT [2022/07/16 20:09:15 ET]
Table 'Kalypso IV' 9-max Seat #5 is the button
Seat 1: Dr G Homer ($2.27 in chips) 
Seat 2: Roody_Tha ($1.95 in chips) 
Seat 3: weverson315 ($2 in chips) 
Seat 4: Dorex2007 ($4.29 in chips) 
Seat 5: Jumbaliah123 ($2 in chips) 
Seat 6: signaturefro ($1.70 in chips) 
Seat 7: alexiscarel7 ($3.94 in chips) 
Seat 8: English_Ian ($1.92 in chips) 
Seat 9: izzu007 ($1.44 in chips) 
signaturefro: posts small blind $0.01
alexiscarel7: posts big blind $0.02
*** HOLE CARDS ***
Dealt to Dorex2007 [Ah 8s]
English_Ian: folds 
izzu007: folds 
Dr G Homer: folds 
Roody_Tha: folds 
weverson315: calls $0.02
Dorex2007: folds 
Jumbaliah123: folds 
signaturefro: folds 
alexiscarel7: checks 
*** FLOP *** [3h 7s 5s]
alexiscarel7: checks 
weverson315: checks 
*** TURN *** [3h 7s 5s] [Jd]
alexiscarel7: checks 
weverson315: checks 
*** RIVER *** [3h 7s 5s Jd] [Jh]
alexiscarel7: checks 
weverson315: checks 
*** SHOW DOWN ***
alexiscarel7: shows [9h 6d] (a pair of Jacks)
weverson315: shows [6c 3c] (two pair, Jacks and Threes)
weverson315 collected $0.05 from pot
*** SUMMARY ***
Total pot $0.05 | Rake $0 
Board [3h 7s 5s Jd Jh]
Seat 1: Dr G Homer folded before Flop (didn't bet)
Seat 2: Roody_Tha folded before Flop (didn't bet)
Seat 3: weverson315 showed [6c 3c] and won ($0.05) with two pair, Jacks and Threes
Seat 4: Dorex2007 folded before Flop (didn't bet)
Seat 5: Jumbaliah123 (button) folded before Flop (didn't bet)
Seat 6: signaturefro (small blind) folded before Flop
Seat 7: alexiscarel7 (big blind) showed [9h 6d] and lost with a pair of Jacks
Seat 8: English_Ian folded before Flop (didn't bet)
Seat 9: izzu007 folded before Flop (didn't bet)



PokerStars Hand #237403319562:  Hold'em No Limit ($0.01/$0.02 USD) - 2022/07/16 17:09:44 PT [2022/07/16 20:09:44 ET]
Table 'Kalypso IV' 9-max Seat #6 is the button
Seat 1: Dr G Homer ($2.27 in chips) 
Seat 2: Roody_Tha ($1.95 in chips) 
Seat 3: weverson315 ($2.03 in chips) 
Seat 4: Dorex2007 ($4.29 in chips) 
Seat 5: Jumbaliah123 ($2 in chips) 
Seat 6: signaturefro ($1.69 in chips) 
Seat 7: alexiscarel7 ($3.92 in chips) 
Seat 8: English_Ian ($1.92 in chips) 
Seat 9: izzu007 ($1.44 in chips) 
alexiscarel7: posts small blind $0.01
English_Ian: posts big blind $0.02
*** HOLE CARDS ***
Dealt to Dorex2007 [Kc 5h]
izzu007: folds 
Dr G Homer: folds 
Roody_Tha: folds 
weverson315: folds 
Dorex2007: folds 
Jumbaliah123: folds 
signaturefro: calls $0.02
alexiscarel7: calls $0.01
English_Ian: checks 
*** FLOP *** [Th Ah Ad]
alexiscarel7: bets $0.03
English_Ian: folds 
signaturefro: calls $0.03
*** TURN *** [Th Ah Ad] [4c]
alexiscarel7: checks 
signaturefro: checks 
*** RIVER *** [Th Ah Ad 4c] [2s]
alexiscarel7: checks 
signaturefro: bets $0.09
alexiscarel7: folds 
Uncalled bet ($0.09) returned to signaturefro
signaturefro collected $0.12 from pot
*** SUMMARY ***
Total pot $0.12 | Rake $0 
Board [Th Ah Ad 4c 2s]
Seat 1: Dr G Homer folded before Flop (didn't bet)
Seat 2: Roody_Tha folded before Flop (didn't bet)
Seat 3: weverson315 folded before Flop (didn't bet)
Seat 4: Dorex2007 folded before Flop (didn't bet)
Seat 5: Jumbaliah123 folded before Flop (didn't bet)
Seat 6: signaturefro (button) collected ($0.12)
Seat 7: alexiscarel7 (small blind) folded on the River
Seat 8: English_Ian (big blind) folded on the Flop
Seat 9: izzu007 folded before Flop (didn't bet)



PokerStars Hand #237403343802:  Hold'em No Limit ($0.01/$0.02 USD) - 2022/07/16 17:10:57 PT [2022/07/16 20:10:57 ET]
Table 'Kalypso IV' 9-max Seat #7 is the button
Seat 1: Dr G Homer ($2.27 in chips) 
Seat 2: Roody_Tha ($1.95 in chips) 
Seat 3: weverson315 ($2.03 in chips) 
Seat 4: Dorex2007 ($4.29 in chips) 
Seat 5: Jumbaliah123 ($2 in chips) 
Seat 6: signaturefro ($1.76 in chips) 
Seat 7: alexiscarel7 ($3.87 in chips) 
Seat 8: English_Ian ($1.90 in chips) 
Seat 9: izzu007 ($1.44 in chips) 
English_Ian: posts small blind $0.01
izzu007: posts big blind $0.02
*** HOLE CARDS ***
Dealt to Dorex2007 [8h 8c]
Dr G Homer: raises $0.04 to $0.06
Roody_Tha: folds 
weverson315: folds 
Dorex2007: calls $0.06
Jumbaliah123: folds 
signaturefro: folds 
alexiscarel7: calls $0.06
English_Ian: folds 
izzu007: calls $0.04
*** FLOP *** [8d 2s Td]
izzu007: checks 
Dr G Homer: checks 
Dorex2007: bets $0.24
alexiscarel7: calls $0.24
izzu007: folds 
Dr G Homer: folds 
*** TURN *** [8d 2s Td] [7h]
Dorex2007: bets $3.99 and is all-in
alexiscarel7: calls $3.57 and is all-in
Uncalled bet ($0.42) returned to Dorex2007
*** RIVER *** [8d 2s Td 7h] [6c]
*** SHOW DOWN ***
Dorex2007: shows [8h 8c] (three of a kind, Eights)
alexiscarel7: shows [Jh Js] (a pair of Jacks)
Dorex2007 cashed out the hand for $6.49 | Cash Out Fee $0.07
*** SUMMARY ***
Total pot $7.87 | Rake $0.28 
Board [8d 2s Td 7h 6c]
Seat 1: Dr G Homer folded on the Flop
Seat 2: Roody_Tha folded before Flop (didn't bet)
Seat 3: weverson315 folded before Flop (didn't bet)
Seat 4: Dorex2007 showed [8h 8c] and won ($7.59) with three of a kind, Eights (pot not awarded as player cashed out)
Seat 5: Jumbaliah123 folded before Flop (didn't bet)
Seat 6: signaturefro folded before Flop (didn't bet)
Seat 7: alexiscarel7 (button) showed [Jh Js] and lost with a pair of Jacks
Seat 8: English_Ian (small blind) folded before Flop
Seat 9: izzu007 (big blind) folded on the Flop



PokerStars Hand #237403363061:  Hold'em No Limit ($0.01/$0.02 USD) - 2022/07/16 17:12:19 PT [2022/07/16 20:12:19 ET]
Table 'Kalypso IV' 9-max Seat #8 is the button
Seat 1: Dr G Homer ($2.21 in chips) 
Seat 2: Roody_Tha ($1.95 in chips) 
Seat 3: weverson315 ($2.03 in chips) 
Seat 4: Dorex2007 ($6.91 in chips) 
Seat 5: Jumbaliah123 ($2 in chips) 
Seat 6: signaturefro ($1.76 in chips) 
Seat 8: English_Ian ($1.89 in chips) 
Seat 9: izzu007 ($1.38 in chips) 
izzu007: posts small blind $0.01
Dr G Homer: posts big blind $0.02
*** HOLE CARDS ***
Dealt to Dorex2007 [Jc 6c]
Roody_Tha: folds 
weverson315: folds 
Dorex2007: folds 
Jumbaliah123: folds 
signaturefro: raises $0.03 to $0.05
English_Ian: folds 
izzu007: calls $0.04
Dr G Homer: calls $0.03
*** FLOP *** [3h Ad 7h]
izzu007: checks 
Dr G Homer: checks 
signaturefro: bets $0.04
izzu007: folds 
Dr G Homer: folds 
Uncalled bet ($0.04) returned to signaturefro
signaturefro collected $0.14 from pot
*** SUMMARY ***
Total pot $0.15 | Rake $0.01 
Board [3h Ad 7h]
Seat 1: Dr G Homer (big blind) folded on the Flop
Seat 2: Roody_Tha folded before Flop (didn't bet)
Seat 3: weverson315 folded before Flop (didn't bet)
Seat 4: Dorex2007 folded before Flop (didn't bet)
Seat 5: Jumbaliah123 folded before Flop (didn't bet)
Seat 6: signaturefro collected ($0.14)
Seat 8: English_Ian (button) folded before Flop (didn't bet)
Seat 9: izzu007 (small blind) folded on the Flop



PokerStars Hand #237403376560:  Hold'em No Limit ($0.01/$0.02 USD) - 2022/07/16 17:13:18 PT [2022/07/16 20:13:18 ET]
Table 'Kalypso IV' 9-max Seat #9 is the button
Seat 2: Roody_Tha ($1.95 in chips) 
Seat 3: weverson315 ($2.03 in chips) 
Seat 4: Dorex2007 ($6.91 in chips) 
Seat 5: Jumbaliah123 ($2 in chips) 
Seat 6: signaturefro ($1.85 in chips) 
Seat 8: English_Ian ($1.89 in chips) 
Seat 9: izzu007 ($1.33 in chips) 
Roody_Tha: posts small blind $0.01
weverson315: posts big blind $0.02
*** HOLE CARDS ***
Dealt to Dorex2007 [Ts 7h]
Dr G Homer leaves the table
Dorex2007: folds 
Jumbaliah123: folds 
alexiscarel7 leaves the table
signaturefro: folds 
English_Ian: folds 
izzu007: raises $0.02 to $0.04
Roody_Tha: folds 
weverson315: calls $0.02
*** FLOP *** [Jh 2d 6d]
weverson315: checks 
izzu007: checks 
*** TURN *** [Jh 2d 6d] [9h]
weverson315: checks 
izzu007: checks 
*** RIVER *** [Jh 2d 6d 9h] [8h]
weverson315: checks 
izzu007: checks 
*** SHOW DOWN ***
weverson315: shows [3h 6s] (a pair of Sixes)
izzu007: mucks hand 
weverson315 collected $0.09 from pot
*** SUMMARY ***
Total pot $0.09 | Rake $0 
Board [Jh 2d 6d 9h 8h]
Seat 2: Roody_Tha (small blind) folded before Flop
Seat 3: weverson315 (big blind) showed [3h 6s] and won ($0.09) with a pair of Sixes
Seat 4: Dorex2007 folded before Flop (didn't bet)
Seat 5: Jumbaliah123 folded before Flop (didn't bet)
Seat 6: signaturefro folded before Flop (didn't bet)
Seat 8: English_Ian folded before Flop (didn't bet)
Seat 9: izzu007 (button) mucked [Qd Kc]



PokerStars Hand #237403391064:  Hold'em No Limit ($0.01/$0.02 USD) - 2022/07/16 17:14:22 PT [2022/07/16 20:14:22 ET]
Table 'Kalypso IV' 9-max Seat #2 is the button
Seat 2: Roody_Tha ($1.94 in chips) 
Seat 3: weverson315 ($2.08 in chips) 
Seat 4: Dorex2007 ($6.91 in chips) 
Seat 5: Jumbaliah123 ($2 in chips) 
Seat 6: signaturefro ($1.85 in chips) 
Seat 8: English_Ian ($1.89 in chips) 
Seat 9: izzu007 ($1.29 in chips) 
weverson315: posts small blind $0.01
Dorex2007: posts big blind $0.02
*** HOLE CARDS ***
Dealt to Dorex2007 [7h 4h]
Jumbaliah123: folds 
HermesDF joins the table at seat #7 
Goya159 joins the table at seat #1 
signaturefro: folds 
English_Ian: calls $0.02
izzu007: folds 
Roody_Tha: raises $0.08 to $0.10
weverson315: calls $0.09
Dorex2007: folds 
English_Ian: calls $0.08
*** FLOP *** [Qs 3c Ks]
weverson315: checks 
English_Ian: checks 
Roody_Tha: bets $0.10
weverson315: calls $0.10
English_Ian: folds 
*** TURN *** [Qs 3c Ks] [2h]
weverson315: checks 
Roody_Tha: bets $0.10
weverson315: calls $0.10
*** RIVER *** [Qs 3c Ks 2h] [Ad]
weverson315: checks 
Roody_Tha: bets $0.34
weverson315: folds 
Uncalled bet ($0.34) returned to Roody_Tha
Roody_Tha collected $0.69 from pot
*** SUMMARY ***
Total pot $0.72 | Rake $0.03 
Board [Qs 3c Ks 2h Ad]
Seat 2: Roody_Tha (button) collected ($0.69)
Seat 3: weverson315 (small blind) folded on the River
Seat 4: Dorex2007 (big blind) folded before Flop
Seat 5: Jumbaliah123 folded before Flop (didn't bet)
Seat 6: signaturefro folded before Flop (didn't bet)
Seat 8: English_Ian folded on the Flop
Seat 9: izzu007 folded before Flop (didn't bet)



PokerStars Hand #237403411517:  Hold'em No Limit ($0.01/$0.02 USD) - 2022/07/16 17:15:52 PT [2022/07/16 20:15:52 ET]
Table 'Kalypso IV' 9-max Seat #3 is the button
Seat 2: Roody_Tha ($2.33 in chips) 
Seat 3: weverson315 ($2 in chips) 
Seat 4: Dorex2007 ($6.89 in chips) 
Seat 5: Jumbaliah123 ($2 in chips) 
Seat 6: signaturefro ($1.85 in chips) 
Seat 7: HermesDF ($0.80 in chips) 
Seat 8: English_Ian ($1.79 in chips) 
Seat 9: izzu007 ($1.29 in chips) 
Dorex2007: posts small blind $0.01
Jumbaliah123: posts big blind $0.02
HermesDF: posts big blind $0.02
Goya159: sits out 
*** HOLE CARDS ***
Dealt to Dorex2007 [Qc 2c]
signaturefro: folds 
HermesDF: checks 
English_Ian: calls $0.02
izzu007: calls $0.02
Roody_Tha has timed out
Roody_Tha: folds 
weverson315: folds 
Dorex2007: folds 
Jumbaliah123: checks 
*** FLOP *** [Qd 3h Td]
Jumbaliah123: checks 
HermesDF: checks 
English_Ian: bets $0.04
izzu007: calls $0.04
Jumbaliah123: folds 
HermesDF: folds 
*** TURN *** [Qd 3h Td] [9s]
English_Ian: bets $0.08
izzu007: calls $0.08
*** RIVER *** [Qd 3h Td 9s] [4c]
English_Ian: bets $0.32
izzu007: calls $0.32
*** SHOW DOWN ***
English_Ian: shows [Kd Jd] (a straight, Nine to King)
izzu007: mucks hand 
English_Ian collected $0.94 from pot
*** SUMMARY ***
Total pot $0.97 | Rake $0.03 
Board [Qd 3h Td 9s 4c]
Seat 2: Roody_Tha folded before Flop (didn't bet)
Seat 3: weverson315 (button) folded before Flop (didn't bet)
Seat 4: Dorex2007 (small blind) folded before Flop
Seat 5: Jumbaliah123 (big blind) folded on the Flop
Seat 6: signaturefro folded before Flop (didn't bet)
Seat 7: HermesDF folded on the Flop (didn't bet)
Seat 8: English_Ian showed [Kd Jd] and won ($0.94) with a straight, Nine to King
Seat 9: izzu007 mucked [Th 8s]



PokerStars Hand #237403427149:  Hold'em No Limit ($0.01/$0.02 USD) - 2022/07/16 17:17:00 PT [2022/07/16 20:17:00 ET]
Table 'Kalypso IV' 9-max Seat #4 is the button
Seat 2: Roody_Tha ($2.33 in chips) 
Seat 3: weverson315 ($2 in chips) 
Seat 4: Dorex2007 ($6.88 in chips) 
Seat 5: Jumbaliah123 ($2 in chips) 
Seat 6: signaturefro ($1.85 in chips) 
Seat 7: HermesDF ($0.78 in chips) 
Seat 8: English_Ian ($2.27 in chips) 
Seat 9: izzu007 ($0.83 in chips) 
Jumbaliah123: posts small blind $0.01
signaturefro: posts big blind $0.02
Goya159: sits out 
*** HOLE CARDS ***
Dealt to Dorex2007 [2h 4s]
HermesDF: calls $0.02
English_Ian: folds 
izzu007: calls $0.02
Roody_Tha: folds 
weverson315: folds 
Dorex2007: folds 
Jumbaliah123: calls $0.01
signaturefro: checks 
*** FLOP *** [2c 9d Th]
Jumbaliah123: checks 
signaturefro: bets $0.02
HermesDF: calls $0.02
izzu007: folds 
Jumbaliah123: calls $0.02
*** TURN *** [2c 9d Th] [Ac]
Jumbaliah123: checks 
signaturefro: bets $0.02
HermesDF: calls $0.02
Jumbaliah123: calls $0.02
*** RIVER *** [2c 9d Th Ac] [3h]
Jumbaliah123: checks 
signaturefro: checks 
HermesDF: checks 
*** SHOW DOWN ***
Jumbaliah123: shows [Jc Qc] (high card Ace)
signaturefro: mucks hand 
HermesDF: shows [Jd Tc] (a pair of Tens)
HermesDF collected $0.19 from pot
*** SUMMARY ***
Total pot $0.20 | Rake $0.01 
Board [2c 9d Th Ac 3h]
Seat 2: Roody_Tha folded before Flop (didn't bet)
Seat 3: weverson315 folded before Flop (didn't bet)
Seat 4: Dorex2007 (button) folded before Flop (didn't bet)
Seat 5: Jumbaliah123 (small blind) showed [Jc Qc] and lost with high card Ace
Seat 6: signaturefro (big blind) mucked [7s 8s]
Seat 7: HermesDF showed [Jd Tc] and won ($0.19) with a pair of Tens
Seat 8: English_Ian folded before Flop (didn't bet)
Seat 9: izzu007 folded on the Flop



PokerStars Hand #237403443542:  Hold'em No Limit ($0.01/$0.02 USD) - 2022/07/16 17:18:12 PT [2022/07/16 20:18:12 ET]
Table 'Kalypso IV' 9-max Seat #5 is the button
Seat 2: Roody_Tha ($2.33 in chips) 
Seat 3: weverson315 ($2 in chips) 
Seat 4: Dorex2007 ($6.88 in chips) 
Seat 5: Jumbaliah123 ($2 in chips) 
Seat 6: signaturefro ($1.79 in chips) 
Seat 7: HermesDF ($0.91 in chips) 
Seat 8: English_Ian ($2.27 in chips) 
Seat 9: izzu007 ($0.81 in chips) 
signaturefro: posts small blind $0.01
HermesDF: posts big blind $0.02
Goya159: sits out 
*** HOLE CARDS ***
Dealt to Dorex2007 [7h Kd]
English_Ian: folds 
izzu007: folds 
Roody_Tha: folds 
weverson315: folds 
Dorex2007: folds 
Jumbaliah123: folds 
signaturefro: calls $0.01
HermesDF: checks 
*** FLOP *** [6s Kc Jh]
signaturefro: checks 
HermesDF: bets $0.02
signaturefro: calls $0.02
*** TURN *** [6s Kc Jh] [4d]
signaturefro: checks 
HermesDF: checks 
*** RIVER *** [6s Kc Jh 4d] [5h]
signaturefro: checks 
HermesDF: checks 
*** SHOW DOWN ***
signaturefro: shows [Qd 2h] (high card King)
HermesDF: shows [5s Ad] (a pair of Fives)
HermesDF collected $0.08 from pot
*** SUMMARY ***
Total pot $0.08 | Rake $0 
Board [6s Kc Jh 4d 5h]
Seat 2: Roody_Tha folded before Flop (didn't bet)
Seat 3: weverson315 folded before Flop (didn't bet)
Seat 4: Dorex2007 folded before Flop (didn't bet)
Seat 5: Jumbaliah123 (button) folded before Flop (didn't bet)
Seat 6: signaturefro (small blind) showed [Qd 2h] and lost with high card King
Seat 7: HermesDF (big blind) showed [5s Ad] and won ($0.08) with a pair of Fives
Seat 8: English_Ian folded before Flop (didn't bet)
Seat 9: izzu007 folded before Flop (didn't bet)



PokerStars Hand #237403454816:  Hold'em No Limit ($0.01/$0.02 USD) - 2022/07/16 17:19:01 PT [2022/07/16 20:19:01 ET]
Table 'Kalypso IV' 9-max Seat #6 is the button
Seat 2: Roody_Tha ($2.33 in chips) 
Seat 3: weverson315 ($2 in chips) 
Seat 4: Dorex2007 ($6.88 in chips) 
Seat 5: Jumbaliah123 ($2 in chips) 
Seat 6: signaturefro ($1.75 in chips) 
Seat 7: HermesDF ($0.95 in chips) 
Seat 8: English_Ian ($2.27 in chips) 
Seat 9: izzu007 ($0.81 in chips) 
HermesDF: posts small blind $0.01
English_Ian: posts big blind $0.02
Goya159: sits out 
*** HOLE CARDS ***
Dealt to Dorex2007 [Ts 3d]
izzu007: raises $0.04 to $0.06
Roody_Tha: folds 
weverson315: folds 
Dorex2007: folds 
Jumbaliah123: folds 
signaturefro: calls $0.06
HermesDF: folds 
English_Ian: folds 
*** FLOP *** [Th 7c Td]
izzu007: checks 
signaturefro: checks 
*** TURN *** [Th 7c Td] [5s]
izzu007: checks 
signaturefro: checks 
*** RIVER *** [Th 7c Td 5s] [Qh]
izzu007: checks 
signaturefro: bets $0.10
izzu007: folds 
Uncalled bet ($0.10) returned to signaturefro
signaturefro collected $0.14 from pot
*** SUMMARY ***
Total pot $0.15 | Rake $0.01 
Board [Th 7c Td 5s Qh]
Seat 2: Roody_Tha folded before Flop (didn't bet)
Seat 3: weverson315 folded before Flop (didn't bet)
Seat 4: Dorex2007 folded before Flop (didn't bet)
Seat 5: Jumbaliah123 folded before Flop (didn't bet)
Seat 6: signaturefro (button) collected ($0.14)
Seat 7: HermesDF (small blind) folded before Flop
Seat 8: English_Ian (big blind) folded before Flop
Seat 9: izzu007 folded on the River



PokerStars Hand #237403464206:  Hold'em No Limit ($0.01/$0.02 USD) - 2022/07/16 17:19:43 PT [2022/07/16 20:19:43 ET]
Table 'Kalypso IV' 9-max Seat #7 is the button
Seat 2: Roody_Tha ($2.33 in chips) 
Seat 3: weverson315 ($2 in chips) 
Seat 4: Dorex2007 ($6.88 in chips) 
Seat 5: Jumbaliah123 ($2 in chips) 
Seat 6: signaturefro ($1.83 in chips) 
Seat 7: HermesDF ($0.94 in chips) 
Seat 8: English_Ian ($2.25 in chips) 
Seat 9: izzu007 ($0.75 in chips) 
English_Ian: posts small blind $0.01
izzu007: posts big blind $0.02
Goya159: sits out 
*** HOLE CARDS ***
Dealt to Dorex2007 [Jh 8d]
Roody_Tha: folds 
weverson315: calls $0.02
Dorex2007: folds 
Jumbaliah123 has timed out
Jumbaliah123: folds 
signaturefro: calls $0.02
HermesDF: calls $0.02
English_Ian: folds 
izzu007: checks 
*** FLOP *** [Qc 8c 6s]
izzu007: checks 
weverson315: checks 
signaturefro: bets $0.02
HermesDF: calls $0.02
izzu007: calls $0.02
weverson315: calls $0.02
*** TURN *** [Qc 8c 6s] [3c]
izzu007: checks 
weverson315: checks 
signaturefro: checks 
HermesDF: bets $0.02
izzu007: calls $0.02
weverson315: folds 
signaturefro: calls $0.02
*** RIVER *** [Qc 8c 6s 3c] [5c]
izzu007: checks 
signaturefro: bets $0.11
HermesDF: calls $0.11
izzu007: folds 
*** SHOW DOWN ***
signaturefro: shows [Jc 7s] (a flush, Queen high)
HermesDF: mucks hand 
signaturefro collected $0.43 from pot
*** SUMMARY ***
Total pot $0.45 | Rake $0.02 
Board [Qc 8c 6s 3c 5c]
Seat 2: Roody_Tha folded before Flop (didn't bet)
Seat 3: weverson315 folded on the Turn
Seat 4: Dorex2007 folded before Flop (didn't bet)
Seat 5: Jumbaliah123 folded before Flop (didn't bet)
Seat 6: signaturefro showed [Jc 7s] and won ($0.43) with a flush, Queen high
Seat 7: HermesDF (button) mucked [Tc Js]
Seat 8: English_Ian (small blind) folded before Flop
Seat 9: izzu007 (big blind) folded on the River



PokerStars Hand #237403489427:  Hold'em No Limit ($0.01/$0.02 USD) - 2022/07/16 17:21:35 PT [2022/07/16 20:21:35 ET]
Table 'Kalypso IV' 9-max Seat #8 is the button
Seat 1: Goya159 ($1.60 in chips) 
Seat 2: Roody_Tha ($2.33 in chips) 
Seat 3: weverson315 ($2 in chips) 
Seat 4: Dorex2007 ($6.88 in chips) 
Seat 5: Jumbaliah123 ($2 in chips) 
Seat 6: signaturefro ($2.09 in chips) 
Seat 7: HermesDF ($0.77 in chips) 
Seat 8: English_Ian ($2.24 in chips) 
Seat 9: izzu007 ($0.69 in chips) 
izzu007: posts small blind $0.01
Goya159: posts big blind $0.02
*** HOLE CARDS ***
Dealt to Dorex2007 [7s 3c]
Roody_Tha: calls $0.02
weverson315: folds 
Dorex2007: folds 
Jumbaliah123: calls $0.02
signaturefro: folds 
HermesDF: folds 
English_Ian: calls $0.02
izzu007: calls $0.01
Goya159: checks 
*** FLOP *** [7d Ks Kc]
izzu007: checks 
Goya159: checks 
Roody_Tha: checks 
Jumbaliah123: checks 
English_Ian: checks 
*** TURN *** [7d Ks Kc] [4d]
izzu007: checks 
Goya159: checks 
Roody_Tha: checks 
Jumbaliah123: checks 
English_Ian: checks 
*** RIVER *** [7d Ks Kc 4d] [2h]
izzu007: checks 
Goya159: checks 
Roody_Tha: checks 
Jumbaliah123: checks 
English_Ian: checks 
*** SHOW DOWN ***
izzu007: shows [Qh Th] (a pair of Kings)
Goya159: mucks hand 
Roody_Tha: shows [5h 4h] (two pair, Kings and Fours)
Jumbaliah123: shows [9h 9s] (two pair, Kings and Nines)
English_Ian: mucks hand 
Jumbaliah123 collected $0.10 from pot
*** SUMMARY ***
Total pot $0.10 | Rake $0 
Board [7d Ks Kc 4d 2h]
Seat 1: Goya159 (big blind) mucked [6h 5s]
Seat 2: Roody_Tha showed [5h 4h] and lost with two pair, Kings and Fours
Seat 3: weverson315 folded before Flop (didn't bet)
Seat 4: Dorex2007 folded before Flop (didn't bet)
Seat 5: Jumbaliah123 showed [9h 9s] and won ($0.10) with two pair, Kings and Nines
Seat 6: signaturefro folded before Flop (didn't bet)
Seat 7: HermesDF folded before Flop (didn't bet)
Seat 8: English_Ian (button) mucked [8s Jd]
Seat 9: izzu007 (small blind) showed [Qh Th] and lost with a pair of Kings



PokerStars Hand #237403519436:  Hold'em No Limit ($0.01/$0.02 USD) - 2022/07/16 17:23:30 PT [2022/07/16 20:23:30 ET]
Table 'Kalypso IV' 9-max Seat #9 is the button
Seat 1: Goya159 ($1.58 in chips) 
Seat 3: weverson315 ($2 in chips) 
Seat 4: Dorex2007 ($6.88 in chips) 
Seat 5: Jumbaliah123 ($2.08 in chips) 
Seat 7: HermesDF ($0.77 in chips) 
Seat 8: English_Ian ($2.22 in chips) 
Seat 9: izzu007 ($0.67 in chips) 
Goya159: posts small blind $0.01
Roody_Tha: is sitting out 
weverson315: posts big blind $0.02
*** HOLE CARDS ***
Dealt to Dorex2007 [As 8c]
Dorex2007: folds 
Roody_Tha leaves the table
Jumbaliah123: folds 
VeRy_N1ce323 joins the table at seat #2 
HermesDF has timed out
HermesDF: folds 
English_Ian: folds 
izzu007: calls $0.02
Goya159: calls $0.01
weverson315: checks 
*** FLOP *** [2c Jh Th]
Goya159: checks 
weverson315: checks 
izzu007: checks 
*** TURN *** [2c Jh Th] [3c]
Goya159: checks 
weverson315: checks 
izzu007: checks 
*** RIVER *** [2c Jh Th 3c] [Qs]
Goya159: bets $0.08
weverson315: folds 
izzu007: folds 
Uncalled bet ($0.08) returned to Goya159
Goya159 collected $0.06 from pot
*** SUMMARY ***
Total pot $0.06 | Rake $0 
Board [2c Jh Th 3c Qs]
Seat 1: Goya159 (small blind) collected ($0.06)
Seat 3: weverson315 (big blind) folded on the River
Seat 4: Dorex2007 folded before Flop (didn't bet)
Seat 5: Jumbaliah123 folded before Flop (didn't bet)
Seat 7: HermesDF folded before Flop (didn't bet)
Seat 8: English_Ian folded before Flop (didn't bet)
Seat 9: izzu007 (button) folded on the River



PokerStars Hand #237403538896:  Hold'em No Limit ($0.01/$0.02 USD) - 2022/07/16 17:24:57 PT [2022/07/16 20:24:57 ET]
Table 'Kalypso IV' 9-max Seat #1 is the button
Seat 1: Goya159 ($1.62 in chips) 
Seat 3: weverson315 ($2 in chips) 
Seat 4: Dorex2007 ($6.88 in chips) 
Seat 5: Jumbaliah123 ($2.08 in chips) 
Seat 7: HermesDF ($0.77 in chips) 
Seat 8: English_Ian ($2.22 in chips) 
Seat 9: izzu007 ($0.65 in chips) 
weverson315: posts small blind $0.01
Dorex2007: posts big blind $0.02
*** HOLE CARDS ***
Dealt to Dorex2007 [2s Kc]
Jumbaliah123: calls $0.02
HermesDF has timed out
HermesDF: folds 
English_Ian: folds 
izzu007: folds 
Goya159: calls $0.02
weverson315: calls $0.01
Dorex2007: checks 
*** FLOP *** [3s Th 4d]
weverson315: checks 
Dorex2007: checks 
Jumbaliah123: bets $0.02
Goya159: calls $0.02
weverson315: calls $0.02
Dorex2007: folds 
*** TURN *** [3s Th 4d] [4s]
weverson315: checks 
Jumbaliah123: checks 
VeRy_N1ce323 is disconnected 
Goya159: checks 
*** RIVER *** [3s Th 4d 4s] [8h]
weverson315: checks 
Jumbaliah123: checks 
Goya159: checks 
*** SHOW DOWN ***
weverson315: shows [5s Ac] (a pair of Fours)
Jumbaliah123: shows [7d Td] (two pair, Tens and Fours)
Goya159: mucks hand 
Jumbaliah123 collected $0.14 from pot
*** SUMMARY ***
Total pot $0.14 | Rake $0 
Board [3s Th 4d 4s 8h]
Seat 1: Goya159 (button) mucked [3h 6h]
Seat 3: weverson315 (small blind) showed [5s Ac] and lost with a pair of Fours
Seat 4: Dorex2007 (big blind) folded on the Flop
Seat 5: Jumbaliah123 showed [7d Td] and won ($0.14) with two pair, Tens and Fours
Seat 7: HermesDF folded before Flop (didn't bet)
Seat 8: English_Ian folded before Flop (didn't bet)
Seat 9: izzu007 folded before Flop (didn't bet)



PokerStars Hand #237403553350:  Hold'em No Limit ($0.01/$0.02 USD) - 2022/07/16 17:26:02 PT [2022/07/16 20:26:02 ET]
Table 'Kalypso IV' 9-max Seat #3 is the button
Seat 1: Goya159 ($1.58 in chips) 
Seat 3: weverson315 ($2 in chips) 
Seat 4: Dorex2007 ($6.86 in chips) 
Seat 5: Jumbaliah123 ($2.18 in chips) 
Seat 6: signaturefro ($2.09 in chips) 
Seat 8: English_Ian ($2.22 in chips) 
Seat 9: izzu007 ($0.65 in chips) 
Dorex2007: posts small blind $0.01
Jumbaliah123: posts big blind $0.02
VeRy_N1ce323 has timed out while disconnected
VeRy_N1ce323: is sitting out 
*** HOLE CARDS ***
Dealt to Dorex2007 [3h 7h]
signaturefro: folds 
signaturefro leaves the table
alexiscarel7 joins the table at seat #6 
English_Ian: folds 
izzu007: calls $0.02
Goya159 has timed out
Goya159: folds 
weverson315: folds 
Dorex2007: folds 
Jumbaliah123: checks 
*** FLOP *** [6s As 4d]
Jumbaliah123: checks 
alexiscarel7 leaves the table
izzu007: checks 
*** TURN *** [6s As 4d] [Jc]
Jumbaliah123: checks 
izzu007: checks 
*** RIVER *** [6s As 4d Jc] [Td]
Jumbaliah123: checks 
AKslaterAK joins the table at seat #6 
izzu007: checks 
*** SHOW DOWN ***
Jumbaliah123: shows [Tc 2h] (a pair of Tens)
izzu007: mucks hand 
Jumbaliah123 collected $0.05 from pot
*** SUMMARY ***
Total pot $0.05 | Rake $0 
Board [6s As 4d Jc Td]
Seat 1: Goya159 folded before Flop (didn't bet)
Seat 3: weverson315 (button) folded before Flop (didn't bet)
Seat 4: Dorex2007 (small blind) folded before Flop
Seat 5: Jumbaliah123 (big blind) showed [Tc 2h] and won ($0.05) with a pair of Tens
Seat 6: signaturefro folded before Flop (didn't bet)
Seat 8: English_Ian folded before Flop (didn't bet)
Seat 9: izzu007 mucked [5d Kd]



PokerStars Hand #237403565309:  Hold'em No Limit ($0.01/$0.02 USD) - 2022/07/16 17:26:55 PT [2022/07/16 20:26:55 ET]
Table 'Kalypso IV' 9-max Seat #4 is the button
Seat 1: Goya159 ($1.58 in chips) 
Seat 3: weverson315 ($2 in chips) 
Seat 4: Dorex2007 ($6.85 in chips) 
Seat 5: Jumbaliah123 ($2.21 in chips) 
Seat 6: AKslaterAK ($2 in chips) 
Seat 8: English_Ian ($2.22 in chips) 
Seat 9: izzu007 ($0.63 in chips) 
Jumbaliah123: posts small blind $0.01
AKslaterAK: posts big blind $0.02
*** HOLE CARDS ***
Dealt to Dorex2007 [4h 4s]
English_Ian: folds 
izzu007: calls $0.02
Goya159: calls $0.02
weverson315: calls $0.02
Dorex2007: calls $0.02
Jumbaliah123: calls $0.01
AKslaterAK: checks 
*** FLOP *** [5d Js 5c]
Jumbaliah123: checks 
AKslaterAK: checks 
izzu007: checks 
Goya159: bets $0.06
weverson315: folds 
Dorex2007: folds 
Jumbaliah123: folds 
AKslaterAK: folds 
izzu007: folds 
Uncalled bet ($0.06) returned to Goya159
Goya159 collected $0.12 from pot
*** SUMMARY ***
Total pot $0.12 | Rake $0 
Board [5d Js 5c]
Seat 1: Goya159 collected ($0.12)
Seat 3: weverson315 folded on the Flop
Seat 4: Dorex2007 (button) folded on the Flop
Seat 5: Jumbaliah123 (small blind) folded on the Flop
Seat 6: AKslaterAK (big blind) folded on the Flop
Seat 8: English_Ian folded before Flop (didn't bet)
Seat 9: izzu007 folded on the Flop



PokerStars Hand #237403583303:  Hold'em No Limit ($0.01/$0.02 USD) - 2022/07/16 17:28:15 PT [2022/07/16 20:28:15 ET]
Table 'Kalypso IV' 9-max Seat #5 is the button
Seat 1: Goya159 ($1.68 in chips) 
Seat 2: VeRy_N1ce323 ($2 in chips) 
Seat 3: weverson315 ($2 in chips) 
Seat 4: Dorex2007 ($6.83 in chips) 
Seat 5: Jumbaliah123 ($2.19 in chips) 
Seat 6: AKslaterAK ($1.98 in chips) 
Seat 7: HermesDF ($0.77 in chips) 
Seat 8: English_Ian ($2.22 in chips) 
Seat 9: izzu007 ($0.61 in chips) 
AKslaterAK: posts small blind $0.01
HermesDF: posts big blind $0.02
VeRy_N1ce323: posts big blind $0.02
*** HOLE CARDS ***
Dealt to Dorex2007 [9s 7c]
English_Ian: calls $0.02
izzu007: folds 
Goya159: folds 
VeRy_N1ce323 is disconnected 
VeRy_N1ce323 has timed out while disconnected
VeRy_N1ce323: checks 
weverson315: folds 
Dorex2007: folds 
Jumbaliah123: calls $0.02
AKslaterAK: calls $0.01
HermesDF: checks 
*** FLOP *** [4d 8d Td]
AKslaterAK: checks 
HermesDF: checks 
English_Ian: checks 
VeRy_N1ce323 has timed out while disconnected
VeRy_N1ce323: checks 
Jumbaliah123: checks 
*** TURN *** [4d 8d Td] [Qs]
AKslaterAK: checks 
HermesDF: checks 
English_Ian: checks 
VeRy_N1ce323 has timed out while disconnected
VeRy_N1ce323: checks 
Jumbaliah123: bets $0.06
AKslaterAK: folds 
HermesDF: folds 
English_Ian: folds 
English_Ian leaves the table
guiaoms joins the table at seat #8 
VeRy_N1ce323 has timed out while disconnected
VeRy_N1ce323: folds 
Uncalled bet ($0.06) returned to Jumbaliah123
Jumbaliah123 collected $0.10 from pot
*** SUMMARY ***
Total pot $0.10 | Rake $0 
Board [4d 8d Td Qs]
Seat 1: Goya159 folded before Flop (didn't bet)
Seat 2: VeRy_N1ce323 folded on the Turn (didn't bet)
Seat 3: weverson315 folded before Flop (didn't bet)
Seat 4: Dorex2007 folded before Flop (didn't bet)
Seat 5: Jumbaliah123 (button) collected ($0.10)
Seat 6: AKslaterAK (small blind) folded on the Turn
Seat 7: HermesDF (big blind) folded on the Turn
Seat 8: English_Ian folded on the Turn
Seat 9: izzu007 folded before Flop (didn't bet)



PokerStars Hand #237403611668:  Hold'em No Limit ($0.01/$0.02 USD) - 2022/07/16 17:30:22 PT [2022/07/16 20:30:22 ET]
Table 'Kalypso IV' 9-max Seat #6 is the button
Seat 1: Goya159 ($1.68 in chips) 
Seat 3: weverson315 ($2 in chips) 
Seat 4: Dorex2007 ($6.83 in chips) 
Seat 5: Jumbaliah123 ($2.27 in chips) 
Seat 6: AKslaterAK ($1.96 in chips) 
Seat 7: HermesDF ($0.75 in chips) 
Seat 8: guiaoms ($1.60 in chips) 
Seat 9: izzu007 ($0.61 in chips) 
HermesDF: posts small blind $0.01
guiaoms: posts big blind $0.02
*** HOLE CARDS ***
Dealt to Dorex2007 [Th 4d]
izzu007: raises $0.02 to $0.04
Goya159: folds 
weverson315: calls $0.04
Dorex2007: folds 
Jumbaliah123: folds 
AKslaterAK: folds 
HermesDF: calls $0.03
guiaoms: calls $0.02
*** FLOP *** [2s 3h As]
HermesDF: bets $0.02
guiaoms: folds 
izzu007: folds 
weverson315: calls $0.02
*** TURN *** [2s 3h As] [Ah]
HermesDF: bets $0.09
weverson315: calls $0.09
*** RIVER *** [2s 3h As Ah] [8d]
HermesDF: bets $0.60 and is all-in
weverson315: folds 
Uncalled bet ($0.60) returned to HermesDF
HermesDF collected $0.37 from pot
*** SUMMARY ***
Total pot $0.38 | Rake $0.01 
Board [2s 3h As Ah 8d]
Seat 1: Goya159 folded before Flop (didn't bet)
Seat 3: weverson315 folded on the River
Seat 4: Dorex2007 folded before Flop (didn't bet)
Seat 5: Jumbaliah123 folded before Flop (didn't bet)
Seat 6: AKslaterAK (button) folded before Flop (didn't bet)
Seat 7: HermesDF (small blind) collected ($0.37)
Seat 8: guiaoms (big blind) folded on the Flop
Seat 9: izzu007 folded on the Flop



PokerStars Hand #237403628945:  Hold'em No Limit ($0.01/$0.02 USD) - 2022/07/16 17:31:39 PT [2022/07/16 20:31:39 ET]
Table 'Kalypso IV' 9-max Seat #7 is the button
Seat 1: Goya159 ($1.68 in chips) 
Seat 3: weverson315 ($2 in chips) 
Seat 4: Dorex2007 ($6.83 in chips) 
Seat 5: Jumbaliah123 ($2.27 in chips) 
Seat 6: AKslaterAK ($1.96 in chips) 
Seat 7: HermesDF ($0.97 in chips) 
Seat 8: guiaoms ($1.56 in chips) 
Seat 9: izzu007 ($0.57 in chips) 
guiaoms: posts small blind $0.01
izzu007: posts big blind $0.02
*** HOLE CARDS ***
Dealt to Dorex2007 [Jd 8h]
Goya159: calls $0.02
weverson315: calls $0.02
Dorex2007: folds 
Jumbaliah123: calls $0.02
AKslaterAK: folds 
HermesDF: raises $0.04 to $0.06
guiaoms: folds 
izzu007: folds 
Goya159: calls $0.04
weverson315: calls $0.04
Jumbaliah123: calls $0.04
*** FLOP *** [Js Kh 5c]
Goya159: checks 
weverson315: checks 
Jumbaliah123: checks 
HermesDF: bets $0.13
Goya159: folds 
VeRy_N1ce323 leaves the table
weverson315: calls $0.13
Jumbaliah123: folds 
*** TURN *** [Js Kh 5c] [8d]
weverson315: checks 
LBDC x Poker joins the table at seat #2 
HermesDF: bets $0.25
weverson315: calls $0.25
*** RIVER *** [Js Kh 5c 8d] [6h]
weverson315: checks 
HermesDF: bets $0.49
weverson315: folds 
Uncalled bet ($0.49) returned to HermesDF
HermesDF collected $0.99 from pot
*** SUMMARY ***
Total pot $1.03 | Rake $0.04 
Board [Js Kh 5c 8d 6h]
Seat 1: Goya159 folded on the Flop
Seat 3: weverson315 folded on the River
Seat 4: Dorex2007 folded before Flop (didn't bet)
Seat 5: Jumbaliah123 folded on the Flop
Seat 6: AKslaterAK folded before Flop (didn't bet)
Seat 7: HermesDF (button) collected ($0.99)
Seat 8: guiaoms (small blind) folded before Flop
Seat 9: izzu007 (big blind) folded before Flop



PokerStars Hand #237403646217:  Hold'em No Limit ($0.01/$0.02 USD) - 2022/07/16 17:32:50 PT [2022/07/16 20:32:50 ET]
Table 'Kalypso IV' 9-max Seat #8 is the button
Seat 1: Goya159 ($1.62 in chips) 
Seat 3: weverson315 ($2 in chips) 
Seat 4: Dorex2007 ($6.83 in chips) 
Seat 5: Jumbaliah123 ($2.21 in chips) 
Seat 6: AKslaterAK ($1.96 in chips) 
Seat 7: HermesDF ($1.52 in chips) 
Seat 8: guiaoms ($1.55 in chips) 
Seat 9: izzu007 ($0.55 in chips) 
izzu007: posts small blind $0.01
Goya159: posts big blind $0.02
LBDC x Poker: sits out 
*** HOLE CARDS ***
Dealt to Dorex2007 [8s Js]
weverson315: calls $0.02
Dorex2007: folds 
Jumbaliah123: folds 
AKslaterAK: raises $0.06 to $0.08
HermesDF: folds 
guiaoms: folds 
izzu007: calls $0.07
Goya159: folds 
weverson315: folds 
*** FLOP *** [5h 6d Kd]
izzu007: checks 
AKslaterAK: checks 
*** TURN *** [5h 6d Kd] [5s]
izzu007: checks 
AKslaterAK: checks 
*** RIVER *** [5h 6d Kd 5s] [Ad]
izzu007: bets $0.19
AKslaterAK: calls $0.19
*** SHOW DOWN ***
izzu007: shows [Jd Ah] (two pair, Aces and Fives)
AKslaterAK: shows [As 9c] (two pair, Aces and Fives)
izzu007 collected $0.28 from pot
AKslaterAK collected $0.28 from pot
*** SUMMARY ***
Total pot $0.58 | Rake $0.02 
Board [5h 6d Kd 5s Ad]
Seat 1: Goya159 (big blind) folded before Flop
Seat 3: weverson315 folded before Flop
Seat 4: Dorex2007 folded before Flop (didn't bet)
Seat 5: Jumbaliah123 folded before Flop (didn't bet)
Seat 6: AKslaterAK showed [As 9c] and won ($0.28) with two pair, Aces and Fives
Seat 7: HermesDF folded before Flop (didn't bet)
Seat 8: guiaoms (button) folded before Flop (didn't bet)
Seat 9: izzu007 (small blind) showed [Jd Ah] and won ($0.28) with two pair, Aces and Fives



PokerStars Hand #237403663564:  Hold'em No Limit ($0.01/$0.02 USD) - 2022/07/16 17:34:08 PT [2022/07/16 20:34:08 ET]
Table 'Kalypso IV' 9-max Seat #9 is the button
Seat 1: Goya159 ($1.60 in chips) 
Seat 2: LBDC x Poker ($2 in chips) 
Seat 3: weverson315 ($2 in chips) 
Seat 4: Dorex2007 ($6.83 in chips) 
Seat 5: Jumbaliah123 ($2.21 in chips) 
Seat 6: AKslaterAK ($1.97 in chips) 
Seat 7: HermesDF ($1.52 in chips) 
Seat 8: guiaoms ($1.55 in chips) 
Seat 9: izzu007 ($0.56 in chips) 
Goya159: posts small blind $0.01
LBDC x Poker: posts big blind $0.02
*** HOLE CARDS ***
Dealt to Dorex2007 [4s Kh]
weverson315: calls $0.02
Dorex2007: folds 
Jumbaliah123: folds 
AKslaterAK: folds 
HermesDF: folds 
guiaoms: folds 
izzu007: calls $0.02
Goya159: raises $0.02 to $0.04
LBDC x Poker: calls $0.02
weverson315: calls $0.02
izzu007: calls $0.02
*** FLOP *** [Ad Jc 9h]
Goya159: checks 
LBDC x Poker: checks 
weverson315: checks 
izzu007: checks 
*** TURN *** [Ad Jc 9h] [8h]
Goya159: checks 
LBDC x Poker: checks 
weverson315: checks 
izzu007 has timed out
izzu007: checks 
*** RIVER *** [Ad Jc 9h 8h] [5h]
Goya159: bets $0.02
LBDC x Poker: raises $0.12 to $0.14
weverson315: raises $1.82 to $1.96 and is all-in
izzu007 has timed out
izzu007: folds 
Goya159: folds 
LBDC x Poker: calls $1.82 and is all-in
*** SHOW DOWN ***
weverson315: shows [Ah 2h] (a flush, Ace high)
LBDC x Poker: shows [Td Qc] (a straight, Eight to Queen)
weverson315 collected $3.96 from pot
*** SUMMARY ***
Total pot $4.10 | Rake $0.14 
Board [Ad Jc 9h 8h 5h]
Seat 1: Goya159 (small blind) folded on the River
Seat 2: LBDC x Poker (big blind) showed [Td Qc] and lost with a straight, Eight to Queen
Seat 3: weverson315 showed [Ah 2h] and won ($3.96) with a flush, Ace high
Seat 4: Dorex2007 folded before Flop (didn't bet)
Seat 5: Jumbaliah123 folded before Flop (didn't bet)
Seat 6: AKslaterAK folded before Flop (didn't bet)
Seat 7: HermesDF folded before Flop (didn't bet)
Seat 8: guiaoms folded before Flop (didn't bet)
Seat 9: izzu007 (button) folded on the River



PokerStars Hand #237403703242:  Hold'em No Limit ($0.01/$0.02 USD) - 2022/07/16 17:36:57 PT [2022/07/16 20:36:57 ET]
Table 'Kalypso IV' 9-max Seat #1 is the button
Seat 1: Goya159 ($1.54 in chips) 
Seat 3: weverson315 ($3.96 in chips) 
Seat 4: Dorex2007 ($6.83 in chips) 
Seat 5: Jumbaliah123 ($2.21 in chips) 
Seat 6: AKslaterAK ($1.97 in chips) 
Seat 7: HermesDF ($1.52 in chips) 
Seat 8: guiaoms ($1.55 in chips) 
weverson315: posts small blind $0.01
Dorex2007: posts big blind $0.02
*** HOLE CARDS ***
Dealt to Dorex2007 [7c 5c]
Jumbaliah123: calls $0.02
LBDC x Poker leaves the table
AKslaterAK: folds 
HermesDF: folds 
guiaoms: folds 
Goya159: calls $0.02
weverson315: calls $0.01
Dorex2007: checks 
*** FLOP *** [8s 7h 3c]
LuckyGranpa joins the table at seat #2 
weverson315: checks 
Dorex2007: checks 
Jumbaliah123: checks 
Goya159: checks 
*** TURN *** [8s 7h 3c] [8d]
weverson315: checks 
Dorex2007: bets $0.08
Jumbaliah123: folds 
Goya159: calls $0.08
weverson315: folds 
*** RIVER *** [8s 7h 3c 8d] [Jc]
Dorex2007: bets $0.11
Goya159: folds 
Uncalled bet ($0.11) returned to Dorex2007
Dorex2007 collected $0.23 from pot
*** SUMMARY ***
Total pot $0.24 | Rake $0.01 
Board [8s 7h 3c 8d Jc]
Seat 1: Goya159 (button) folded on the River
Seat 3: weverson315 (small blind) folded on the Turn
Seat 4: Dorex2007 (big blind) collected ($0.23)
Seat 5: Jumbaliah123 folded on the Turn
Seat 6: AKslaterAK folded before Flop (didn't bet)
Seat 7: HermesDF folded before Flop (didn't bet)
Seat 8: guiaoms folded before Flop (didn't bet)



PokerStars Hand #237403721515:  Hold'em No Limit ($0.01/$0.02 USD) - 2022/07/16 17:38:19 PT [2022/07/16 20:38:19 ET]
Table 'Kalypso IV' 9-max Seat #3 is the button
Seat 1: Goya159 ($1.44 in chips) 
Seat 2: LuckyGranpa ($0.80 in chips) 
Seat 3: weverson315 ($3.94 in chips) 
Seat 4: Dorex2007 ($6.96 in chips) 
Seat 5: Jumbaliah123 ($2.19 in chips) 
Seat 6: AKslaterAK ($1.97 in chips) 
Seat 7: HermesDF ($1.52 in chips) 
Seat 8: guiaoms ($1.55 in chips) 
Dorex2007: posts small blind $0.01
Jumbaliah123: posts big blind $0.02
LuckyGranpa: posts big blind $0.02
*** HOLE CARDS ***
Dealt to Dorex2007 [4h Jd]
AKslaterAK: folds 
HermesDF: calls $0.02
guiaoms: folds 
Goya159 has timed out
Goya159: folds 
LuckyGranpa: checks 
weverson315: calls $0.02
Dorex2007: folds 
Jumbaliah123: checks 
*** FLOP *** [4d 4c 9c]
Jumbaliah123: checks 
HermesDF: bets $0.02
LuckyGranpa: calls $0.02
weverson315: folds 
Jumbaliah123: folds 
*** TURN *** [4d 4c 9c] [Jh]
HermesDF: bets $0.02
LuckyGranpa: calls $0.02
*** RIVER *** [4d 4c 9c Jh] [3h]
HermesDF: checks 
LuckyGranpa: checks 
*** SHOW DOWN ***
HermesDF: shows [Ac 2s] (a pair of Fours)
LuckyGranpa: shows [6s 6d] (two pair, Sixes and Fours)
LuckyGranpa collected $0.16 from pot
*** SUMMARY ***
Total pot $0.17 | Rake $0.01 
Board [4d 4c 9c Jh 3h]
Seat 1: Goya159 folded before Flop (didn't bet)
Seat 2: LuckyGranpa showed [6s 6d] and won ($0.16) with two pair, Sixes and Fours
Seat 3: weverson315 (button) folded on the Flop
Seat 4: Dorex2007 (small blind) folded before Flop
Seat 5: Jumbaliah123 (big blind) folded on the Flop
Seat 6: AKslaterAK folded before Flop (didn't bet)
Seat 7: HermesDF showed [Ac 2s] and lost with a pair of Fours
Seat 8: guiaoms folded before Flop (didn't bet)



PokerStars Hand #237403741794:  Hold'em No Limit ($0.01/$0.02 USD) - 2022/07/16 17:39:24 PT [2022/07/16 20:39:24 ET]
Table 'Kalypso IV' 9-max Seat #4 is the button
Seat 1: Goya159 ($1.44 in chips) 
Seat 2: LuckyGranpa ($0.90 in chips) 
Seat 3: weverson315 ($3.92 in chips) 
Seat 4: Dorex2007 ($6.95 in chips) 
Seat 5: Jumbaliah123 ($2.17 in chips) 
Seat 6: AKslaterAK ($1.97 in chips) 
Seat 7: HermesDF ($1.46 in chips) 
Seat 8: guiaoms ($1.55 in chips) 
Jumbaliah123: posts small blind $0.01
AKslaterAK: posts big blind $0.02
*** HOLE CARDS ***
Dealt to Dorex2007 [7d Tc]
HermesDF: calls $0.02
guiaoms: folds 
Goya159 has timed out
Goya159: folds 
LuckyGranpa: folds 
weverson315: calls $0.02
Dorex2007: folds 
Jumbaliah123: calls $0.01
AKslaterAK: checks 
*** FLOP *** [6c 5s 6h]
Jumbaliah123: checks 
AKslaterAK: checks 
HermesDF: checks 
weverson315: checks 
*** TURN *** [6c 5s 6h] [Ad]
Jumbaliah123: checks 
AKslaterAK: bets $0.06
HermesDF: calls $0.06
weverson315: folds 
Jumbaliah123: folds 
*** RIVER *** [6c 5s 6h Ad] [Qc]
AKslaterAK: bets $0.10
HermesDF: calls $0.10
*** SHOW DOWN ***
AKslaterAK: shows [3d 6s] (three of a kind, Sixes)
HermesDF: mucks hand 
AKslaterAK collected $0.39 from pot
*** SUMMARY ***
Total pot $0.40 | Rake $0.01 
Board [6c 5s 6h Ad Qc]
Seat 1: Goya159 folded before Flop (didn't bet)
Seat 2: LuckyGranpa folded before Flop (didn't bet)
Seat 3: weverson315 folded on the Turn
Seat 4: Dorex2007 (button) folded before Flop (didn't bet)
Seat 5: Jumbaliah123 (small blind) folded on the Turn
Seat 6: AKslaterAK (big blind) showed [3d 6s] and won ($0.39) with three of a kind, Sixes
Seat 7: HermesDF mucked [Ah 7s]
Seat 8: guiaoms folded before Flop (didn't bet)



PokerStars Hand #237403757269:  Hold'em No Limit ($0.01/$0.02 USD) - 2022/07/16 17:40:35 PT [2022/07/16 20:40:35 ET]
Table 'Kalypso IV' 9-max Seat #5 is the button
Seat 1: Goya159 ($1.44 in chips) 
Seat 2: LuckyGranpa ($0.90 in chips) 
Seat 3: weverson315 ($3.90 in chips) 
Seat 4: Dorex2007 ($6.95 in chips) 
Seat 5: Jumbaliah123 ($2.15 in chips) 
Seat 6: AKslaterAK ($2.18 in chips) 
Seat 7: HermesDF ($1.28 in chips) 
Seat 8: guiaoms ($1.55 in chips) 
Seat 9: izzu007 ($0.52 in chips) 
AKslaterAK: posts small blind $0.01
HermesDF: posts big blind $0.02
*** HOLE CARDS ***
Dealt to Dorex2007 [5d 3s]
guiaoms: folds 
izzu007: folds 
Goya159: calls $0.02
LuckyGranpa: raises $0.04 to $0.06
weverson315: folds 
Dorex2007: folds 
Jumbaliah123: folds 
AKslaterAK: folds 
HermesDF: calls $0.04
Goya159: calls $0.04
*** FLOP *** [2d 2s 3h]
HermesDF: bets $0.02
Goya159: raises $0.11 to $0.13
LuckyGranpa: calls $0.13
HermesDF: folds 
*** TURN *** [2d 2s 3h] [Jc]
Goya159: bets $0.12
LuckyGranpa: calls $0.12
*** RIVER *** [2d 2s 3h Jc] [Qs]
Goya159: checks 
LuckyGranpa: bets $0.59 and is all-in
Goya159: folds 
Uncalled bet ($0.59) returned to LuckyGranpa
LuckyGranpa collected $0.69 from pot
*** SUMMARY ***
Total pot $0.71 | Rake $0.02 
Board [2d 2s 3h Jc Qs]
Seat 1: Goya159 folded on the River
Seat 2: LuckyGranpa collected ($0.69)
Seat 3: weverson315 folded before Flop (didn't bet)
Seat 4: Dorex2007 folded before Flop (didn't bet)
Seat 5: Jumbaliah123 (button) folded before Flop (didn't bet)
Seat 6: AKslaterAK (small blind) folded before Flop
Seat 7: HermesDF (big blind) folded on the Flop
Seat 8: guiaoms folded before Flop (didn't bet)
Seat 9: izzu007 folded before Flop (didn't bet)



PokerStars Hand #237403771582:  Hold'em No Limit ($0.01/$0.02 USD) - 2022/07/16 17:41:40 PT [2022/07/16 20:41:40 ET]
Table 'Kalypso IV' 9-max Seat #6 is the button
Seat 1: Goya159 ($1.13 in chips) 
Seat 2: LuckyGranpa ($1.28 in chips) 
Seat 3: weverson315 ($3.90 in chips) 
Seat 4: Dorex2007 ($6.95 in chips) 
Seat 5: Jumbaliah123 ($2.15 in chips) 
Seat 6: AKslaterAK ($2.17 in chips) 
Seat 7: HermesDF ($1.20 in chips) 
Seat 8: guiaoms ($1.55 in chips) 
Seat 9: izzu007 ($0.52 in chips) 
HermesDF: posts small blind $0.01
guiaoms: posts big blind $0.02
*** HOLE CARDS ***
Dealt to Dorex2007 [6h Kc]
izzu007: folds 
Goya159: calls $0.02
LuckyGranpa: folds 
weverson315: calls $0.02
Dorex2007: folds 
Jumbaliah123: calls $0.02
AKslaterAK: folds 
HermesDF: folds 
guiaoms: checks 
*** FLOP *** [9d 4s 8h]
guiaoms: checks 
Goya159: bets $0.02
weverson315: calls $0.02
Jumbaliah123: calls $0.02
guiaoms: folds 
*** TURN *** [9d 4s 8h] [3c]
Goya159: bets $0.02
weverson315: calls $0.02
Jumbaliah123: folds 
*** RIVER *** [9d 4s 8h 3c] [8s]
Goya159: bets $0.10
weverson315: folds 
Uncalled bet ($0.10) returned to Goya159
Goya159 collected $0.18 from pot
*** SUMMARY ***
Total pot $0.19 | Rake $0.01 
Board [9d 4s 8h 3c 8s]
Seat 1: Goya159 collected ($0.18)
Seat 2: LuckyGranpa folded before Flop (didn't bet)
Seat 3: weverson315 folded on the River
Seat 4: Dorex2007 folded before Flop (didn't bet)
Seat 5: Jumbaliah123 folded on the Turn
Seat 6: AKslaterAK (button) folded before Flop (didn't bet)
Seat 7: HermesDF (small blind) folded before Flop
Seat 8: guiaoms (big blind) folded on the Flop
Seat 9: izzu007 folded before Flop (didn't bet)



PokerStars Hand #237403784873:  Hold'em No Limit ($0.01/$0.02 USD) - 2022/07/16 17:42:41 PT [2022/07/16 20:42:41 ET]
Table 'Kalypso IV' 9-max Seat #7 is the button
Seat 1: Goya159 ($1.25 in chips) 
Seat 2: LuckyGranpa ($1.28 in chips) 
Seat 3: weverson315 ($3.84 in chips) 
Seat 4: Dorex2007 ($6.95 in chips) 
Seat 5: Jumbaliah123 ($2.11 in chips) 
Seat 6: AKslaterAK ($2.17 in chips) 
Seat 7: HermesDF ($1.19 in chips) 
Seat 8: guiaoms ($1.53 in chips) 
guiaoms: posts small blind $0.01
Goya159: posts big blind $0.02
*** HOLE CARDS ***
Dealt to Dorex2007 [7c Tc]
LuckyGranpa: calls $0.02
weverson315: folds 
Dorex2007: folds 
Jumbaliah123: folds 
AKslaterAK: folds 
HermesDF: calls $0.02
guiaoms: folds 
Goya159: checks 
*** FLOP *** [3d Qh 7h]
Goya159: checks 
LuckyGranpa: bets $0.07
HermesDF: calls $0.07
Goya159: folds 
*** TURN *** [3d Qh 7h] [5s]
LuckyGranpa: bets $1.19 and is all-in
HermesDF: calls $1.10 and is all-in
Uncalled bet ($0.09) returned to LuckyGranpa
*** RIVER *** [3d Qh 7h 5s] [2h]
*** SHOW DOWN ***
LuckyGranpa: shows [Qc Ac] (a pair of Queens)
HermesDF: shows [Ah 4h] (a flush, Ace high)
HermesDF collected $2.33 from pot
LuckyGranpa cashed out the hand for $1.52 | Cash Out Fee $0.02
*** SUMMARY ***
Total pot $2.41 | Rake $0.08 
Board [3d Qh 7h 5s 2h]
Seat 1: Goya159 (big blind) folded on the Flop
Seat 2: LuckyGranpa showed [Qc Ac] and lost with a pair of Queens (cashed out).
Seat 3: weverson315 folded before Flop (didn't bet)
Seat 4: Dorex2007 folded before Flop (didn't bet)
Seat 5: Jumbaliah123 folded before Flop (didn't bet)
Seat 6: AKslaterAK folded before Flop (didn't bet)
Seat 7: HermesDF (button) showed [Ah 4h] and won ($2.33) with a flush, Ace high
Seat 8: guiaoms (small blind) folded before Flop



PokerStars Hand #237403804848:  Hold'em No Limit ($0.01/$0.02 USD) - 2022/07/16 17:43:38 PT [2022/07/16 20:43:38 ET]
Table 'Kalypso IV' 9-max Seat #8 is the button
Seat 1: Goya159 ($1.23 in chips) 
Seat 2: LuckyGranpa ($1.61 in chips) 
Seat 3: weverson315 ($3.84 in chips) 
Seat 4: Dorex2007 ($6.95 in chips) 
Seat 5: Jumbaliah123 ($2.11 in chips) 
Seat 6: AKslaterAK ($2.17 in chips) 
Seat 7: HermesDF ($2.33 in chips) 
Seat 8: guiaoms ($1.52 in chips) 
Goya159: posts small blind $0.01
LuckyGranpa: posts big blind $0.02
*** HOLE CARDS ***
Dealt to Dorex2007 [5d Jd]
weverson315: calls $0.02
Dorex2007: folds 
Jumbaliah123: calls $0.02
AKslaterAK: folds 
HermesDF: raises $0.04 to $0.06
guiaoms: folds 
Goya159: folds 
LuckyGranpa: folds 
weverson315: calls $0.04
Jumbaliah123: calls $0.04
*** FLOP *** [7c 4s 2h]
weverson315: checks 
Jumbaliah123: checks 
HermesDF: bets $0.02
weverson315: calls $0.02
Jumbaliah123: calls $0.02
*** TURN *** [7c 4s 2h] [6c]
weverson315: checks 
Jumbaliah123: checks 
HermesDF: bets $0.02
weverson315: calls $0.02
Jumbaliah123: calls $0.02
*** RIVER *** [7c 4s 2h 6c] [3d]
weverson315: checks 
Jumbaliah123: checks 
HermesDF: checks 
*** SHOW DOWN ***
weverson315: shows [7d 9d] (a pair of Sevens)
Jumbaliah123: shows [7h 7s] (three of a kind, Sevens)
HermesDF: mucks hand 
Jumbaliah123 collected $0.32 from pot
*** SUMMARY ***
Total pot $0.33 | Rake $0.01 
Board [7c 4s 2h 6c 3d]
Seat 1: Goya159 (small blind) folded before Flop
Seat 2: LuckyGranpa (big blind) folded before Flop
Seat 3: weverson315 showed [7d 9d] and lost with a pair of Sevens
Seat 4: Dorex2007 folded before Flop (didn't bet)
Seat 5: Jumbaliah123 showed [7h 7s] and won ($0.32) with three of a kind, Sevens
Seat 6: AKslaterAK folded before Flop (didn't bet)
Seat 7: HermesDF mucked [Kc Jc]
Seat 8: guiaoms (button) folded before Flop (didn't bet)



PokerStars Hand #237403818578:  Hold'em No Limit ($0.01/$0.02 USD) - 2022/07/16 17:44:42 PT [2022/07/16 20:44:42 ET]
Table 'Kalypso IV' 9-max Seat #1 is the button
Seat 1: Goya159 ($1.22 in chips) 
Seat 2: LuckyGranpa ($1.59 in chips) 
Seat 3: weverson315 ($3.74 in chips) 
Seat 4: Dorex2007 ($6.95 in chips) 
Seat 5: Jumbaliah123 ($2.33 in chips) 
Seat 6: AKslaterAK ($2.17 in chips) 
Seat 7: HermesDF ($2.23 in chips) 
Seat 8: guiaoms ($1.52 in chips) 
LuckyGranpa: posts small blind $0.01
weverson315: posts big blind $0.02
izzu007: sits out 
*** HOLE CARDS ***
Dealt to Dorex2007 [9h 2c]
Dorex2007: folds 
Jumbaliah123: folds 
AKslaterAK: folds 
HermesDF: calls $0.02
guiaoms: calls $0.02
Goya159: folds 
LuckyGranpa: calls $0.01
weverson315: checks 
*** FLOP *** [8s 7s Jd]
LuckyGranpa: checks 
weverson315: checks 
HermesDF: bets $0.04
guiaoms: folds 
LuckyGranpa: folds 
weverson315: calls $0.04
*** TURN *** [8s 7s Jd] [8h]
weverson315: checks 
HermesDF: bets $0.07
weverson315: calls $0.07
*** RIVER *** [8s 7s Jd 8h] [Ts]
weverson315: bets $0.10
HermesDF: calls $0.10
*** SHOW DOWN ***
weverson315: shows [2s 9s] (a flush, Ten high)
HermesDF: mucks hand 
weverson315 collected $0.48 from pot
*** SUMMARY ***
Total pot $0.50 | Rake $0.02 
Board [8s 7s Jd 8h Ts]
Seat 1: Goya159 (button) folded before Flop (didn't bet)
Seat 2: LuckyGranpa (small blind) folded on the Flop
Seat 3: weverson315 (big blind) showed [2s 9s] and won ($0.48) with a flush, Ten high
Seat 4: Dorex2007 folded before Flop (didn't bet)
Seat 5: Jumbaliah123 folded before Flop (didn't bet)
Seat 6: AKslaterAK folded before Flop (didn't bet)
Seat 7: HermesDF mucked [Jc Th]
Seat 8: guiaoms folded on the Flop



PokerStars Hand #237403841339:  Hold'em No Limit ($0.01/$0.02 USD) - 2022/07/16 17:45:46 PT [2022/07/16 20:45:46 ET]
Table 'Kalypso IV' 9-max Seat #2 is the button
Seat 1: Goya159 ($1.22 in chips) 
Seat 2: LuckyGranpa ($1.57 in chips) 
Seat 3: weverson315 ($3.99 in chips) 
Seat 4: Dorex2007 ($6.95 in chips) 
Seat 5: Jumbaliah123 ($2.33 in chips) 
Seat 6: AKslaterAK ($2.17 in chips) 
Seat 7: HermesDF ($2 in chips) 
Seat 8: guiaoms ($1.50 in chips) 
weverson315: posts small blind $0.01
Dorex2007: posts big blind $0.02
izzu007: sits out 
*** HOLE CARDS ***
Dealt to Dorex2007 [5c 7c]
Jumbaliah123: folds 
AKslaterAK: folds 
HermesDF: folds 
guiaoms: raises $0.04 to $0.06
Goya159: folds 
LuckyGranpa: folds 
weverson315: calls $0.05
Dorex2007: folds 
*** FLOP *** [Jh 8s 2h]
weverson315: checks 
guiaoms: checks 
*** TURN *** [Jh 8s 2h] [Jd]
weverson315: bets $0.02
guiaoms: calls $0.02
*** RIVER *** [Jh 8s 2h Jd] [Qh]
weverson315: checks 
guiaoms: bets $0.08
weverson315: folds 
Uncalled bet ($0.08) returned to guiaoms
guiaoms collected $0.17 from pot
*** SUMMARY ***
Total pot $0.18 | Rake $0.01 
Board [Jh 8s 2h Jd Qh]
Seat 1: Goya159 folded before Flop (didn't bet)
Seat 2: LuckyGranpa (button) folded before Flop (didn't bet)
Seat 3: weverson315 (small blind) folded on the River
Seat 4: Dorex2007 (big blind) folded before Flop
Seat 5: Jumbaliah123 folded before Flop (didn't bet)
Seat 6: AKslaterAK folded before Flop (didn't bet)
Seat 7: HermesDF folded before Flop (didn't bet)
Seat 8: guiaoms collected ($0.17)



PokerStars Hand #237403848564:  Hold'em No Limit ($0.01/$0.02 USD) - 2022/07/16 17:46:20 PT [2022/07/16 20:46:20 ET]
Table 'Kalypso IV' 9-max Seat #3 is the button
Seat 1: Goya159 ($1.22 in chips) 
Seat 2: LuckyGranpa ($1.57 in chips) 
Seat 3: weverson315 ($3.91 in chips) 
Seat 4: Dorex2007 ($6.93 in chips) 
Seat 5: Jumbaliah123 ($2.33 in chips) 
Seat 6: AKslaterAK ($2.17 in chips) 
Seat 7: HermesDF ($2 in chips) 
Seat 8: guiaoms ($1.59 in chips) 
Dorex2007: posts small blind $0.01
Jumbaliah123: posts big blind $0.02
izzu007: sits out 
*** HOLE CARDS ***
Dealt to Dorex2007 [Tc 8c]
AKslaterAK: folds 
HermesDF: raises $0.04 to $0.06
guiaoms: calls $0.06
Goya159: calls $0.06
LuckyGranpa: folds 
weverson315: folds 
Dorex2007: folds 
Jumbaliah123: folds 
*** FLOP *** [Kc Jd 2h]
HermesDF: bets $0.02
guiaoms: calls $0.02
Goya159: folds 
*** TURN *** [Kc Jd 2h] [2c]
HermesDF: bets $0.02
guiaoms: raises $0.02 to $0.04
HermesDF: calls $0.02
*** RIVER *** [Kc Jd 2h 2c] [5h]
HermesDF: checks 
guiaoms: bets $0.16
HermesDF: calls $0.16
*** SHOW DOWN ***
guiaoms: shows [Ks Jh] (two pair, Kings and Jacks)
HermesDF: mucks hand 
guiaoms collected $0.63 from pot
*** SUMMARY ***
Total pot $0.65 | Rake $0.02 
Board [Kc Jd 2h 2c 5h]
Seat 1: Goya159 folded on the Flop
Seat 2: LuckyGranpa folded before Flop (didn't bet)
Seat 3: weverson315 (button) folded before Flop (didn't bet)
Seat 4: Dorex2007 (small blind) folded before Flop
Seat 5: Jumbaliah123 (big blind) folded before Flop
Seat 6: AKslaterAK folded before Flop (didn't bet)
Seat 7: HermesDF mucked [Qh Qc]
Seat 8: guiaoms showed [Ks Jh] and won ($0.63) with two pair, Kings and Jacks



PokerStars Hand #237403862440:  Hold'em No Limit ($0.01/$0.02 USD) - 2022/07/16 17:47:24 PT [2022/07/16 20:47:24 ET]
Table 'Kalypso IV' 9-max Seat #4 is the button
Seat 1: Goya159 ($1.16 in chips) 
Seat 2: LuckyGranpa ($1.57 in chips) 
Seat 3: weverson315 ($3.91 in chips) 
Seat 4: Dorex2007 ($6.92 in chips) 
Seat 5: Jumbaliah123 ($2.31 in chips) 
Seat 6: AKslaterAK ($2.17 in chips) 
Seat 7: HermesDF ($1.72 in chips) 
Seat 8: guiaoms ($1.94 in chips) 
Jumbaliah123: posts small blind $0.01
AKslaterAK: posts big blind $0.02
izzu007: sits out 
*** HOLE CARDS ***
Dealt to Dorex2007 [3h 7h]
HermesDF: calls $0.02
guiaoms: folds 
guiaoms leaves the table
Goya159: calls $0.02
LuckyGranpa: folds 
weverson315: folds 
Dorex2007 has timed out
Dorex2007: folds 
Jumbaliah123: calls $0.01
AKslaterAK: checks 
*** FLOP *** [8c 4d 6c]
TrzymamKolo joins the table at seat #8 
Jumbaliah123: checks 
AKslaterAK: checks 
HermesDF: bets $0.02
Goya159: calls $0.02
Jumbaliah123: calls $0.02
AKslaterAK: calls $0.02
*** TURN *** [8c 4d 6c] [Tc]
Jumbaliah123: checks 
AKslaterAK: checks 
TrzymamKolo leaves the table
HermesDF: bets $0.02
Goya159: raises $0.10 to $0.12
Jumbaliah123: folds 
AKslaterAK: folds 
HermesDF: calls $0.10
*** RIVER *** [8c 4d 6c Tc] [Ah]
HermesDF: checks 
Goya159: bets $0.19
HermesDF: calls $0.19
*** SHOW DOWN ***
Goya159: shows [9d 7d] (a straight, Six to Ten)
HermesDF: mucks hand 
Goya159 collected $0.75 from pot
*** SUMMARY ***
Total pot $0.78 | Rake $0.03 
Board [8c 4d 6c Tc Ah]
Seat 1: Goya159 showed [9d 7d] and won ($0.75) with a straight, Six to Ten
Seat 2: LuckyGranpa folded before Flop (didn't bet)
Seat 3: weverson315 folded before Flop (didn't bet)
Seat 4: Dorex2007 (button) folded before Flop (didn't bet)
Seat 5: Jumbaliah123 (small blind) folded on the Turn
Seat 6: AKslaterAK (big blind) folded on the Turn
Seat 7: HermesDF mucked [Ac 5d]
Seat 8: guiaoms folded before Flop (didn't bet)



PokerStars Hand #237403877081:  Hold'em No Limit ($0.01/$0.02 USD) - 2022/07/16 17:48:32 PT [2022/07/16 20:48:32 ET]
Table 'Kalypso IV' 9-max Seat #5 is the button
Seat 1: Goya159 ($1.56 in chips) 
Seat 2: LuckyGranpa ($1.57 in chips) 
Seat 3: weverson315 ($3.91 in chips) 
Seat 4: Dorex2007 ($6.92 in chips) 
Seat 5: Jumbaliah123 ($2.27 in chips) 
Seat 6: AKslaterAK ($2.13 in chips) 
Seat 7: HermesDF ($1.37 in chips) 
AKslaterAK: posts small blind $0.01
HermesDF: posts big blind $0.02
izzu007: sits out 
*** HOLE CARDS ***
Dealt to Dorex2007 [Th 7s]
Goya159: folds 
LuckyGranpa: folds 
weverson315: folds 
Dorex2007: folds 
Jumbaliah123: calls $0.02
AKslaterAK: folds 
HermesDF: checks 
*** FLOP *** [Kh 7h 3d]
HermesDF: checks 
Jumbaliah123: bets $0.02
HermesDF: calls $0.02
*** TURN *** [Kh 7h 3d] [Tc]
HermesDF: checks 
Jumbaliah123: checks 
*** RIVER *** [Kh 7h 3d Tc] [Js]
HermesDF: checks 
Jumbaliah123: checks 
*** SHOW DOWN ***
HermesDF: shows [6h Ah] (high card Ace)
Jumbaliah123: shows [5s 5h] (a pair of Fives)
Jumbaliah123 collected $0.09 from pot
*** SUMMARY ***
Total pot $0.09 | Rake $0 
Board [Kh 7h 3d Tc Js]
Seat 1: Goya159 folded before Flop (didn't bet)
Seat 2: LuckyGranpa folded before Flop (didn't bet)
Seat 3: weverson315 folded before Flop (didn't bet)
Seat 4: Dorex2007 folded before Flop (didn't bet)
Seat 5: Jumbaliah123 (button) showed [5s 5h] and won ($0.09) with a pair of Fives
Seat 6: AKslaterAK (small blind) folded before Flop
Seat 7: HermesDF (big blind) showed [6h Ah] and lost with high card Ace



PokerStars Hand #237403883802:  Hold'em No Limit ($0.01/$0.02 USD) - 2022/07/16 17:49:03 PT [2022/07/16 20:49:03 ET]
Table 'Kalypso IV' 9-max Seat #6 is the button
Seat 1: Goya159 ($1.56 in chips) 
Seat 2: LuckyGranpa ($1.57 in chips) 
Seat 3: weverson315 ($3.91 in chips) 
Seat 4: Dorex2007 ($6.92 in chips) 
Seat 5: Jumbaliah123 ($2.32 in chips) 
Seat 6: AKslaterAK ($2.12 in chips) 
Seat 7: HermesDF ($1.33 in chips) 
Seat 9: izzu007 ($0.52 in chips) 
HermesDF: posts small blind $0.01
izzu007: posts big blind $0.02
*** HOLE CARDS ***
Dealt to Dorex2007 [2h Jh]
Goya159: folds 
LuckyGranpa: folds 
weverson315: calls $0.02
Dorex2007: folds 
Jumbaliah123: calls $0.02
kiling1 joins the table at seat #8 
LuckyGranpa leaves the table
AKslaterAK: folds 
HermesDF: calls $0.01
nomamezque joins the table at seat #2 
izzu007: raises $0.02 to $0.04
weverson315: calls $0.02
Jumbaliah123: calls $0.02
HermesDF: calls $0.02
*** FLOP *** [4d 3h 5h]
HermesDF: checks 
izzu007: checks 
weverson315: checks 
Jumbaliah123: checks 
*** TURN *** [4d 3h 5h] [9c]
HermesDF: checks 
izzu007: checks 
weverson315: checks 
Jumbaliah123: checks 
*** RIVER *** [4d 3h 5h 9c] [2s]
HermesDF: bets $0.07
izzu007: folds 
weverson315: calls $0.07
Jumbaliah123: folds 
*** SHOW DOWN ***
HermesDF: shows [Jd As] (a straight, Ace to Five)
weverson315: shows [Ac 7c] (a straight, Ace to Five)
HermesDF collected $0.15 from pot
weverson315 collected $0.14 from pot
*** SUMMARY ***
Total pot $0.30 | Rake $0.01 
Board [4d 3h 5h 9c 2s]
Seat 1: Goya159 folded before Flop (didn't bet)
Seat 2: LuckyGranpa folded before Flop (didn't bet)
Seat 3: weverson315 showed [Ac 7c] and won ($0.14) with a straight, Ace to Five
Seat 4: Dorex2007 folded before Flop (didn't bet)
Seat 5: Jumbaliah123 folded on the River
Seat 6: AKslaterAK (button) folded before Flop (didn't bet)
Seat 7: HermesDF (small blind) showed [Jd As] and won ($0.15) with a straight, Ace to Five
Seat 9: izzu007 (big blind) folded on the River



PokerStars Hand #237403906324:  Hold'em No Limit ($0.01/$0.02 USD) - 2022/07/16 17:50:48 PT [2022/07/16 20:50:48 ET]
Table 'Kalypso IV' 9-max Seat #7 is the button
Seat 1: Goya159 ($1.56 in chips) 
Seat 2: nomamezque ($2 in chips) 
Seat 3: weverson315 ($3.94 in chips) 
Seat 4: Dorex2007 ($6.92 in chips) 
Seat 5: Jumbaliah123 ($2.28 in chips) 
Seat 6: AKslaterAK ($2.12 in chips) 
Seat 7: HermesDF ($1.37 in chips) 
Seat 9: izzu007 ($0.48 in chips) 
izzu007: posts small blind $0.01
Goya159: posts big blind $0.02
nomamezque: posts big blind $0.02
*** HOLE CARDS ***
Dealt to Dorex2007 [Tc 3s]
nomamezque: raises $0.04 to $0.06
weverson315: folds 
Dorex2007: folds 
Jumbaliah123: folds 
AKslaterAK: folds 
HermesDF: folds 
izzu007: folds 
Goya159: folds 
Uncalled bet ($0.04) returned to nomamezque
nomamezque collected $0.05 from pot
*** SUMMARY ***
Total pot $0.05 | Rake $0 
Seat 1: Goya159 (big blind) folded before Flop
Seat 2: nomamezque collected ($0.05)
Seat 3: weverson315 folded before Flop (didn't bet)
Seat 4: Dorex2007 folded before Flop (didn't bet)
Seat 5: Jumbaliah123 folded before Flop (didn't bet)
Seat 6: AKslaterAK folded before Flop (didn't bet)
Seat 7: HermesDF (button) folded before Flop (didn't bet)
Seat 9: izzu007 (small blind) folded before Flop



PokerStars Hand #237403912049:  Hold'em No Limit ($0.01/$0.02 USD) - 2022/07/16 17:51:15 PT [2022/07/16 20:51:15 ET]
Table 'Kalypso IV' 9-max Seat #9 is the button
Seat 1: Goya159 ($1.54 in chips) 
Seat 2: nomamezque ($2.03 in chips) 
Seat 3: weverson315 ($3.94 in chips) 
Seat 4: Dorex2007 ($6.92 in chips) 
Seat 5: Jumbaliah123 ($2.28 in chips) 
Seat 6: AKslaterAK ($2.12 in chips) 
Seat 7: HermesDF ($1.37 in chips) 
Seat 9: izzu007 ($0.47 in chips) 
Goya159: posts small blind $0.01
nomamezque: posts big blind $0.02
kiling1: sits out 
*** HOLE CARDS ***
Dealt to Dorex2007 [3c 5s]
weverson315: calls $0.02
Dorex2007: folds 
Jumbaliah123: folds 
AKslaterAK: folds 
HermesDF: calls $0.02
izzu007: folds 
Goya159: folds 
nomamezque: checks 
*** FLOP *** [Ah 8h 4c]
nomamezque: checks 
weverson315: checks 
HermesDF: checks 
*** TURN *** [Ah 8h 4c] [9d]
nomamezque: bets $0.04
weverson315: folds 
HermesDF: calls $0.04
*** RIVER *** [Ah 8h 4c 9d] [8d]
nomamezque: checks 
HermesDF: checks 
*** SHOW DOWN ***
nomamezque: shows [4h Td] (two pair, Eights and Fours)
HermesDF: mucks hand 
nomamezque collected $0.14 from pot
*** SUMMARY ***
Total pot $0.15 | Rake $0.01 
Board [Ah 8h 4c 9d 8d]
Seat 1: Goya159 (small blind) folded before Flop
Seat 2: nomamezque (big blind) showed [4h Td] and won ($0.14) with two pair, Eights and Fours
Seat 3: weverson315 folded on the Turn
Seat 4: Dorex2007 folded before Flop (didn't bet)
Seat 5: Jumbaliah123 folded before Flop (didn't bet)
Seat 6: AKslaterAK folded before Flop (didn't bet)
Seat 7: HermesDF mucked [Qh Jd]
Seat 9: izzu007 (button) folded before Flop (didn't bet)



PokerStars Hand #237403931274:  Hold'em No Limit ($0.01/$0.02 USD) - 2022/07/16 17:52:14 PT [2022/07/16 20:52:14 ET]
Table 'Kalypso IV' 9-max Seat #1 is the button
Seat 1: Goya159 ($1.53 in chips) 
Seat 2: nomamezque ($2.11 in chips) 
Seat 3: weverson315 ($3.92 in chips) 
Seat 4: Dorex2007 ($6.92 in chips) 
Seat 5: Jumbaliah123 ($2.28 in chips) 
Seat 6: AKslaterAK ($2.12 in chips) 
Seat 7: HermesDF ($1.31 in chips) 
Seat 9: izzu007 ($0.47 in chips) 
nomamezque: posts small blind $0.01
weverson315: posts big blind $0.02
kiling1: sits out 
*** HOLE CARDS ***
Dealt to Dorex2007 [8c As]
Dorex2007: folds 
Jumbaliah123: folds 
AKslaterAK: folds 
HermesDF: folds 
izzu007: folds 
Goya159: calls $0.02
nomamezque: raises $0.04 to $0.06
weverson315: folds 
Goya159: folds 
Uncalled bet ($0.04) returned to nomamezque
nomamezque collected $0.06 from pot
*** SUMMARY ***
Total pot $0.06 | Rake $0 
Seat 1: Goya159 (button) folded before Flop
Seat 2: nomamezque (small blind) collected ($0.06)
Seat 3: weverson315 (big blind) folded before Flop
Seat 4: Dorex2007 folded before Flop (didn't bet)
Seat 5: Jumbaliah123 folded before Flop (didn't bet)
Seat 6: AKslaterAK folded before Flop (didn't bet)
Seat 7: HermesDF folded before Flop (didn't bet)
Seat 9: izzu007 folded before Flop (didn't bet)



PokerStars Hand #237403938481:  Hold'em No Limit ($0.01/$0.02 USD) - 2022/07/16 17:52:48 PT [2022/07/16 20:52:48 ET]
Table 'Kalypso IV' 9-max Seat #2 is the button
Seat 1: Goya159 ($1.51 in chips) 
Seat 2: nomamezque ($2.15 in chips) 
Seat 3: weverson315 ($3.90 in chips) 
Seat 4: Dorex2007 ($6.92 in chips) 
Seat 5: Jumbaliah123 ($2.28 in chips) 
Seat 6: AKslaterAK ($2.12 in chips) 
Seat 7: HermesDF ($1.31 in chips) 
Seat 9: izzu007 ($0.47 in chips) 
weverson315: posts small blind $0.01
Dorex2007: posts big blind $0.02
kiling1: sits out 
*** HOLE CARDS ***
Dealt to Dorex2007 [Kc Td]
Jumbaliah123: folds 
AKslaterAK: folds 
HermesDF: folds 
izzu007: folds 
Goya159: calls $0.02
nomamezque: raises $0.04 to $0.06
weverson315: folds 
Dorex2007: calls $0.04
Goya159: calls $0.04
*** FLOP *** [Kh Qc Jc]
Dorex2007: bets $0.18
Goya159: calls $0.18
nomamezque: calls $0.18
*** TURN *** [Kh Qc Jc] [7d]
Dorex2007: bets $0.35
Goya159: calls $0.35
nomamezque: folds 
*** RIVER *** [Kh Qc Jc 7d] [8d]
Dorex2007: bets $0.32
Goya159: raises $0.60 to $0.92 and is all-in
Dorex2007: folds 
Uncalled bet ($0.60) returned to Goya159
Goya159 collected $2 from pot
*** SUMMARY ***
Total pot $2.07 | Rake $0.07 
Board [Kh Qc Jc 7d 8d]
Seat 1: Goya159 collected ($2)
Seat 2: nomamezque (button) folded on the Turn
Seat 3: weverson315 (small blind) folded before Flop
Seat 4: Dorex2007 (big blind) folded on the River
Seat 5: Jumbaliah123 folded before Flop (didn't bet)
Seat 6: AKslaterAK folded before Flop (didn't bet)
Seat 7: HermesDF folded before Flop (didn't bet)
Seat 9: izzu007 folded before Flop (didn't bet)



PokerStars Hand #237403961166:  Hold'em No Limit ($0.01/$0.02 USD) - 2022/07/16 17:54:34 PT [2022/07/16 20:54:34 ET]
Table 'Kalypso IV' 9-max Seat #3 is the button
Seat 1: Goya159 ($2.60 in chips) 
Seat 2: nomamezque ($1.91 in chips) 
Seat 3: weverson315 ($3.89 in chips) 
Seat 4: Dorex2007 ($6.01 in chips) 
Seat 5: Jumbaliah123 ($2.28 in chips) 
Seat 6: AKslaterAK ($2.12 in chips) 
Seat 7: HermesDF ($1.31 in chips) 
Seat 9: izzu007 ($0.47 in chips) 
Dorex2007: posts small blind $0.01
Jumbaliah123: posts big blind $0.02
kiling1: sits out 
*** HOLE CARDS ***
Dealt to Dorex2007 [5d 2c]
AKslaterAK: folds 
HermesDF: raises $0.04 to $0.06
izzu007: calls $0.06
Goya159: calls $0.06
nomamezque: folds 
weverson315: folds 
Dorex2007: folds 
Jumbaliah123: folds 
*** FLOP *** [9h 7s Jc]
HermesDF: bets $0.02
izzu007: calls $0.02
Goya159: calls $0.02
*** TURN *** [9h 7s Jc] [8s]
HermesDF: bets $0.02
izzu007: calls $0.02
Goya159: raises $0.16 to $0.18
HermesDF: calls $0.16
izzu007: folds 
*** RIVER *** [9h 7s Jc 8s] [Th]
HermesDF: bets $1.05 and is all-in
Goya159: folds 
Uncalled bet ($1.05) returned to HermesDF
HermesDF collected $0.63 from pot
*** SUMMARY ***
Total pot $0.65 | Rake $0.02 
Board [9h 7s Jc 8s Th]
Seat 1: Goya159 folded on the River
Seat 2: nomamezque folded before Flop (didn't bet)
Seat 3: weverson315 (button) folded before Flop (didn't bet)
Seat 4: Dorex2007 (small blind) folded before Flop
Seat 5: Jumbaliah123 (big blind) folded before Flop
Seat 6: AKslaterAK folded before Flop (didn't bet)
Seat 7: HermesDF collected ($0.63)
Seat 9: izzu007 folded on the Turn



PokerStars Hand #237403977761:  Hold'em No Limit ($0.01/$0.02 USD) - 2022/07/16 17:55:59 PT [2022/07/16 20:55:59 ET]
Table 'Kalypso IV' 9-max Seat #4 is the button
Seat 1: Goya159 ($2.34 in chips) 
Seat 2: nomamezque ($1.91 in chips) 
Seat 3: weverson315 ($3.89 in chips) 
Seat 4: Dorex2007 ($6 in chips) 
Seat 5: Jumbaliah123 ($2.26 in chips) 
Seat 6: AKslaterAK ($2.12 in chips) 
Seat 7: HermesDF ($1.68 in chips) 
Seat 9: izzu007 ($0.37 in chips) 
Jumbaliah123: posts small blind $0.01
AKslaterAK: posts big blind $0.02
kiling1: sits out 
*** HOLE CARDS ***
Dealt to Dorex2007 [7h 5d]
HermesDF: calls $0.02
izzu007: folds 
Goya159: folds 
nomamezque: raises $0.04 to $0.06
weverson315: folds 
Dorex2007: folds 
Jumbaliah123: calls $0.05
AKslaterAK: folds 
HermesDF: folds 
*** FLOP *** [7c Td 8h]
Jumbaliah123: checks 
nomamezque: bets $0.10
Jumbaliah123: calls $0.10
*** TURN *** [7c Td 8h] [2d]
Jumbaliah123: checks 
nomamezque: checks 
*** RIVER *** [7c Td 8h 2d] [Qd]
Jumbaliah123: bets $0.20
nomamezque: folds 
Uncalled bet ($0.20) returned to Jumbaliah123
Jumbaliah123 collected $0.35 from pot
*** SUMMARY ***
Total pot $0.36 | Rake $0.01 
Board [7c Td 8h 2d Qd]
Seat 1: Goya159 folded before Flop (didn't bet)
Seat 2: nomamezque folded on the River
Seat 3: weverson315 folded before Flop (didn't bet)
Seat 4: Dorex2007 (button) folded before Flop (didn't bet)
Seat 5: Jumbaliah123 (small blind) collected ($0.35)
Seat 6: AKslaterAK (big blind) folded before Flop
Seat 7: HermesDF folded before Flop
Seat 9: izzu007 folded before Flop (didn't bet)



PokerStars Hand #237403991877:  Hold'em No Limit ($0.01/$0.02 USD) - 2022/07/16 17:57:18 PT [2022/07/16 20:57:18 ET]
Table 'Kalypso IV' 9-max Seat #5 is the button
Seat 1: Goya159 ($2.34 in chips) 
Seat 2: nomamezque ($1.75 in chips) 
Seat 3: weverson315 ($3.89 in chips) 
Seat 4: Dorex2007 ($6 in chips) 
Seat 5: Jumbaliah123 ($2.45 in chips) 
Seat 6: AKslaterAK ($2.10 in chips) 
Seat 7: HermesDF ($1.66 in chips) 
Seat 9: izzu007 ($0.37 in chips) 
AKslaterAK: posts small blind $0.01
HermesDF: posts big blind $0.02
kiling1: sits out 
*** HOLE CARDS ***
Dealt to Dorex2007 [Ah 7s]
izzu007: folds 
Goya159 has timed out
Goya159: folds 
nomamezque: raises $0.04 to $0.06
weverson315: folds 
Dorex2007: folds 
Jumbaliah123: folds 
AKslaterAK: folds 
HermesDF: calls $0.04
*** FLOP *** [4d Ac As]
HermesDF: bets $0.02
nomamezque: calls $0.02
*** TURN *** [4d Ac As] [9h]
HermesDF: bets $0.02
nomamezque: calls $0.02
*** RIVER *** [4d Ac As 9h] [Qd]
HermesDF: bets $0.02
nomamezque: folds 
Uncalled bet ($0.02) returned to HermesDF
HermesDF collected $0.20 from pot
*** SUMMARY ***
Total pot $0.21 | Rake $0.01 
Board [4d Ac As 9h Qd]
Seat 1: Goya159 folded before Flop (didn't bet)
Seat 2: nomamezque folded on the River
Seat 3: weverson315 folded before Flop (didn't bet)
Seat 4: Dorex2007 folded before Flop (didn't bet)
Seat 5: Jumbaliah123 (button) folded before Flop (didn't bet)
Seat 6: AKslaterAK (small blind) folded before Flop
Seat 7: HermesDF (big blind) collected ($0.20)
Seat 9: izzu007 folded before Flop (didn't bet)



PokerStars Hand #237404006352:  Hold'em No Limit ($0.01/$0.02 USD) - 2022/07/16 17:58:39 PT [2022/07/16 20:58:39 ET]
Table 'Kalypso IV' 9-max Seat #6 is the button
Seat 1: Goya159 ($2.34 in chips) 
Seat 2: nomamezque ($1.65 in chips) 
Seat 3: weverson315 ($3.89 in chips) 
Seat 4: Dorex2007 ($6 in chips) 
Seat 5: Jumbaliah123 ($2.45 in chips) 
Seat 6: AKslaterAK ($2.09 in chips) 
Seat 7: HermesDF ($1.76 in chips) 
Seat 8: kiling1 ($2 in chips) 
Seat 9: izzu007 ($0.37 in chips) 
HermesDF: posts small blind $0.01
kiling1: posts big blind $0.02
*** HOLE CARDS ***
Dealt to Dorex2007 [6d 5d]
izzu007: folds 
Goya159: folds 
nomamezque: raises $0.04 to $0.06
weverson315: folds 
Dorex2007: folds 
Jumbaliah123: folds 
AKslaterAK: folds 
HermesDF: calls $0.05
kiling1: folds 
*** FLOP *** [Tc Qs Jc]
HermesDF: bets $0.02
nomamezque: calls $0.02
*** TURN *** [Tc Qs Jc] [5h]
HermesDF: bets $0.02
nomamezque: calls $0.02
*** RIVER *** [Tc Qs Jc 5h] [2c]
HermesDF: bets $0.02
nomamezque: calls $0.02
*** SHOW DOWN ***
HermesDF: shows [Ah 9d] (high card Ace)
nomamezque: shows [4h 4c] (a pair of Fours)
nomamezque collected $0.25 from pot
*** SUMMARY ***
Total pot $0.26 | Rake $0.01 
Board [Tc Qs Jc 5h 2c]
Seat 1: Goya159 folded before Flop (didn't bet)
Seat 2: nomamezque showed [4h 4c] and won ($0.25) with a pair of Fours
Seat 3: weverson315 folded before Flop (didn't bet)
Seat 4: Dorex2007 folded before Flop (didn't bet)
Seat 5: Jumbaliah123 folded before Flop (didn't bet)
Seat 6: AKslaterAK (button) folded before Flop (didn't bet)
Seat 7: HermesDF (small blind) showed [Ah 9d] and lost with high card Ace
Seat 8: kiling1 (big blind) folded before Flop
Seat 9: izzu007 folded before Flop (didn't bet)



PokerStars Hand #237404017880:  Hold'em No Limit ($0.01/$0.02 USD) - 2022/07/16 17:59:44 PT [2022/07/16 20:59:44 ET]
Table 'Kalypso IV' 9-max Seat #7 is the button
Seat 1: Goya159 ($2.34 in chips) 
Seat 2: nomamezque ($1.78 in chips) 
Seat 3: weverson315 ($3.89 in chips) 
Seat 4: Dorex2007 ($6 in chips) 
Seat 5: Jumbaliah123 ($2.45 in chips) 
Seat 6: AKslaterAK ($2.09 in chips) 
Seat 7: HermesDF ($1.64 in chips) 
Seat 8: kiling1 ($1.98 in chips) 
Seat 9: izzu007 ($0.37 in chips) 
kiling1: posts small blind $0.01
izzu007: posts big blind $0.02
*** HOLE CARDS ***
Dealt to Dorex2007 [Kc 5c]
Goya159: calls $0.02
nomamezque: raises $0.04 to $0.06
weverson315: folds 
Dorex2007: folds 
Jumbaliah123: calls $0.06
AKslaterAK: folds 
HermesDF: folds 
kiling1: folds 
izzu007: folds 
Goya159: calls $0.04
*** FLOP *** [6h Jd Kh]
Goya159: checks 
nomamezque: bets $0.14
Jumbaliah123: folds 
Goya159: folds 
Uncalled bet ($0.14) returned to nomamezque
nomamezque collected $0.20 from pot
*** SUMMARY ***
Total pot $0.21 | Rake $0.01 
Board [6h Jd Kh]
Seat 1: Goya159 folded on the Flop
Seat 2: nomamezque collected ($0.20)
Seat 3: weverson315 folded before Flop (didn't bet)
Seat 4: Dorex2007 folded before Flop (didn't bet)
Seat 5: Jumbaliah123 folded on the Flop
Seat 6: AKslaterAK folded before Flop (didn't bet)
Seat 7: HermesDF (button) folded before Flop (didn't bet)
Seat 8: kiling1 (small blind) folded before Flop
Seat 9: izzu007 (big blind) folded before Flop



PokerStars Hand #237404025356:  Hold'em No Limit ($0.01/$0.02 USD) - 2022/07/16 18:00:24 PT [2022/07/16 21:00:24 ET]
Table 'Kalypso IV' 9-max Seat #8 is the button
Seat 1: Goya159 ($2.28 in chips) 
Seat 2: nomamezque ($1.92 in chips) 
Seat 3: weverson315 ($3.89 in chips) 
Seat 4: Dorex2007 ($6 in chips) 
Seat 5: Jumbaliah123 ($2.39 in chips) 
Seat 6: AKslaterAK ($2.09 in chips) 
Seat 7: HermesDF ($1.64 in chips) 
Seat 8: kiling1 ($1.97 in chips) 
Seat 9: izzu007 ($0.35 in chips) 
izzu007: posts small blind $0.01
Goya159: posts big blind $0.02
*** HOLE CARDS ***
Dealt to Dorex2007 [9s 8s]
nomamezque: folds 
weverson315: folds 
Dorex2007: calls $0.02
Jumbaliah123: folds 
AKslaterAK: raises $0.08 to $0.10
HermesDF: folds 
kiling1: folds 
izzu007 has timed out
izzu007: folds 
Goya159: calls $0.08
Dorex2007: folds 
*** FLOP *** [2d 7h 5d]
Goya159: checks 
AKslaterAK: bets $0.14
Goya159: folds 
Uncalled bet ($0.14) returned to AKslaterAK
AKslaterAK collected $0.22 from pot
*** SUMMARY ***
Total pot $0.23 | Rake $0.01 
Board [2d 7h 5d]
Seat 1: Goya159 (big blind) folded on the Flop
Seat 2: nomamezque folded before Flop (didn't bet)
Seat 3: weverson315 folded before Flop (didn't bet)
Seat 4: Dorex2007 folded before Flop
Seat 5: Jumbaliah123 folded before Flop (didn't bet)
Seat 6: AKslaterAK collected ($0.22)
Seat 7: HermesDF folded before Flop (didn't bet)
Seat 8: kiling1 (button) folded before Flop (didn't bet)
Seat 9: izzu007 (small blind) folded before Flop



PokerStars Hand #237404037280:  Hold'em No Limit ($0.01/$0.02 USD) - 2022/07/16 18:01:24 PT [2022/07/16 21:01:24 ET]
Table 'Kalypso IV' 9-max Seat #9 is the button
Seat 1: Goya159 ($2.18 in chips) 
Seat 2: nomamezque ($1.92 in chips) 
Seat 3: weverson315 ($3.89 in chips) 
Seat 4: Dorex2007 ($5.98 in chips) 
Seat 5: Jumbaliah123 ($2.39 in chips) 
Seat 6: AKslaterAK ($2.21 in chips) 
Seat 7: HermesDF ($1.64 in chips) 
Seat 8: kiling1 ($1.97 in chips) 
Seat 9: izzu007 ($0.34 in chips) 
Goya159: posts small blind $0.01
nomamezque: posts big blind $0.02
*** HOLE CARDS ***
Dealt to Dorex2007 [4d 7h]
weverson315: folds 
Dorex2007: folds 
Jumbaliah123: folds 
AKslaterAK: folds 
HermesDF: raises $0.04 to $0.06
kiling1: raises $0.12 to $0.18
izzu007: folds 
Goya159: folds 
nomamezque: folds 
HermesDF: calls $0.12
*** FLOP *** [3h 3s As]
HermesDF: checks 
kiling1: bets $0.19
HermesDF: folds [9d 9h]
Uncalled bet ($0.19) returned to kiling1
kiling1 collected $0.38 from pot
*** SUMMARY ***
Total pot $0.39 | Rake $0.01 
Board [3h 3s As]
Seat 1: Goya159 (small blind) folded before Flop
Seat 2: nomamezque (big blind) folded before Flop
Seat 3: weverson315 folded before Flop (didn't bet)
Seat 4: Dorex2007 folded before Flop (didn't bet)
Seat 5: Jumbaliah123 folded before Flop (didn't bet)
Seat 6: AKslaterAK folded before Flop (didn't bet)
Seat 7: HermesDF folded on the Flop
Seat 8: kiling1 collected ($0.38)
Seat 9: izzu007 (button) folded before Flop (didn't bet)



PokerStars Hand #237404048496:  Hold'em No Limit ($0.01/$0.02 USD) - 2022/07/16 18:02:18 PT [2022/07/16 21:02:18 ET]
Table 'Kalypso IV' 9-max Seat #1 is the button
Seat 1: Goya159 ($2.17 in chips) 
Seat 2: nomamezque ($1.90 in chips) 
Seat 3: weverson315 ($3.89 in chips) 
Seat 4: Dorex2007 ($5.98 in chips) 
Seat 5: Jumbaliah123 ($2.39 in chips) 
Seat 6: AKslaterAK ($2.21 in chips) 
Seat 7: HermesDF ($1.46 in chips) 
Seat 8: kiling1 ($2.17 in chips) 
Seat 9: izzu007 ($0.34 in chips) 
nomamezque: posts small blind $0.01
weverson315: posts big blind $0.02
*** HOLE CARDS ***
Dealt to Dorex2007 [9c Th]
Dorex2007: calls $0.02
Jumbaliah123: folds 
AKslaterAK: folds 
HermesDF: folds 
kiling1: folds 
izzu007: folds 
Goya159: calls $0.02
nomamezque: calls $0.01
weverson315: checks 
*** FLOP *** [9h Ac Jc]
nomamezque: checks 
weverson315: checks 
Dorex2007: checks 
Goya159: bets $0.02
nomamezque: folds 
weverson315: folds 
Dorex2007: folds 
Uncalled bet ($0.02) returned to Goya159
Goya159 collected $0.08 from pot
*** SUMMARY ***
Total pot $0.08 | Rake $0 
Board [9h Ac Jc]
Seat 1: Goya159 (button) collected ($0.08)
Seat 2: nomamezque (small blind) folded on the Flop
Seat 3: weverson315 (big blind) folded on the Flop
Seat 4: Dorex2007 folded on the Flop
Seat 5: Jumbaliah123 folded before Flop (didn't bet)
Seat 6: AKslaterAK folded before Flop (didn't bet)
Seat 7: HermesDF folded before Flop (didn't bet)
Seat 8: kiling1 folded before Flop (didn't bet)
Seat 9: izzu007 folded before Flop (didn't bet)



PokerStars Hand #237404059289:  Hold'em No Limit ($0.01/$0.02 USD) - 2022/07/16 18:03:09 PT [2022/07/16 21:03:09 ET]
Table 'Kalypso IV' 9-max Seat #2 is the button
Seat 1: Goya159 ($2.23 in chips) 
Seat 2: nomamezque ($1.88 in chips) 
Seat 3: weverson315 ($3.87 in chips) 
Seat 4: Dorex2007 ($5.96 in chips) 
Seat 5: Jumbaliah123 ($2.39 in chips) 
Seat 6: AKslaterAK ($2.21 in chips) 
Seat 7: HermesDF ($1.46 in chips) 
Seat 8: kiling1 ($2.17 in chips) 
Seat 9: izzu007 ($0.34 in chips) 
weverson315: posts small blind $0.01
Dorex2007: posts big blind $0.02
*** HOLE CARDS ***
Dealt to Dorex2007 [8h 4h]
Jumbaliah123: folds 
AKslaterAK: folds 
HermesDF: calls $0.02
kiling1: folds 
izzu007: folds 
Goya159: calls $0.02
nomamezque: raises $0.04 to $0.06
weverson315: folds 
Dorex2007: folds 
HermesDF: calls $0.04
Goya159: calls $0.04
*** FLOP *** [3d Jd Ts]
HermesDF: bets $0.02
Goya159: folds 
nomamezque: raises $0.10 to $0.12
HermesDF: calls $0.10
*** TURN *** [3d Jd Ts] [7d]
HermesDF: bets $0.21
nomamezque: folds 
Uncalled bet ($0.21) returned to HermesDF
HermesDF collected $0.43 from pot
*** SUMMARY ***
Total pot $0.45 | Rake $0.02 
Board [3d Jd Ts 7d]
Seat 1: Goya159 folded on the Flop
Seat 2: nomamezque (button) folded on the Turn
Seat 3: weverson315 (small blind) folded before Flop
Seat 4: Dorex2007 (big blind) folded before Flop
Seat 5: Jumbaliah123 folded before Flop (didn't bet)
Seat 6: AKslaterAK folded before Flop (didn't bet)
Seat 7: HermesDF collected ($0.43)
Seat 8: kiling1 folded before Flop (didn't bet)
Seat 9: izzu007 folded before Flop (didn't bet)



PokerStars Hand #237404075960:  Hold'em No Limit ($0.01/$0.02 USD) - 2022/07/16 18:04:30 PT [2022/07/16 21:04:30 ET]
Table 'Kalypso IV' 9-max Seat #3 is the button
Seat 1: Goya159 ($2.17 in chips) 
Seat 2: nomamezque ($1.70 in chips) 
Seat 3: weverson315 ($3.86 in chips) 
Seat 4: Dorex2007 ($5.94 in chips) 
Seat 5: Jumbaliah123 ($2.39 in chips) 
Seat 6: AKslaterAK ($2.21 in chips) 
Seat 7: HermesDF ($1.71 in chips) 
Seat 8: kiling1 ($2.17 in chips) 
Seat 9: izzu007 ($0.34 in chips) 
Dorex2007: posts small blind $0.01
Jumbaliah123: posts big blind $0.02
*** HOLE CARDS ***
Dealt to Dorex2007 [Js Jd]
AKslaterAK: raises $0.04 to $0.06
HermesDF: folds 
kiling1: folds 
izzu007: calls $0.06
Goya159: calls $0.06
nomamezque: folds 
weverson315: folds 
Dorex2007: raises $0.26 to $0.32
Jumbaliah123: folds 
AKslaterAK: folds 
izzu007: folds 
Goya159: folds 
Uncalled bet ($0.26) returned to Dorex2007
Dorex2007 collected $0.26 from pot
*** SUMMARY ***
Total pot $0.26 | Rake $0 
Seat 1: Goya159 folded before Flop
Seat 2: nomamezque folded before Flop (didn't bet)
Seat 3: weverson315 (button) folded before Flop (didn't bet)
Seat 4: Dorex2007 (small blind) collected ($0.26)
Seat 5: Jumbaliah123 (big blind) folded before Flop
Seat 6: AKslaterAK folded before Flop
Seat 7: HermesDF folded before Flop (didn't bet)
Seat 8: kiling1 folded before Flop (didn't bet)
Seat 9: izzu007 folded before Flop



