PokerStars Hand #228375193172:  Hold'em No Limit ($0.01/$0.02 USD) - 2021/07/17 23:17:07 PT [2021/07/18 2:17:07 ET]
Table 'Philia' 9-max Seat #5 is the button
Seat 1: Skumme ($0.69 in chips) 
Seat 2: sleeper hipi ($6.82 in chips) 
Seat 3: ariman1980 ($0.87 in chips) 
Seat 4: Dorex2007 ($2 in chips) 
Seat 5: Aristarh0 ($2.36 in chips) 
Seat 6: Gora858 ($1.98 in chips) 
Seat 7: Pokension ($2.67 in chips) 
Seat 8: Luks_Jr ($3.17 in chips) 
Seat 9: keki8787 ($1.96 in chips) 
Gora858: posts small blind $0.01
Pokension: posts big blind $0.02
Dorex2007: posts big blind $0.02
*** HOLE CARDS ***
Dealt to Dorex2007 [Th 4d]
Luks_Jr: folds 
keki8787: folds 
Skumme: folds 
sleeper hipi: folds 
ariman1980: folds 
Dorex2007: checks 
Aristarh0: raises $0.04 to $0.06
Gora858: calls $0.05
Pokension: folds 
Dorex2007: folds 
*** FLOP *** [5h 8s Jh]
Gora858: bets $0.08
Aristarh0: raises $0.31 to $0.39
Gora858: raises $0.47 to $0.86
Aristarh0: raises $1.44 to $2.30 and is all-in
Gora858: calls $1.06 and is all-in
Uncalled bet ($0.38) returned to Aristarh0
*** TURN *** [5h 8s Jh] [3s]
*** RIVER *** [5h 8s Jh 3s] [Qh]
*** SHOW DOWN ***
Gora858: shows [Ts Td] (a pair of Tens)
Aristarh0: shows [2h Kc] (high card King)
Gora858 collected $3.86 from pot
*** SUMMARY ***
Total pot $4 | Rake $0.14 
Board [5h 8s Jh 3s Qh]
Seat 1: Skumme folded before Flop (didn't bet)
Seat 2: sleeper hipi folded before Flop (didn't bet)
Seat 3: ariman1980 folded before Flop (didn't bet)
Seat 4: Dorex2007 folded before Flop (didn't bet)
Seat 5: Aristarh0 (button) showed [2h Kc] and lost with high card King
Seat 6: Gora858 (small blind) showed [Ts Td] and won ($3.86) with a pair of Tens
Seat 7: Pokension (big blind) folded before Flop
Seat 8: Luks_Jr folded before Flop (didn't bet)
Seat 9: keki8787 folded before Flop (didn't bet)



PokerStars Hand #228375201339:  Hold'em No Limit ($0.01/$0.02 USD) - 2021/07/17 23:18:02 PT [2021/07/18 2:18:02 ET]
Table 'Philia' 9-max Seat #6 is the button
Seat 1: Skumme ($0.69 in chips) 
Seat 2: sleeper hipi ($6.82 in chips) 
Seat 3: ariman1980 ($0.87 in chips) 
Seat 4: Dorex2007 ($1.98 in chips) 
Seat 5: Aristarh0 ($0.38 in chips) 
Seat 6: Gora858 ($3.86 in chips) 
Seat 7: Pokension ($2.65 in chips) 
Seat 8: Luks_Jr ($3.17 in chips) 
Seat 9: keki8787 ($1.96 in chips) 
Pokension: posts small blind $0.01
Luks_Jr: posts big blind $0.02
*** HOLE CARDS ***
Dealt to Dorex2007 [Js 9h]
keki8787: calls $0.02
Skumme: calls $0.02
sleeper hipi: folds 
ariman1980: folds 
Dorex2007: calls $0.02
Aristarh0: raises $0.11 to $0.13
Gora858: folds 
Pokension: folds 
Luks_Jr: folds 
keki8787: folds 
Skumme: calls $0.11
Dorex2007: folds 
*** FLOP *** [Ts 6c 8h]
Skumme: checks 
Aristarh0: bets $0.25 and is all-in
Skumme: calls $0.25
*** TURN *** [Ts 6c 8h] [5d]
*** RIVER *** [Ts 6c 8h 5d] [6d]
*** SHOW DOWN ***
Skumme: shows [Kh 9s] (a pair of Sixes)
Aristarh0: shows [5c Th] (two pair, Tens and Sixes)
Aristarh0 collected $0.80 from pot
*** SUMMARY ***
Total pot $0.83 | Rake $0.03 
Board [Ts 6c 8h 5d 6d]
Seat 1: Skumme showed [Kh 9s] and lost with a pair of Sixes
Seat 2: sleeper hipi folded before Flop (didn't bet)
Seat 3: ariman1980 folded before Flop (didn't bet)
Seat 4: Dorex2007 folded before Flop
Seat 5: Aristarh0 showed [5c Th] and won ($0.80) with two pair, Tens and Sixes
Seat 6: Gora858 (button) folded before Flop (didn't bet)
Seat 7: Pokension (small blind) folded before Flop
Seat 8: Luks_Jr (big blind) folded before Flop
Seat 9: keki8787 folded before Flop



PokerStars Hand #228375207763:  Hold'em No Limit ($0.01/$0.02 USD) - 2021/07/17 23:18:47 PT [2021/07/18 2:18:47 ET]
Table 'Philia' 9-max Seat #7 is the button
Seat 1: Skumme ($0.31 in chips) 
Seat 2: sleeper hipi ($6.82 in chips) 
Seat 3: ariman1980 ($0.87 in chips) 
Seat 4: Dorex2007 ($1.96 in chips) 
Seat 5: Aristarh0 ($0.80 in chips) 
Seat 6: Gora858 ($3.86 in chips) 
Seat 7: Pokension ($2.64 in chips) 
Seat 8: Luks_Jr ($3.15 in chips) 
Seat 9: keki8787 ($1.94 in chips) 
Luks_Jr: posts small blind $0.01
keki8787: posts big blind $0.02
*** HOLE CARDS ***
Dealt to Dorex2007 [2c Tc]
Skumme: folds 
sleeper hipi: folds 
ariman1980: folds 
Dorex2007: folds 
Aristarh0: raises $0.04 to $0.06
Gora858: folds 
Pokension: calls $0.06
Luks_Jr: folds 
keki8787: calls $0.04
*** FLOP *** [6c Jd 5d]
keki8787: checks 
Aristarh0: bets $0.74 and is all-in
Pokension: folds 
keki8787: folds 
Uncalled bet ($0.74) returned to Aristarh0
Aristarh0 collected $0.18 from pot
Aristarh0: doesn't show hand 
*** SUMMARY ***
Total pot $0.19 | Rake $0.01 
Board [6c Jd 5d]
Seat 1: Skumme folded before Flop (didn't bet)
Seat 2: sleeper hipi folded before Flop (didn't bet)
Seat 3: ariman1980 folded before Flop (didn't bet)
Seat 4: Dorex2007 folded before Flop (didn't bet)
Seat 5: Aristarh0 collected ($0.18)
Seat 6: Gora858 folded before Flop (didn't bet)
Seat 7: Pokension (button) folded on the Flop
Seat 8: Luks_Jr (small blind) folded before Flop
Seat 9: keki8787 (big blind) folded on the Flop



PokerStars Hand #228375212648:  Hold'em No Limit ($0.01/$0.02 USD) - 2021/07/17 23:19:21 PT [2021/07/18 2:19:21 ET]
Table 'Philia' 9-max Seat #8 is the button
Seat 1: Skumme ($0.31 in chips) 
Seat 2: sleeper hipi ($6.82 in chips) 
Seat 3: ariman1980 ($0.87 in chips) 
Seat 4: Dorex2007 ($1.96 in chips) 
Seat 5: Aristarh0 ($0.92 in chips) 
Seat 6: Gora858 ($3.86 in chips) 
Seat 7: Pokension ($2.58 in chips) 
Seat 8: Luks_Jr ($3.14 in chips) 
Seat 9: keki8787 ($1.88 in chips) 
keki8787: posts small blind $0.01
Skumme: posts big blind $0.02
*** HOLE CARDS ***
Dealt to Dorex2007 [9d 4h]
sleeper hipi: folds 
ariman1980: folds 
Dorex2007: folds 
Aristarh0: raises $0.05 to $0.07
Gora858: folds 
Pokension: folds 
Luks_Jr: folds 
keki8787: folds 
Skumme: calls $0.05
*** FLOP *** [Jd Qs 5d]
Skumme: checks 
Aristarh0: checks 
*** TURN *** [Jd Qs 5d] [Ac]
Skumme: bets $0.24 and is all-in
Aristarh0: folds 
Uncalled bet ($0.24) returned to Skumme
Skumme collected $0.14 from pot
Skumme: doesn't show hand 
*** SUMMARY ***
Total pot $0.15 | Rake $0.01 
Board [Jd Qs 5d Ac]
Seat 1: Skumme (big blind) collected ($0.14)
Seat 2: sleeper hipi folded before Flop (didn't bet)
Seat 3: ariman1980 folded before Flop (didn't bet)
Seat 4: Dorex2007 folded before Flop (didn't bet)
Seat 5: Aristarh0 folded on the Turn
Seat 6: Gora858 folded before Flop (didn't bet)
Seat 7: Pokension folded before Flop (didn't bet)
Seat 8: Luks_Jr (button) folded before Flop (didn't bet)
Seat 9: keki8787 (small blind) folded before Flop



PokerStars Hand #228375217828:  Hold'em No Limit ($0.01/$0.02 USD) - 2021/07/17 23:19:57 PT [2021/07/18 2:19:57 ET]
Table 'Philia' 9-max Seat #9 is the button
Seat 1: Skumme ($0.38 in chips) 
Seat 2: sleeper hipi ($6.82 in chips) 
Seat 3: ariman1980 ($0.87 in chips) 
Seat 4: Dorex2007 ($1.96 in chips) 
Seat 5: Aristarh0 ($0.85 in chips) 
Seat 6: Gora858 ($3.86 in chips) 
Seat 7: Pokension ($2.58 in chips) 
Seat 8: Luks_Jr ($3.14 in chips) 
Seat 9: keki8787 ($1.87 in chips) 
Skumme: posts small blind $0.01
sleeper hipi: posts big blind $0.02
*** HOLE CARDS ***
Dealt to Dorex2007 [4h 6s]
ariman1980: raises $0.05 to $0.07
Dorex2007: folds 
Aristarh0: raises $0.78 to $0.85 and is all-in
Gora858: folds 
Pokension: folds 
Luks_Jr: folds 
keki8787: folds 
Skumme: calls $0.37 and is all-in
sleeper hipi: folds 
ariman1980: calls $0.78
*** FLOP *** [Kd 4c Qh]
*** TURN *** [Kd 4c Qh] [8h]
*** RIVER *** [Kd 4c Qh 8h] [2d]
*** SHOW DOWN ***
ariman1980: shows [Kc Ac] (a pair of Kings)
Aristarh0: shows [As Jh] (high card Ace)
Skumme: shows [Ts Tc] (a pair of Tens)
ariman1980 cashed out the hand for $1.10 | Cash Out Fee $0.01
*** SUMMARY ***
Total pot $2.10 Main pot $1.12. Side pot $0.91. | Rake $0.07 
Board [Kd 4c Qh 8h 2d]
Seat 1: Skumme (small blind) showed [Ts Tc] and lost with a pair of Tens
Seat 2: sleeper hipi (big blind) folded before Flop
Seat 3: ariman1980 showed [Kc Ac] and won ($2.03) with a pair of Kings (pot not awarded as player cashed out)
Seat 4: Dorex2007 folded before Flop (didn't bet)
Seat 5: Aristarh0 showed [As Jh] and lost with high card Ace
Seat 6: Gora858 folded before Flop (didn't bet)
Seat 7: Pokension folded before Flop (didn't bet)
Seat 8: Luks_Jr folded before Flop (didn't bet)
Seat 9: keki8787 (button) folded before Flop (didn't bet)



PokerStars Hand #228375223347:  Hold'em No Limit ($0.01/$0.02 USD) - 2021/07/17 23:20:35 PT [2021/07/18 2:20:35 ET]
Table 'Philia' 9-max Seat #2 is the button
Seat 2: sleeper hipi ($6.80 in chips) 
Seat 3: ariman1980 ($1.12 in chips) 
Seat 4: Dorex2007 ($1.96 in chips) 
Seat 6: Gora858 ($3.86 in chips) 
Seat 7: Pokension ($2.58 in chips) 
Seat 8: Luks_Jr ($3.14 in chips) 
Seat 9: keki8787 ($1.87 in chips) 
ariman1980: posts small blind $0.01
Dorex2007: posts big blind $0.02
*** HOLE CARDS ***
Dealt to Dorex2007 [6s 2h]
Aristarh0 leaves the table
Gora858: raises $0.02 to $0.04
Pokension: calls $0.04
uptosumn joins the table at seat #5 
Luks_Jr: folds 
keki8787: folds 
sleeper hipi: folds 
ariman1980: folds 
Dorex2007: folds 
*** FLOP *** [2c 7c Qs]
Gora858: bets $0.08
Pokension: folds 
Uncalled bet ($0.08) returned to Gora858
Gora858 collected $0.11 from pot
*** SUMMARY ***
Total pot $0.11 | Rake $0 
Board [2c 7c Qs]
Seat 2: sleeper hipi (button) folded before Flop (didn't bet)
Seat 3: ariman1980 (small blind) folded before Flop
Seat 4: Dorex2007 (big blind) folded before Flop
Seat 6: Gora858 collected ($0.11)
Seat 7: Pokension folded on the Flop
Seat 8: Luks_Jr folded before Flop (didn't bet)
Seat 9: keki8787 folded before Flop (didn't bet)



PokerStars Hand #228375227832:  Hold'em No Limit ($0.01/$0.02 USD) - 2021/07/17 23:21:06 PT [2021/07/18 2:21:06 ET]
Table 'Philia' 9-max Seat #3 is the button
Seat 1: Skumme ($0.80 in chips) 
Seat 2: sleeper hipi ($6.80 in chips) 
Seat 3: ariman1980 ($1.11 in chips) 
Seat 4: Dorex2007 ($1.94 in chips) 
Seat 5: uptosumn ($0.80 in chips) 
Seat 6: Gora858 ($3.93 in chips) 
Seat 7: Pokension ($2.54 in chips) 
Seat 8: Luks_Jr ($3.14 in chips) 
Seat 9: keki8787 ($1.87 in chips) 
Dorex2007: posts small blind $0.01
uptosumn: posts big blind $0.02
*** HOLE CARDS ***
Dealt to Dorex2007 [Kd 7h]
Gora858: folds 
Pokension: folds 
Luks_Jr: folds 
keki8787: folds 
Skumme: raises $0.02 to $0.04
sleeper hipi: folds 
ariman1980: folds 
Dorex2007: folds 
uptosumn: calls $0.02
*** FLOP *** [9c 6d 2h]
uptosumn: checks 
Skumme: bets $0.09
uptosumn: folds 
Uncalled bet ($0.09) returned to Skumme
Skumme collected $0.09 from pot
Skumme: doesn't show hand 
*** SUMMARY ***
Total pot $0.09 | Rake $0 
Board [9c 6d 2h]
Seat 1: Skumme collected ($0.09)
Seat 2: sleeper hipi folded before Flop (didn't bet)
Seat 3: ariman1980 (button) folded before Flop (didn't bet)
Seat 4: Dorex2007 (small blind) folded before Flop
Seat 5: uptosumn (big blind) folded on the Flop
Seat 6: Gora858 folded before Flop (didn't bet)
Seat 7: Pokension folded before Flop (didn't bet)
Seat 8: Luks_Jr folded before Flop (didn't bet)
Seat 9: keki8787 folded before Flop (didn't bet)



PokerStars Hand #228375231096:  Hold'em No Limit ($0.01/$0.02 USD) - 2021/07/17 23:21:29 PT [2021/07/18 2:21:29 ET]
Table 'Philia' 9-max Seat #4 is the button
Seat 1: Skumme ($0.85 in chips) 
Seat 2: sleeper hipi ($6.80 in chips) 
Seat 3: ariman1980 ($1.11 in chips) 
Seat 4: Dorex2007 ($1.93 in chips) 
Seat 5: uptosumn ($0.76 in chips) 
Seat 6: Gora858 ($3.93 in chips) 
Seat 7: Pokension ($2.54 in chips) 
Seat 8: Luks_Jr ($3.14 in chips) 
Seat 9: keki8787 ($1.87 in chips) 
uptosumn: posts small blind $0.01
Gora858: posts big blind $0.02
*** HOLE CARDS ***
Dealt to Dorex2007 [3s Jh]
Pokension: folds 
Luks_Jr: folds 
keki8787: folds 
Skumme: folds 
sleeper hipi: folds 
ariman1980: raises $0.05 to $0.07
Dorex2007: folds 
uptosumn: folds 
Gora858: calls $0.05
*** FLOP *** [2d Jc 2h]
Gora858: checks 
ariman1980: bets $0.07
Gora858: folds 
Uncalled bet ($0.07) returned to ariman1980
ariman1980 collected $0.14 from pot
ariman1980: doesn't show hand 
*** SUMMARY ***
Total pot $0.15 | Rake $0.01 
Board [2d Jc 2h]
Seat 1: Skumme folded before Flop (didn't bet)
Seat 2: sleeper hipi folded before Flop (didn't bet)
Seat 3: ariman1980 collected ($0.14)
Seat 4: Dorex2007 (button) folded before Flop (didn't bet)
Seat 5: uptosumn (small blind) folded before Flop
Seat 6: Gora858 (big blind) folded on the Flop
Seat 7: Pokension folded before Flop (didn't bet)
Seat 8: Luks_Jr folded before Flop (didn't bet)
Seat 9: keki8787 folded before Flop (didn't bet)



PokerStars Hand #228375242120:  Hold'em No Limit ($0.01/$0.02 USD) - 2021/07/17 23:22:02 PT [2021/07/18 2:22:02 ET]
Table 'Philia' 9-max Seat #5 is the button
Seat 1: Skumme ($0.85 in chips) 
Seat 2: sleeper hipi ($6.80 in chips) 
Seat 3: ariman1980 ($1.18 in chips) 
Seat 4: Dorex2007 ($1.93 in chips) 
Seat 5: uptosumn ($0.75 in chips) 
Seat 6: Gora858 ($3.86 in chips) 
Seat 7: Pokension ($2.54 in chips) 
Seat 8: Luks_Jr ($3.14 in chips) 
Seat 9: keki8787 ($1.87 in chips) 
Gora858: posts small blind $0.01
Pokension: posts big blind $0.02
*** HOLE CARDS ***
Dealt to Dorex2007 [Ah Kh]
Luks_Jr: folds 
keki8787: folds 
Skumme: calls $0.02
sleeper hipi: folds 
ariman1980: folds 
Dorex2007: raises $0.04 to $0.06
uptosumn: folds 
Gora858: folds 
Pokension: folds 
Skumme: calls $0.04
*** FLOP *** [Ad 8d 6h]
Skumme: bets $0.07
Dorex2007: raises $0.17 to $0.24
Skumme: raises $0.55 to $0.79 and is all-in
Dorex2007: calls $0.55
*** TURN *** [Ad 8d 6h] [3s]
*** RIVER *** [Ad 8d 6h 3s] [7h]
*** SHOW DOWN ***
Skumme: shows [As 7s] (two pair, Aces and Sevens)
Dorex2007: shows [Ah Kh] (a pair of Aces)
Skumme collected $1.67 from pot
Dorex2007 cashed out the hand for $1.40 | Cash Out Fee $0.01
*** SUMMARY ***
Total pot $1.73 | Rake $0.06 
Board [Ad 8d 6h 3s 7h]
Seat 1: Skumme showed [As 7s] and won ($1.67) with two pair, Aces and Sevens
Seat 2: sleeper hipi folded before Flop (didn't bet)
Seat 3: ariman1980 folded before Flop (didn't bet)
Seat 4: Dorex2007 showed [Ah Kh] and lost with a pair of Aces (cashed out).
Seat 5: uptosumn (button) folded before Flop (didn't bet)
Seat 6: Gora858 (small blind) folded before Flop
Seat 7: Pokension (big blind) folded before Flop
Seat 8: Luks_Jr folded before Flop (didn't bet)
Seat 9: keki8787 folded before Flop (didn't bet)



PokerStars Hand #228375253965:  Hold'em No Limit ($0.01/$0.02 USD) - 2021/07/17 23:22:58 PT [2021/07/18 2:22:58 ET]
Table 'Philia' 9-max Seat #6 is the button
Seat 1: Skumme ($1.67 in chips) 
Seat 2: sleeper hipi ($6.80 in chips) 
Seat 3: ariman1980 ($1.18 in chips) 
Seat 4: Dorex2007 ($2.48 in chips) 
Seat 5: uptosumn ($0.75 in chips) 
Seat 6: Gora858 ($3.85 in chips) 
Seat 7: Pokension ($2.52 in chips) 
Seat 8: Luks_Jr ($3.14 in chips) 
Seat 9: keki8787 ($1.87 in chips) 
Pokension: posts small blind $0.01
Luks_Jr: posts big blind $0.02
*** HOLE CARDS ***
Dealt to Dorex2007 [8c 6c]
keki8787: folds 
Skumme: raises $0.02 to $0.04
sleeper hipi: calls $0.04
ariman1980: folds 
Dorex2007: folds 
uptosumn: folds 
Gora858: folds 
Pokension: calls $0.03
Luks_Jr: calls $0.02
*** FLOP *** [Kc Td 6s]
Pokension: checks 
Luks_Jr: checks 
Skumme: bets $0.04
sleeper hipi: calls $0.04
Pokension: calls $0.04
Luks_Jr: calls $0.04
*** TURN *** [Kc Td 6s] [5d]
Pokension: checks 
Luks_Jr: checks 
Skumme: checks 
sleeper hipi: checks 
*** RIVER *** [Kc Td 6s 5d] [Qs]
Pokension: bets $0.16
Luks_Jr: folds 
Skumme: calls $0.16
sleeper hipi: folds 
*** SHOW DOWN ***
Pokension: shows [Th Ts] (three of a kind, Tens)
Skumme: mucks hand 
Pokension collected $0.62 from pot
*** SUMMARY ***
Total pot $0.64 | Rake $0.02 
Board [Kc Td 6s 5d Qs]
Seat 1: Skumme mucked [Qh As]
Seat 2: sleeper hipi folded on the River
Seat 3: ariman1980 folded before Flop (didn't bet)
Seat 4: Dorex2007 folded before Flop (didn't bet)
Seat 5: uptosumn folded before Flop (didn't bet)
Seat 6: Gora858 (button) folded before Flop (didn't bet)
Seat 7: Pokension (small blind) showed [Th Ts] and won ($0.62) with three of a kind, Tens
Seat 8: Luks_Jr (big blind) folded on the River
Seat 9: keki8787 folded before Flop (didn't bet)



PokerStars Hand #228375263894:  Hold'em No Limit ($0.01/$0.02 USD) - 2021/07/17 23:24:06 PT [2021/07/18 2:24:06 ET]
Table 'Philia' 9-max Seat #7 is the button
Seat 1: Skumme ($1.43 in chips) 
Seat 2: sleeper hipi ($6.72 in chips) 
Seat 3: ariman1980 ($1.18 in chips) 
Seat 4: Dorex2007 ($2.48 in chips) 
Seat 5: uptosumn ($0.75 in chips) 
Seat 6: Gora858 ($3.85 in chips) 
Seat 7: Pokension ($2.90 in chips) 
Seat 8: Luks_Jr ($3.06 in chips) 
Seat 9: keki8787 ($1.87 in chips) 
Luks_Jr: posts small blind $0.01
keki8787: posts big blind $0.02
*** HOLE CARDS ***
Dealt to Dorex2007 [2s 6d]
Skumme: folds 
sleeper hipi: folds 
ariman1980: raises $0.05 to $0.07
Dorex2007: folds 
uptosumn: folds 
Gora858: folds 
Pokension: calls $0.07
Luks_Jr: folds 
keki8787: calls $0.05
*** FLOP *** [Jh 5c 7s]
keki8787: checks 
ariman1980: bets $0.21
Pokension: folds 
keki8787: folds 
Uncalled bet ($0.21) returned to ariman1980
ariman1980 collected $0.21 from pot
ariman1980: doesn't show hand 
*** SUMMARY ***
Total pot $0.22 | Rake $0.01 
Board [Jh 5c 7s]
Seat 1: Skumme folded before Flop (didn't bet)
Seat 2: sleeper hipi folded before Flop (didn't bet)
Seat 3: ariman1980 collected ($0.21)
Seat 4: Dorex2007 folded before Flop (didn't bet)
Seat 5: uptosumn folded before Flop (didn't bet)
Seat 6: Gora858 folded before Flop (didn't bet)
Seat 7: Pokension (button) folded on the Flop
Seat 8: Luks_Jr (small blind) folded before Flop
Seat 9: keki8787 (big blind) folded on the Flop



PokerStars Hand #228375269467:  Hold'em No Limit ($0.01/$0.02 USD) - 2021/07/17 23:24:45 PT [2021/07/18 2:24:45 ET]
Table 'Philia' 9-max Seat #8 is the button
Seat 1: Skumme ($1.43 in chips) 
Seat 2: sleeper hipi ($6.72 in chips) 
Seat 3: ariman1980 ($1.32 in chips) 
Seat 4: Dorex2007 ($2.48 in chips) 
Seat 5: uptosumn ($0.75 in chips) 
Seat 6: Gora858 ($3.85 in chips) 
Seat 7: Pokension ($2.83 in chips) 
Seat 8: Luks_Jr ($3.05 in chips) 
Seat 9: keki8787 ($1.80 in chips) 
keki8787: posts small blind $0.01
Skumme: posts big blind $0.02
*** HOLE CARDS ***
Dealt to Dorex2007 [Ks Th]
sleeper hipi: folds 
ariman1980: folds 
Dorex2007: folds 
uptosumn: calls $0.02
Gora858: calls $0.02
Pokension: calls $0.02
Luks_Jr: folds 
keki8787: calls $0.01
Skumme: checks 
*** FLOP *** [Qd 6d Qc]
keki8787: checks 
Skumme: bets $0.06
uptosumn: folds 
Gora858: folds 
Pokension: folds 
keki8787: folds 
Uncalled bet ($0.06) returned to Skumme
Skumme collected $0.10 from pot
Skumme: doesn't show hand 
*** SUMMARY ***
Total pot $0.10 | Rake $0 
Board [Qd 6d Qc]
Seat 1: Skumme (big blind) collected ($0.10)
Seat 2: sleeper hipi folded before Flop (didn't bet)
Seat 3: ariman1980 folded before Flop (didn't bet)
Seat 4: Dorex2007 folded before Flop (didn't bet)
Seat 5: uptosumn folded on the Flop
Seat 6: Gora858 folded on the Flop
Seat 7: Pokension folded on the Flop
Seat 8: Luks_Jr (button) folded before Flop (didn't bet)
Seat 9: keki8787 (small blind) folded on the Flop



PokerStars Hand #228375275184:  Hold'em No Limit ($0.01/$0.02 USD) - 2021/07/17 23:25:25 PT [2021/07/18 2:25:25 ET]
Table 'Philia' 9-max Seat #9 is the button
Seat 1: Skumme ($1.51 in chips) 
Seat 2: sleeper hipi ($6.72 in chips) 
Seat 3: ariman1980 ($1.32 in chips) 
Seat 4: Dorex2007 ($2.48 in chips) 
Seat 5: uptosumn ($0.73 in chips) 
Seat 6: Gora858 ($3.83 in chips) 
Seat 7: Pokension ($2.81 in chips) 
Seat 8: Luks_Jr ($3.05 in chips) 
Seat 9: keki8787 ($1.78 in chips) 
Skumme: posts small blind $0.01
sleeper hipi: posts big blind $0.02
*** HOLE CARDS ***
Dealt to Dorex2007 [8s 2c]
ariman1980: folds 
Dorex2007: folds 
uptosumn: calls $0.02
Gora858: folds 
Pokension: calls $0.02
Luks_Jr: folds 
keki8787: raises $0.02 to $0.04
Skumme: calls $0.03
sleeper hipi: folds 
uptosumn: raises $0.02 to $0.06
Pokension: calls $0.04
keki8787: calls $0.02
Skumme: calls $0.02
*** FLOP *** [9s 2h 9c]
Skumme: bets $0.25
uptosumn: calls $0.25
Pokension: raises $2.50 to $2.75 and is all-in
keki8787: folds 
Skumme: folds 
uptosumn: calls $0.42 and is all-in
Uncalled bet ($2.08) returned to Pokension
*** TURN *** [9s 2h 9c] [8h]
*** RIVER *** [9s 2h 9c 8h] [4c]
*** SHOW DOWN ***
uptosumn: shows [Tc Kd] (a pair of Nines)
Pokension: shows [9d 8d] (a full house, Nines full of Eights)
Pokension collected $1.79 from pot
uptosumn cashed out the hand for $0.04
*** SUMMARY ***
Total pot $1.85 | Rake $0.06 
Board [9s 2h 9c 8h 4c]
Seat 1: Skumme (small blind) folded on the Flop
Seat 2: sleeper hipi (big blind) folded before Flop
Seat 3: ariman1980 folded before Flop (didn't bet)
Seat 4: Dorex2007 folded before Flop (didn't bet)
Seat 5: uptosumn showed [Tc Kd] and lost with a pair of Nines (cashed out).
Seat 6: Gora858 folded before Flop (didn't bet)
Seat 7: Pokension showed [9d 8d] and won ($1.79) with a full house, Nines full of Eights
Seat 8: Luks_Jr folded before Flop (didn't bet)
Seat 9: keki8787 (button) folded on the Flop



PokerStars Hand #228375285134:  Hold'em No Limit ($0.01/$0.02 USD) - 2021/07/17 23:26:33 PT [2021/07/18 2:26:33 ET]
Table 'Philia' 9-max Seat #1 is the button
Seat 1: Skumme ($1.20 in chips) 
Seat 2: sleeper hipi ($6.70 in chips) 
Seat 3: ariman1980 ($1.32 in chips) 
Seat 4: Dorex2007 ($2.48 in chips) 
Seat 5: uptosumn ($0.04 in chips) 
Seat 6: Gora858 ($3.83 in chips) 
Seat 7: Pokension ($3.87 in chips) 
Seat 8: Luks_Jr ($3.05 in chips) 
Seat 9: keki8787 ($1.72 in chips) 
sleeper hipi: posts small blind $0.01
ariman1980: posts big blind $0.02
*** HOLE CARDS ***
Dealt to Dorex2007 [7h 4c]
Dorex2007: folds 
uptosumn: folds 
Gora858: folds 
Pokension: calls $0.02
Luks_Jr: folds 
keki8787: calls $0.02
Skumme: calls $0.02
sleeper hipi: calls $0.01
ariman1980: checks 
*** FLOP *** [Qh 2c Jh]
sleeper hipi: checks 
ariman1980: checks 
Pokension: checks 
keki8787: checks 
Skumme: checks 
*** TURN *** [Qh 2c Jh] [Jd]
sleeper hipi: checks 
ariman1980: checks 
Pokension: checks 
keki8787: checks 
Skumme: checks 
*** RIVER *** [Qh 2c Jh Jd] [Td]
sleeper hipi: checks 
ariman1980: checks 
Pokension: checks 
keki8787: checks 
Skumme: checks 
*** SHOW DOWN ***
sleeper hipi: shows [Th Ks] (two pair, Jacks and Tens)
ariman1980: mucks hand 
Pokension: mucks hand 
keki8787: mucks hand 
Skumme: mucks hand 
sleeper hipi collected $0.10 from pot
*** SUMMARY ***
Total pot $0.10 | Rake $0 
Board [Qh 2c Jh Jd Td]
Seat 1: Skumme (button) mucked [6d 8d]
Seat 2: sleeper hipi (small blind) showed [Th Ks] and won ($0.10) with two pair, Jacks and Tens
Seat 3: ariman1980 (big blind) mucked [2d 9d]
Seat 4: Dorex2007 folded before Flop (didn't bet)
Seat 5: uptosumn folded before Flop (didn't bet)
Seat 6: Gora858 folded before Flop (didn't bet)
Seat 7: Pokension mucked [5s As]
Seat 8: Luks_Jr folded before Flop (didn't bet)
Seat 9: keki8787 mucked [8s Ad]



PokerStars Hand #228375297414:  Hold'em No Limit ($0.01/$0.02 USD) - 2021/07/17 23:27:58 PT [2021/07/18 2:27:58 ET]
Table 'Philia' 9-max Seat #2 is the button
Seat 1: Skumme ($1.18 in chips) 
Seat 2: sleeper hipi ($6.78 in chips) 
Seat 3: ariman1980 ($1.30 in chips) 
Seat 4: Dorex2007 ($2.48 in chips) 
Seat 5: uptosumn ($0.04 in chips) 
Seat 6: Gora858 ($3.83 in chips) 
Seat 7: Pokension ($3.85 in chips) 
Seat 8: Luks_Jr ($3.05 in chips) 
Seat 9: keki8787 ($1.70 in chips) 
ariman1980: posts small blind $0.01
Dorex2007: posts big blind $0.02
*** HOLE CARDS ***
Dealt to Dorex2007 [5d 4c]
uptosumn: calls $0.02
Gora858: raises $0.02 to $0.04
Pokension: folds 
Luks_Jr: folds 
keki8787: folds 
Skumme: folds 
sleeper hipi: folds 
ariman1980: calls $0.03
Dorex2007: folds 
uptosumn: calls $0.02 and is all-in
*** FLOP *** [2h As Qc]
ariman1980: checks 
Gora858: bets $0.11
ariman1980: folds 
Uncalled bet ($0.11) returned to Gora858
Gora858 has timed out
*** TURN *** [2h As Qc] [8s]
*** RIVER *** [2h As Qc 8s] [2s]
*** SHOW DOWN ***
uptosumn: shows [Qd Ah] (two pair, Aces and Queens)
Gora858: shows [Ac 2c] (a full house, Deuces full of Aces)
Gora858 collected $0.14 from pot
*** SUMMARY ***
Total pot $0.14 | Rake $0 
Board [2h As Qc 8s 2s]
Seat 1: Skumme folded before Flop (didn't bet)
Seat 2: sleeper hipi (button) folded before Flop (didn't bet)
Seat 3: ariman1980 (small blind) folded on the Flop
Seat 4: Dorex2007 (big blind) folded before Flop
Seat 5: uptosumn showed [Qd Ah] and lost with two pair, Aces and Queens
Seat 6: Gora858 showed [Ac 2c] and won ($0.14) with a full house, Deuces full of Aces
Seat 7: Pokension folded before Flop (didn't bet)
Seat 8: Luks_Jr folded before Flop (didn't bet)
Seat 9: keki8787 folded before Flop (didn't bet)



PokerStars Hand #228375305711:  Hold'em No Limit ($0.01/$0.02 USD) - 2021/07/17 23:28:55 PT [2021/07/18 2:28:55 ET]
Table 'Philia' 9-max Seat #3 is the button
Seat 1: Skumme ($1.18 in chips) 
Seat 2: sleeper hipi ($6.78 in chips) 
Seat 3: ariman1980 ($1.26 in chips) 
Seat 4: Dorex2007 ($2.46 in chips) 
Seat 6: Gora858 ($3.93 in chips) 
Seat 7: Pokension ($3.85 in chips) 
Seat 8: Luks_Jr ($3.05 in chips) 
Seat 9: keki8787 ($1.70 in chips) 
Dorex2007: posts small blind $0.01
Gora858: posts big blind $0.02
*** HOLE CARDS ***
Dealt to Dorex2007 [8c 9c]
Pokension: folds 
Luks_Jr: folds 
uptosumn leaves the table
keki8787: calls $0.02
Skumme: calls $0.02
sleeper hipi: folds 
ariman1980: raises $0.09 to $0.11
Dorex2007: folds 
Gora858: folds 
keki8787: folds 
Skumme: folds 
Uncalled bet ($0.09) returned to ariman1980
ariman1980 collected $0.09 from pot
ariman1980: doesn't show hand 
*** SUMMARY ***
Total pot $0.09 | Rake $0 
Seat 1: Skumme folded before Flop
Seat 2: sleeper hipi folded before Flop (didn't bet)
Seat 3: ariman1980 (button) collected ($0.09)
Seat 4: Dorex2007 (small blind) folded before Flop
Seat 6: Gora858 (big blind) folded before Flop
Seat 7: Pokension folded before Flop (didn't bet)
Seat 8: Luks_Jr folded before Flop (didn't bet)
Seat 9: keki8787 folded before Flop



PokerStars Hand #228375309679:  Hold'em No Limit ($0.01/$0.02 USD) - 2021/07/17 23:29:22 PT [2021/07/18 2:29:22 ET]
Table 'Philia' 9-max Seat #4 is the button
Seat 1: Skumme ($1.16 in chips) 
Seat 2: sleeper hipi ($6.78 in chips) 
Seat 3: ariman1980 ($1.33 in chips) 
Seat 4: Dorex2007 ($2.45 in chips) 
Seat 6: Gora858 ($3.91 in chips) 
Seat 7: Pokension ($3.85 in chips) 
Seat 8: Luks_Jr ($3.05 in chips) 
Seat 9: keki8787 ($1.68 in chips) 
Gora858: posts small blind $0.01
Pokension: posts big blind $0.02
*** HOLE CARDS ***
Dealt to Dorex2007 [8d 3c]
Luks_Jr: folds 
keki8787: raises $0.02 to $0.04
Istytech joins the table at seat #5 
Skumme: folds 
sleeper hipi: folds 
ariman1980: folds 
Dorex2007: folds 
Gora858: folds 
Pokension: calls $0.02
*** FLOP *** [Ts 8c Ac]
Pokension: checks 
keki8787: checks 
*** TURN *** [Ts 8c Ac] [As]
Pokension: bets $0.06
keki8787: calls $0.06
*** RIVER *** [Ts 8c Ac As] [5s]
Pokension: bets $0.13
keki8787: calls $0.13
*** SHOW DOWN ***
Pokension: shows [6d 4s] (a pair of Aces)
keki8787: shows [Jh Jd] (two pair, Aces and Jacks)
keki8787 collected $0.45 from pot
*** SUMMARY ***
Total pot $0.47 | Rake $0.02 
Board [Ts 8c Ac As 5s]
Seat 1: Skumme folded before Flop (didn't bet)
Seat 2: sleeper hipi folded before Flop (didn't bet)
Seat 3: ariman1980 folded before Flop (didn't bet)
Seat 4: Dorex2007 (button) folded before Flop (didn't bet)
Seat 6: Gora858 (small blind) folded before Flop
Seat 7: Pokension (big blind) showed [6d 4s] and lost with a pair of Aces
Seat 8: Luks_Jr folded before Flop (didn't bet)
Seat 9: keki8787 showed [Jh Jd] and won ($0.45) with two pair, Aces and Jacks



PokerStars Hand #228375313942:  Hold'em No Limit ($0.01/$0.02 USD) - 2021/07/17 23:29:52 PT [2021/07/18 2:29:52 ET]
Table 'Philia' 9-max Seat #6 is the button
Seat 1: Skumme ($1.16 in chips) 
Seat 2: sleeper hipi ($6.78 in chips) 
Seat 3: ariman1980 ($1.33 in chips) 
Seat 4: Dorex2007 ($2.45 in chips) 
Seat 6: Gora858 ($3.90 in chips) 
Seat 8: Luks_Jr ($3.05 in chips) 
Seat 9: keki8787 ($1.90 in chips) 
Luks_Jr: posts small blind $0.01
keki8787: posts big blind $0.02
Istytech: sits out 
*** HOLE CARDS ***
Dealt to Dorex2007 [7d 5d]
Skumme: folds 
Pokension said, "lmao u called"
Pokension leaves the table
sleeper hipi: folds 
ariman1980: folds 
Dorex2007: folds 
Gora858: raises $0.04 to $0.06
Luks_Jr: folds 
keki8787: calls $0.04
*** FLOP *** [3h Jh 6d]
keki8787: checks 
Gora858: bets $0.09
keki8787: calls $0.09
*** TURN *** [3h Jh 6d] [Js]
keki8787: checks 
Gora858: checks 
*** RIVER *** [3h Jh 6d Js] [9h]
keki8787: bets $0.11
Gora858: calls $0.11
*** SHOW DOWN ***
keki8787: shows [Qh 8h] (a flush, Queen high)
Gora858: shows [Ah Th] (a flush, Ace high)
Gora858 collected $0.51 from pot
*** SUMMARY ***
Total pot $0.53 | Rake $0.02 
Board [3h Jh 6d Js 9h]
Seat 1: Skumme folded before Flop (didn't bet)
Seat 2: sleeper hipi folded before Flop (didn't bet)
Seat 3: ariman1980 folded before Flop (didn't bet)
Seat 4: Dorex2007 folded before Flop (didn't bet)
Seat 6: Gora858 (button) showed [Ah Th] and won ($0.51) with a flush, Ace high
Seat 8: Luks_Jr (small blind) folded before Flop
Seat 9: keki8787 (big blind) showed [Qh 8h] and lost with a flush, Queen high



PokerStars Hand #228375321681:  Hold'em No Limit ($0.01/$0.02 USD) - 2021/07/17 23:30:45 PT [2021/07/18 2:30:45 ET]
Table 'Philia' 9-max Seat #8 is the button
Seat 1: Skumme ($1.16 in chips) 
Seat 2: sleeper hipi ($6.78 in chips) 
Seat 3: ariman1980 ($1.33 in chips) 
Seat 4: Dorex2007 ($2.45 in chips) 
Seat 6: Gora858 ($4.15 in chips) 
Seat 8: Luks_Jr ($3.04 in chips) 
Seat 9: keki8787 ($1.64 in chips) 
keki8787: posts small blind $0.01
Skumme: posts big blind $0.02
Istytech: sits out 
*** HOLE CARDS ***
Dealt to Dorex2007 [2s 5h]
sleeper hipi: folds 
ariman1980: calls $0.02
Dorex2007: folds 
Gora858: calls $0.02
Luks_Jr: folds 
keki8787: calls $0.01
Skumme: checks 
*** FLOP *** [3s 5s 6s]
keki8787: checks 
Skumme: bets $0.04
ariman1980: folds 
Lt Boost joins the table at seat #7 
Gora858: folds 
keki8787: calls $0.04
*** TURN *** [3s 5s 6s] [Js]
keki8787: checks 
Skumme: checks 
*** RIVER *** [3s 5s 6s Js] [3h]
keki8787: checks 
Skumme: bets $0.05
keki8787: folds 
Uncalled bet ($0.05) returned to Skumme
Skumme collected $0.15 from pot
Skumme: doesn't show hand 
*** SUMMARY ***
Total pot $0.16 | Rake $0.01 
Board [3s 5s 6s Js 3h]
Seat 1: Skumme (big blind) collected ($0.15)
Seat 2: sleeper hipi folded before Flop (didn't bet)
Seat 3: ariman1980 folded on the Flop
Seat 4: Dorex2007 folded before Flop (didn't bet)
Seat 6: Gora858 folded on the Flop
Seat 8: Luks_Jr (button) folded before Flop (didn't bet)
Seat 9: keki8787 (small blind) folded on the River



PokerStars Hand #228375329156:  Hold'em No Limit ($0.01/$0.02 USD) - 2021/07/17 23:31:36 PT [2021/07/18 2:31:36 ET]
Table 'Philia' 9-max Seat #9 is the button
Seat 1: Skumme ($1.25 in chips) 
Seat 2: sleeper hipi ($6.78 in chips) 
Seat 3: ariman1980 ($1.31 in chips) 
Seat 4: Dorex2007 ($2.45 in chips) 
Seat 6: Gora858 ($4.13 in chips) 
Seat 8: Luks_Jr ($3.04 in chips) 
Seat 9: keki8787 ($1.58 in chips) 
Skumme: posts small blind $0.01
sleeper hipi: posts big blind $0.02
Istytech: sits out 
Lt Boost: sits out 
*** HOLE CARDS ***
Dealt to Dorex2007 [8s 3d]
ariman1980: folds 
Dorex2007: folds 
Gora858: folds 
Luks_Jr: raises $0.02 to $0.04
keki8787: raises $0.02 to $0.06
Skumme: folds 
sleeper hipi: folds 
Luks_Jr: calls $0.02
*** FLOP *** [2h 6c Jd]
Luks_Jr: checks 
keki8787: checks 
*** TURN *** [2h 6c Jd] [7h]
Istytech leaves the table
kolyamex joins the table at seat #5 
Luks_Jr: bets $0.08
keki8787: calls $0.08
*** RIVER *** [2h 6c Jd 7h] [7s]
Luks_Jr: checks 
keki8787: checks 
*** SHOW DOWN ***
Luks_Jr: shows [Th 8h] (a pair of Sevens)
keki8787: shows [5s 5c] (two pair, Sevens and Fives)
keki8787 collected $0.30 from pot
*** SUMMARY ***
Total pot $0.31 | Rake $0.01 
Board [2h 6c Jd 7h 7s]
Seat 1: Skumme (small blind) folded before Flop
Seat 2: sleeper hipi (big blind) folded before Flop
Seat 3: ariman1980 folded before Flop (didn't bet)
Seat 4: Dorex2007 folded before Flop (didn't bet)
Seat 6: Gora858 folded before Flop (didn't bet)
Seat 8: Luks_Jr showed [Th 8h] and lost with a pair of Sevens
Seat 9: keki8787 (button) showed [5s 5c] and won ($0.30) with two pair, Sevens and Fives



PokerStars Hand #228375334927:  Hold'em No Limit ($0.01/$0.02 USD) - 2021/07/17 23:32:16 PT [2021/07/18 2:32:16 ET]
Table 'Philia' 9-max Seat #1 is the button
Seat 1: Skumme ($1.24 in chips) 
Seat 2: sleeper hipi ($6.76 in chips) 
Seat 3: ariman1980 ($1.31 in chips) 
Seat 4: Dorex2007 ($2.45 in chips) 
Seat 6: Gora858 ($4.13 in chips) 
Seat 7: Lt Boost ($1.60 in chips) 
Seat 8: Luks_Jr ($2.90 in chips) 
Seat 9: keki8787 ($1.74 in chips) 
sleeper hipi: posts small blind $0.01
ariman1980: posts big blind $0.02
kolyamex: sits out 
Lt Boost: posts big blind $0.02
*** HOLE CARDS ***
Dealt to Dorex2007 [5h Qh]
Dorex2007: folds 
Gora858: folds 
Lt Boost: checks 
Luks_Jr: folds 
keki8787: calls $0.02
Skumme: calls $0.02
sleeper hipi: calls $0.01
ariman1980: checks 
*** FLOP *** [As 2c 7d]
sleeper hipi: checks 
ariman1980: checks 
Lt Boost: checks 
keki8787: checks 
Skumme: checks 
*** TURN *** [As 2c 7d] [8d]
sleeper hipi: checks 
ariman1980: checks 
Lt Boost: bets $0.02
keki8787: calls $0.02
Skumme: calls $0.02
sleeper hipi: folds 
ariman1980: calls $0.02
*** RIVER *** [As 2c 7d 8d] [8s]
ariman1980: checks 
Lt Boost: checks 
keki8787: checks 
Skumme: checks 
*** SHOW DOWN ***
ariman1980: shows [7c 3c] (two pair, Eights and Sevens)
Lt Boost: shows [Jd 7s] (two pair, Eights and Sevens)
keki8787: mucks hand 
Skumme: mucks hand 
ariman1980 collected $0.09 from pot
Lt Boost collected $0.08 from pot
*** SUMMARY ***
Total pot $0.18 | Rake $0.01 
Board [As 2c 7d 8d 8s]
Seat 1: Skumme (button) mucked [4d 4h]
Seat 2: sleeper hipi (small blind) folded on the Turn
Seat 3: ariman1980 (big blind) showed [7c 3c] and won ($0.09) with two pair, Eights and Sevens
Seat 4: Dorex2007 folded before Flop (didn't bet)
Seat 6: Gora858 folded before Flop (didn't bet)
Seat 7: Lt Boost showed [Jd 7s] and won ($0.08) with two pair, Eights and Sevens
Seat 8: Luks_Jr folded before Flop (didn't bet)
Seat 9: keki8787 mucked [Jh Ts]



PokerStars Hand #228375345817:  Hold'em No Limit ($0.01/$0.02 USD) - 2021/07/17 23:33:30 PT [2021/07/18 2:33:30 ET]
Table 'Philia' 9-max Seat #2 is the button
Seat 1: Skumme ($1.20 in chips) 
Seat 2: sleeper hipi ($6.74 in chips) 
Seat 3: ariman1980 ($1.36 in chips) 
Seat 4: Dorex2007 ($2.45 in chips) 
Seat 5: kolyamex ($1.60 in chips) 
Seat 6: Gora858 ($4.13 in chips) 
Seat 7: Lt Boost ($1.64 in chips) 
Seat 8: Luks_Jr ($2.90 in chips) 
Seat 9: keki8787 ($1.70 in chips) 
ariman1980: posts small blind $0.01
Dorex2007: posts big blind $0.02
kolyamex: posts big blind $0.02
*** HOLE CARDS ***
Dealt to Dorex2007 [Th Jd]
kolyamex: checks 
Gora858: folds 
Lt Boost: folds 
Luks_Jr: folds 
keki8787: calls $0.02
Skumme: folds 
sleeper hipi: folds 
ariman1980: calls $0.01
Dorex2007: checks 
*** FLOP *** [8d 7h 9d]
ariman1980: checks 
Dorex2007: bets $0.04
kolyamex: folds 
keki8787: folds 
ariman1980: calls $0.04
*** TURN *** [8d 7h 9d] [Qs]
ariman1980: checks 
Dorex2007: bets $0.15
ariman1980: calls $0.15
*** RIVER *** [8d 7h 9d Qs] [6c]
ariman1980: bets $1.15 and is all-in
Dorex2007: calls $1.15
*** SHOW DOWN ***
ariman1980: shows [5d Ad] (a straight, Five to Nine)
Dorex2007: shows [Th Jd] (a straight, Eight to Queen)
Dorex2007 collected $2.66 from pot
*** SUMMARY ***
Total pot $2.76 | Rake $0.10 
Board [8d 7h 9d Qs 6c]
Seat 1: Skumme folded before Flop (didn't bet)
Seat 2: sleeper hipi (button) folded before Flop (didn't bet)
Seat 3: ariman1980 (small blind) showed [5d Ad] and lost with a straight, Five to Nine
Seat 4: Dorex2007 (big blind) showed [Th Jd] and won ($2.66) with a straight, Eight to Queen
Seat 5: kolyamex folded on the Flop (didn't bet)
Seat 6: Gora858 folded before Flop (didn't bet)
Seat 7: Lt Boost folded before Flop (didn't bet)
Seat 8: Luks_Jr folded before Flop (didn't bet)
Seat 9: keki8787 folded on the Flop



PokerStars Hand #228375358506:  Hold'em No Limit ($0.01/$0.02 USD) - 2021/07/17 23:34:57 PT [2021/07/18 2:34:57 ET]
Table 'Philia' 9-max Seat #4 is the button
Seat 1: Skumme ($1.20 in chips) 
Seat 2: sleeper hipi ($6.74 in chips) 
Seat 4: Dorex2007 ($3.75 in chips) 
Seat 5: kolyamex ($1.58 in chips) 
Seat 6: Gora858 ($4.13 in chips) 
Seat 7: Lt Boost ($1.64 in chips) 
Seat 8: Luks_Jr ($2.90 in chips) 
Seat 9: keki8787 ($1.68 in chips) 
kolyamex: posts small blind $0.01
Gora858: posts big blind $0.02
*** HOLE CARDS ***
Dealt to Dorex2007 [Ah 6h]
Lt Boost: folds 
ariman1980 leaves the table
Luks_Jr: folds 
keki8787: calls $0.02
Skumme: folds 
sleeper hipi: folds 
Dorex2007: calls $0.02
kolyamex: folds 
Gora858: checks 
*** FLOP *** [Qc 2h 2d]
Lord7 Sergio joins the table at seat #3 
Gora858: bets $0.05
keki8787: raises $0.05 to $0.10
Dorex2007: folds 
Gora858: calls $0.05
*** TURN *** [Qc 2h 2d] [As]
Gora858: checks 
keki8787: bets $0.02
Gora858: calls $0.02
*** RIVER *** [Qc 2h 2d As] [4h]
Gora858: checks 
keki8787: bets $0.02
Gora858: calls $0.02
*** SHOW DOWN ***
keki8787: shows [2s 3h] (three of a kind, Deuces)
Gora858: mucks hand 
keki8787 collected $0.34 from pot
*** SUMMARY ***
Total pot $0.35 | Rake $0.01 
Board [Qc 2h 2d As 4h]
Seat 1: Skumme folded before Flop (didn't bet)
Seat 2: sleeper hipi folded before Flop (didn't bet)
Seat 4: Dorex2007 (button) folded on the Flop
Seat 5: kolyamex (small blind) folded before Flop
Seat 6: Gora858 (big blind) mucked [Qs Kd]
Seat 7: Lt Boost folded before Flop (didn't bet)
Seat 8: Luks_Jr folded before Flop (didn't bet)
Seat 9: keki8787 showed [2s 3h] and won ($0.34) with three of a kind, Deuces



PokerStars Hand #228375368352:  Hold'em No Limit ($0.01/$0.02 USD) - 2021/07/17 23:36:04 PT [2021/07/18 2:36:04 ET]
Table 'Philia' 9-max Seat #5 is the button
Seat 1: Skumme ($1.20 in chips) 
Seat 2: sleeper hipi ($6.74 in chips) 
Seat 4: Dorex2007 ($3.73 in chips) 
Seat 5: kolyamex ($1.57 in chips) 
Seat 6: Gora858 ($3.97 in chips) 
Seat 7: Lt Boost ($1.64 in chips) 
Seat 8: Luks_Jr ($2.90 in chips) 
Seat 9: keki8787 ($1.86 in chips) 
Gora858: posts small blind $0.01
Lt Boost: posts big blind $0.02
Lord7 Sergio: sits out 
*** HOLE CARDS ***
Dealt to Dorex2007 [Js Ts]
Luks_Jr: folds 
keki8787: folds 
Skumme: calls $0.02
sleeper hipi: folds 
Dorex2007: calls $0.02
kolyamex has timed out
kolyamex: folds 
Gora858: calls $0.01
Lt Boost: checks 
*** FLOP *** [4h 8s Jh]
Gora858: checks 
Lt Boost: checks 
Skumme: bets $0.02
Dorex2007: raises $0.12 to $0.14
Gora858: folds 
Lt Boost: folds 
Skumme: folds 
Uncalled bet ($0.12) returned to Dorex2007
Dorex2007 collected $0.12 from pot
Dorex2007: doesn't show hand 
*** SUMMARY ***
Total pot $0.12 | Rake $0 
Board [4h 8s Jh]
Seat 1: Skumme folded on the Flop
Seat 2: sleeper hipi folded before Flop (didn't bet)
Seat 4: Dorex2007 collected ($0.12)
Seat 5: kolyamex (button) folded before Flop (didn't bet)
Seat 6: Gora858 (small blind) folded on the Flop
Seat 7: Lt Boost (big blind) folded on the Flop
Seat 8: Luks_Jr folded before Flop (didn't bet)
Seat 9: keki8787 folded before Flop (didn't bet)



PokerStars Hand #228375375143:  Hold'em No Limit ($0.01/$0.02 USD) - 2021/07/17 23:36:50 PT [2021/07/18 2:36:50 ET]
Table 'Philia' 9-max Seat #6 is the button
Seat 1: Skumme ($1.16 in chips) 
Seat 2: sleeper hipi ($6.74 in chips) 
Seat 4: Dorex2007 ($3.81 in chips) 
Seat 5: kolyamex ($1.57 in chips) 
Seat 6: Gora858 ($3.95 in chips) 
Seat 7: Lt Boost ($1.62 in chips) 
Seat 8: Luks_Jr ($2.90 in chips) 
Seat 9: keki8787 ($1.86 in chips) 
Lt Boost: posts small blind $0.01
Luks_Jr: posts big blind $0.02
Lord7 Sergio: sits out 
*** HOLE CARDS ***
Dealt to Dorex2007 [3h Qd]
keki8787: folds 
Skumme: calls $0.02
sleeper hipi: calls $0.02
Dorex2007: folds 
kolyamex: folds 
Gora858: raises $0.04 to $0.06
Lt Boost: calls $0.05
Luks_Jr: folds 
Skumme: calls $0.04
sleeper hipi: calls $0.04
*** FLOP *** [7s Th Js]
Lt Boost: checks 
Skumme: bets $0.04
sleeper hipi: folds 
Gora858: raises $0.08 to $0.12
Lt Boost: folds 
Skumme: calls $0.08
*** TURN *** [7s Th Js] [Jh]
Skumme: bets $0.24
Gora858: calls $0.24
*** RIVER *** [7s Th Js Jh] [Qs]
Skumme: checks 
Gora858: checks 
*** SHOW DOWN ***
Skumme: shows [Ad 7d] (two pair, Jacks and Sevens)
Gora858: shows [Jc Kc] (three of a kind, Jacks)
Gora858 collected $0.95 from pot
*** SUMMARY ***
Total pot $0.98 | Rake $0.03 
Board [7s Th Js Jh Qs]
Seat 1: Skumme showed [Ad 7d] and lost with two pair, Jacks and Sevens
Seat 2: sleeper hipi folded on the Flop
Seat 4: Dorex2007 folded before Flop (didn't bet)
Seat 5: kolyamex folded before Flop (didn't bet)
Seat 6: Gora858 (button) showed [Jc Kc] and won ($0.95) with three of a kind, Jacks
Seat 7: Lt Boost (small blind) folded on the Flop
Seat 8: Luks_Jr (big blind) folded before Flop
Seat 9: keki8787 folded before Flop (didn't bet)



PokerStars Hand #228375385056:  Hold'em No Limit ($0.01/$0.02 USD) - 2021/07/17 23:37:57 PT [2021/07/18 2:37:57 ET]
Table 'Philia' 9-max Seat #7 is the button
Seat 1: Skumme ($0.74 in chips) 
Seat 2: sleeper hipi ($6.68 in chips) 
Seat 4: Dorex2007 ($3.81 in chips) 
Seat 5: kolyamex ($1.57 in chips) 
Seat 6: Gora858 ($4.48 in chips) 
Seat 7: Lt Boost ($1.56 in chips) 
Seat 8: Luks_Jr ($2.88 in chips) 
Seat 9: keki8787 ($1.86 in chips) 
Luks_Jr: posts small blind $0.01
keki8787: posts big blind $0.02
Lord7 Sergio: sits out 
*** HOLE CARDS ***
Dealt to Dorex2007 [8s 3c]
Skumme: folds 
sleeper hipi: folds 
Dorex2007: folds 
kolyamex: raises $0.04 to $0.06
Gora858: calls $0.06
Lt Boost: calls $0.06
Luks_Jr: folds 
keki8787: calls $0.04
*** FLOP *** [4h 2c 8c]
keki8787: checks 
kolyamex: checks 
Gora858: checks 
Lt Boost: checks 
*** TURN *** [4h 2c 8c] [Ks]
keki8787: checks 
kolyamex: checks 
Gora858: bets $0.12
Lt Boost: folds 
keki8787: folds 
kolyamex: folds 
Uncalled bet ($0.12) returned to Gora858
Gora858 collected $0.24 from pot
*** SUMMARY ***
Total pot $0.25 | Rake $0.01 
Board [4h 2c 8c Ks]
Seat 1: Skumme folded before Flop (didn't bet)
Seat 2: sleeper hipi folded before Flop (didn't bet)
Seat 4: Dorex2007 folded before Flop (didn't bet)
Seat 5: kolyamex folded on the Turn
Seat 6: Gora858 collected ($0.24)
Seat 7: Lt Boost (button) folded on the Turn
Seat 8: Luks_Jr (small blind) folded before Flop
Seat 9: keki8787 (big blind) folded on the Turn



PokerStars Hand #228375395215:  Hold'em No Limit ($0.01/$0.02 USD) - 2021/07/17 23:39:06 PT [2021/07/18 2:39:06 ET]
Table 'Philia' 9-max Seat #8 is the button
Seat 1: Skumme ($0.74 in chips) 
Seat 2: sleeper hipi ($6.68 in chips) 
Seat 4: Dorex2007 ($3.81 in chips) 
Seat 5: kolyamex ($1.51 in chips) 
Seat 6: Gora858 ($4.66 in chips) 
Seat 7: Lt Boost ($1.50 in chips) 
Seat 8: Luks_Jr ($2.87 in chips) 
Seat 9: keki8787 ($1.80 in chips) 
keki8787: posts small blind $0.01
Skumme: posts big blind $0.02
Lord7 Sergio: sits out 
*** HOLE CARDS ***
Dealt to Dorex2007 [9h Jd]
sleeper hipi: raises $0.04 to $0.06
Lt Boost is disconnected 
Dorex2007: folds 
kolyamex: folds 
Gora858: folds 
Lt Boost: folds 
Luks_Jr: folds 
keki8787: calls $0.05
Skumme: raises $0.06 to $0.12
sleeper hipi: calls $0.06
keki8787: calls $0.06
*** FLOP *** [Qc 7s 5d]
keki8787: checks 
Skumme: bets $0.35
sleeper hipi: folds 
keki8787: folds 
Uncalled bet ($0.35) returned to Skumme
Skumme collected $0.35 from pot
Skumme: doesn't show hand 
*** SUMMARY ***
Total pot $0.36 | Rake $0.01 
Board [Qc 7s 5d]
Seat 1: Skumme (big blind) collected ($0.35)
Seat 2: sleeper hipi folded on the Flop
Seat 4: Dorex2007 folded before Flop (didn't bet)
Seat 5: kolyamex folded before Flop (didn't bet)
Seat 6: Gora858 folded before Flop (didn't bet)
Seat 7: Lt Boost folded before Flop (didn't bet)
Seat 8: Luks_Jr (button) folded before Flop (didn't bet)
Seat 9: keki8787 (small blind) folded on the Flop



PokerStars Hand #228375402271:  Hold'em No Limit ($0.01/$0.02 USD) - 2021/07/17 23:39:53 PT [2021/07/18 2:39:53 ET]
Table 'Philia' 9-max Seat #9 is the button
Seat 1: Skumme ($0.97 in chips) 
Seat 2: sleeper hipi ($6.56 in chips) 
Seat 4: Dorex2007 ($3.81 in chips) 
Seat 5: kolyamex ($1.51 in chips) 
Seat 6: Gora858 ($4.66 in chips) 
Seat 7: Lt Boost ($1.50 in chips) 
Seat 8: Luks_Jr ($2.87 in chips) 
Seat 9: keki8787 ($1.68 in chips) 
Skumme: posts small blind $0.01
sleeper hipi: posts big blind $0.02
Lord7 Sergio: sits out 
*** HOLE CARDS ***
Dealt to Dorex2007 [Qh 2c]
Lt Boost is disconnected 
Dorex2007: folds 
kolyamex: folds 
Gora858: raises $0.02 to $0.04
Lt Boost has timed out while disconnected
Lt Boost: folds 
Luks_Jr: folds 
keki8787: folds 
Skumme: calls $0.03
sleeper hipi: folds 
*** FLOP *** [8s 9s 7h]
Skumme: bets $0.04
Gora858: calls $0.04
*** TURN *** [8s 9s 7h] [9c]
Skumme: bets $0.06
Gora858: folds 
Uncalled bet ($0.06) returned to Skumme
Skumme collected $0.17 from pot
Skumme: doesn't show hand 
*** SUMMARY ***
Total pot $0.18 | Rake $0.01 
Board [8s 9s 7h 9c]
Seat 1: Skumme (small blind) collected ($0.17)
Seat 2: sleeper hipi (big blind) folded before Flop
Seat 4: Dorex2007 folded before Flop (didn't bet)
Seat 5: kolyamex folded before Flop (didn't bet)
Seat 6: Gora858 folded on the Turn
Seat 7: Lt Boost folded before Flop (didn't bet)
Seat 8: Luks_Jr folded before Flop (didn't bet)
Seat 9: keki8787 (button) folded before Flop (didn't bet)



PokerStars Hand #228375411464:  Hold'em No Limit ($0.01/$0.02 USD) - 2021/07/17 23:40:56 PT [2021/07/18 2:40:56 ET]
Table 'Philia' 9-max Seat #1 is the button
Seat 1: Skumme ($1.06 in chips) 
Seat 2: sleeper hipi ($6.54 in chips) 
Seat 3: Lord7 Sergio ($2 in chips) 
Seat 4: Dorex2007 ($3.81 in chips) 
Seat 5: kolyamex ($1.51 in chips) 
Seat 6: Gora858 ($4.58 in chips) 
Seat 7: Lt Boost ($1.50 in chips) 
Seat 8: Luks_Jr ($2.87 in chips) 
Seat 9: keki8787 ($1.68 in chips) 
sleeper hipi: posts small blind $0.01
Lord7 Sergio: posts big blind $0.02
*** HOLE CARDS ***
Dealt to Dorex2007 [Qd Jc]
Dorex2007: folds 
kolyamex: folds 
Gora858: folds 
Lt Boost: folds 
Luks_Jr: folds 
keki8787: folds 
Skumme: folds 
sleeper hipi: calls $0.01
Lord7 Sergio: checks 
*** FLOP *** [6s Qs 8d]
sleeper hipi: bets $0.02
Lord7 Sergio: folds 
Uncalled bet ($0.02) returned to sleeper hipi
sleeper hipi collected $0.04 from pot
sleeper hipi: doesn't show hand 
*** SUMMARY ***
Total pot $0.04 | Rake $0 
Board [6s Qs 8d]
Seat 1: Skumme (button) folded before Flop (didn't bet)
Seat 2: sleeper hipi (small blind) collected ($0.04)
Seat 3: Lord7 Sergio (big blind) folded on the Flop
Seat 4: Dorex2007 folded before Flop (didn't bet)
Seat 5: kolyamex folded before Flop (didn't bet)
Seat 6: Gora858 folded before Flop (didn't bet)
Seat 7: Lt Boost folded before Flop (didn't bet)
Seat 8: Luks_Jr folded before Flop (didn't bet)
Seat 9: keki8787 folded before Flop (didn't bet)



PokerStars Hand #228375418051:  Hold'em No Limit ($0.01/$0.02 USD) - 2021/07/17 23:41:40 PT [2021/07/18 2:41:40 ET]
Table 'Philia' 9-max Seat #2 is the button
Seat 1: Skumme ($1.06 in chips) 
Seat 2: sleeper hipi ($6.56 in chips) 
Seat 3: Lord7 Sergio ($1.98 in chips) 
Seat 4: Dorex2007 ($3.81 in chips) 
Seat 5: kolyamex ($1.51 in chips) 
Seat 6: Gora858 ($4.58 in chips) 
Seat 7: Lt Boost ($1.50 in chips) 
Seat 8: Luks_Jr ($2.87 in chips) 
Seat 9: keki8787 ($1.68 in chips) 
Lord7 Sergio: posts small blind $0.01
Dorex2007: posts big blind $0.02
*** HOLE CARDS ***
Dealt to Dorex2007 [6d Kc]
kolyamex: folds 
Gora858: folds 
Lt Boost: calls $0.02
Luks_Jr: folds 
keki8787: calls $0.02
Skumme: folds 
sleeper hipi: folds 
Lord7 Sergio: folds 
Dorex2007: checks 
*** FLOP *** [6s Ad 7d]
Dorex2007: checks 
Lt Boost: checks 
keki8787: checks 
*** TURN *** [6s Ad 7d] [Qd]
Dorex2007: checks 
Lt Boost: checks 
keki8787: bets $0.06
Dorex2007: folds 
Lt Boost: folds 
Uncalled bet ($0.06) returned to keki8787
keki8787 collected $0.07 from pot
keki8787: doesn't show hand 
*** SUMMARY ***
Total pot $0.07 | Rake $0 
Board [6s Ad 7d Qd]
Seat 1: Skumme folded before Flop (didn't bet)
Seat 2: sleeper hipi (button) folded before Flop (didn't bet)
Seat 3: Lord7 Sergio (small blind) folded before Flop
Seat 4: Dorex2007 (big blind) folded on the Turn
Seat 5: kolyamex folded before Flop (didn't bet)
Seat 6: Gora858 folded before Flop (didn't bet)
Seat 7: Lt Boost folded on the Turn
Seat 8: Luks_Jr folded before Flop (didn't bet)
Seat 9: keki8787 collected ($0.07)



PokerStars Hand #228375427412:  Hold'em No Limit ($0.01/$0.02 USD) - 2021/07/17 23:42:42 PT [2021/07/18 2:42:42 ET]
Table 'Philia' 9-max Seat #3 is the button
Seat 1: Skumme ($1.06 in chips) 
Seat 2: sleeper hipi ($6.56 in chips) 
Seat 3: Lord7 Sergio ($1.97 in chips) 
Seat 4: Dorex2007 ($3.79 in chips) 
Seat 5: kolyamex ($1.51 in chips) 
Seat 6: Gora858 ($4.58 in chips) 
Seat 7: Lt Boost ($1.48 in chips) 
Seat 8: Luks_Jr ($2.87 in chips) 
Seat 9: keki8787 ($1.73 in chips) 
Dorex2007: posts small blind $0.01
kolyamex: posts big blind $0.02
*** HOLE CARDS ***
Dealt to Dorex2007 [3s 2s]
Gora858: folds 
Lt Boost: calls $0.02
Luks_Jr: folds 
keki8787: calls $0.02
Skumme: calls $0.02
sleeper hipi: folds 
Lord7 Sergio: raises $0.04 to $0.06
Dorex2007: folds 
kolyamex: folds 
Luks_Jr leaves the table
Lt Boost: calls $0.04
keki8787: calls $0.04
Skumme: calls $0.04
*** FLOP *** [6c Qs Td]
voshod999 joins the table at seat #8 
Lt Boost: bets $0.06
keki8787: calls $0.06
Skumme: folds 
Lord7 Sergio: raises $1.85 to $1.91 and is all-in
Lt Boost: calls $1.36 and is all-in
keki8787: folds 
Uncalled bet ($0.49) returned to Lord7 Sergio
*** TURN *** [6c Qs Td] [8s]
*** RIVER *** [6c Qs Td 8s] [5d]
*** SHOW DOWN ***
Lt Boost: shows [Th Tc] (three of a kind, Tens)
Lord7 Sergio: shows [Ts Qc] (two pair, Queens and Tens)
Lt Boost collected $3.06 from pot
*** SUMMARY ***
Total pot $3.17 | Rake $0.11 
Board [6c Qs Td 8s 5d]
Seat 1: Skumme folded on the Flop
Seat 2: sleeper hipi folded before Flop (didn't bet)
Seat 3: Lord7 Sergio (button) showed [Ts Qc] and lost with two pair, Queens and Tens
Seat 4: Dorex2007 (small blind) folded before Flop
Seat 5: kolyamex (big blind) folded before Flop
Seat 6: Gora858 folded before Flop (didn't bet)
Seat 7: Lt Boost showed [Th Tc] and won ($3.06) with three of a kind, Tens
Seat 8: Luks_Jr folded before Flop (didn't bet)
Seat 9: keki8787 folded on the Flop



PokerStars Hand #228375439397:  Hold'em No Limit ($0.01/$0.02 USD) - 2021/07/17 23:44:03 PT [2021/07/18 2:44:03 ET]
Table 'Philia' 9-max Seat #4 is the button
Seat 1: Skumme ($1 in chips) 
Seat 2: sleeper hipi ($6.56 in chips) 
Seat 3: Lord7 Sergio ($0.49 in chips) 
Seat 4: Dorex2007 ($3.78 in chips) 
Seat 5: kolyamex ($1.49 in chips) 
Seat 6: Gora858 ($4.58 in chips) 
Seat 7: Lt Boost ($3.06 in chips) 
Seat 8: voshod999 ($0.87 in chips) 
Seat 9: keki8787 ($1.61 in chips) 
kolyamex: posts small blind $0.01
Gora858: posts big blind $0.02
voshod999: posts big blind $0.02
*** HOLE CARDS ***
Dealt to Dorex2007 [Qs 2d]
Lt Boost: calls $0.02
voshod999: checks 
keki8787: calls $0.02
Skumme: calls $0.02
sleeper hipi: calls $0.02
Lord7 Sergio: folds 
Dorex2007: folds 
kolyamex: raises $0.04 to $0.06
Gora858: folds 
Lt Boost: calls $0.04
voshod999: calls $0.04
keki8787: calls $0.04
Skumme: calls $0.04
sleeper hipi: calls $0.04
*** FLOP *** [4c 8c 8s]
kolyamex: checks 
Lt Boost: checks 
voshod999: checks 
keki8787: checks 
Skumme: bets $0.37
sleeper hipi: folds 
kolyamex: folds 
Lt Boost: folds 
voshod999: folds 
keki8787: folds 
Uncalled bet ($0.37) returned to Skumme
Skumme collected $0.37 from pot
Skumme: doesn't show hand 
*** SUMMARY ***
Total pot $0.38 | Rake $0.01 
Board [4c 8c 8s]
Seat 1: Skumme collected ($0.37)
Seat 2: sleeper hipi folded on the Flop
Seat 3: Lord7 Sergio folded before Flop (didn't bet)
Seat 4: Dorex2007 (button) folded before Flop (didn't bet)
Seat 5: kolyamex (small blind) folded on the Flop
Seat 6: Gora858 (big blind) folded before Flop
Seat 7: Lt Boost folded on the Flop
Seat 8: voshod999 folded on the Flop
Seat 9: keki8787 folded on the Flop



PokerStars Hand #228375450062:  Hold'em No Limit ($0.01/$0.02 USD) - 2021/07/17 23:45:13 PT [2021/07/18 2:45:13 ET]
Table 'Philia' 9-max Seat #5 is the button
Seat 1: Skumme ($1.31 in chips) 
Seat 2: sleeper hipi ($6.50 in chips) 
Seat 3: Lord7 Sergio ($0.49 in chips) 
Seat 4: Dorex2007 ($3.78 in chips) 
Seat 5: kolyamex ($1.43 in chips) 
Seat 6: Gora858 ($4.56 in chips) 
Seat 7: Lt Boost ($3 in chips) 
Seat 8: voshod999 ($0.81 in chips) 
Seat 9: keki8787 ($1.55 in chips) 
Gora858: posts small blind $0.01
Lt Boost: posts big blind $0.02
*** HOLE CARDS ***
Dealt to Dorex2007 [Kh 6d]
voshod999: folds 
keki8787: calls $0.02
Skumme: folds 
sleeper hipi: folds 
Lord7 Sergio: folds 
Dorex2007: folds 
kolyamex: calls $0.02
Gora858: folds 
Lt Boost: checks 
*** FLOP *** [Tc 8d 3d]
Lt Boost: bets $0.02
keki8787: calls $0.02
kolyamex: calls $0.02
*** TURN *** [Tc 8d 3d] [Ks]
Lt Boost: checks 
keki8787: checks 
kolyamex: bets $0.08
Lt Boost: folds 
keki8787: folds 
Uncalled bet ($0.08) returned to kolyamex
kolyamex collected $0.13 from pot
kolyamex: doesn't show hand 
*** SUMMARY ***
Total pot $0.13 | Rake $0 
Board [Tc 8d 3d Ks]
Seat 1: Skumme folded before Flop (didn't bet)
Seat 2: sleeper hipi folded before Flop (didn't bet)
Seat 3: Lord7 Sergio folded before Flop (didn't bet)
Seat 4: Dorex2007 folded before Flop (didn't bet)
Seat 5: kolyamex (button) collected ($0.13)
Seat 6: Gora858 (small blind) folded before Flop
Seat 7: Lt Boost (big blind) folded on the Turn
Seat 8: voshod999 folded before Flop (didn't bet)
Seat 9: keki8787 folded on the Turn



PokerStars Hand #228375458454:  Hold'em No Limit ($0.01/$0.02 USD) - 2021/07/17 23:46:10 PT [2021/07/18 2:46:10 ET]
Table 'Philia' 9-max Seat #6 is the button
Seat 1: Skumme ($1.31 in chips) 
Seat 2: sleeper hipi ($6.50 in chips) 
Seat 3: Lord7 Sergio ($2 in chips) 
Seat 4: Dorex2007 ($3.78 in chips) 
Seat 5: kolyamex ($1.52 in chips) 
Seat 6: Gora858 ($4.55 in chips) 
Seat 8: voshod999 ($0.81 in chips) 
Seat 9: keki8787 ($1.51 in chips) 
voshod999: posts small blind $0.01
keki8787: posts big blind $0.02
*** HOLE CARDS ***
Dealt to Dorex2007 [4d 7d]
Skumme: folds 
sleeper hipi: folds 
Lord7 Sergio: folds 
Dorex2007: folds 
Lt Boost leaves the table
kolyamex: raises $0.02 to $0.04
Gora858: folds 
voshod999: calls $0.03
keki8787: calls $0.02
*** FLOP *** [8h 2h Jh]
mimimouse6 joins the table at seat #7 
voshod999: checks 
keki8787: checks 
kolyamex: checks 
*** TURN *** [8h 2h Jh] [8d]
voshod999: bets $0.08
keki8787: folds 
kolyamex: calls $0.08
*** RIVER *** [8h 2h Jh 8d] [Kc]
voshod999: checks 
kolyamex: checks 
*** SHOW DOWN ***
voshod999: shows [8c 6c] (three of a kind, Eights)
kolyamex: mucks hand 
voshod999 collected $0.27 from pot
*** SUMMARY ***
Total pot $0.28 | Rake $0.01 
Board [8h 2h Jh 8d Kc]
Seat 1: Skumme folded before Flop (didn't bet)
Seat 2: sleeper hipi folded before Flop (didn't bet)
Seat 3: Lord7 Sergio folded before Flop (didn't bet)
Seat 4: Dorex2007 folded before Flop (didn't bet)
Seat 5: kolyamex mucked [Qc Qh]
Seat 6: Gora858 (button) folded before Flop (didn't bet)
Seat 8: voshod999 (small blind) showed [8c 6c] and won ($0.27) with three of a kind, Eights
Seat 9: keki8787 (big blind) folded on the Turn



PokerStars Hand #228375474223:  Hold'em No Limit ($0.01/$0.02 USD) - 2021/07/17 23:47:03 PT [2021/07/18 2:47:03 ET]
Table 'Philia' 9-max Seat #8 is the button
Seat 1: Skumme ($1.31 in chips) 
Seat 2: sleeper hipi ($6.50 in chips) 
Seat 3: Lord7 Sergio ($2 in chips) 
Seat 4: Dorex2007 ($3.78 in chips) 
Seat 5: kolyamex ($1.40 in chips) 
Seat 6: Gora858 ($4.55 in chips) 
Seat 8: voshod999 ($0.96 in chips) 
Seat 9: keki8787 ($1.47 in chips) 
keki8787: posts small blind $0.01
Skumme: posts big blind $0.02
mimimouse6: sits out 
*** HOLE CARDS ***
Dealt to Dorex2007 [9c Td]
sleeper hipi: folds 
Lord7 Sergio: raises $0.08 to $0.10
Dorex2007: folds 
kolyamex: folds 
Gora858: folds 
voshod999: folds 
keki8787: calls $0.09
Skumme: folds 
*** FLOP *** [4c 9s Kc]
keki8787: checks 
Lord7 Sergio: checks 
*** TURN *** [4c 9s Kc] [Ks]
keki8787: checks 
Lord7 Sergio: checks 
*** RIVER *** [4c 9s Kc Ks] [6d]
keki8787: checks 
Lord7 Sergio: checks 
*** SHOW DOWN ***
keki8787: shows [9d 5d] (two pair, Kings and Nines)
Lord7 Sergio: mucks hand 
keki8787 collected $0.21 from pot
*** SUMMARY ***
Total pot $0.22 | Rake $0.01 
Board [4c 9s Kc Ks 6d]
Seat 1: Skumme (big blind) folded before Flop
Seat 2: sleeper hipi folded before Flop (didn't bet)
Seat 3: Lord7 Sergio mucked [Qs Ad]
Seat 4: Dorex2007 folded before Flop (didn't bet)
Seat 5: kolyamex folded before Flop (didn't bet)
Seat 6: Gora858 folded before Flop (didn't bet)
Seat 8: voshod999 (button) folded before Flop (didn't bet)
Seat 9: keki8787 (small blind) showed [9d 5d] and won ($0.21) with two pair, Kings and Nines



PokerStars Hand #228375480355:  Hold'em No Limit ($0.01/$0.02 USD) - 2021/07/17 23:47:43 PT [2021/07/18 2:47:43 ET]
Table 'Philia' 9-max Seat #9 is the button
Seat 1: Skumme ($1.29 in chips) 
Seat 2: sleeper hipi ($6.50 in chips) 
Seat 3: Lord7 Sergio ($1.90 in chips) 
Seat 4: Dorex2007 ($3.78 in chips) 
Seat 5: kolyamex ($1.40 in chips) 
Seat 6: Gora858 ($4.55 in chips) 
Seat 8: voshod999 ($0.96 in chips) 
Seat 9: keki8787 ($1.58 in chips) 
Skumme: posts small blind $0.01
sleeper hipi: posts big blind $0.02
mimimouse6: sits out 
*** HOLE CARDS ***
Dealt to Dorex2007 [6h Qd]
Lord7 Sergio: folds 
Dorex2007: folds 
kolyamex: folds 
Gora858: folds 
voshod999: folds 
keki8787: calls $0.02
Skumme: calls $0.01
sleeper hipi: checks 
*** FLOP *** [As Ks 8d]
Skumme: checks 
sleeper hipi: checks 
keki8787: checks 
*** TURN *** [As Ks 8d] [Th]
Skumme: checks 
sleeper hipi: checks 
keki8787: checks 
*** RIVER *** [As Ks 8d Th] [4d]
Skumme: bets $0.02
sleeper hipi: folds 
keki8787: raises $0.02 to $0.04
Skumme: calls $0.02
*** SHOW DOWN ***
keki8787: shows [3h Ad] (a pair of Aces)
Skumme: mucks hand 
keki8787 collected $0.14 from pot
*** SUMMARY ***
Total pot $0.14 | Rake $0 
Board [As Ks 8d Th 4d]
Seat 1: Skumme (small blind) mucked [2s 4h]
Seat 2: sleeper hipi (big blind) folded on the River
Seat 3: Lord7 Sergio folded before Flop (didn't bet)
Seat 4: Dorex2007 folded before Flop (didn't bet)
Seat 5: kolyamex folded before Flop (didn't bet)
Seat 6: Gora858 folded before Flop (didn't bet)
Seat 8: voshod999 folded before Flop (didn't bet)
Seat 9: keki8787 (button) showed [3h Ad] and won ($0.14) with a pair of Aces



PokerStars Hand #228375488028:  Hold'em No Limit ($0.01/$0.02 USD) - 2021/07/17 23:48:35 PT [2021/07/18 2:48:35 ET]
Table 'Philia' 9-max Seat #1 is the button
Seat 1: Skumme ($1.23 in chips) 
Seat 2: sleeper hipi ($6.48 in chips) 
Seat 3: Lord7 Sergio ($1.90 in chips) 
Seat 4: Dorex2007 ($3.78 in chips) 
Seat 5: kolyamex ($1.40 in chips) 
Seat 6: Gora858 ($4.55 in chips) 
Seat 8: voshod999 ($0.96 in chips) 
Seat 9: keki8787 ($1.66 in chips) 
sleeper hipi: posts small blind $0.01
Lord7 Sergio: posts big blind $0.02
mimimouse6: sits out 
*** HOLE CARDS ***
Dealt to Dorex2007 [Kh 4s]
Dorex2007: folds 
kolyamex has timed out
kolyamex: folds 
Gora858: folds 
voshod999: folds 
keki8787: folds 
Skumme: folds 
sleeper hipi: calls $0.01
Lord7 Sergio: raises $0.05 to $0.07
sleeper hipi: folds 
Uncalled bet ($0.05) returned to Lord7 Sergio
Lord7 Sergio collected $0.04 from pot
Lord7 Sergio: doesn't show hand 
*** SUMMARY ***
Total pot $0.04 | Rake $0 
Seat 1: Skumme (button) folded before Flop (didn't bet)
Seat 2: sleeper hipi (small blind) folded before Flop
Seat 3: Lord7 Sergio (big blind) collected ($0.04)
Seat 4: Dorex2007 folded before Flop (didn't bet)
Seat 5: kolyamex folded before Flop (didn't bet)
Seat 6: Gora858 folded before Flop (didn't bet)
Seat 8: voshod999 folded before Flop (didn't bet)
Seat 9: keki8787 folded before Flop (didn't bet)



PokerStars Hand #228375493583:  Hold'em No Limit ($0.01/$0.02 USD) - 2021/07/17 23:49:11 PT [2021/07/18 2:49:11 ET]
Table 'Philia' 9-max Seat #2 is the button
Seat 1: Skumme ($1.23 in chips) 
Seat 2: sleeper hipi ($6.46 in chips) 
Seat 3: Lord7 Sergio ($1.92 in chips) 
Seat 4: Dorex2007 ($3.78 in chips) 
Seat 5: kolyamex ($1.40 in chips) 
Seat 6: Gora858 ($4.55 in chips) 
Seat 8: voshod999 ($0.96 in chips) 
Seat 9: keki8787 ($1.66 in chips) 
Lord7 Sergio: posts small blind $0.01
Dorex2007: posts big blind $0.02
mimimouse6: sits out 
*** HOLE CARDS ***
Dealt to Dorex2007 [6d 9h]
kolyamex has timed out
kolyamex: folds 
Gora858: folds 
voshod999: folds 
keki8787: calls $0.02
Skumme: folds 
sleeper hipi: folds 
Lord7 Sergio: folds 
Dorex2007: checks 
*** FLOP *** [2h 9d 3s]
Dorex2007: checks 
keki8787: checks 
*** TURN *** [2h 9d 3s] [8d]
Dorex2007: bets $0.10
keki8787: calls $0.10
*** RIVER *** [2h 9d 3s 8d] [Kc]
Dorex2007: bets $0.12
keki8787: calls $0.12
*** SHOW DOWN ***
Dorex2007: shows [6d 9h] (a pair of Nines)
keki8787: shows [Ks 8c] (two pair, Kings and Eights)
keki8787 collected $0.47 from pot
*** SUMMARY ***
Total pot $0.49 | Rake $0.02 
Board [2h 9d 3s 8d Kc]
Seat 1: Skumme folded before Flop (didn't bet)
Seat 2: sleeper hipi (button) folded before Flop (didn't bet)
Seat 3: Lord7 Sergio (small blind) folded before Flop
Seat 4: Dorex2007 (big blind) showed [6d 9h] and lost with a pair of Nines
Seat 5: kolyamex folded before Flop (didn't bet)
Seat 6: Gora858 folded before Flop (didn't bet)
Seat 8: voshod999 folded before Flop (didn't bet)
Seat 9: keki8787 showed [Ks 8c] and won ($0.47) with two pair, Kings and Eights



PokerStars Hand #228375501148:  Hold'em No Limit ($0.01/$0.02 USD) - 2021/07/17 23:50:02 PT [2021/07/18 2:50:02 ET]
Table 'Philia' 9-max Seat #3 is the button
Seat 1: Skumme ($1.23 in chips) 
Seat 2: sleeper hipi ($6.46 in chips) 
Seat 3: Lord7 Sergio ($1.91 in chips) 
Seat 4: Dorex2007 ($3.54 in chips) 
Seat 5: kolyamex ($1.40 in chips) 
Seat 6: Gora858 ($4.55 in chips) 
Seat 8: voshod999 ($0.96 in chips) 
Seat 9: keki8787 ($1.89 in chips) 
Dorex2007: posts small blind $0.01
kolyamex: posts big blind $0.02
mimimouse6: sits out 
*** HOLE CARDS ***
Dealt to Dorex2007 [9d 8s]
Gora858: folds 
voshod999: folds 
keki8787: raises $0.02 to $0.04
Skumme: folds 
sleeper hipi: folds 
Lord7 Sergio: folds 
Dorex2007: calls $0.03
kolyamex: calls $0.02
*** FLOP *** [6c 2c Kd]
Dorex2007: checks 
kolyamex: checks 
keki8787: checks 
*** TURN *** [6c 2c Kd] [8h]
Dorex2007: bets $0.12
kolyamex: folds 
keki8787: folds 
Uncalled bet ($0.12) returned to Dorex2007
Dorex2007 collected $0.12 from pot
Dorex2007: doesn't show hand 
*** SUMMARY ***
Total pot $0.12 | Rake $0 
Board [6c 2c Kd 8h]
Seat 1: Skumme folded before Flop (didn't bet)
Seat 2: sleeper hipi folded before Flop (didn't bet)
Seat 3: Lord7 Sergio (button) folded before Flop (didn't bet)
Seat 4: Dorex2007 (small blind) collected ($0.12)
Seat 5: kolyamex (big blind) folded on the Turn
Seat 6: Gora858 folded before Flop (didn't bet)
Seat 8: voshod999 folded before Flop (didn't bet)
Seat 9: keki8787 folded on the Turn



PokerStars Hand #228375506068:  Hold'em No Limit ($0.01/$0.02 USD) - 2021/07/17 23:50:34 PT [2021/07/18 2:50:34 ET]
Table 'Philia' 9-max Seat #4 is the button
Seat 1: Skumme ($1.23 in chips) 
Seat 2: sleeper hipi ($6.46 in chips) 
Seat 3: Lord7 Sergio ($1.91 in chips) 
Seat 4: Dorex2007 ($3.62 in chips) 
Seat 5: kolyamex ($1.36 in chips) 
Seat 6: Gora858 ($4.55 in chips) 
Seat 8: voshod999 ($0.96 in chips) 
Seat 9: keki8787 ($1.85 in chips) 
kolyamex: posts small blind $0.01
Gora858: posts big blind $0.02
mimimouse6: sits out 
*** HOLE CARDS ***
Dealt to Dorex2007 [2h Kh]
voshod999: folds 
keki8787: folds 
Skumme: folds 
sleeper hipi: folds 
Lord7 Sergio: raises $0.04 to $0.06
Dorex2007: folds 
kolyamex: calls $0.05
Gora858: folds 
*** FLOP *** [6h 7h Jc]
kolyamex: bets $0.08
Lord7 Sergio: raises $0.08 to $0.16
kolyamex: folds 
Uncalled bet ($0.08) returned to Lord7 Sergio
Lord7 Sergio collected $0.29 from pot
Lord7 Sergio: doesn't show hand 
*** SUMMARY ***
Total pot $0.30 | Rake $0.01 
Board [6h 7h Jc]
Seat 1: Skumme folded before Flop (didn't bet)
Seat 2: sleeper hipi folded before Flop (didn't bet)
Seat 3: Lord7 Sergio collected ($0.29)
Seat 4: Dorex2007 (button) folded before Flop (didn't bet)
Seat 5: kolyamex (small blind) folded on the Flop
Seat 6: Gora858 (big blind) folded before Flop
Seat 8: voshod999 folded before Flop (didn't bet)
Seat 9: keki8787 folded before Flop (didn't bet)



PokerStars Hand #228375515343:  Hold'em No Limit ($0.01/$0.02 USD) - 2021/07/17 23:51:36 PT [2021/07/18 2:51:36 ET]
Table 'Philia' 9-max Seat #5 is the button
Seat 1: Skumme ($1.23 in chips) 
Seat 2: sleeper hipi ($6.46 in chips) 
Seat 3: Lord7 Sergio ($2.06 in chips) 
Seat 4: Dorex2007 ($3.62 in chips) 
Seat 5: kolyamex ($1.22 in chips) 
Seat 6: Gora858 ($4.53 in chips) 
Seat 7: mimimouse6 ($1.92 in chips) 
Seat 8: voshod999 ($0.96 in chips) 
Seat 9: keki8787 ($1.85 in chips) 
Gora858: posts small blind $0.01
mimimouse6: posts big blind $0.02
*** HOLE CARDS ***
Dealt to Dorex2007 [5h Th]
voshod999: folds 
voshod999 leaves the table
keki8787: folds 
Skumme: calls $0.02
sleeper hipi: folds 
Lord7 Sergio: folds 
Dorex2007: folds 
kolyamex: calls $0.02
Gora858: folds 
mimimouse6: raises $0.08 to $0.10
Skumme: calls $0.08
kolyamex: folds 
*** FLOP *** [8h Jc Qh]
mimimouse6: bets $0.11
Skumme: calls $0.11
*** TURN *** [8h Jc Qh] [Ac]
mimimouse6: bets $0.40
Skumme: folds 
Uncalled bet ($0.40) returned to mimimouse6
mimimouse6 collected $0.43 from pot
mimimouse6: doesn't show hand 
*** SUMMARY ***
Total pot $0.45 | Rake $0.02 
Board [8h Jc Qh Ac]
Seat 1: Skumme folded on the Turn
Seat 2: sleeper hipi folded before Flop (didn't bet)
Seat 3: Lord7 Sergio folded before Flop (didn't bet)
Seat 4: Dorex2007 folded before Flop (didn't bet)
Seat 5: kolyamex (button) folded before Flop
Seat 6: Gora858 (small blind) folded before Flop
Seat 7: mimimouse6 (big blind) collected ($0.43)
Seat 8: voshod999 folded before Flop (didn't bet)
Seat 9: keki8787 folded before Flop (didn't bet)



PokerStars Hand #228375524865:  Hold'em No Limit ($0.01/$0.02 USD) - 2021/07/17 23:52:41 PT [2021/07/18 2:52:41 ET]
Table 'Philia' 9-max Seat #6 is the button
Seat 1: Skumme ($1.02 in chips) 
Seat 2: sleeper hipi ($6.46 in chips) 
Seat 3: Lord7 Sergio ($2.06 in chips) 
Seat 4: Dorex2007 ($3.62 in chips) 
Seat 5: kolyamex ($1.20 in chips) 
Seat 6: Gora858 ($4.52 in chips) 
Seat 7: mimimouse6 ($2.14 in chips) 
Seat 9: keki8787 ($1.85 in chips) 
mimimouse6: posts small blind $0.01
keki8787: posts big blind $0.02
*** HOLE CARDS ***
Dealt to Dorex2007 [As 5h]
Skumme: folds 
sleeper hipi: folds 
Lord7 Sergio: folds 
Dorex2007: folds 
kolyamex: folds 
Gora858: raises $0.02 to $0.04
mimimouse6: folds 
keki8787: calls $0.02
*** FLOP *** [6h Ts Qs]
keki8787: checks 
Gora858: bets $0.07
keki8787: calls $0.07
*** TURN *** [6h Ts Qs] [5s]
keki8787: checks 
Gora858: bets $0.06
keki8787: calls $0.06
*** RIVER *** [6h Ts Qs 5s] [9s]
keki8787: checks 
Gora858: checks 
*** SHOW DOWN ***
keki8787: shows [Qd 6s] (a flush, Queen high)
Gora858: mucks hand 
keki8787 collected $0.34 from pot
*** SUMMARY ***
Total pot $0.35 | Rake $0.01 
Board [6h Ts Qs 5s 9s]
Seat 1: Skumme folded before Flop (didn't bet)
Seat 2: sleeper hipi folded before Flop (didn't bet)
Seat 3: Lord7 Sergio folded before Flop (didn't bet)
Seat 4: Dorex2007 folded before Flop (didn't bet)
Seat 5: kolyamex folded before Flop (didn't bet)
Seat 6: Gora858 (button) mucked [6d Td]
Seat 7: mimimouse6 (small blind) folded before Flop
Seat 9: keki8787 (big blind) showed [Qd 6s] and won ($0.34) with a flush, Queen high



PokerStars Hand #228375531241:  Hold'em No Limit ($0.01/$0.02 USD) - 2021/07/17 23:53:24 PT [2021/07/18 2:53:24 ET]
Table 'Philia' 9-max Seat #7 is the button
Seat 1: Skumme ($1.02 in chips) 
Seat 2: sleeper hipi ($6.46 in chips) 
Seat 3: Lord7 Sergio ($2.06 in chips) 
Seat 4: Dorex2007 ($3.62 in chips) 
Seat 5: kolyamex ($1.20 in chips) 
Seat 6: Gora858 ($4.35 in chips) 
Seat 7: mimimouse6 ($2.13 in chips) 
Seat 9: keki8787 ($2.02 in chips) 
keki8787: posts small blind $0.01
Skumme: posts big blind $0.02
*** HOLE CARDS ***
Dealt to Dorex2007 [Kc 4h]
sleeper hipi: folds 
Lord7 Sergio: folds 
Dorex2007: folds 
kolyamex: folds 
Gora858: folds 
mimimouse6: folds 
keki8787: calls $0.01
Skumme: checks 
*** FLOP *** [Ad Kh Ah]
keki8787: checks 
Skumme: bets $0.02
keki8787: folds 
Uncalled bet ($0.02) returned to Skumme
Skumme collected $0.04 from pot
Skumme: doesn't show hand 
*** SUMMARY ***
Total pot $0.04 | Rake $0 
Board [Ad Kh Ah]
Seat 1: Skumme (big blind) collected ($0.04)
Seat 2: sleeper hipi folded before Flop (didn't bet)
Seat 3: Lord7 Sergio folded before Flop (didn't bet)
Seat 4: Dorex2007 folded before Flop (didn't bet)
Seat 5: kolyamex folded before Flop (didn't bet)
Seat 6: Gora858 folded before Flop (didn't bet)
Seat 7: mimimouse6 (button) folded before Flop (didn't bet)
Seat 9: keki8787 (small blind) folded on the Flop



PokerStars Hand #228375536569:  Hold'em No Limit ($0.01/$0.02 USD) - 2021/07/17 23:53:59 PT [2021/07/18 2:53:59 ET]
Table 'Philia' 9-max Seat #9 is the button
Seat 1: Skumme ($1.04 in chips) 
Seat 2: sleeper hipi ($6.46 in chips) 
Seat 3: Lord7 Sergio ($2.06 in chips) 
Seat 4: Dorex2007 ($3.62 in chips) 
Seat 5: kolyamex ($1.20 in chips) 
Seat 6: Gora858 ($4.35 in chips) 
Seat 7: mimimouse6 ($2.13 in chips) 
Seat 9: keki8787 ($2 in chips) 
Skumme: posts small blind $0.01
sleeper hipi: posts big blind $0.02
*** HOLE CARDS ***
Dealt to Dorex2007 [6h Qd]
Lord7 Sergio: folds 
Dorex2007: folds 
Istytech joins the table at seat #8 
kolyamex: folds 
Gora858: folds 
mimimouse6: folds 
keki8787: calls $0.02
Skumme: calls $0.01
sleeper hipi: checks 
*** FLOP *** [8s 5s 6c]
Skumme: bets $0.03
sleeper hipi: folds 
keki8787: calls $0.03
*** TURN *** [8s 5s 6c] [Jh]
Skumme: bets $0.02
keki8787: calls $0.02
*** RIVER *** [8s 5s 6c Jh] [9c]
Skumme: bets $0.15
keki8787: calls $0.15
*** SHOW DOWN ***
Skumme: shows [7h 3s] (a straight, Five to Nine)
keki8787: mucks hand 
Skumme collected $0.44 from pot
*** SUMMARY ***
Total pot $0.46 | Rake $0.02 
Board [8s 5s 6c Jh 9c]
Seat 1: Skumme (small blind) showed [7h 3s] and won ($0.44) with a straight, Five to Nine
Seat 2: sleeper hipi (big blind) folded on the Flop
Seat 3: Lord7 Sergio folded before Flop (didn't bet)
Seat 4: Dorex2007 folded before Flop (didn't bet)
Seat 5: kolyamex folded before Flop (didn't bet)
Seat 6: Gora858 folded before Flop (didn't bet)
Seat 7: mimimouse6 folded before Flop (didn't bet)
Seat 9: keki8787 (button) mucked [8h Kh]



PokerStars Hand #228375544281:  Hold'em No Limit ($0.01/$0.02 USD) - 2021/07/17 23:54:52 PT [2021/07/18 2:54:52 ET]
Table 'Philia' 9-max Seat #1 is the button
Seat 1: Skumme ($1.26 in chips) 
Seat 2: sleeper hipi ($6.44 in chips) 
Seat 3: Lord7 Sergio ($2.06 in chips) 
Seat 4: Dorex2007 ($3.62 in chips) 
Seat 5: kolyamex ($1.20 in chips) 
Seat 6: Gora858 ($4.35 in chips) 
Seat 7: mimimouse6 ($2.13 in chips) 
Seat 9: keki8787 ($1.78 in chips) 
sleeper hipi: posts small blind $0.01
Lord7 Sergio: posts big blind $0.02
Istytech: sits out 
*** HOLE CARDS ***
Dealt to Dorex2007 [6d Qc]
Dorex2007: folds 
kolyamex: folds 
Gora858: folds 
mimimouse6: folds 
keki8787: raises $0.07 to $0.09
Skumme: folds 
sleeper hipi: folds 
Lord7 Sergio: folds 
Uncalled bet ($0.07) returned to keki8787
keki8787 collected $0.05 from pot
keki8787: doesn't show hand 
*** SUMMARY ***
Total pot $0.05 | Rake $0 
Seat 1: Skumme (button) folded before Flop (didn't bet)
Seat 2: sleeper hipi (small blind) folded before Flop
Seat 3: Lord7 Sergio (big blind) folded before Flop
Seat 4: Dorex2007 folded before Flop (didn't bet)
Seat 5: kolyamex folded before Flop (didn't bet)
Seat 6: Gora858 folded before Flop (didn't bet)
Seat 7: mimimouse6 folded before Flop (didn't bet)
Seat 9: keki8787 collected ($0.05)



PokerStars Hand #228375547427:  Hold'em No Limit ($0.01/$0.02 USD) - 2021/07/17 23:55:14 PT [2021/07/18 2:55:14 ET]
Table 'Philia' 9-max Seat #2 is the button
Seat 1: Skumme ($1.26 in chips) 
Seat 2: sleeper hipi ($6.43 in chips) 
Seat 3: Lord7 Sergio ($2.04 in chips) 
Seat 4: Dorex2007 ($3.62 in chips) 
Seat 5: kolyamex ($1.20 in chips) 
Seat 6: Gora858 ($4.35 in chips) 
Seat 7: mimimouse6 ($2.13 in chips) 
Seat 9: keki8787 ($1.81 in chips) 
Lord7 Sergio: posts small blind $0.01
Dorex2007: posts big blind $0.02
Istytech: sits out 
*** HOLE CARDS ***
Dealt to Dorex2007 [4h 2d]
kolyamex: folds 
Gora858: folds 
mimimouse6: raises $0.04 to $0.06
keki8787: calls $0.06
Skumme: folds 
sleeper hipi: folds 
Lord7 Sergio: folds 
Dorex2007: folds 
*** FLOP *** [8h 4s Qd]
mimimouse6: bets $0.07
keki8787: calls $0.07
*** TURN *** [8h 4s Qd] [6c]
mimimouse6: bets $0.12
keki8787: folds 
Uncalled bet ($0.12) returned to mimimouse6
mimimouse6 collected $0.28 from pot
mimimouse6: doesn't show hand 
*** SUMMARY ***
Total pot $0.29 | Rake $0.01 
Board [8h 4s Qd 6c]
Seat 1: Skumme folded before Flop (didn't bet)
Seat 2: sleeper hipi (button) folded before Flop (didn't bet)
Seat 3: Lord7 Sergio (small blind) folded before Flop
Seat 4: Dorex2007 (big blind) folded before Flop
Seat 5: kolyamex folded before Flop (didn't bet)
Seat 6: Gora858 folded before Flop (didn't bet)
Seat 7: mimimouse6 collected ($0.28)
Seat 9: keki8787 folded on the Turn



PokerStars Hand #228375553865:  Hold'em No Limit ($0.01/$0.02 USD) - 2021/07/17 23:56:03 PT [2021/07/18 2:56:03 ET]
Table 'Philia' 9-max Seat #3 is the button
Seat 1: Skumme ($1.26 in chips) 
Seat 2: sleeper hipi ($6.43 in chips) 
Seat 3: Lord7 Sergio ($2.03 in chips) 
Seat 4: Dorex2007 ($3.60 in chips) 
Seat 6: Gora858 ($4.35 in chips) 
Seat 7: mimimouse6 ($2.28 in chips) 
Seat 9: keki8787 ($1.68 in chips) 
Dorex2007: posts small blind $0.01
Gora858: posts big blind $0.02
Istytech: sits out 
*** HOLE CARDS ***
Dealt to Dorex2007 [5d 7c]
mimimouse6: folds 
keki8787: calls $0.02
Skumme: raises $0.02 to $0.04
sleeper hipi: folds 
Lord7 Sergio: folds 
Dorex2007: folds 
Gora858: calls $0.02
keki8787: calls $0.02
*** FLOP *** [Qs 8h 6s]
Gora858: checks 
keki8787: checks 
Skumme: bets $0.04
Gora858: folds 
keki8787: calls $0.04
*** TURN *** [Qs 8h 6s] [4s]
keki8787: checks 
Skumme: bets $0.05
keki8787: calls $0.05
*** RIVER *** [Qs 8h 6s 4s] [Js]
keki8787: checks 
Skumme: checks 
*** SHOW DOWN ***
keki8787: shows [8d 7s] (a flush, Queen high)
Skumme: mucks hand 
keki8787 collected $0.30 from pot
*** SUMMARY ***
Total pot $0.31 | Rake $0.01 
Board [Qs 8h 6s 4s Js]
Seat 1: Skumme mucked [Qc Qd]
Seat 2: sleeper hipi folded before Flop (didn't bet)
Seat 3: Lord7 Sergio (button) folded before Flop (didn't bet)
Seat 4: Dorex2007 (small blind) folded before Flop
Seat 6: Gora858 (big blind) folded on the Flop
Seat 7: mimimouse6 folded before Flop (didn't bet)
Seat 9: keki8787 showed [8d 7s] and won ($0.30) with a flush, Queen high



PokerStars Hand #228375564150:  Hold'em No Limit ($0.01/$0.02 USD) - 2021/07/17 23:57:21 PT [2021/07/18 2:57:21 ET]
Table 'Philia' 9-max Seat #4 is the button
Seat 1: Skumme ($1.13 in chips) 
Seat 2: sleeper hipi ($6.43 in chips) 
Seat 3: Lord7 Sergio ($2.03 in chips) 
Seat 4: Dorex2007 ($3.59 in chips) 
Seat 6: Gora858 ($4.31 in chips) 
Seat 7: mimimouse6 ($2.28 in chips) 
Seat 9: keki8787 ($1.85 in chips) 
Gora858: posts small blind $0.01
mimimouse6: posts big blind $0.02
Istytech: sits out 
*** HOLE CARDS ***
Dealt to Dorex2007 [Jc Td]
keki8787: calls $0.02
Skumme: raises $0.04 to $0.06
sleeper hipi: folds 
Lord7 Sergio: folds 
Dorex2007: folds 
Gora858: folds 
mimimouse6: folds 
keki8787: calls $0.04
*** FLOP *** [Kc 8s 4c]
keki8787: checks 
Skumme: bets $0.04
keki8787: calls $0.04
*** TURN *** [Kc 8s 4c] [2s]
keki8787: checks 
Skumme: bets $0.05
keki8787: folds 
Uncalled bet ($0.05) returned to Skumme
Skumme collected $0.22 from pot
Skumme: doesn't show hand 
*** SUMMARY ***
Total pot $0.23 | Rake $0.01 
Board [Kc 8s 4c 2s]
Seat 1: Skumme collected ($0.22)
Seat 2: sleeper hipi folded before Flop (didn't bet)
Seat 3: Lord7 Sergio folded before Flop (didn't bet)
Seat 4: Dorex2007 (button) folded before Flop (didn't bet)
Seat 6: Gora858 (small blind) folded before Flop
Seat 7: mimimouse6 (big blind) folded before Flop
Seat 9: keki8787 folded on the Turn



PokerStars Hand #228375571753:  Hold'em No Limit ($0.01/$0.02 USD) - 2021/07/17 23:58:19 PT [2021/07/18 2:58:19 ET]
Table 'Philia' 9-max Seat #6 is the button
Seat 1: Skumme ($1.25 in chips) 
Seat 2: sleeper hipi ($6.43 in chips) 
Seat 3: Lord7 Sergio ($2.03 in chips) 
Seat 4: Dorex2007 ($3.59 in chips) 
Seat 6: Gora858 ($4.30 in chips) 
Seat 7: mimimouse6 ($2.26 in chips) 
Seat 8: Istytech ($1.66 in chips) 
Seat 9: keki8787 ($1.75 in chips) 
mimimouse6: posts small blind $0.01
Istytech: posts big blind $0.02
*** HOLE CARDS ***
Dealt to Dorex2007 [6h Qh]
keki8787: raises $0.02 to $0.04
Skumme: folds 
sleeper hipi: calls $0.04
Lord7 Sergio: folds 
Dorex2007: folds 
Gora858: folds 
mimimouse6: folds 
Istytech: calls $0.02
*** FLOP *** [3s 5c 7s]
Istytech: bets $0.07
keki8787: folds 
sleeper hipi: calls $0.07
*** TURN *** [3s 5c 7s] [Kc]
Istytech: bets $0.15
sleeper hipi: raises $0.23 to $0.38
Istytech: calls $0.23
*** RIVER *** [3s 5c 7s Kc] [9d]
Istytech: bets $0.38
sleeper hipi: raises $5.56 to $5.94 and is all-in
Istytech: folds 
Uncalled bet ($5.56) returned to sleeper hipi
sleeper hipi collected $1.73 from pot
sleeper hipi: doesn't show hand 
*** SUMMARY ***
Total pot $1.79 | Rake $0.06 
Board [3s 5c 7s Kc 9d]
Seat 1: Skumme folded before Flop (didn't bet)
Seat 2: sleeper hipi collected ($1.73)
Seat 3: Lord7 Sergio folded before Flop (didn't bet)
Seat 4: Dorex2007 folded before Flop (didn't bet)
Seat 6: Gora858 (button) folded before Flop (didn't bet)
Seat 7: mimimouse6 (small blind) folded before Flop
Seat 8: Istytech (big blind) folded on the River
Seat 9: keki8787 folded on the Flop



PokerStars Hand #228375594587:  Hold'em No Limit ($0.01/$0.02 USD) - 2021/07/18 0:00:02 PT [2021/07/18 3:00:02 ET]
Table 'Philia' 9-max Seat #7 is the button
Seat 1: Skumme ($1.25 in chips) 
Seat 2: sleeper hipi ($7.29 in chips) 
Seat 3: Lord7 Sergio ($2.03 in chips) 
Seat 4: Dorex2007 ($3.59 in chips) 
Seat 5: kolyamex ($1.20 in chips) 
Seat 6: Gora858 ($4.30 in chips) 
Seat 7: mimimouse6 ($2.25 in chips) 
Seat 8: Istytech ($0.79 in chips) 
Seat 9: keki8787 ($1.71 in chips) 
Istytech: posts small blind $0.01
keki8787: posts big blind $0.02
kolyamex: posts small & big blinds $0.03
*** HOLE CARDS ***
Dealt to Dorex2007 [6d 6s]
Skumme: calls $0.02
sleeper hipi: folds 
Lord7 Sergio: folds 
Dorex2007: calls $0.02
kolyamex: checks 
Gora858: folds 
mimimouse6: folds 
Istytech: folds 
keki8787: checks 
*** FLOP *** [3h Qs 4h]
Istytech leaves the table
keki8787: bets $0.06
Skumme: calls $0.06
Dorex2007: folds 
kolyamex: folds 
*** TURN *** [3h Qs 4h] [2s]
keki8787: bets $0.06
VIST0988 joins the table at seat #8 
Skumme: raises $0.06 to $0.12
keki8787: calls $0.06
*** RIVER *** [3h Qs 4h 2s] [6c]
keki8787: checks 
Skumme: bets $0.44
keki8787: folds 
Uncalled bet ($0.44) returned to Skumme
Skumme collected $0.44 from pot
Skumme: doesn't show hand 
*** SUMMARY ***
Total pot $0.46 | Rake $0.02 
Board [3h Qs 4h 2s 6c]
Seat 1: Skumme collected ($0.44)
Seat 2: sleeper hipi folded before Flop (didn't bet)
Seat 3: Lord7 Sergio folded before Flop (didn't bet)
Seat 4: Dorex2007 folded on the Flop
Seat 5: kolyamex folded on the Flop (didn't bet)
Seat 6: Gora858 folded before Flop (didn't bet)
Seat 7: mimimouse6 (button) folded before Flop (didn't bet)
Seat 8: Istytech (small blind) folded before Flop
Seat 9: keki8787 (big blind) folded on the River



PokerStars Hand #228375602619:  Hold'em No Limit ($0.01/$0.02 USD) - 2021/07/18 0:01:00 PT [2021/07/18 3:01:00 ET]
Table 'Philia' 9-max Seat #9 is the button
Seat 1: Skumme ($1.49 in chips) 
Seat 2: sleeper hipi ($7.29 in chips) 
Seat 3: Lord7 Sergio ($2.03 in chips) 
Seat 4: Dorex2007 ($3.57 in chips) 
Seat 6: Gora858 ($4.30 in chips) 
Seat 7: mimimouse6 ($2.25 in chips) 
Seat 9: keki8787 ($1.51 in chips) 
Skumme: posts small blind $0.01
sleeper hipi: posts big blind $0.02
VIST0988: sits out 
*** HOLE CARDS ***
Dealt to Dorex2007 [Kc 5c]
Lord7 Sergio: folds 
Lord7 Sergio leaves the table
Dorex2007: folds 
Gora858: raises $0.02 to $0.04
elojometalik joins the table at seat #3 
mimimouse6: calls $0.04
keki8787: calls $0.04
Skumme: calls $0.03
sleeper hipi: calls $0.02
*** FLOP *** [7h 5s Ah]
Skumme: checks 
sleeper hipi: checks 
Gora858: checks 
mimimouse6: checks 
keki8787: bets $0.05
Skumme: calls $0.05
sleeper hipi: calls $0.05
Gora858: folds 
mimimouse6: folds 
*** TURN *** [7h 5s Ah] [Jc]
Skumme: checks 
sleeper hipi: checks 
keki8787: bets $0.07
Skumme: calls $0.07
sleeper hipi: calls $0.07
*** RIVER *** [7h 5s Ah Jc] [6h]
Skumme: bets $0.54
sleeper hipi: calls $0.54
keki8787: calls $0.54
*** SHOW DOWN ***
Skumme: shows [4s 3c] (a straight, Three to Seven)
sleeper hipi: shows [2h 8h] (a flush, Ace high)
keki8787: mucks hand 
sleeper hipi collected $2.10 from pot
*** SUMMARY ***
Total pot $2.18 | Rake $0.08 
Board [7h 5s Ah Jc 6h]
Seat 1: Skumme (small blind) showed [4s 3c] and lost with a straight, Three to Seven
Seat 2: sleeper hipi (big blind) showed [2h 8h] and won ($2.10) with a flush, Ace high
Seat 3: Lord7 Sergio folded before Flop (didn't bet)
Seat 4: Dorex2007 folded before Flop (didn't bet)
Seat 6: Gora858 folded on the Flop
Seat 7: mimimouse6 folded on the Flop
Seat 9: keki8787 (button) mucked [Ad 7s]



PokerStars Hand #228375620203:  Hold'em No Limit ($0.01/$0.02 USD) - 2021/07/18 0:02:56 PT [2021/07/18 3:02:56 ET]
Table 'Philia' 9-max Seat #1 is the button
Seat 1: Skumme ($0.79 in chips) 
Seat 2: sleeper hipi ($8.69 in chips) 
Seat 3: elojometalik ($0.80 in chips) 
Seat 4: Dorex2007 ($3.57 in chips) 
Seat 6: Gora858 ($4.26 in chips) 
Seat 7: mimimouse6 ($2.21 in chips) 
Seat 9: keki8787 ($0.81 in chips) 
sleeper hipi: posts small blind $0.01
elojometalik: posts big blind $0.02
VIST0988: sits out 
*** HOLE CARDS ***
Dealt to Dorex2007 [3d 8c]
Dorex2007: folds 
Gora858: folds 
mimimouse6: folds 
keki8787: calls $0.02
Skumme: raises $0.02 to $0.04
sleeper hipi: folds 
elojometalik: calls $0.02
keki8787: calls $0.02
*** FLOP *** [5c 9s Th]
elojometalik: checks 
keki8787: checks 
Skumme: checks 
*** TURN *** [5c 9s Th] [4d]
elojometalik: checks 
keki8787: checks 
Skumme: checks 
*** RIVER *** [5c 9s Th 4d] [7h]
elojometalik: checks 
keki8787: checks 
Skumme: checks 
*** SHOW DOWN ***
elojometalik: shows [Qd 6d] (high card Queen)
keki8787: shows [8s 5h] (a pair of Fives)
Skumme: mucks hand 
keki8787 collected $0.13 from pot
*** SUMMARY ***
Total pot $0.13 | Rake $0 
Board [5c 9s Th 4d 7h]
Seat 1: Skumme (button) mucked [Qc Kc]
Seat 2: sleeper hipi (small blind) folded before Flop
Seat 3: elojometalik (big blind) showed [Qd 6d] and lost with high card Queen
Seat 4: Dorex2007 folded before Flop (didn't bet)
Seat 6: Gora858 folded before Flop (didn't bet)
Seat 7: mimimouse6 folded before Flop (didn't bet)
Seat 9: keki8787 showed [8s 5h] and won ($0.13) with a pair of Fives



PokerStars Hand #228375627762:  Hold'em No Limit ($0.01/$0.02 USD) - 2021/07/18 0:03:46 PT [2021/07/18 3:03:46 ET]
Table 'Philia' 9-max Seat #2 is the button
Seat 1: Skumme ($0.75 in chips) 
Seat 2: sleeper hipi ($8.68 in chips) 
Seat 3: elojometalik ($0.76 in chips) 
Seat 4: Dorex2007 ($3.57 in chips) 
Seat 5: kolyamex ($1.17 in chips) 
Seat 6: Gora858 ($4.26 in chips) 
Seat 7: mimimouse6 ($2.21 in chips) 
Seat 9: keki8787 ($0.90 in chips) 
elojometalik: posts small blind $0.01
Dorex2007: posts big blind $0.02
VIST0988: sits out 
*** HOLE CARDS ***
Dealt to Dorex2007 [5c Tc]
kolyamex has timed out
kolyamex: folds 
Gora858: folds 
mimimouse6: folds 
keki8787: calls $0.02
Skumme: folds 
sleeper hipi: folds 
elojometalik: calls $0.01
Dorex2007: checks 
*** FLOP *** [9s Qc Ac]
elojometalik: bets $0.02
Dorex2007: calls $0.02
keki8787: calls $0.02
*** TURN *** [9s Qc Ac] [Jc]
elojometalik: bets $0.02
Dorex2007: calls $0.02
keki8787: calls $0.02
*** RIVER *** [9s Qc Ac Jc] [Kc]
elojometalik: bets $0.04
Dorex2007: raises $0.08 to $0.12
keki8787: calls $0.12
elojometalik: folds 
*** SHOW DOWN ***
Dorex2007: shows [5c Tc] (a Royal Flush)
keki8787: mucks hand 
Dorex2007 collected $0.44 from pot
*** SUMMARY ***
Total pot $0.46 | Rake $0.02 
Board [9s Qc Ac Jc Kc]
Seat 1: Skumme folded before Flop (didn't bet)
Seat 2: sleeper hipi (button) folded before Flop (didn't bet)
Seat 3: elojometalik (small blind) folded on the River
Seat 4: Dorex2007 (big blind) showed [5c Tc] and won ($0.44) with a Royal Flush
Seat 5: kolyamex folded before Flop (didn't bet)
Seat 6: Gora858 folded before Flop (didn't bet)
Seat 7: mimimouse6 folded before Flop (didn't bet)
Seat 9: keki8787 mucked [7d 9c]



PokerStars Hand #228375642006:  Hold'em No Limit ($0.01/$0.02 USD) - 2021/07/18 0:05:18 PT [2021/07/18 3:05:18 ET]
Table 'Philia' 9-max Seat #3 is the button
Seat 1: Skumme ($0.75 in chips) 
Seat 2: sleeper hipi ($8.68 in chips) 
Seat 3: elojometalik ($0.66 in chips) 
Seat 4: Dorex2007 ($3.83 in chips) 
Seat 5: kolyamex ($1.17 in chips) 
Seat 6: Gora858 ($4.26 in chips) 
Seat 7: mimimouse6 ($2.21 in chips) 
Seat 9: keki8787 ($0.72 in chips) 
Dorex2007: posts small blind $0.01
kolyamex: posts big blind $0.02
VIST0988: sits out 
*** HOLE CARDS ***
Dealt to Dorex2007 [3d Tc]
Gora858: folds 
mimimouse6: folds 
keki8787: calls $0.02
Skumme: calls $0.02
sleeper hipi: folds 
elojometalik: calls $0.02
Dorex2007: folds 
kolyamex: raises $0.02 to $0.04
keki8787: calls $0.02
Skumme: calls $0.02
elojometalik: calls $0.02
*** FLOP *** [2d Js 5h]
kolyamex: checks 
keki8787: checks 
Skumme: checks 
elojometalik: checks 
*** TURN *** [2d Js 5h] [Kd]
kolyamex: checks 
keki8787: checks 
Skumme: bets $0.02
elojometalik: folds 
kolyamex: folds 
keki8787: folds 
Uncalled bet ($0.02) returned to Skumme
Skumme collected $0.16 from pot
Skumme: doesn't show hand 
*** SUMMARY ***
Total pot $0.17 | Rake $0.01 
Board [2d Js 5h Kd]
Seat 1: Skumme collected ($0.16)
Seat 2: sleeper hipi folded before Flop (didn't bet)
Seat 3: elojometalik (button) folded on the Turn
Seat 4: Dorex2007 (small blind) folded before Flop
Seat 5: kolyamex (big blind) folded on the Turn
Seat 6: Gora858 folded before Flop (didn't bet)
Seat 7: mimimouse6 folded before Flop (didn't bet)
Seat 9: keki8787 folded on the Turn



PokerStars Hand #228375653684:  Hold'em No Limit ($0.01/$0.02 USD) - 2021/07/18 0:06:34 PT [2021/07/18 3:06:34 ET]
Table 'Philia' 9-max Seat #4 is the button
Seat 1: Skumme ($0.87 in chips) 
Seat 2: sleeper hipi ($8.68 in chips) 
Seat 3: elojometalik ($0.62 in chips) 
Seat 4: Dorex2007 ($3.82 in chips) 
Seat 5: kolyamex ($1.13 in chips) 
Seat 6: Gora858 ($4.26 in chips) 
Seat 7: mimimouse6 ($2.21 in chips) 
Seat 9: keki8787 ($0.68 in chips) 
kolyamex: posts small blind $0.01
Gora858: posts big blind $0.02
VIST0988: sits out 
*** HOLE CARDS ***
Dealt to Dorex2007 [9h 7h]
mimimouse6: raises $0.04 to $0.06
keki8787: calls $0.06
Skumme: folds 
sleeper hipi: calls $0.06
elojometalik: folds 
Dorex2007: folds 
kolyamex: folds 
Gora858: folds 
*** FLOP *** [8d 5s 7d]
mimimouse6: bets $0.20
keki8787: calls $0.20
sleeper hipi: folds 
*** TURN *** [8d 5s 7d] [Kc]
mimimouse6: bets $0.59
keki8787: calls $0.42 and is all-in
Uncalled bet ($0.17) returned to mimimouse6
*** RIVER *** [8d 5s 7d Kc] [3c]
*** SHOW DOWN ***
mimimouse6: shows [Ad Ah] (a pair of Aces)
keki8787: shows [8s Ts] (a pair of Eights)
mimimouse6 collected $1.40 from pot
keki8787 cashed out the hand for $0.15
*** SUMMARY ***
Total pot $1.45 | Rake $0.05 
Board [8d 5s 7d Kc 3c]
Seat 1: Skumme folded before Flop (didn't bet)
Seat 2: sleeper hipi folded on the Flop
Seat 3: elojometalik folded before Flop (didn't bet)
Seat 4: Dorex2007 (button) folded before Flop (didn't bet)
Seat 5: kolyamex (small blind) folded before Flop
Seat 6: Gora858 (big blind) folded before Flop
Seat 7: mimimouse6 showed [Ad Ah] and won ($1.40) with a pair of Aces
Seat 9: keki8787 showed [8s Ts] and lost with a pair of Eights (cashed out).



PokerStars Hand #228375661241:  Hold'em No Limit ($0.01/$0.02 USD) - 2021/07/18 0:07:22 PT [2021/07/18 3:07:22 ET]
Table 'Philia' 9-max Seat #5 is the button
Seat 1: Skumme ($0.87 in chips) 
Seat 2: sleeper hipi ($8.62 in chips) 
Seat 3: elojometalik ($0.62 in chips) 
Seat 4: Dorex2007 ($3.82 in chips) 
Seat 5: kolyamex ($1.12 in chips) 
Seat 6: Gora858 ($4.24 in chips) 
Seat 7: mimimouse6 ($2.93 in chips) 
Seat 9: keki8787 ($0.15 in chips) 
Gora858: posts small blind $0.01
mimimouse6: posts big blind $0.02
VIST0988: sits out 
*** HOLE CARDS ***
Dealt to Dorex2007 [5c 7c]
keki8787: calls $0.02
Skumme: folds 
sleeper hipi: calls $0.02
elojometalik: calls $0.02
Dorex2007: folds 
kolyamex: calls $0.02
Gora858: folds 
mimimouse6: checks 
*** FLOP *** [8c Td 7s]
mimimouse6: checks 
keki8787: bets $0.13 and is all-in
sleeper hipi: folds 
elojometalik: folds 
kolyamex: folds 
mimimouse6: folds 
Uncalled bet ($0.13) returned to keki8787
keki8787 collected $0.11 from pot
keki8787: doesn't show hand 
*** SUMMARY ***
Total pot $0.11 | Rake $0 
Board [8c Td 7s]
Seat 1: Skumme folded before Flop (didn't bet)
Seat 2: sleeper hipi folded on the Flop
Seat 3: elojometalik folded on the Flop
Seat 4: Dorex2007 folded before Flop (didn't bet)
Seat 5: kolyamex (button) folded on the Flop
Seat 6: Gora858 (small blind) folded before Flop
Seat 7: mimimouse6 (big blind) folded on the Flop
Seat 9: keki8787 collected ($0.11)



PokerStars Hand #228375670664:  Hold'em No Limit ($0.01/$0.02 USD) - 2021/07/18 0:08:24 PT [2021/07/18 3:08:24 ET]
Table 'Philia' 9-max Seat #6 is the button
Seat 1: Skumme ($0.87 in chips) 
Seat 2: sleeper hipi ($8.60 in chips) 
Seat 3: elojometalik ($0.60 in chips) 
Seat 4: Dorex2007 ($3.82 in chips) 
Seat 6: Gora858 ($4.23 in chips) 
Seat 7: mimimouse6 ($2.91 in chips) 
Seat 8: VIST0988 ($0.80 in chips) 
Seat 9: keki8787 ($0.24 in chips) 
mimimouse6: posts small blind $0.01
VIST0988: posts big blind $0.02
*** HOLE CARDS ***
Dealt to Dorex2007 [3s 4d]
keki8787: calls $0.02
Skumme: folds 
sleeper hipi: folds 
elojometalik: folds 
Dorex2007: folds 
Gora858: folds 
mimimouse6: calls $0.01
VIST0988: checks 
*** FLOP *** [8h 4h 4s]
mimimouse6: bets $0.06
VIST0988: folds 
keki8787: calls $0.06
*** TURN *** [8h 4h 4s] [Jh]
mimimouse6: checks 
keki8787: checks 
*** RIVER *** [8h 4h 4s Jh] [5h]
mimimouse6: checks 
keki8787: checks 
*** SHOW DOWN ***
mimimouse6: shows [8c 7c] (two pair, Eights and Fours)
keki8787: mucks hand 
mimimouse6 collected $0.17 from pot
*** SUMMARY ***
Total pot $0.18 | Rake $0.01 
Board [8h 4h 4s Jh 5h]
Seat 1: Skumme folded before Flop (didn't bet)
Seat 2: sleeper hipi folded before Flop (didn't bet)
Seat 3: elojometalik folded before Flop (didn't bet)
Seat 4: Dorex2007 folded before Flop (didn't bet)
Seat 6: Gora858 (button) folded before Flop (didn't bet)
Seat 7: mimimouse6 (small blind) showed [8c 7c] and won ($0.17) with two pair, Eights and Fours
Seat 8: VIST0988 (big blind) folded on the Flop
Seat 9: keki8787 mucked [Qc 9c]



PokerStars Hand #228375680552:  Hold'em No Limit ($0.01/$0.02 USD) - 2021/07/18 0:09:29 PT [2021/07/18 3:09:29 ET]
Table 'Philia' 9-max Seat #7 is the button
Seat 1: Skumme ($0.87 in chips) 
Seat 2: sleeper hipi ($8.60 in chips) 
Seat 3: elojometalik ($0.60 in chips) 
Seat 4: Dorex2007 ($3.82 in chips) 
Seat 5: kolyamex ($1.10 in chips) 
Seat 6: Gora858 ($4.23 in chips) 
Seat 7: mimimouse6 ($3 in chips) 
Seat 8: VIST0988 ($0.78 in chips) 
Seat 9: keki8787 ($0.16 in chips) 
VIST0988: posts small blind $0.01
keki8787: posts big blind $0.02
*** HOLE CARDS ***
Dealt to Dorex2007 [Qd Td]
Skumme: folds 
sleeper hipi: folds 
elojometalik: folds 
Dorex2007: folds 
kolyamex has timed out
kolyamex: folds 
Gora858: folds 
mimimouse6: raises $0.04 to $0.06
VIST0988: folds 
keki8787: folds 
Uncalled bet ($0.04) returned to mimimouse6
mimimouse6 collected $0.05 from pot
mimimouse6: doesn't show hand 
*** SUMMARY ***
Total pot $0.05 | Rake $0 
Seat 1: Skumme folded before Flop (didn't bet)
Seat 2: sleeper hipi folded before Flop (didn't bet)
Seat 3: elojometalik folded before Flop (didn't bet)
Seat 4: Dorex2007 folded before Flop (didn't bet)
Seat 5: kolyamex folded before Flop (didn't bet)
Seat 6: Gora858 folded before Flop (didn't bet)
Seat 7: mimimouse6 (button) collected ($0.05)
Seat 8: VIST0988 (small blind) folded before Flop
Seat 9: keki8787 (big blind) folded before Flop



PokerStars Hand #228375687036:  Hold'em No Limit ($0.01/$0.02 USD) - 2021/07/18 0:10:11 PT [2021/07/18 3:10:11 ET]
Table 'Philia' 9-max Seat #8 is the button
Seat 1: Skumme ($0.87 in chips) 
Seat 2: sleeper hipi ($8.60 in chips) 
Seat 3: elojometalik ($0.60 in chips) 
Seat 4: Dorex2007 ($3.82 in chips) 
Seat 6: Gora858 ($4.23 in chips) 
Seat 7: mimimouse6 ($3.03 in chips) 
Seat 8: VIST0988 ($0.77 in chips) 
Seat 9: keki8787 ($0.14 in chips) 
keki8787: posts small blind $0.01
Skumme: posts big blind $0.02
*** HOLE CARDS ***
Dealt to Dorex2007 [Kh Kd]
sleeper hipi: folds 
elojometalik: folds 
Dorex2007: raises $0.04 to $0.06
Gora858: folds 
mimimouse6: folds 
VIST0988: folds 
keki8787: calls $0.05
Skumme: calls $0.04
*** FLOP *** [Qh 4c 9s]
keki8787: checks 
Skumme: bets $0.08
Dorex2007: raises $0.12 to $0.20
keki8787: folds 
Skumme: folds 
Uncalled bet ($0.12) returned to Dorex2007
Dorex2007 collected $0.33 from pot
Dorex2007: doesn't show hand 
*** SUMMARY ***
Total pot $0.34 | Rake $0.01 
Board [Qh 4c 9s]
Seat 1: Skumme (big blind) folded on the Flop
Seat 2: sleeper hipi folded before Flop (didn't bet)
Seat 3: elojometalik folded before Flop (didn't bet)
Seat 4: Dorex2007 collected ($0.33)
Seat 6: Gora858 folded before Flop (didn't bet)
Seat 7: mimimouse6 folded before Flop (didn't bet)
Seat 8: VIST0988 (button) folded before Flop (didn't bet)
Seat 9: keki8787 (small blind) folded on the Flop



PokerStars Hand #228375694883:  Hold'em No Limit ($0.01/$0.02 USD) - 2021/07/18 0:11:02 PT [2021/07/18 3:11:02 ET]
Table 'Philia' 9-max Seat #9 is the button
Seat 1: Skumme ($0.73 in chips) 
Seat 2: sleeper hipi ($8.60 in chips) 
Seat 3: elojometalik ($0.60 in chips) 
Seat 4: Dorex2007 ($4.01 in chips) 
Seat 5: kolyamex ($1.10 in chips) 
Seat 6: Gora858 ($4.23 in chips) 
Seat 7: mimimouse6 ($3.03 in chips) 
Seat 8: VIST0988 ($0.77 in chips) 
Seat 9: keki8787 ($0.08 in chips) 
Skumme: posts small blind $0.01
sleeper hipi: posts big blind $0.02
*** HOLE CARDS ***
Dealt to Dorex2007 [5s 2h]
elojometalik: calls $0.02
Dorex2007: folds 
kolyamex: raises $0.02 to $0.04
Gora858: folds 
mimimouse6: folds 
VIST0988: folds 
keki8787: folds 
Skumme: calls $0.03
sleeper hipi: calls $0.02
elojometalik: calls $0.02
*** FLOP *** [4d 7s 4c]
Skumme: bets $0.15
sleeper hipi: folds 
elojometalik: folds 
kolyamex: folds 
Uncalled bet ($0.15) returned to Skumme
Skumme collected $0.15 from pot
Skumme: doesn't show hand 
*** SUMMARY ***
Total pot $0.16 | Rake $0.01 
Board [4d 7s 4c]
Seat 1: Skumme (small blind) collected ($0.15)
Seat 2: sleeper hipi (big blind) folded on the Flop
Seat 3: elojometalik folded on the Flop
Seat 4: Dorex2007 folded before Flop (didn't bet)
Seat 5: kolyamex folded on the Flop
Seat 6: Gora858 folded before Flop (didn't bet)
Seat 7: mimimouse6 folded before Flop (didn't bet)
Seat 8: VIST0988 folded before Flop (didn't bet)
Seat 9: keki8787 (button) folded before Flop (didn't bet)



PokerStars Hand #228375702293:  Hold'em No Limit ($0.01/$0.02 USD) - 2021/07/18 0:11:51 PT [2021/07/18 3:11:51 ET]
Table 'Philia' 9-max Seat #1 is the button
Seat 1: Skumme ($0.84 in chips) 
Seat 2: sleeper hipi ($8.56 in chips) 
Seat 3: elojometalik ($0.56 in chips) 
Seat 4: Dorex2007 ($4.01 in chips) 
Seat 5: kolyamex ($1.06 in chips) 
Seat 6: Gora858 ($4.23 in chips) 
Seat 7: mimimouse6 ($3.03 in chips) 
Seat 8: VIST0988 ($0.77 in chips) 
Seat 9: keki8787 ($0.08 in chips) 
sleeper hipi: posts small blind $0.01
elojometalik: posts big blind $0.02
*** HOLE CARDS ***
Dealt to Dorex2007 [Ah 4h]
Dorex2007: folds 
kolyamex: folds 
Gora858: folds 
mimimouse6: raises $0.04 to $0.06
VIST0988: folds 
keki8787: folds 
Skumme: calls $0.06
sleeper hipi: folds 
elojometalik: calls $0.04
*** FLOP *** [6s As 3d]
elojometalik: checks 
mimimouse6: bets $0.09
Skumme: raises $0.09 to $0.18
elojometalik: folds 
mimimouse6: calls $0.09
*** TURN *** [6s As 3d] [Kh]
mimimouse6: checks 
Skumme: bets $0.26
mimimouse6: folds 
Uncalled bet ($0.26) returned to Skumme
Skumme collected $0.53 from pot
Skumme: doesn't show hand 
*** SUMMARY ***
Total pot $0.55 | Rake $0.02 
Board [6s As 3d Kh]
Seat 1: Skumme (button) collected ($0.53)
Seat 2: sleeper hipi (small blind) folded before Flop
Seat 3: elojometalik (big blind) folded on the Flop
Seat 4: Dorex2007 folded before Flop (didn't bet)
Seat 5: kolyamex folded before Flop (didn't bet)
Seat 6: Gora858 folded before Flop (didn't bet)
Seat 7: mimimouse6 folded on the Turn
Seat 8: VIST0988 folded before Flop (didn't bet)
Seat 9: keki8787 folded before Flop (didn't bet)



PokerStars Hand #228375712594:  Hold'em No Limit ($0.01/$0.02 USD) - 2021/07/18 0:12:58 PT [2021/07/18 3:12:58 ET]
Table 'Philia' 9-max Seat #2 is the button
Seat 1: Skumme ($1.13 in chips) 
Seat 2: sleeper hipi ($8.55 in chips) 
Seat 3: elojometalik ($0.50 in chips) 
Seat 4: Dorex2007 ($4.01 in chips) 
Seat 5: kolyamex ($1.06 in chips) 
Seat 6: Gora858 ($4.23 in chips) 
Seat 7: mimimouse6 ($2.79 in chips) 
Seat 8: VIST0988 ($0.77 in chips) 
Seat 9: keki8787 ($0.08 in chips) 
elojometalik: posts small blind $0.01
Dorex2007: posts big blind $0.02
*** HOLE CARDS ***
Dealt to Dorex2007 [8s Qd]
kolyamex has timed out
kolyamex: folds 
Gora858: folds 
mimimouse6: folds 
VIST0988: calls $0.02
keki8787: folds 
Skumme: folds 
sleeper hipi: raises $0.08 to $0.10
elojometalik: folds 
Dorex2007: folds 
VIST0988: folds 
Uncalled bet ($0.08) returned to sleeper hipi
sleeper hipi collected $0.07 from pot
sleeper hipi: doesn't show hand 
*** SUMMARY ***
Total pot $0.07 | Rake $0 
Seat 1: Skumme folded before Flop (didn't bet)
Seat 2: sleeper hipi (button) collected ($0.07)
Seat 3: elojometalik (small blind) folded before Flop
Seat 4: Dorex2007 (big blind) folded before Flop
Seat 5: kolyamex folded before Flop (didn't bet)
Seat 6: Gora858 folded before Flop (didn't bet)
Seat 7: mimimouse6 folded before Flop (didn't bet)
Seat 8: VIST0988 folded before Flop
Seat 9: keki8787 folded before Flop (didn't bet)



PokerStars Hand #228375718232:  Hold'em No Limit ($0.01/$0.02 USD) - 2021/07/18 0:13:35 PT [2021/07/18 3:13:35 ET]
Table 'Philia' 9-max Seat #3 is the button
Seat 1: Skumme ($1.13 in chips) 
Seat 2: sleeper hipi ($8.60 in chips) 
Seat 3: elojometalik ($0.49 in chips) 
Seat 4: Dorex2007 ($3.99 in chips) 
Seat 5: kolyamex ($1.06 in chips) 
Seat 6: Gora858 ($4.23 in chips) 
Seat 7: mimimouse6 ($2.79 in chips) 
Seat 8: VIST0988 ($0.75 in chips) 
Seat 9: keki8787 ($0.08 in chips) 
Dorex2007: posts small blind $0.01
kolyamex: posts big blind $0.02
*** HOLE CARDS ***
Dealt to Dorex2007 [5d 2d]
Gora858: folds 
mimimouse6: folds 
VIST0988: folds 
keki8787: calls $0.02
Skumme: calls $0.02
sleeper hipi: folds 
elojometalik: calls $0.02
Dorex2007: folds 
kolyamex: checks 
*** FLOP *** [7c Js Ts]
kolyamex: bets $0.02
keki8787: raises $0.04 to $0.06 and is all-in
Skumme: calls $0.06
elojometalik: folds 
kolyamex: calls $0.04
*** TURN *** [7c Js Ts] [Jc]
kolyamex: checks 
Skumme: checks 
*** RIVER *** [7c Js Ts Jc] [4s]
kolyamex: checks 
Skumme: checks 
*** SHOW DOWN ***
kolyamex: shows [Qh 8s] (a pair of Jacks)
keki8787: shows [Ad 5s] (a pair of Jacks - Ace kicker)
Skumme: mucks hand 
keki8787 collected $0.26 from pot
*** SUMMARY ***
Total pot $0.27 | Rake $0.01 
Board [7c Js Ts Jc 4s]
Seat 1: Skumme mucked [8h 6h]
Seat 2: sleeper hipi folded before Flop (didn't bet)
Seat 3: elojometalik (button) folded on the Flop
Seat 4: Dorex2007 (small blind) folded before Flop
Seat 5: kolyamex (big blind) showed [Qh 8s] and lost with a pair of Jacks
Seat 6: Gora858 folded before Flop (didn't bet)
Seat 7: mimimouse6 folded before Flop (didn't bet)
Seat 8: VIST0988 folded before Flop (didn't bet)
Seat 9: keki8787 showed [Ad 5s] and won ($0.26) with a pair of Jacks



PokerStars Hand #228375729408:  Hold'em No Limit ($0.01/$0.02 USD) - 2021/07/18 0:14:47 PT [2021/07/18 3:14:47 ET]
Table 'Philia' 9-max Seat #4 is the button
Seat 1: Skumme ($1.05 in chips) 
Seat 2: sleeper hipi ($8.60 in chips) 
Seat 3: elojometalik ($0.47 in chips) 
Seat 4: Dorex2007 ($3.98 in chips) 
Seat 5: kolyamex ($0.98 in chips) 
Seat 6: Gora858 ($4.23 in chips) 
Seat 7: mimimouse6 ($2.79 in chips) 
Seat 8: VIST0988 ($0.75 in chips) 
Seat 9: keki8787 ($0.26 in chips) 
kolyamex: posts small blind $0.01
Gora858: posts big blind $0.02
*** HOLE CARDS ***
Dealt to Dorex2007 [7s 5c]
mimimouse6: folds 
VIST0988: calls $0.02
keki8787: folds 
Skumme: folds 
sleeper hipi: calls $0.02
elojometalik: folds 
Dorex2007: folds 
kolyamex: folds 
Gora858: checks 
*** FLOP *** [Ac 8h 3s]
Gora858: checks 
VIST0988: checks 
sleeper hipi: checks 
*** TURN *** [Ac 8h 3s] [Qd]
Gora858: checks 
VIST0988: checks 
sleeper hipi: checks 
*** RIVER *** [Ac 8h 3s Qd] [9d]
Gora858: checks 
VIST0988: checks 
sleeper hipi: checks 
*** SHOW DOWN ***
Gora858: shows [7h 4h] (high card Ace)
VIST0988: shows [4d 4c] (a pair of Fours)
sleeper hipi: mucks hand 
VIST0988 collected $0.07 from pot
*** SUMMARY ***
Total pot $0.07 | Rake $0 
Board [Ac 8h 3s Qd 9d]
Seat 1: Skumme folded before Flop (didn't bet)
Seat 2: sleeper hipi mucked [6d 7d]
Seat 3: elojometalik folded before Flop (didn't bet)
Seat 4: Dorex2007 (button) folded before Flop (didn't bet)
Seat 5: kolyamex (small blind) folded before Flop
Seat 6: Gora858 (big blind) showed [7h 4h] and lost with high card Ace
Seat 7: mimimouse6 folded before Flop (didn't bet)
Seat 8: VIST0988 showed [4d 4c] and won ($0.07) with a pair of Fours
Seat 9: keki8787 folded before Flop (didn't bet)



PokerStars Hand #228375739129:  Hold'em No Limit ($0.01/$0.02 USD) - 2021/07/18 0:15:49 PT [2021/07/18 3:15:49 ET]
Table 'Philia' 9-max Seat #5 is the button
Seat 1: Skumme ($1.05 in chips) 
Seat 2: sleeper hipi ($8.58 in chips) 
Seat 3: elojometalik ($0.47 in chips) 
Seat 4: Dorex2007 ($3.98 in chips) 
Seat 5: kolyamex ($0.97 in chips) 
Seat 6: Gora858 ($4.21 in chips) 
Seat 7: mimimouse6 ($2.79 in chips) 
Seat 8: VIST0988 ($0.80 in chips) 
Seat 9: keki8787 ($0.26 in chips) 
Gora858: posts small blind $0.01
mimimouse6: posts big blind $0.02
*** HOLE CARDS ***
Dealt to Dorex2007 [Ts Ah]
VIST0988: folds 
keki8787: calls $0.02
Skumme: calls $0.02
sleeper hipi: folds 
elojometalik: folds 
Dorex2007: calls $0.02
kolyamex: folds 
kolyamex leaves the table
Gora858: folds 
mimimouse6: checks 
*** FLOP *** [2s 8s As]
mimimouse6: checks 
keki8787: bets $0.04
Skumme: folds 
Dorex2007: calls $0.04
sprintergaul joins the table at seat #5 
mimimouse6: folds 
*** TURN *** [2s 8s As] [Qc]
keki8787: checks 
Dorex2007: bets $0.16
keki8787: calls $0.16
*** RIVER *** [2s 8s As Qc] [Qd]
keki8787: checks 
Dorex2007: bets $0.47
keki8787: calls $0.04 and is all-in
Uncalled bet ($0.43) returned to Dorex2007
*** SHOW DOWN ***
Dorex2007: shows [Ts Ah] (two pair, Aces and Queens)
keki8787: shows [5s Ac] (two pair, Aces and Queens - lower kicker)
Dorex2007 collected $0.55 from pot
*** SUMMARY ***
Total pot $0.57 | Rake $0.02 
Board [2s 8s As Qc Qd]
Seat 1: Skumme folded on the Flop
Seat 2: sleeper hipi folded before Flop (didn't bet)
Seat 3: elojometalik folded before Flop (didn't bet)
Seat 4: Dorex2007 showed [Ts Ah] and won ($0.55) with two pair, Aces and Queens
Seat 5: kolyamex (button) folded before Flop (didn't bet)
Seat 6: Gora858 (small blind) folded before Flop
Seat 7: mimimouse6 (big blind) folded on the Flop
Seat 8: VIST0988 folded before Flop (didn't bet)
Seat 9: keki8787 showed [5s Ac] and lost with two pair, Aces and Queens



PokerStars Hand #228375748410:  Hold'em No Limit ($0.01/$0.02 USD) - 2021/07/18 0:16:48 PT [2021/07/18 3:16:48 ET]
Table 'Philia' 9-max Seat #6 is the button
Seat 1: Skumme ($1.03 in chips) 
Seat 2: sleeper hipi ($8.58 in chips) 
Seat 3: elojometalik ($0.47 in chips) 
Seat 4: Dorex2007 ($4.27 in chips) 
Seat 6: Gora858 ($4.20 in chips) 
Seat 7: mimimouse6 ($2.77 in chips) 
Seat 8: VIST0988 ($0.80 in chips) 
mimimouse6: posts small blind $0.01
VIST0988: posts big blind $0.02
sprintergaul: sits out 
*** HOLE CARDS ***
Dealt to Dorex2007 [Ks Ts]
Skumme: folds 
sleeper hipi: folds 
elojometalik: calls $0.02
Dorex2007: folds 
Gora858: folds 
keki8787 leaves the table
mimimouse6: calls $0.01
VIST0988: checks 
*** FLOP *** [6h 4c Qd]
mimimouse6: bets $0.03
simioniwed joins the table at seat #9 
VIST0988: folds 
elojometalik: folds 
Uncalled bet ($0.03) returned to mimimouse6
mimimouse6 collected $0.06 from pot
mimimouse6: doesn't show hand 
*** SUMMARY ***
Total pot $0.06 | Rake $0 
Board [6h 4c Qd]
Seat 1: Skumme folded before Flop (didn't bet)
Seat 2: sleeper hipi folded before Flop (didn't bet)
Seat 3: elojometalik folded on the Flop
Seat 4: Dorex2007 folded before Flop (didn't bet)
Seat 6: Gora858 (button) folded before Flop (didn't bet)
Seat 7: mimimouse6 (small blind) collected ($0.06)
Seat 8: VIST0988 (big blind) folded on the Flop



PokerStars Hand #228375843471:  Hold'em No Limit ($0.01/$0.02 USD) - 2021/07/18 0:26:47 PT [2021/07/18 3:26:47 ET]
Table 'Philia' 9-max Seat #8 is the button
Seat 1: Skumme ($0.98 in chips) 
Seat 2: sleeper hipi ($8.39 in chips) 
Seat 4: Dorex2007 ($4.27 in chips) 
Seat 5: sprintergaul ($0.83 in chips) 
Seat 6: Gora858 ($4.56 in chips) 
Seat 7: mimimouse6 ($2.76 in chips) 
Seat 8: VIST0988 ($0.51 in chips) 
Seat 9: simioniwed ($1.32 in chips) 
simioniwed: posts small blind $0.01
Skumme: posts big blind $0.02
Dorex2007: posts small & big blinds $0.03
*** HOLE CARDS ***
Dealt to Dorex2007 [Qh 9d]
sleeper hipi: folds 
Dorex2007: checks 
sprintergaul: calls $0.02
Gora858: folds 
mimimouse6: folds 
VIST0988: calls $0.02
simioniwed: folds 
Skumme: checks 
*** FLOP *** [7h 8d 8s]
simioniwed leaves the table
Skumme: checks 
Dorex2007: checks 
sprintergaul: bets $0.02
VIST0988: calls $0.02
Skumme: calls $0.02
Dorex2007: calls $0.02
*** TURN *** [7h 8d 8s] [Kc]
Skumme: checks 
NocnyFryzjer joins the table at seat #9 
Dorex2007: checks 
sprintergaul: bets $0.04
VIST0988: folds 
Skumme: folds 
Dorex2007: folds 
Uncalled bet ($0.04) returned to sprintergaul
sprintergaul collected $0.17 from pot
sprintergaul: doesn't show hand 
*** SUMMARY ***
Total pot $0.18 | Rake $0.01 
Board [7h 8d 8s Kc]
Seat 1: Skumme (big blind) folded on the Turn
Seat 2: sleeper hipi folded before Flop (didn't bet)
Seat 4: Dorex2007 folded on the Turn
Seat 5: sprintergaul collected ($0.17)
Seat 6: Gora858 folded before Flop (didn't bet)
Seat 7: mimimouse6 folded before Flop (didn't bet)
Seat 8: VIST0988 (button) folded on the Turn
Seat 9: simioniwed (small blind) folded before Flop



PokerStars Hand #228375855023:  Hold'em No Limit ($0.01/$0.02 USD) - 2021/07/18 0:27:59 PT [2021/07/18 3:27:59 ET]
Table 'Philia' 9-max Seat #1 is the button
Seat 1: Skumme ($0.94 in chips) 
Seat 2: sleeper hipi ($8.39 in chips) 
Seat 4: Dorex2007 ($4.22 in chips) 
Seat 5: sprintergaul ($0.96 in chips) 
Seat 6: Gora858 ($4.56 in chips) 
Seat 7: mimimouse6 ($2.76 in chips) 
Seat 8: VIST0988 ($0.47 in chips) 
sleeper hipi: posts small blind $0.01
Dorex2007: posts big blind $0.02
NocnyFryzjer: sits out 
*** HOLE CARDS ***
Dealt to Dorex2007 [4c 6d]
sprintergaul: calls $0.02
Gora858: folds 
mimimouse6: folds 
VIST0988: folds 
Skumme: calls $0.02
sleeper hipi: calls $0.01
Dorex2007: checks 
*** FLOP *** [3c As 9h]
sleeper hipi: checks 
Dorex2007: checks 
sprintergaul: checks 
Skumme: checks 
*** TURN *** [3c As 9h] [Kh]
sleeper hipi: bets $0.04
Dorex2007: folds 
sprintergaul: folds 
Skumme: folds 
Uncalled bet ($0.04) returned to sleeper hipi
sleeper hipi collected $0.08 from pot
sleeper hipi: doesn't show hand 
*** SUMMARY ***
Total pot $0.08 | Rake $0 
Board [3c As 9h Kh]
Seat 1: Skumme (button) folded on the Turn
Seat 2: sleeper hipi (small blind) collected ($0.08)
Seat 4: Dorex2007 (big blind) folded on the Turn
Seat 5: sprintergaul folded on the Turn
Seat 6: Gora858 folded before Flop (didn't bet)
Seat 7: mimimouse6 folded before Flop (didn't bet)
Seat 8: VIST0988 folded before Flop (didn't bet)



PokerStars Hand #228375862702:  Hold'em No Limit ($0.01/$0.02 USD) - 2021/07/18 0:28:47 PT [2021/07/18 3:28:47 ET]
Table 'Philia' 9-max Seat #2 is the button
Seat 1: Skumme ($0.92 in chips) 
Seat 2: sleeper hipi ($8.45 in chips) 
Seat 4: Dorex2007 ($4.20 in chips) 
Seat 5: sprintergaul ($0.94 in chips) 
Seat 6: Gora858 ($4.56 in chips) 
Seat 7: mimimouse6 ($2.76 in chips) 
Seat 8: VIST0988 ($0.47 in chips) 
Dorex2007: posts small blind $0.01
sprintergaul: posts big blind $0.02
NocnyFryzjer: sits out 
*** HOLE CARDS ***
Dealt to Dorex2007 [Js 9c]
Gora858: raises $0.02 to $0.04
mimimouse6: folds 
VIST0988: folds 
Skumme: raises $0.04 to $0.08
sleeper hipi: folds 
Dorex2007: folds 
sprintergaul: folds 
Gora858: calls $0.04
*** FLOP *** [7d 7c 4h]
Gora858: bets $0.06
Skumme: calls $0.06
*** TURN *** [7d 7c 4h] [2c]
Gora858: bets $0.10
Skumme: folds 
Uncalled bet ($0.10) returned to Gora858
Gora858 collected $0.30 from pot
*** SUMMARY ***
Total pot $0.31 | Rake $0.01 
Board [7d 7c 4h 2c]
Seat 1: Skumme folded on the Turn
Seat 2: sleeper hipi (button) folded before Flop (didn't bet)
Seat 4: Dorex2007 (small blind) folded before Flop
Seat 5: sprintergaul (big blind) folded before Flop
Seat 6: Gora858 collected ($0.30)
Seat 7: mimimouse6 folded before Flop (didn't bet)
Seat 8: VIST0988 folded before Flop (didn't bet)



PokerStars Hand #228375869046:  Hold'em No Limit ($0.01/$0.02 USD) - 2021/07/18 0:29:27 PT [2021/07/18 3:29:27 ET]
Table 'Philia' 9-max Seat #4 is the button
Seat 1: Skumme ($0.78 in chips) 
Seat 2: sleeper hipi ($8.45 in chips) 
Seat 3: dealembub ($1.60 in chips) 
Seat 4: Dorex2007 ($4.19 in chips) 
Seat 5: sprintergaul ($0.92 in chips) 
Seat 6: Gora858 ($4.72 in chips) 
Seat 7: mimimouse6 ($2.76 in chips) 
Seat 8: VIST0988 ($0.47 in chips) 
sprintergaul: posts small blind $0.01
Gora858: posts big blind $0.02
NocnyFryzjer: sits out 
dealembub: posts big blind $0.02
*** HOLE CARDS ***
Dealt to Dorex2007 [6s 9s]
mimimouse6: folds 
VIST0988: folds 
Skumme: calls $0.02
sleeper hipi: folds 
dealembub: checks 
Dorex2007: folds 
sprintergaul: calls $0.01
Gora858: checks 
*** FLOP *** [Kh 7d 5s]
sprintergaul: checks 
Gora858: checks 
Skumme: bets $0.08
dealembub: folds 
sprintergaul: folds 
Gora858: folds 
Uncalled bet ($0.08) returned to Skumme
Skumme collected $0.08 from pot
Skumme: doesn't show hand 
*** SUMMARY ***
Total pot $0.08 | Rake $0 
Board [Kh 7d 5s]
Seat 1: Skumme collected ($0.08)
Seat 2: sleeper hipi folded before Flop (didn't bet)
Seat 3: dealembub folded on the Flop (didn't bet)
Seat 4: Dorex2007 (button) folded before Flop (didn't bet)
Seat 5: sprintergaul (small blind) folded on the Flop
Seat 6: Gora858 (big blind) folded on the Flop
Seat 7: mimimouse6 folded before Flop (didn't bet)
Seat 8: VIST0988 folded before Flop (didn't bet)



PokerStars Hand #228375874205:  Hold'em No Limit ($0.01/$0.02 USD) - 2021/07/18 0:29:59 PT [2021/07/18 3:29:59 ET]
Table 'Philia' 9-max Seat #5 is the button
Seat 1: Skumme ($0.84 in chips) 
Seat 2: sleeper hipi ($8.45 in chips) 
Seat 3: dealembub ($1.58 in chips) 
Seat 4: Dorex2007 ($4.19 in chips) 
Seat 5: sprintergaul ($0.90 in chips) 
Seat 6: Gora858 ($4.70 in chips) 
Seat 7: mimimouse6 ($2.76 in chips) 
Seat 8: VIST0988 ($0.47 in chips) 
Gora858: posts small blind $0.01
mimimouse6: posts big blind $0.02
NocnyFryzjer: sits out 
*** HOLE CARDS ***
Dealt to Dorex2007 [3d 3s]
VIST0988: folds 
Skumme: folds 
sleeper hipi: folds 
dealembub: raises $0.04 to $0.06
Dorex2007: folds 
sprintergaul: folds 
Gora858: folds 
mimimouse6: folds 
Uncalled bet ($0.04) returned to dealembub
dealembub collected $0.05 from pot
dealembub: doesn't show hand 
*** SUMMARY ***
Total pot $0.05 | Rake $0 
Seat 1: Skumme folded before Flop (didn't bet)
Seat 2: sleeper hipi folded before Flop (didn't bet)
Seat 3: dealembub collected ($0.05)
Seat 4: Dorex2007 folded before Flop (didn't bet)
Seat 5: sprintergaul (button) folded before Flop (didn't bet)
Seat 6: Gora858 (small blind) folded before Flop
Seat 7: mimimouse6 (big blind) folded before Flop
Seat 8: VIST0988 folded before Flop (didn't bet)



PokerStars Hand #228375877104:  Hold'em No Limit ($0.01/$0.02 USD) - 2021/07/18 0:30:17 PT [2021/07/18 3:30:17 ET]
Table 'Philia' 9-max Seat #6 is the button
Seat 1: Skumme ($0.84 in chips) 
Seat 2: sleeper hipi ($8.45 in chips) 
Seat 3: dealembub ($1.61 in chips) 
Seat 4: Dorex2007 ($4.19 in chips) 
Seat 5: sprintergaul ($0.90 in chips) 
Seat 6: Gora858 ($4.69 in chips) 
Seat 7: mimimouse6 ($2.74 in chips) 
Seat 8: VIST0988 ($0.47 in chips) 
mimimouse6: posts small blind $0.01
VIST0988: posts big blind $0.02
NocnyFryzjer: sits out 
*** HOLE CARDS ***
Dealt to Dorex2007 [Ac 3d]
Skumme: folds 
sleeper hipi: calls $0.02
dealembub: folds 
Dorex2007: folds 
sprintergaul: folds 
Gora858: folds 
mimimouse6: folds 
VIST0988: checks 
*** FLOP *** [Qs 9d 2h]
VIST0988: checks 
sleeper hipi: bets $0.02
VIST0988: calls $0.02
*** TURN *** [Qs 9d 2h] [Tc]
VIST0988: checks 
Dorex2007 said, "how you making out tonight/"
sleeper hipi: bets $0.04
dealembub said, "even"
VIST0988: calls $0.04
*** RIVER *** [Qs 9d 2h Tc] [4c]
VIST0988: checks 
sleeper hipi: checks 
*** SHOW DOWN ***
VIST0988: shows [2s Jd] (a pair of Deuces)
sleeper hipi: shows [2c 2d] (three of a kind, Deuces)
sleeper hipi collected $0.16 from pot
*** SUMMARY ***
Total pot $0.17 | Rake $0.01 
Board [Qs 9d 2h Tc 4c]
Seat 1: Skumme folded before Flop (didn't bet)
Seat 2: sleeper hipi showed [2c 2d] and won ($0.16) with three of a kind, Deuces
Seat 3: dealembub folded before Flop (didn't bet)
Seat 4: Dorex2007 folded before Flop (didn't bet)
Seat 5: sprintergaul folded before Flop (didn't bet)
Seat 6: Gora858 (button) folded before Flop (didn't bet)
Seat 7: mimimouse6 (small blind) folded before Flop
Seat 8: VIST0988 (big blind) showed [2s Jd] and lost with a pair of Deuces



PokerStars Hand #228375888071:  Hold'em No Limit ($0.01/$0.02 USD) - 2021/07/18 0:31:25 PT [2021/07/18 3:31:25 ET]
Table 'Philia' 9-max Seat #7 is the button
Seat 1: Skumme ($0.84 in chips) 
Seat 2: sleeper hipi ($8.53 in chips) 
Seat 3: dealembub ($1.61 in chips) 
Seat 4: Dorex2007 ($4.19 in chips) 
Seat 5: sprintergaul ($0.90 in chips) 
Seat 6: Gora858 ($4.69 in chips) 
Seat 7: mimimouse6 ($2.73 in chips) 
Seat 8: VIST0988 ($0.39 in chips) 
Seat 9: NocnyFryzjer ($1.60 in chips) 
VIST0988: posts small blind $0.01
NocnyFryzjer: posts big blind $0.02
*** HOLE CARDS ***
Dealt to Dorex2007 [Ad 7s]
Dorex2007 said, "I"m up a bit. Hard playing tonight"
Skumme: calls $0.02
dealembub said, "went to three tables before i started getting good cards"
sleeper hipi: calls $0.02
dealembub: folds 
Dorex2007: folds 
sprintergaul: calls $0.02
Gora858: folds 
mimimouse6: folds 
VIST0988: raises $0.37 to $0.39 and is all-in
NocnyFryzjer: folds 
Skumme: folds 
sleeper hipi: folds 
sprintergaul: folds 
Uncalled bet ($0.37) returned to VIST0988
VIST0988 collected $0.10 from pot
VIST0988: doesn't show hand 
*** SUMMARY ***
Total pot $0.10 | Rake $0 
Seat 1: Skumme folded before Flop
Seat 2: sleeper hipi folded before Flop
Seat 3: dealembub folded before Flop (didn't bet)
Seat 4: Dorex2007 folded before Flop (didn't bet)
Seat 5: sprintergaul folded before Flop
Seat 6: Gora858 folded before Flop (didn't bet)
Seat 7: mimimouse6 (button) folded before Flop (didn't bet)
Seat 8: VIST0988 (small blind) collected ($0.10)
Seat 9: NocnyFryzjer (big blind) folded before Flop



PokerStars Hand #228375897132:  Hold'em No Limit ($0.01/$0.02 USD) - 2021/07/18 0:32:21 PT [2021/07/18 3:32:21 ET]
Table 'Philia' 9-max Seat #8 is the button
Seat 1: Skumme ($0.82 in chips) 
Seat 2: sleeper hipi ($8.51 in chips) 
Seat 3: dealembub ($1.61 in chips) 
Seat 4: Dorex2007 ($4.19 in chips) 
Seat 5: sprintergaul ($0.88 in chips) 
Seat 6: Gora858 ($4.69 in chips) 
Seat 7: mimimouse6 ($2.73 in chips) 
Seat 8: VIST0988 ($0.47 in chips) 
Seat 9: NocnyFryzjer ($1.58 in chips) 
Dorex2007 said, "got a Royal Flush tonight in clubs"
NocnyFryzjer: posts small blind $0.01
Skumme: posts big blind $0.02
*** HOLE CARDS ***
Dealt to Dorex2007 [Qc 9s]
sleeper hipi: folds 
dealembub: calls $0.02
Dorex2007: folds 
sprintergaul: folds 
Gora858: folds 
mimimouse6: folds 
VIST0988: folds 
NocnyFryzjer: folds 
dealembub said, "wow...congrats...haven't seen one of those in a very long time"
Skumme: raises $0.02 to $0.04
dealembub: calls $0.02
*** FLOP *** [Qs Kh Td]
Dorex2007 said, "first one ever"
Skumme: bets $0.04
dealembub: calls $0.04
*** TURN *** [Qs Kh Td] [Jd]
Skumme: checks 
dealembub: bets $0.08
Skumme: folds 
Uncalled bet ($0.08) returned to dealembub
dealembub collected $0.16 from pot
dealembub: doesn't show hand 
*** SUMMARY ***
Total pot $0.17 | Rake $0.01 
Board [Qs Kh Td Jd]
Seat 1: Skumme (big blind) folded on the Turn
Seat 2: sleeper hipi folded before Flop (didn't bet)
Seat 3: dealembub collected ($0.16)
Seat 4: Dorex2007 folded before Flop (didn't bet)
Seat 5: sprintergaul folded before Flop (didn't bet)
Seat 6: Gora858 folded before Flop (didn't bet)
Seat 7: mimimouse6 folded before Flop (didn't bet)
Seat 8: VIST0988 (button) folded before Flop (didn't bet)
Seat 9: NocnyFryzjer (small blind) folded before Flop



PokerStars Hand #228375903596:  Hold'em No Limit ($0.01/$0.02 USD) - 2021/07/18 0:33:01 PT [2021/07/18 3:33:01 ET]
Table 'Philia' 9-max Seat #9 is the button
Seat 1: Skumme ($0.74 in chips) 
Seat 2: sleeper hipi ($8.51 in chips) 
Seat 3: dealembub ($1.69 in chips) 
Seat 4: Dorex2007 ($4.19 in chips) 
Seat 5: sprintergaul ($0.88 in chips) 
Seat 6: Gora858 ($4.69 in chips) 
Seat 7: mimimouse6 ($2.73 in chips) 
Seat 8: VIST0988 ($0.47 in chips) 
Seat 9: NocnyFryzjer ($1.57 in chips) 
Skumme: posts small blind $0.01
sleeper hipi: posts big blind $0.02
*** HOLE CARDS ***
Dealt to Dorex2007 [Jh Qc]
dealembub: calls $0.02
Dorex2007: folds 
sprintergaul: folds 
Gora858: folds 
mimimouse6: folds 
VIST0988: raises $0.02 to $0.04
dealembub said, "thats so neat for you"
NocnyFryzjer: folds 
Skumme: folds 
sleeper hipi: calls $0.02
dealembub: calls $0.02
*** FLOP *** [3s 7h Jc]
Dorex2007 said, "didn't make a lot, but it was sweet"
sleeper hipi: checks 
dealembub: bets $0.04
VIST0988: calls $0.04
sleeper hipi: calls $0.04
*** TURN *** [3s 7h Jc] [7c]
sleeper hipi: checks 
dealembub: bets $0.10
VIST0988: calls $0.10
sleeper hipi: raises $0.24 to $0.34
dealembub: raises $1.27 to $1.61 and is all-in
VIST0988: calls $0.29 and is all-in
sleeper hipi: calls $1.27
*** RIVER *** [3s 7h Jc 7c] [5d]
*** SHOW DOWN ***
sleeper hipi: shows [7d Ad] (three of a kind, Sevens)
dealembub: shows [Ah 7s] (three of a kind, Sevens)
VIST0988: shows [3c 3h] (a full house, Threes full of Sevens)
VIST0988 collected $1.37 from main pot
sleeper hipi cashed out the hand for $1.26 | Cash Out Fee $0.01
dealembub cashed out the hand for $1.24 | Cash Out Fee $0.01
*** SUMMARY ***
Total pot $3.86 Main pot $1.37. Side pot $2.35. | Rake $0.14 
Board [3s 7h Jc 7c 5d]
Seat 1: Skumme (small blind) folded before Flop
Seat 2: sleeper hipi (big blind) showed [7d Ad] and won ($1.18) with three of a kind, Sevens (pot not awarded as player cashed out)
Seat 3: dealembub showed [Ah 7s] and won ($1.17) with three of a kind, Sevens (pot not awarded as player cashed out)
Seat 4: Dorex2007 folded before Flop (didn't bet)
Seat 5: sprintergaul folded before Flop (didn't bet)
Seat 6: Gora858 folded before Flop (didn't bet)
Seat 7: mimimouse6 folded before Flop (didn't bet)
Seat 8: VIST0988 showed [3c 3h] and won ($1.37) with a full house, Threes full of Sevens
Seat 9: NocnyFryzjer (button) folded before Flop (didn't bet)



PokerStars Hand #228375918636:  Hold'em No Limit ($0.01/$0.02 USD) - 2021/07/18 0:34:34 PT [2021/07/18 3:34:34 ET]
Table 'Philia' 9-max Seat #1 is the button
Seat 1: Skumme ($0.73 in chips) 
Seat 2: sleeper hipi ($8.08 in chips) 
Seat 3: dealembub ($1.24 in chips) 
Seat 4: Dorex2007 ($4.19 in chips) 
Seat 5: sprintergaul ($0.88 in chips) 
Seat 6: Gora858 ($4.69 in chips) 
Seat 7: mimimouse6 ($2.73 in chips) 
Seat 8: VIST0988 ($1.37 in chips) 
Seat 9: NocnyFryzjer ($1.57 in chips) 
sleeper hipi: posts small blind $0.01
dealembub: posts big blind $0.02
*** HOLE CARDS ***
Dealt to Dorex2007 [2c 8h]
Dorex2007: folds 
sprintergaul: calls $0.02
Gora858: folds 
mimimouse6: raises $0.04 to $0.06
VIST0988: calls $0.06
Dorex2007 said, "that looked fun...ish"
NocnyFryzjer: folds 
Skumme: folds 
sleeper hipi: folds 
dealembub: folds 
sprintergaul: calls $0.04
*** FLOP *** [Qc 9c 3c]
dealembub said, "have i told you how much i hate 3's"
sprintergaul: checks 
mimimouse6: checks 
VIST0988: checks 
*** TURN *** [Qc 9c 3c] [8c]
sprintergaul: bets $0.02
mimimouse6: folds 
VIST0988: calls $0.02
*** RIVER *** [Qc 9c 3c 8c] [Qs]
sprintergaul: bets $0.06
dealembub said, "you wouldn't believe how much i've lost to 3's in the past two weeks"
VIST0988: calls $0.06
*** SHOW DOWN ***
sprintergaul: shows [Tc Ks] (a flush, Queen high)
VIST0988: mucks hand 
sprintergaul collected $0.36 from pot
*** SUMMARY ***
Total pot $0.37 | Rake $0.01 
Board [Qc 9c 3c 8c Qs]
Seat 1: Skumme (button) folded before Flop (didn't bet)
Seat 2: sleeper hipi (small blind) folded before Flop
Seat 3: dealembub (big blind) folded before Flop
Seat 4: Dorex2007 folded before Flop (didn't bet)
Seat 5: sprintergaul showed [Tc Ks] and won ($0.36) with a flush, Queen high
Seat 6: Gora858 folded before Flop (didn't bet)
Seat 7: mimimouse6 folded on the Turn
Seat 8: VIST0988 mucked [6c 6h]
Seat 9: NocnyFryzjer folded before Flop (didn't bet)



PokerStars Hand #228375928854:  Hold'em No Limit ($0.01/$0.02 USD) - 2021/07/18 0:35:37 PT [2021/07/18 3:35:37 ET]
Table 'Philia' 9-max Seat #2 is the button
Seat 1: Skumme ($0.73 in chips) 
Seat 2: sleeper hipi ($8.07 in chips) 
Seat 3: dealembub ($1.22 in chips) 
Seat 4: Dorex2007 ($4.19 in chips) 
Seat 5: sprintergaul ($1.10 in chips) 
Seat 6: Gora858 ($4.69 in chips) 
Seat 7: mimimouse6 ($2.67 in chips) 
Seat 8: VIST0988 ($1.23 in chips) 
Seat 9: NocnyFryzjer ($1.57 in chips) 
dealembub: posts small blind $0.01
Dorex2007: posts big blind $0.02
*** HOLE CARDS ***
Dealt to Dorex2007 [8c Qh]
sprintergaul: folds 
Gora858: folds 
mimimouse6: folds 
VIST0988 has timed out
VIST0988: folds 
NocnyFryzjer: folds 
Skumme: calls $0.02
sleeper hipi: folds 
dealembub: raises $0.06 to $0.08
Dorex2007: folds 
Skumme: calls $0.06
*** FLOP *** [Qc Ad Th]
dealembub: bets $0.09
Skumme: raises $0.56 to $0.65 and is all-in
dealembub: calls $0.56
*** TURN *** [Qc Ad Th] [2s]
*** RIVER *** [Qc Ad Th 2s] [Ts]
*** SHOW DOWN ***
dealembub: shows [Kh Qd] (two pair, Queens and Tens)
Skumme: shows [Tc Kd] (three of a kind, Tens)
Skumme collected $1.43 from pot
*** SUMMARY ***
Total pot $1.48 | Rake $0.05 
Board [Qc Ad Th 2s Ts]
Seat 1: Skumme showed [Tc Kd] and won ($1.43) with three of a kind, Tens
Seat 2: sleeper hipi (button) folded before Flop (didn't bet)
Seat 3: dealembub (small blind) showed [Kh Qd] and lost with two pair, Queens and Tens
Seat 4: Dorex2007 (big blind) folded before Flop
Seat 5: sprintergaul folded before Flop (didn't bet)
Seat 6: Gora858 folded before Flop (didn't bet)
Seat 7: mimimouse6 folded before Flop (didn't bet)
Seat 8: VIST0988 folded before Flop (didn't bet)
Seat 9: NocnyFryzjer folded before Flop (didn't bet)



PokerStars Hand #228375937571:  Hold'em No Limit ($0.01/$0.02 USD) - 2021/07/18 0:36:31 PT [2021/07/18 3:36:31 ET]
Table 'Philia' 9-max Seat #3 is the button
Seat 1: Skumme ($1.43 in chips) 
Seat 2: sleeper hipi ($8.07 in chips) 
Seat 3: dealembub ($0.49 in chips) 
Seat 4: Dorex2007 ($4.17 in chips) 
Seat 5: sprintergaul ($1.10 in chips) 
Seat 6: Gora858 ($4.69 in chips) 
Seat 7: mimimouse6 ($2.67 in chips) 
Seat 8: VIST0988 ($1.23 in chips) 
Seat 9: NocnyFryzjer ($1.57 in chips) 
Dorex2007: posts small blind $0.01
sprintergaul: posts big blind $0.02
*** HOLE CARDS ***
Dealt to Dorex2007 [3s 3c]
Gora858: folds 
mimimouse6: folds 
VIST0988: raises $0.08 to $0.10
NocnyFryzjer: folds 
Skumme: folds 
sleeper hipi: folds 
dealembub: folds 
Dorex2007: folds 
sprintergaul: folds 
Uncalled bet ($0.08) returned to VIST0988
VIST0988 collected $0.05 from pot
Skumme leaves the table
VIST0988: doesn't show hand 
*** SUMMARY ***
Total pot $0.05 | Rake $0 
Seat 1: Skumme folded before Flop (didn't bet)
Seat 2: sleeper hipi folded before Flop (didn't bet)
Seat 3: dealembub (button) folded before Flop (didn't bet)
Seat 4: Dorex2007 (small blind) folded before Flop
Seat 5: sprintergaul (big blind) folded before Flop
Seat 6: Gora858 folded before Flop (didn't bet)
Seat 7: mimimouse6 folded before Flop (didn't bet)
Seat 8: VIST0988 collected ($0.05)
Seat 9: NocnyFryzjer folded before Flop (didn't bet)



PokerStars Hand #228375950212:  Hold'em No Limit ($0.01/$0.02 USD) - 2021/07/18 0:36:57 PT [2021/07/18 3:36:57 ET]
Table 'Philia' 9-max Seat #4 is the button
Seat 2: sleeper hipi ($8.07 in chips) 
Seat 3: dealembub ($0.49 in chips) 
Seat 4: Dorex2007 ($4.16 in chips) 
Seat 5: sprintergaul ($1.08 in chips) 
Seat 6: Gora858 ($4.69 in chips) 
Seat 7: mimimouse6 ($2.67 in chips) 
Seat 8: VIST0988 ($1.26 in chips) 
Seat 9: NocnyFryzjer ($1.57 in chips) 
sprintergaul: posts small blind $0.01
Gora858: posts big blind $0.02
*** HOLE CARDS ***
Dealt to Dorex2007 [3c 5h]
mimimouse6: folds 
VIST0988: calls $0.02
zielonysnipe joins the table at seat #1 
NocnyFryzjer: folds 
sleeper hipi: calls $0.02
dealembub: folds 
Dorex2007: folds 
sprintergaul: calls $0.01
Gora858: checks 
*** FLOP *** [2s 8c 4c]
sprintergaul: checks 
Gora858: bets $0.04
VIST0988: folds 
sleeper hipi: folds 
sprintergaul: calls $0.04
*** TURN *** [2s 8c 4c] [2d]
sprintergaul: checks 
Gora858: bets $0.08
sprintergaul: folds 
Uncalled bet ($0.08) returned to Gora858
Gora858 collected $0.15 from pot
*** SUMMARY ***
Total pot $0.16 | Rake $0.01 
Board [2s 8c 4c 2d]
Seat 2: sleeper hipi folded on the Flop
Seat 3: dealembub folded before Flop (didn't bet)
Seat 4: Dorex2007 (button) folded before Flop (didn't bet)
Seat 5: sprintergaul (small blind) folded on the Turn
Seat 6: Gora858 (big blind) collected ($0.15)
Seat 7: mimimouse6 folded before Flop (didn't bet)
Seat 8: VIST0988 folded on the Flop
Seat 9: NocnyFryzjer folded before Flop (didn't bet)



PokerStars Hand #228375958178:  Hold'em No Limit ($0.01/$0.02 USD) - 2021/07/18 0:37:45 PT [2021/07/18 3:37:45 ET]
Table 'Philia' 9-max Seat #5 is the button
Seat 2: sleeper hipi ($8.05 in chips) 
Seat 3: dealembub ($0.49 in chips) 
Seat 4: Dorex2007 ($4.16 in chips) 
Seat 5: sprintergaul ($1.02 in chips) 
Seat 6: Gora858 ($4.78 in chips) 
Seat 7: mimimouse6 ($2.67 in chips) 
Seat 8: VIST0988 ($1.24 in chips) 
Seat 9: NocnyFryzjer ($1.57 in chips) 
Gora858: posts small blind $0.01
mimimouse6: posts big blind $0.02
zielonysnipe: sits out 
*** HOLE CARDS ***
Dealt to Dorex2007 [5h Ts]
VIST0988: folds 
NocnyFryzjer: folds 
sleeper hipi: folds 
dealembub: folds 
Dorex2007: folds 
sprintergaul: folds 
Gora858: folds 
Uncalled bet ($0.01) returned to mimimouse6
mimimouse6 collected $0.02 from pot
mimimouse6: doesn't show hand 
*** SUMMARY ***
Total pot $0.02 | Rake $0 
Seat 2: sleeper hipi folded before Flop (didn't bet)
Seat 3: dealembub folded before Flop (didn't bet)
Seat 4: Dorex2007 folded before Flop (didn't bet)
Seat 5: sprintergaul (button) folded before Flop (didn't bet)
Seat 6: Gora858 (small blind) folded before Flop
Seat 7: mimimouse6 (big blind) collected ($0.02)
Seat 8: VIST0988 folded before Flop (didn't bet)
Seat 9: NocnyFryzjer folded before Flop (didn't bet)



PokerStars Hand #228375960524:  Hold'em No Limit ($0.01/$0.02 USD) - 2021/07/18 0:38:00 PT [2021/07/18 3:38:00 ET]
Table 'Philia' 9-max Seat #6 is the button
Seat 2: sleeper hipi ($8.05 in chips) 
Seat 3: dealembub ($0.49 in chips) 
Seat 4: Dorex2007 ($4.16 in chips) 
Seat 5: sprintergaul ($1.02 in chips) 
Seat 6: Gora858 ($4.77 in chips) 
Seat 7: mimimouse6 ($2.68 in chips) 
Seat 8: VIST0988 ($1.24 in chips) 
Seat 9: NocnyFryzjer ($1.57 in chips) 
mimimouse6: posts small blind $0.01
VIST0988: posts big blind $0.02
zielonysnipe: sits out 
*** HOLE CARDS ***
Dealt to Dorex2007 [2s Jd]
NocnyFryzjer: folds 
sleeper hipi: folds 
dealembub: folds 
Dorex2007: folds 
sprintergaul: calls $0.02
Gora858: folds 
mimimouse6: calls $0.01
VIST0988: checks 
*** FLOP *** [7s 2c Qd]
mimimouse6: checks 
VIST0988: checks 
sprintergaul: checks 
*** TURN *** [7s 2c Qd] [7c]
mimimouse6: checks 
VIST0988: bets $0.03
sprintergaul: calls $0.03
mimimouse6: folds 
*** RIVER *** [7s 2c Qd 7c] [Ks]
VIST0988: checks 
sprintergaul: checks 
*** SHOW DOWN ***
VIST0988: shows [4h 3s] (a pair of Sevens)
sprintergaul: shows [Jc Ad] (a pair of Sevens - Ace kicker)
sprintergaul collected $0.12 from pot
*** SUMMARY ***
Total pot $0.12 | Rake $0 
Board [7s 2c Qd 7c Ks]
Seat 2: sleeper hipi folded before Flop (didn't bet)
Seat 3: dealembub folded before Flop (didn't bet)
Seat 4: Dorex2007 folded before Flop (didn't bet)
Seat 5: sprintergaul showed [Jc Ad] and won ($0.12) with a pair of Sevens
Seat 6: Gora858 (button) folded before Flop (didn't bet)
Seat 7: mimimouse6 (small blind) folded on the Turn
Seat 8: VIST0988 (big blind) showed [4h 3s] and lost with a pair of Sevens
Seat 9: NocnyFryzjer folded before Flop (didn't bet)



PokerStars Hand #228375967203:  Hold'em No Limit ($0.01/$0.02 USD) - 2021/07/18 0:38:41 PT [2021/07/18 3:38:41 ET]
Table 'Philia' 9-max Seat #7 is the button
Seat 1: zielonysnipe ($2 in chips) 
Seat 2: sleeper hipi ($8.05 in chips) 
Seat 3: dealembub ($0.49 in chips) 
Seat 4: Dorex2007 ($4.16 in chips) 
Seat 5: sprintergaul ($1.09 in chips) 
Seat 6: Gora858 ($4.77 in chips) 
Seat 7: mimimouse6 ($2.66 in chips) 
Seat 8: VIST0988 ($1.19 in chips) 
Seat 9: NocnyFryzjer ($1.57 in chips) 
VIST0988: posts small blind $0.01
NocnyFryzjer: posts big blind $0.02
zielonysnipe: posts big blind $0.02
*** HOLE CARDS ***
Dealt to Dorex2007 [3c 7h]
zielonysnipe: raises $0.02 to $0.04
sleeper hipi: folds 
dealembub: calls $0.04
Dorex2007: folds 
sprintergaul: folds 
Gora858: folds 
mimimouse6: folds 
VIST0988: calls $0.03
NocnyFryzjer: folds 
*** FLOP *** [8d Ah 8h]
VIST0988: checks 
zielonysnipe: checks 
dealembub: checks 
*** TURN *** [8d Ah 8h] [Ts]
VIST0988: checks 
zielonysnipe: bets $0.06
dealembub: folds 
VIST0988: folds 
Uncalled bet ($0.06) returned to zielonysnipe
zielonysnipe collected $0.14 from pot
zielonysnipe: doesn't show hand 
*** SUMMARY ***
Total pot $0.14 | Rake $0 
Board [8d Ah 8h Ts]
Seat 1: zielonysnipe collected ($0.14)
Seat 2: sleeper hipi folded before Flop (didn't bet)
Seat 3: dealembub folded on the Turn
Seat 4: Dorex2007 folded before Flop (didn't bet)
Seat 5: sprintergaul folded before Flop (didn't bet)
Seat 6: Gora858 folded before Flop (didn't bet)
Seat 7: mimimouse6 (button) folded before Flop (didn't bet)
Seat 8: VIST0988 (small blind) folded on the Turn
Seat 9: NocnyFryzjer (big blind) folded before Flop



PokerStars Hand #228375976405:  Hold'em No Limit ($0.01/$0.02 USD) - 2021/07/18 0:39:38 PT [2021/07/18 3:39:38 ET]
Table 'Philia' 9-max Seat #8 is the button
Seat 1: zielonysnipe ($2.10 in chips) 
Seat 2: sleeper hipi ($8.05 in chips) 
Seat 3: dealembub ($0.45 in chips) 
Seat 4: Dorex2007 ($4.16 in chips) 
Seat 5: sprintergaul ($1.09 in chips) 
Seat 6: Gora858 ($4.77 in chips) 
Seat 7: mimimouse6 ($2.66 in chips) 
Seat 8: VIST0988 ($1.15 in chips) 
Seat 9: NocnyFryzjer ($1.55 in chips) 
NocnyFryzjer: posts small blind $0.01
zielonysnipe: posts big blind $0.02
*** HOLE CARDS ***
Dealt to Dorex2007 [Js Jh]
sleeper hipi: raises $0.04 to $0.06
dealembub: folds 
Dorex2007: calls $0.06
sprintergaul: folds 
Gora858: folds 
mimimouse6: calls $0.06
VIST0988: folds 
NocnyFryzjer: folds 
zielonysnipe: folds 
*** FLOP *** [5c 7h Qs]
sleeper hipi: checks 
Dorex2007: bets $0.10
mimimouse6: calls $0.10
sleeper hipi: folds 
*** TURN *** [5c 7h Qs] [5d]
Dorex2007: checks 
mimimouse6: bets $0.20
dealembub said, "trips....lol"
Dorex2007: folds 
Uncalled bet ($0.20) returned to mimimouse6
mimimouse6 collected $0.40 from pot
mimimouse6: doesn't show hand 
*** SUMMARY ***
Total pot $0.41 | Rake $0.01 
Board [5c 7h Qs 5d]
Seat 1: zielonysnipe (big blind) folded before Flop
Seat 2: sleeper hipi folded on the Flop
Seat 3: dealembub folded before Flop (didn't bet)
Seat 4: Dorex2007 folded on the Turn
Seat 5: sprintergaul folded before Flop (didn't bet)
Seat 6: Gora858 folded before Flop (didn't bet)
Seat 7: mimimouse6 collected ($0.40)
Seat 8: VIST0988 (button) folded before Flop (didn't bet)
Seat 9: NocnyFryzjer (small blind) folded before Flop



PokerStars Hand #228375985416:  Hold'em No Limit ($0.01/$0.02 USD) - 2021/07/18 0:40:32 PT [2021/07/18 3:40:32 ET]
Table 'Philia' 9-max Seat #9 is the button
Seat 1: zielonysnipe ($2.08 in chips) 
Seat 2: sleeper hipi ($7.99 in chips) 
Seat 3: dealembub ($0.45 in chips) 
Seat 4: Dorex2007 ($4 in chips) 
Seat 5: sprintergaul ($1.09 in chips) 
Seat 6: Gora858 ($4.77 in chips) 
Seat 7: mimimouse6 ($2.90 in chips) 
Seat 8: VIST0988 ($1.15 in chips) 
Seat 9: NocnyFryzjer ($1.54 in chips) 
zielonysnipe: posts small blind $0.01
sleeper hipi: posts big blind $0.02
*** HOLE CARDS ***
Dealt to Dorex2007 [Qd 8h]
dealembub: raises $0.05 to $0.07
Dorex2007: folds 
sprintergaul: calls $0.07
Gora858: folds 
mimimouse6: folds 
VIST0988: folds 
NocnyFryzjer: folds 
zielonysnipe: calls $0.06
sleeper hipi: folds 
*** FLOP *** [8s 9h 4d]
zielonysnipe: bets $0.10
dealembub: calls $0.10
sprintergaul: calls $0.10
*** TURN *** [8s 9h 4d] [2s]
zielonysnipe: bets $0.30
dealembub: folds 
sprintergaul: folds 
Uncalled bet ($0.30) returned to zielonysnipe
zielonysnipe collected $0.51 from pot
zielonysnipe: doesn't show hand 
*** SUMMARY ***
Total pot $0.53 | Rake $0.02 
Board [8s 9h 4d 2s]
Seat 1: zielonysnipe (small blind) collected ($0.51)
Seat 2: sleeper hipi (big blind) folded before Flop
Seat 3: dealembub folded on the Turn
Seat 4: Dorex2007 folded before Flop (didn't bet)
Seat 5: sprintergaul folded on the Turn
Seat 6: Gora858 folded before Flop (didn't bet)
Seat 7: mimimouse6 folded before Flop (didn't bet)
Seat 8: VIST0988 folded before Flop (didn't bet)
Seat 9: NocnyFryzjer (button) folded before Flop (didn't bet)



PokerStars Hand #228375993890:  Hold'em No Limit ($0.01/$0.02 USD) - 2021/07/18 0:41:24 PT [2021/07/18 3:41:24 ET]
Table 'Philia' 9-max Seat #1 is the button
Seat 1: zielonysnipe ($2.42 in chips) 
Seat 2: sleeper hipi ($7.97 in chips) 
Seat 3: dealembub ($0.28 in chips) 
Seat 4: Dorex2007 ($4 in chips) 
Seat 5: sprintergaul ($0.92 in chips) 
Seat 6: Gora858 ($4.77 in chips) 
Seat 7: mimimouse6 ($2.90 in chips) 
Seat 8: VIST0988 ($1.15 in chips) 
Seat 9: NocnyFryzjer ($1.54 in chips) 
sleeper hipi: posts small blind $0.01
dealembub: posts big blind $0.02
*** HOLE CARDS ***
Dealt to Dorex2007 [5s Ah]
Dorex2007: folds 
sprintergaul: folds 
Gora858: folds 
mimimouse6: folds 
VIST0988 has timed out
VIST0988: folds 
NocnyFryzjer: raises $0.04 to $0.06
zielonysnipe: folds 
sleeper hipi: folds 
dealembub: folds 
Uncalled bet ($0.04) returned to NocnyFryzjer
NocnyFryzjer collected $0.05 from pot
NocnyFryzjer: doesn't show hand 
*** SUMMARY ***
Total pot $0.05 | Rake $0 
Seat 1: zielonysnipe (button) folded before Flop (didn't bet)
Seat 2: sleeper hipi (small blind) folded before Flop
Seat 3: dealembub (big blind) folded before Flop
Seat 4: Dorex2007 folded before Flop (didn't bet)
Seat 5: sprintergaul folded before Flop (didn't bet)
Seat 6: Gora858 folded before Flop (didn't bet)
Seat 7: mimimouse6 folded before Flop (didn't bet)
Seat 8: VIST0988 folded before Flop (didn't bet)
Seat 9: NocnyFryzjer collected ($0.05)



PokerStars Hand #228375999247:  Hold'em No Limit ($0.01/$0.02 USD) - 2021/07/18 0:41:57 PT [2021/07/18 3:41:57 ET]
Table 'Philia' 9-max Seat #2 is the button
Seat 1: zielonysnipe ($2.42 in chips) 
Seat 2: sleeper hipi ($7.96 in chips) 
Seat 3: dealembub ($1.82 in chips) 
Seat 4: Dorex2007 ($4 in chips) 
Seat 5: sprintergaul ($0.92 in chips) 
Seat 6: Gora858 ($4.77 in chips) 
Seat 7: mimimouse6 ($2.90 in chips) 
Seat 9: NocnyFryzjer ($1.57 in chips) 
dealembub: posts small blind $0.01
Dorex2007: posts big blind $0.02
*** HOLE CARDS ***
Dealt to Dorex2007 [2d 8s]
sprintergaul: calls $0.02
VIST0988 leaves the table
Gora858: folds 
mimimouse6: folds 
NocnyFryzjer: folds 
zielonysnipe: folds 
sleeper hipi: folds 
dealembub: calls $0.01
Dorex2007: checks 
*** FLOP *** [Th 4c Js]
dealembub: checks 
Dorex2007: checks 
sprintergaul: bets $0.02
dealembub: calls $0.02
Dorex2007: folds 
*** TURN *** [Th 4c Js] [6c]
dealembub: checks 
Koksmix87 joins the table at seat #8 
sprintergaul: bets $0.04
dealembub: folds 
Uncalled bet ($0.04) returned to sprintergaul
sprintergaul collected $0.10 from pot
sprintergaul: doesn't show hand 
*** SUMMARY ***
Total pot $0.10 | Rake $0 
Board [Th 4c Js 6c]
Seat 1: zielonysnipe folded before Flop (didn't bet)
Seat 2: sleeper hipi (button) folded before Flop (didn't bet)
Seat 3: dealembub (small blind) folded on the Turn
Seat 4: Dorex2007 (big blind) folded on the Flop
Seat 5: sprintergaul collected ($0.10)
Seat 6: Gora858 folded before Flop (didn't bet)
Seat 7: mimimouse6 folded before Flop (didn't bet)
Seat 9: NocnyFryzjer folded before Flop (didn't bet)



PokerStars Hand #228376007066:  Hold'em No Limit ($0.01/$0.02 USD) - 2021/07/18 0:42:45 PT [2021/07/18 3:42:45 ET]
Table 'Philia' 9-max Seat #3 is the button
Seat 1: zielonysnipe ($2.42 in chips) 
Seat 2: sleeper hipi ($7.96 in chips) 
Seat 3: dealembub ($1.96 in chips) 
Seat 4: Dorex2007 ($3.98 in chips) 
Seat 5: sprintergaul ($0.98 in chips) 
Seat 6: Gora858 ($4.77 in chips) 
Seat 7: mimimouse6 ($2.90 in chips) 
Seat 9: NocnyFryzjer ($1.57 in chips) 
Dorex2007: posts small blind $0.01
sprintergaul: posts big blind $0.02
Koksmix87: sits out 
*** HOLE CARDS ***
Dealt to Dorex2007 [2s Jd]
Gora858: raises $0.02 to $0.04
mimimouse6: folds 
NocnyFryzjer: folds 
zielonysnipe: calls $0.04
sleeper hipi: folds 
dealembub: calls $0.04
Dorex2007: folds 
sprintergaul: calls $0.02
*** FLOP *** [Ad 6d 4s]
sprintergaul: checks 
Gora858: checks 
zielonysnipe: bets $0.10
dealembub: folds 
sprintergaul: folds 
Gora858: folds 
Uncalled bet ($0.10) returned to zielonysnipe
zielonysnipe collected $0.16 from pot
zielonysnipe: doesn't show hand 
*** SUMMARY ***
Total pot $0.17 | Rake $0.01 
Board [Ad 6d 4s]
Seat 1: zielonysnipe collected ($0.16)
Seat 2: sleeper hipi folded before Flop (didn't bet)
Seat 3: dealembub (button) folded on the Flop
Seat 4: Dorex2007 (small blind) folded before Flop
Seat 5: sprintergaul (big blind) folded on the Flop
Seat 6: Gora858 folded on the Flop
Seat 7: mimimouse6 folded before Flop (didn't bet)
Seat 9: NocnyFryzjer folded before Flop (didn't bet)



PokerStars Hand #228376015055:  Hold'em No Limit ($0.01/$0.02 USD) - 2021/07/18 0:43:34 PT [2021/07/18 3:43:34 ET]
Table 'Philia' 9-max Seat #4 is the button
Seat 1: zielonysnipe ($2.54 in chips) 
Seat 2: sleeper hipi ($7.96 in chips) 
Seat 3: dealembub ($1.92 in chips) 
Seat 4: Dorex2007 ($3.97 in chips) 
Seat 5: sprintergaul ($0.94 in chips) 
Seat 6: Gora858 ($4.73 in chips) 
Seat 7: mimimouse6 ($2.90 in chips) 
Seat 9: NocnyFryzjer ($1.57 in chips) 
sprintergaul: posts small blind $0.01
Gora858: posts big blind $0.02
Koksmix87: sits out 
*** HOLE CARDS ***
Dealt to Dorex2007 [Jh 5s]
mimimouse6: folds 
NocnyFryzjer: folds 
zielonysnipe: folds 
sleeper hipi: folds 
dealembub: raises $0.02 to $0.04
Dorex2007: folds 
sprintergaul: folds 
Gora858: folds 
Uncalled bet ($0.02) returned to dealembub
dealembub collected $0.05 from pot
dealembub: doesn't show hand 
*** SUMMARY ***
Total pot $0.05 | Rake $0 
Seat 1: zielonysnipe folded before Flop (didn't bet)
Seat 2: sleeper hipi folded before Flop (didn't bet)
Seat 3: dealembub collected ($0.05)
Seat 4: Dorex2007 (button) folded before Flop (didn't bet)
Seat 5: sprintergaul (small blind) folded before Flop
Seat 6: Gora858 (big blind) folded before Flop
Seat 7: mimimouse6 folded before Flop (didn't bet)
Seat 9: NocnyFryzjer folded before Flop (didn't bet)



PokerStars Hand #228376018261:  Hold'em No Limit ($0.01/$0.02 USD) - 2021/07/18 0:43:54 PT [2021/07/18 3:43:54 ET]
Table 'Philia' 9-max Seat #5 is the button
Seat 1: zielonysnipe ($2.54 in chips) 
Seat 2: sleeper hipi ($7.96 in chips) 
Seat 3: dealembub ($1.95 in chips) 
Seat 4: Dorex2007 ($3.97 in chips) 
Seat 5: sprintergaul ($0.93 in chips) 
Seat 6: Gora858 ($4.71 in chips) 
Seat 7: mimimouse6 ($2.90 in chips) 
Seat 9: NocnyFryzjer ($1.57 in chips) 
Gora858: posts small blind $0.01
mimimouse6: posts big blind $0.02
Koksmix87: sits out 
*** HOLE CARDS ***
Dealt to Dorex2007 [Kd 8s]
NocnyFryzjer has timed out
NocnyFryzjer: folds 
zielonysnipe: folds 
sleeper hipi: folds 
dealembub: folds 
Dorex2007: folds 
sprintergaul: folds 
Gora858: folds 
Uncalled bet ($0.01) returned to mimimouse6
mimimouse6 collected $0.02 from pot
mimimouse6: doesn't show hand 
*** SUMMARY ***
Total pot $0.02 | Rake $0 
Seat 1: zielonysnipe folded before Flop (didn't bet)
Seat 2: sleeper hipi folded before Flop (didn't bet)
Seat 3: dealembub folded before Flop (didn't bet)
Seat 4: Dorex2007 folded before Flop (didn't bet)
Seat 5: sprintergaul (button) folded before Flop (didn't bet)
Seat 6: Gora858 (small blind) folded before Flop
Seat 7: mimimouse6 (big blind) collected ($0.02)
Seat 9: NocnyFryzjer folded before Flop (didn't bet)



PokerStars Hand #228376021858:  Hold'em No Limit ($0.01/$0.02 USD) - 2021/07/18 0:44:16 PT [2021/07/18 3:44:16 ET]
Table 'Philia' 9-max Seat #6 is the button
Seat 1: zielonysnipe ($2.54 in chips) 
Seat 2: sleeper hipi ($7.96 in chips) 
Seat 3: dealembub ($1.95 in chips) 
Seat 4: Dorex2007 ($3.97 in chips) 
Seat 5: sprintergaul ($0.93 in chips) 
Seat 6: Gora858 ($4.70 in chips) 
Seat 7: mimimouse6 ($2.91 in chips) 
Seat 8: Koksmix87 ($2 in chips) 
Seat 9: NocnyFryzjer ($1.57 in chips) 
mimimouse6: posts small blind $0.01
Koksmix87: posts big blind $0.02
*** HOLE CARDS ***
Dealt to Dorex2007 [4s Th]
NocnyFryzjer: folds 
zielonysnipe: folds 
sleeper hipi: folds 
dealembub: calls $0.02
Dorex2007: folds 
sprintergaul: calls $0.02
Gora858: folds 
mimimouse6: calls $0.01
Koksmix87: checks 
*** FLOP *** [Kd 6h Ks]
mimimouse6: checks 
Koksmix87: checks 
dealembub: checks 
sprintergaul: checks 
*** TURN *** [Kd 6h Ks] [3s]
mimimouse6: checks 
Koksmix87: checks 
dealembub: checks 
sprintergaul: checks 
*** RIVER *** [Kd 6h Ks 3s] [9d]
mimimouse6: checks 
Koksmix87: checks 
dealembub: checks 
sprintergaul: checks 
*** SHOW DOWN ***
mimimouse6: shows [8d Jd] (a pair of Kings)
Koksmix87: shows [6d Qh] (two pair, Kings and Sixes)
dealembub: mucks hand 
sprintergaul: mucks hand 
Koksmix87 collected $0.08 from pot
*** SUMMARY ***
Total pot $0.08 | Rake $0 
Board [Kd 6h Ks 3s 9d]
Seat 1: zielonysnipe folded before Flop (didn't bet)
Seat 2: sleeper hipi folded before Flop (didn't bet)
Seat 3: dealembub mucked [4d Ac]
Seat 4: Dorex2007 folded before Flop (didn't bet)
Seat 5: sprintergaul mucked [Qc Ad]
Seat 6: Gora858 (button) folded before Flop (didn't bet)
Seat 7: mimimouse6 (small blind) showed [8d Jd] and lost with a pair of Kings
Seat 8: Koksmix87 (big blind) showed [6d Qh] and won ($0.08) with two pair, Kings and Sixes
Seat 9: NocnyFryzjer folded before Flop (didn't bet)



PokerStars Hand #228376032187:  Hold'em No Limit ($0.01/$0.02 USD) - 2021/07/18 0:45:19 PT [2021/07/18 3:45:19 ET]
Table 'Philia' 9-max Seat #7 is the button
Seat 1: zielonysnipe ($2.54 in chips) 
Seat 2: sleeper hipi ($7.96 in chips) 
Seat 3: dealembub ($1.93 in chips) 
Seat 4: Dorex2007 ($3.97 in chips) 
Seat 5: sprintergaul ($0.91 in chips) 
Seat 6: Gora858 ($4.70 in chips) 
Seat 7: mimimouse6 ($2.89 in chips) 
Seat 8: Koksmix87 ($2.06 in chips) 
Seat 9: NocnyFryzjer ($1.57 in chips) 
Koksmix87: posts small blind $0.01
NocnyFryzjer: posts big blind $0.02
*** HOLE CARDS ***
Dealt to Dorex2007 [Jh Ah]
zielonysnipe: folds 
sleeper hipi: raises $0.04 to $0.06
dealembub: folds 
Dorex2007: calls $0.06
sprintergaul: folds 
Gora858: folds 
mimimouse6: folds 
Koksmix87: folds 
NocnyFryzjer: folds 
*** FLOP *** [4c Qc Ks]
sleeper hipi: bets $0.08
Dorex2007: folds 
Uncalled bet ($0.08) returned to sleeper hipi
sleeper hipi collected $0.14 from pot
sleeper hipi: doesn't show hand 
*** SUMMARY ***
Total pot $0.15 | Rake $0.01 
Board [4c Qc Ks]
Seat 1: zielonysnipe folded before Flop (didn't bet)
Seat 2: sleeper hipi collected ($0.14)
Seat 3: dealembub folded before Flop (didn't bet)
Seat 4: Dorex2007 folded on the Flop
Seat 5: sprintergaul folded before Flop (didn't bet)
Seat 6: Gora858 folded before Flop (didn't bet)
Seat 7: mimimouse6 (button) folded before Flop (didn't bet)
Seat 8: Koksmix87 (small blind) folded before Flop
Seat 9: NocnyFryzjer (big blind) folded before Flop



PokerStars Hand #228376039028:  Hold'em No Limit ($0.01/$0.02 USD) - 2021/07/18 0:46:01 PT [2021/07/18 3:46:01 ET]
Table 'Philia' 9-max Seat #8 is the button
Seat 1: zielonysnipe ($2.54 in chips) 
Seat 2: sleeper hipi ($8.04 in chips) 
Seat 3: dealembub ($1.93 in chips) 
Seat 4: Dorex2007 ($3.91 in chips) 
Seat 5: sprintergaul ($0.91 in chips) 
Seat 6: Gora858 ($4.70 in chips) 
Seat 7: mimimouse6 ($2.89 in chips) 
Seat 8: Koksmix87 ($2.05 in chips) 
Seat 9: NocnyFryzjer ($1.55 in chips) 
NocnyFryzjer: posts small blind $0.01
zielonysnipe: posts big blind $0.02
*** HOLE CARDS ***
Dealt to Dorex2007 [4c 5s]
sleeper hipi: folds 
dealembub: calls $0.02
Dorex2007: folds 
sprintergaul: folds 
Gora858: folds 
mimimouse6: folds 
Koksmix87: folds 
NocnyFryzjer: folds 
zielonysnipe: checks 
*** FLOP *** [Ks 4d 5d]
zielonysnipe: bets $0.06
dealembub: folds 
Uncalled bet ($0.06) returned to zielonysnipe
zielonysnipe collected $0.05 from pot
zielonysnipe: doesn't show hand 
*** SUMMARY ***
Total pot $0.05 | Rake $0 
Board [Ks 4d 5d]
Seat 1: zielonysnipe (big blind) collected ($0.05)
Seat 2: sleeper hipi folded before Flop (didn't bet)
Seat 3: dealembub folded on the Flop
Seat 4: Dorex2007 folded before Flop (didn't bet)
Seat 5: sprintergaul folded before Flop (didn't bet)
Seat 6: Gora858 folded before Flop (didn't bet)
Seat 7: mimimouse6 folded before Flop (didn't bet)
Seat 8: Koksmix87 (button) folded before Flop (didn't bet)
Seat 9: NocnyFryzjer (small blind) folded before Flop



PokerStars Hand #228376043717:  Hold'em No Limit ($0.01/$0.02 USD) - 2021/07/18 0:46:28 PT [2021/07/18 3:46:28 ET]
Table 'Philia' 9-max Seat #9 is the button
Seat 1: zielonysnipe ($2.57 in chips) 
Seat 2: sleeper hipi ($8.04 in chips) 
Seat 3: dealembub ($1.91 in chips) 
Seat 4: Dorex2007 ($3.91 in chips) 
Seat 5: sprintergaul ($0.91 in chips) 
Seat 6: Gora858 ($4.70 in chips) 
Seat 7: mimimouse6 ($2.89 in chips) 
Seat 8: Koksmix87 ($2.05 in chips) 
Seat 9: NocnyFryzjer ($1.54 in chips) 
zielonysnipe: posts small blind $0.01
sleeper hipi: posts big blind $0.02
*** HOLE CARDS ***
Dealt to Dorex2007 [3h Qc]
dealembub: folds 
Dorex2007: folds 
sprintergaul: folds 
Gora858: folds 
mimimouse6: raises $0.04 to $0.06
Koksmix87: folds 
NocnyFryzjer: folds 
zielonysnipe: folds 
sleeper hipi: calls $0.04
*** FLOP *** [Ad 8d Jd]
Dorex2007 said, "I"m going to quit playing the cards I'm supposed to and start playing the ones I"m supposed to fold"
Dorex2007 said, "they hit more often"
sleeper hipi: checks 
mimimouse6: bets $0.07
dealembub said, "lol...i know...same for me"
sleeper hipi: folds 
Uncalled bet ($0.07) returned to mimimouse6
mimimouse6 collected $0.13 from pot
mimimouse6: doesn't show hand 
*** SUMMARY ***
Total pot $0.13 | Rake $0 
Board [Ad 8d Jd]
Seat 1: zielonysnipe (small blind) folded before Flop
Seat 2: sleeper hipi (big blind) folded on the Flop
Seat 3: dealembub folded before Flop (didn't bet)
Seat 4: Dorex2007 folded before Flop (didn't bet)
Seat 5: sprintergaul folded before Flop (didn't bet)
Seat 6: Gora858 folded before Flop (didn't bet)
Seat 7: mimimouse6 collected ($0.13)
Seat 8: Koksmix87 folded before Flop (didn't bet)
Seat 9: NocnyFryzjer (button) folded before Flop (didn't bet)



PokerStars Hand #228376052289:  Hold'em No Limit ($0.01/$0.02 USD) - 2021/07/18 0:47:20 PT [2021/07/18 3:47:20 ET]
Table 'Philia' 9-max Seat #1 is the button
Seat 1: zielonysnipe ($2.56 in chips) 
Seat 2: sleeper hipi ($7.98 in chips) 
Seat 3: dealembub ($1.91 in chips) 
Seat 4: Dorex2007 ($3.91 in chips) 
Seat 5: sprintergaul ($0.91 in chips) 
Seat 6: Gora858 ($4.70 in chips) 
Seat 7: mimimouse6 ($2.96 in chips) 
Seat 8: Koksmix87 ($2.05 in chips) 
Seat 9: NocnyFryzjer ($1.54 in chips) 
sleeper hipi: posts small blind $0.01
dealembub: posts big blind $0.02
*** HOLE CARDS ***
Dealt to Dorex2007 [Jd 6h]
Dorex2007: folds 
sprintergaul: folds 
Gora858: raises $0.02 to $0.04
mimimouse6: folds 
Koksmix87: folds 
NocnyFryzjer: folds 
zielonysnipe: folds 
sleeper hipi: folds 
dealembub: calls $0.02
*** FLOP *** [Qd 9d 5c]
dealembub: bets $0.09
Gora858: folds 
Uncalled bet ($0.09) returned to dealembub
dealembub collected $0.09 from pot
dealembub: doesn't show hand 
dealembub said, "last night i took a break...then went up to the 2/5 and 5/10 tables."
*** SUMMARY ***
Total pot $0.09 | Rake $0 
Board [Qd 9d 5c]
Seat 1: zielonysnipe (button) folded before Flop (didn't bet)
Seat 2: sleeper hipi (small blind) folded before Flop
Seat 3: dealembub (big blind) collected ($0.09)
Seat 4: Dorex2007 folded before Flop (didn't bet)
Seat 5: sprintergaul folded before Flop (didn't bet)
Seat 6: Gora858 folded on the Flop
Seat 7: mimimouse6 folded before Flop (didn't bet)
Seat 8: Koksmix87 folded before Flop (didn't bet)
Seat 9: NocnyFryzjer folded before Flop (didn't bet)



PokerStars Hand #228376061474:  Hold'em No Limit ($0.01/$0.02 USD) - 2021/07/18 0:48:16 PT [2021/07/18 3:48:16 ET]
Table 'Philia' 9-max Seat #2 is the button
Seat 1: zielonysnipe ($2.56 in chips) 
Seat 2: sleeper hipi ($7.97 in chips) 
Seat 3: dealembub ($1.96 in chips) 
Seat 4: Dorex2007 ($3.91 in chips) 
Seat 5: sprintergaul ($0.91 in chips) 
Seat 6: Gora858 ($4.66 in chips) 
Seat 7: mimimouse6 ($2.96 in chips) 
Seat 8: Koksmix87 ($2.05 in chips) 
Seat 9: NocnyFryzjer ($1.54 in chips) 
dealembub: posts small blind $0.01
Dorex2007: posts big blind $0.02
*** HOLE CARDS ***
Dealt to Dorex2007 [Js Td]
sprintergaul: calls $0.02
Gora858: folds 
mimimouse6: folds 
dealembub said, "made out very well in just a few hands"
Koksmix87: folds 
NocnyFryzjer: raises $0.04 to $0.06
zielonysnipe: folds 
sleeper hipi: folds 
dealembub: calls $0.05
Dorex2007: folds 
sprintergaul: calls $0.04
*** FLOP *** [5h 9d 3c]
Dorex2007 said, "nice"
dealembub: checks 
sprintergaul: checks 
NocnyFryzjer: bets $0.10
dealembub: folds 
sprintergaul: folds 
Uncalled bet ($0.10) returned to NocnyFryzjer
NocnyFryzjer collected $0.19 from pot
NocnyFryzjer: doesn't show hand 
*** SUMMARY ***
Total pot $0.20 | Rake $0.01 
Board [5h 9d 3c]
Seat 1: zielonysnipe folded before Flop (didn't bet)
Seat 2: sleeper hipi (button) folded before Flop (didn't bet)
Seat 3: dealembub (small blind) folded on the Flop
Seat 4: Dorex2007 (big blind) folded before Flop
Seat 5: sprintergaul folded on the Flop
Seat 6: Gora858 folded before Flop (didn't bet)
Seat 7: mimimouse6 folded before Flop (didn't bet)
Seat 8: Koksmix87 folded before Flop (didn't bet)
Seat 9: NocnyFryzjer collected ($0.19)



PokerStars Hand #228376069280:  Hold'em No Limit ($0.01/$0.02 USD) - 2021/07/18 0:49:03 PT [2021/07/18 3:49:03 ET]
Table 'Philia' 9-max Seat #3 is the button
Seat 1: zielonysnipe ($2.56 in chips) 
Seat 2: sleeper hipi ($7.97 in chips) 
Seat 3: dealembub ($1.90 in chips) 
Seat 4: Dorex2007 ($3.89 in chips) 
Seat 6: Gora858 ($4.66 in chips) 
Seat 7: mimimouse6 ($2.96 in chips) 
Seat 8: Koksmix87 ($2.05 in chips) 
Seat 9: NocnyFryzjer ($1.67 in chips) 
Dorex2007: posts small blind $0.01
sprintergaul: is sitting out 
Gora858: posts big blind $0.02
*** HOLE CARDS ***
Dealt to Dorex2007 [6h 8c]
mimimouse6: raises $0.04 to $0.06
sprintergaul leaves the table
Koksmix87: raises $0.15 to $0.21
NocnyFryzjer: folds 
zielonysnipe: folds 
sleeper hipi: folds 
dealembub: folds 
Dorex2007: folds 
Gora858: raises $4.45 to $4.66 and is all-in
mimimouse6: folds 
Koksmix87: folds 
Uncalled bet ($4.45) returned to Gora858
Gora858 collected $0.49 from pot
*** SUMMARY ***
Total pot $0.49 | Rake $0 
Seat 1: zielonysnipe folded before Flop (didn't bet)
Seat 2: sleeper hipi folded before Flop (didn't bet)
Seat 3: dealembub (button) folded before Flop (didn't bet)
Seat 4: Dorex2007 (small blind) folded before Flop
Seat 6: Gora858 (big blind) collected ($0.49)
Seat 7: mimimouse6 folded before Flop
Seat 8: Koksmix87 folded before Flop
Seat 9: NocnyFryzjer folded before Flop (didn't bet)



PokerStars Hand #228376075114:  Hold'em No Limit ($0.01/$0.02 USD) - 2021/07/18 0:49:39 PT [2021/07/18 3:49:39 ET]
Table 'Philia' 9-max Seat #4 is the button
Seat 1: zielonysnipe ($2.56 in chips) 
Seat 2: sleeper hipi ($7.97 in chips) 
Seat 3: dealembub ($1.90 in chips) 
Seat 4: Dorex2007 ($3.88 in chips) 
Seat 6: Gora858 ($4.94 in chips) 
Seat 7: mimimouse6 ($2.90 in chips) 
Seat 8: Koksmix87 ($2 in chips) 
Seat 9: NocnyFryzjer ($1.67 in chips) 
Gora858: posts small blind $0.01
mimimouse6: posts big blind $0.02
*** HOLE CARDS ***
Dealt to Dorex2007 [8d Jh]
Koksmix87: folds 
NocnyFryzjer: folds 
zielonysnipe: folds 
sleeper hipi: raises $0.04 to $0.06
Lord7 Sergio joins the table at seat #5 
dealembub: calls $0.06
Dorex2007: folds 
Gora858: folds 
mimimouse6: calls $0.04
*** FLOP *** [5c Jd 8h]
mimimouse6: checks 
sleeper hipi: bets $0.09
dealembub: raises $0.09 to $0.18
mimimouse6: folds 
sleeper hipi: calls $0.09
*** TURN *** [5c Jd 8h] [Ks]
sleeper hipi: checks 
dealembub: bets $0.53
sleeper hipi: folds 
Uncalled bet ($0.53) returned to dealembub
dealembub collected $0.53 from pot
dealembub: doesn't show hand 
*** SUMMARY ***
Total pot $0.55 | Rake $0.02 
Board [5c Jd 8h Ks]
Seat 1: zielonysnipe folded before Flop (didn't bet)
Seat 2: sleeper hipi folded on the Turn
Seat 3: dealembub collected ($0.53)
Seat 4: Dorex2007 (button) folded before Flop (didn't bet)
Seat 6: Gora858 (small blind) folded before Flop
Seat 7: mimimouse6 (big blind) folded on the Flop
Seat 8: Koksmix87 folded before Flop (didn't bet)
Seat 9: NocnyFryzjer folded before Flop (didn't bet)



PokerStars Hand #228376082927:  Hold'em No Limit ($0.01/$0.02 USD) - 2021/07/18 0:50:27 PT [2021/07/18 3:50:27 ET]
Table 'Philia' 9-max Seat #6 is the button
Seat 1: zielonysnipe ($2.56 in chips) 
Seat 2: sleeper hipi ($7.73 in chips) 
Seat 3: dealembub ($2.19 in chips) 
Seat 4: Dorex2007 ($3.88 in chips) 
Seat 6: Gora858 ($4.93 in chips) 
Seat 7: mimimouse6 ($2.84 in chips) 
Seat 8: Koksmix87 ($2 in chips) 
Seat 9: NocnyFryzjer ($1.67 in chips) 
mimimouse6: posts small blind $0.01
Koksmix87: posts big blind $0.02
Lord7 Sergio: sits out 
*** HOLE CARDS ***
Dealt to Dorex2007 [Qh 5d]
NocnyFryzjer: folds 
zielonysnipe: folds 
sleeper hipi: folds 
dealembub: folds 
Dorex2007: folds 
Gora858: folds 
dealembub said, "trips"
mimimouse6: folds 
Uncalled bet ($0.01) returned to Koksmix87
Koksmix87 collected $0.02 from pot
Koksmix87: doesn't show hand 
*** SUMMARY ***
Total pot $0.02 | Rake $0 
Seat 1: zielonysnipe folded before Flop (didn't bet)
Seat 2: sleeper hipi folded before Flop (didn't bet)
Seat 3: dealembub folded before Flop (didn't bet)
Seat 4: Dorex2007 folded before Flop (didn't bet)
Seat 6: Gora858 (button) folded before Flop (didn't bet)
Seat 7: mimimouse6 (small blind) folded before Flop
Seat 8: Koksmix87 (big blind) collected ($0.02)
Seat 9: NocnyFryzjer folded before Flop (didn't bet)



PokerStars Hand #228376084811:  Hold'em No Limit ($0.01/$0.02 USD) - 2021/07/18 0:50:38 PT [2021/07/18 3:50:38 ET]
Table 'Philia' 9-max Seat #7 is the button
Seat 1: zielonysnipe ($2.56 in chips) 
Seat 2: sleeper hipi ($7.73 in chips) 
Seat 3: dealembub ($2.19 in chips) 
Seat 4: Dorex2007 ($3.88 in chips) 
Seat 5: Lord7 Sergio ($2.03 in chips) 
Seat 6: Gora858 ($4.93 in chips) 
Seat 7: mimimouse6 ($2.83 in chips) 
Seat 8: Koksmix87 ($2.01 in chips) 
Seat 9: NocnyFryzjer ($1.67 in chips) 
Koksmix87: posts small blind $0.01
NocnyFryzjer: posts big blind $0.02
Lord7 Sergio: posts big blind $0.02
*** HOLE CARDS ***
Dealt to Dorex2007 [8h 3d]
zielonysnipe: folds 
sleeper hipi: folds 
dealembub: folds 
Dorex2007: folds 
Lord7 Sergio: checks 
Gora858: folds 
mimimouse6: folds 
Koksmix87: calls $0.01
NocnyFryzjer: checks 
*** FLOP *** [Th 5s 2c]
Koksmix87: checks 
NocnyFryzjer: checks 
Dorex2007 said, "i'd of flopped 2 pair and been all in  LOL"
Lord7 Sergio: checks 
*** TURN *** [Th 5s 2c] [Ks]
Koksmix87: checks 
Dorex2007 said, "J & 8"
NocnyFryzjer: bets $0.04
Lord7 Sergio: folds 
dealembub said, "you're welcome to donate anytime"
Koksmix87: folds 
Uncalled bet ($0.04) returned to NocnyFryzjer
dealembub said, "all contributions are welcome"
NocnyFryzjer collected $0.06 from pot
NocnyFryzjer: doesn't show hand 
*** SUMMARY ***
Total pot $0.06 | Rake $0 
Board [Th 5s 2c Ks]
Seat 1: zielonysnipe folded before Flop (didn't bet)
Seat 2: sleeper hipi folded before Flop (didn't bet)
Seat 3: dealembub folded before Flop (didn't bet)
Seat 4: Dorex2007 folded before Flop (didn't bet)
Seat 5: Lord7 Sergio folded on the Turn (didn't bet)
Seat 6: Gora858 folded before Flop (didn't bet)
Seat 7: mimimouse6 (button) folded before Flop (didn't bet)
Seat 8: Koksmix87 (small blind) folded on the Turn
Seat 9: NocnyFryzjer (big blind) collected ($0.06)



PokerStars Hand #228376093551:  Hold'em No Limit ($0.01/$0.02 USD) - 2021/07/18 0:51:31 PT [2021/07/18 3:51:31 ET]
Table 'Philia' 9-max Seat #8 is the button
Seat 1: zielonysnipe ($2.56 in chips) 
Seat 2: sleeper hipi ($7.73 in chips) 
Seat 3: dealembub ($2.19 in chips) 
Seat 4: Dorex2007 ($3.88 in chips) 
Seat 5: Lord7 Sergio ($2.01 in chips) 
Seat 6: Gora858 ($4.93 in chips) 
Seat 7: mimimouse6 ($2.83 in chips) 
Seat 8: Koksmix87 ($2 in chips) 
Seat 9: NocnyFryzjer ($1.71 in chips) 
NocnyFryzjer: posts small blind $0.01
zielonysnipe: posts big blind $0.02
*** HOLE CARDS ***
Dealt to Dorex2007 [4s Kd]
Dorex2007 said, "you still owe me coffee"
sleeper hipi: folds 
dealembub: raises $0.02 to $0.04
Dorex2007: folds 
Lord7 Sergio: raises $0.06 to $0.10
Gora858: folds 
mimimouse6: folds 
dealembub said, "i need to go make a pot of 4"
Koksmix87: folds 
NocnyFryzjer: folds 
zielonysnipe: folds 
dealembub: calls $0.06
*** FLOP *** [4d 9d Jc]
dealembub: checks 
Lord7 Sergio: bets $0.22
dealembub: calls $0.22
*** TURN *** [4d 9d Jc] [Ad]
dealembub: checks 
Lord7 Sergio: bets $0.32
dealembub: folds 
Uncalled bet ($0.32) returned to Lord7 Sergio
Lord7 Sergio collected $0.65 from pot
Lord7 Sergio: doesn't show hand 
*** SUMMARY ***
Total pot $0.67 | Rake $0.02 
Board [4d 9d Jc Ad]
Seat 1: zielonysnipe (big blind) folded before Flop
Seat 2: sleeper hipi folded before Flop (didn't bet)
Seat 3: dealembub folded on the Turn
Seat 4: Dorex2007 folded before Flop (didn't bet)
Seat 5: Lord7 Sergio collected ($0.65)
Seat 6: Gora858 folded before Flop (didn't bet)
Seat 7: mimimouse6 folded before Flop (didn't bet)
Seat 8: Koksmix87 (button) folded before Flop (didn't bet)
Seat 9: NocnyFryzjer (small blind) folded before Flop



PokerStars Hand #228376100613:  Hold'em No Limit ($0.01/$0.02 USD) - 2021/07/18 0:52:14 PT [2021/07/18 3:52:14 ET]
Table 'Philia' 9-max Seat #9 is the button
Seat 1: zielonysnipe ($2.54 in chips) 
Seat 2: sleeper hipi ($7.73 in chips) 
Seat 3: dealembub ($1.87 in chips) 
Seat 4: Dorex2007 ($3.88 in chips) 
Seat 5: Lord7 Sergio ($2.34 in chips) 
Seat 6: Gora858 ($4.93 in chips) 
Seat 7: mimimouse6 ($2.83 in chips) 
Seat 8: Koksmix87 ($2 in chips) 
Seat 9: NocnyFryzjer ($1.70 in chips) 
zielonysnipe: posts small blind $0.01
sleeper hipi: posts big blind $0.02
*** HOLE CARDS ***
Dealt to Dorex2007 [8c As]
dealembub: raises $0.02 to $0.04
Dorex2007: folds 
Lord7 Sergio: folds 
Gora858: calls $0.04
mimimouse6: folds 
Koksmix87: folds 
NocnyFryzjer: folds 
zielonysnipe: folds 
sleeper hipi: folds 
*** FLOP *** [Kc 3c 4d]
dealembub: bets $0.12
Gora858: calls $0.12
*** TURN *** [Kc 3c 4d] [Qd]
dealembub: bets $0.40
Gora858: folds 
Uncalled bet ($0.40) returned to dealembub
dealembub collected $0.34 from pot
dealembub: doesn't show hand 
*** SUMMARY ***
Total pot $0.35 | Rake $0.01 
Board [Kc 3c 4d Qd]
Seat 1: zielonysnipe (small blind) folded before Flop
Seat 2: sleeper hipi (big blind) folded before Flop
Seat 3: dealembub collected ($0.34)
Seat 4: Dorex2007 folded before Flop (didn't bet)
Seat 5: Lord7 Sergio folded before Flop (didn't bet)
Seat 6: Gora858 folded on the Turn
Seat 7: mimimouse6 folded before Flop (didn't bet)
Seat 8: Koksmix87 folded before Flop (didn't bet)
Seat 9: NocnyFryzjer (button) folded before Flop (didn't bet)



PokerStars Hand #228376107497:  Hold'em No Limit ($0.01/$0.02 USD) - 2021/07/18 0:52:56 PT [2021/07/18 3:52:56 ET]
Table 'Philia' 9-max Seat #1 is the button
Seat 1: zielonysnipe ($2.53 in chips) 
Seat 2: sleeper hipi ($7.71 in chips) 
Seat 3: dealembub ($2.05 in chips) 
Seat 4: Dorex2007 ($3.88 in chips) 
Seat 5: Lord7 Sergio ($2.34 in chips) 
Seat 6: Gora858 ($4.77 in chips) 
Seat 7: mimimouse6 ($2.83 in chips) 
Seat 8: Koksmix87 ($2 in chips) 
Seat 9: NocnyFryzjer ($1.70 in chips) 
sleeper hipi: posts small blind $0.01
dealembub: posts big blind $0.02
*** HOLE CARDS ***
Dealt to Dorex2007 [5c Jh]
Dorex2007: folds 
Lord7 Sergio: folds 
Gora858: raises $0.02 to $0.04
dealembub said, "brb"
mimimouse6: calls $0.04
Koksmix87: folds 
NocnyFryzjer: folds 
zielonysnipe: folds 
sleeper hipi: calls $0.03
dealembub: folds 
*** FLOP *** [Qc 3s 5s]
sleeper hipi: checks 
Gora858: bets $0.07
mimimouse6: raises $0.15 to $0.22
sleeper hipi: folds 
Gora858: calls $0.15
*** TURN *** [Qc 3s 5s] [9c]
Gora858: bets $0.14
mimimouse6: raises $0.14 to $0.28
Gora858: calls $0.14
*** RIVER *** [Qc 3s 5s 9c] [6c]
Gora858: checks 
mimimouse6: checks 
*** SHOW DOWN ***
Gora858: shows [9s Ts] (a pair of Nines)
mimimouse6: shows [Qs Js] (a pair of Queens)
mimimouse6 collected $1.10 from pot
*** SUMMARY ***
Total pot $1.14 | Rake $0.04 
Board [Qc 3s 5s 9c 6c]
Seat 1: zielonysnipe (button) folded before Flop (didn't bet)
Seat 2: sleeper hipi (small blind) folded on the Flop
Seat 3: dealembub (big blind) folded before Flop
Seat 4: Dorex2007 folded before Flop (didn't bet)
Seat 5: Lord7 Sergio folded before Flop (didn't bet)
Seat 6: Gora858 showed [9s Ts] and lost with a pair of Nines
Seat 7: mimimouse6 showed [Qs Js] and won ($1.10) with a pair of Queens
Seat 8: Koksmix87 folded before Flop (didn't bet)
Seat 9: NocnyFryzjer folded before Flop (didn't bet)



PokerStars Hand #228376130922:  Hold'em No Limit ($0.01/$0.02 USD) - 2021/07/18 0:55:20 PT [2021/07/18 3:55:20 ET]
Table 'Philia' 9-max Seat #2 is the button
Seat 1: zielonysnipe ($2.53 in chips) 
Seat 2: sleeper hipi ($7.67 in chips) 
Seat 4: Dorex2007 ($3.88 in chips) 
Seat 5: Lord7 Sergio ($2.34 in chips) 
Seat 6: Gora858 ($4.23 in chips) 
Seat 7: mimimouse6 ($3.39 in chips) 
Seat 8: Koksmix87 ($2 in chips) 
Seat 9: NocnyFryzjer ($1.70 in chips) 
Dorex2007: posts small blind $0.01
Lord7 Sergio: posts big blind $0.02
*** HOLE CARDS ***
Dealt to Dorex2007 [Jd Qs]
Gora858: folds 
mimimouse6: folds 
Koksmix87: folds 
NocnyFryzjer: folds 
zielonysnipe: folds 
sleeper hipi: folds 
Dorex2007: raises $0.04 to $0.06
Lord7 Sergio: calls $0.04
*** FLOP *** [2c 9h 9d]
Dorex2007: bets $0.08
Lord7 Sergio: calls $0.08
*** TURN *** [2c 9h 9d] [Ad]
Dorex2007: checks 
Lord7 Sergio: bets $0.07
Dorex2007: folds 
Uncalled bet ($0.07) returned to Lord7 Sergio
Lord7 Sergio collected $0.27 from pot
Lord7 Sergio: doesn't show hand 
*** SUMMARY ***
Total pot $0.28 | Rake $0.01 
Board [2c 9h 9d Ad]
Seat 1: zielonysnipe folded before Flop (didn't bet)
Seat 2: sleeper hipi (button) folded before Flop (didn't bet)
Seat 4: Dorex2007 (small blind) folded on the Turn
Seat 5: Lord7 Sergio (big blind) collected ($0.27)
Seat 6: Gora858 folded before Flop (didn't bet)
Seat 7: mimimouse6 folded before Flop (didn't bet)
Seat 8: Koksmix87 folded before Flop (didn't bet)
Seat 9: NocnyFryzjer folded before Flop (didn't bet)



PokerStars Hand #228376136681:  Hold'em No Limit ($0.01/$0.02 USD) - 2021/07/18 0:55:58 PT [2021/07/18 3:55:58 ET]
Table 'Philia' 9-max Seat #4 is the button
Seat 1: zielonysnipe ($2.53 in chips) 
Seat 2: sleeper hipi ($7.67 in chips) 
Seat 4: Dorex2007 ($3.74 in chips) 
Seat 5: Lord7 Sergio ($2.47 in chips) 
Seat 6: Gora858 ($4.23 in chips) 
Seat 7: mimimouse6 ($3.39 in chips) 
Seat 8: Koksmix87 ($2 in chips) 
Seat 9: NocnyFryzjer ($1.70 in chips) 
Lord7 Sergio: posts small blind $0.01
Gora858: posts big blind $0.02
*** HOLE CARDS ***
Dealt to Dorex2007 [9s 6d]
mimimouse6: folds 
Koksmix87: folds 
NocnyFryzjer: folds 
zielonysnipe: folds 
sleeper hipi: folds 
Dorex2007: folds 
Lord7 Sergio: folds 
Uncalled bet ($0.01) returned to Gora858
Gora858 collected $0.02 from pot
*** SUMMARY ***
Total pot $0.02 | Rake $0 
Seat 1: zielonysnipe folded before Flop (didn't bet)
Seat 2: sleeper hipi folded before Flop (didn't bet)
Seat 4: Dorex2007 (button) folded before Flop (didn't bet)
Seat 5: Lord7 Sergio (small blind) folded before Flop
Seat 6: Gora858 (big blind) collected ($0.02)
Seat 7: mimimouse6 folded before Flop (didn't bet)
Seat 8: Koksmix87 folded before Flop (didn't bet)
Seat 9: NocnyFryzjer folded before Flop (didn't bet)



PokerStars Hand #228376138613:  Hold'em No Limit ($0.01/$0.02 USD) - 2021/07/18 0:56:11 PT [2021/07/18 3:56:11 ET]
Table 'Philia' 9-max Seat #5 is the button
Seat 1: zielonysnipe ($2.53 in chips) 
Seat 2: sleeper hipi ($7.67 in chips) 
Seat 4: Dorex2007 ($3.74 in chips) 
Seat 5: Lord7 Sergio ($2.46 in chips) 
Seat 6: Gora858 ($4.24 in chips) 
Seat 7: mimimouse6 ($3.39 in chips) 
Seat 8: Koksmix87 ($2 in chips) 
Seat 9: NocnyFryzjer ($1.70 in chips) 
Gora858: posts small blind $0.01
mimimouse6: posts big blind $0.02
*** HOLE CARDS ***
Dealt to Dorex2007 [2h 5c]
Koksmix87: folds 
NocnyFryzjer: folds 
zielonysnipe: raises $0.02 to $0.04
sleeper hipi: calls $0.04
Dorex2007: folds 
Lord7 Sergio: raises $0.02 to $0.06
Gora858: folds 
mimimouse6: folds 
zielonysnipe: calls $0.02
sleeper hipi: calls $0.02
*** FLOP *** [4c Qc 7s]
zielonysnipe: checks 
sleeper hipi: checks 
Lord7 Sergio: checks 
*** TURN *** [4c Qc 7s] [Qs]
zielonysnipe: bets $0.10
sleeper hipi: calls $0.10
Lord7 Sergio: folds 
*** RIVER *** [4c Qc 7s Qs] [3c]
zielonysnipe has timed out
zielonysnipe: checks 
sleeper hipi: bets $0.19
dealembub said, "love the smell of fresh timmies brewing"
zielonysnipe has timed out
zielonysnipe: folds 
Uncalled bet ($0.19) returned to sleeper hipi
sleeper hipi collected $0.40 from pot
sleeper hipi: doesn't show hand 
*** SUMMARY ***
Total pot $0.41 | Rake $0.01 
Board [4c Qc 7s Qs 3c]
Seat 1: zielonysnipe folded on the River
Seat 2: sleeper hipi collected ($0.40)
Seat 4: Dorex2007 folded before Flop (didn't bet)
Seat 5: Lord7 Sergio (button) folded on the Turn
Seat 6: Gora858 (small blind) folded before Flop
Seat 7: mimimouse6 (big blind) folded before Flop
Seat 8: Koksmix87 folded before Flop (didn't bet)
Seat 9: NocnyFryzjer folded before Flop (didn't bet)



PokerStars Hand #228376154931:  Hold'em No Limit ($0.01/$0.02 USD) - 2021/07/18 0:58:03 PT [2021/07/18 3:58:03 ET]
Table 'Philia' 9-max Seat #6 is the button
Seat 1: zielonysnipe ($2.37 in chips) 
Seat 2: sleeper hipi ($7.91 in chips) 
Seat 4: Dorex2007 ($3.74 in chips) 
Seat 5: Lord7 Sergio ($2.40 in chips) 
Seat 6: Gora858 ($4.23 in chips) 
Seat 7: mimimouse6 ($3.37 in chips) 
Seat 9: NocnyFryzjer ($1.70 in chips) 
mimimouse6: posts small blind $0.01
Koksmix87: is sitting out 
NocnyFryzjer: posts big blind $0.02
dealembub: sits out 
*** HOLE CARDS ***
Dealt to Dorex2007 [7c 7s]
Dorex2007 said, ":)"
zielonysnipe said, "****"
Koksmix87 leaves the table
zielonysnipe has timed out
zielonysnipe: folds 
sleeper hipi: folds 
Dorex2007: raises $0.04 to $0.06
dealembub said, "i already blocked his chat from another table"
Lord7 Sergio has timed out
Lord7 Sergio: folds 
Gora858: folds 
mimimouse6: calls $0.05
mendel777 joins the table at seat #8 
NocnyFryzjer: folds 
*** FLOP *** [5d 4h 2h]
mimimouse6: bets $0.07
Dorex2007: raises $0.28 to $0.35
mimimouse6: folds 
Uncalled bet ($0.28) returned to Dorex2007
Dorex2007 collected $0.27 from pot
Dorex2007: doesn't show hand 
*** SUMMARY ***
Total pot $0.28 | Rake $0.01 
Board [5d 4h 2h]
Seat 1: zielonysnipe folded before Flop (didn't bet)
Seat 2: sleeper hipi folded before Flop (didn't bet)
Seat 4: Dorex2007 collected ($0.27)
Seat 5: Lord7 Sergio folded before Flop (didn't bet)
Seat 6: Gora858 (button) folded before Flop (didn't bet)
Seat 7: mimimouse6 (small blind) folded on the Flop
Seat 9: NocnyFryzjer (big blind) folded before Flop



PokerStars Hand #228376164641:  Hold'em No Limit ($0.01/$0.02 USD) - 2021/07/18 0:59:10 PT [2021/07/18 3:59:10 ET]
Table 'Philia' 9-max Seat #7 is the button
Seat 1: zielonysnipe ($2.37 in chips) 
Seat 2: sleeper hipi ($7.91 in chips) 
Seat 3: dealembub ($2.03 in chips) 
Seat 4: Dorex2007 ($3.88 in chips) 
Seat 5: Lord7 Sergio ($2.40 in chips) 
Seat 6: Gora858 ($4.23 in chips) 
Seat 7: mimimouse6 ($3.24 in chips) 
Seat 9: NocnyFryzjer ($1.68 in chips) 
NocnyFryzjer: posts small blind $0.01
zielonysnipe: posts big blind $0.02
dealembub: posts small blind $0.01
*** HOLE CARDS ***
Dealt to Dorex2007 [Kc 8d]
sleeper hipi: folds 
dealembub: folds 
Dorex2007: folds 
Lord7 Sergio: folds 
Gora858: folds 
mimimouse6: folds 
NocnyFryzjer: raises $0.04 to $0.06
zielonysnipe: folds 
Uncalled bet ($0.04) returned to NocnyFryzjer
NocnyFryzjer collected $0.05 from pot
NocnyFryzjer: doesn't show hand 
Dorex2007 said, "I must of done it at some point in the past also"
*** SUMMARY ***
Total pot $0.05 | Rake $0 
Seat 1: zielonysnipe (big blind) folded before Flop
Seat 2: sleeper hipi folded before Flop (didn't bet)
Seat 3: dealembub folded before Flop (didn't bet)
Seat 4: Dorex2007 folded before Flop (didn't bet)
Seat 5: Lord7 Sergio folded before Flop (didn't bet)
Seat 6: Gora858 folded before Flop (didn't bet)
Seat 7: mimimouse6 (button) folded before Flop (didn't bet)
Seat 9: NocnyFryzjer (small blind) collected ($0.05)



PokerStars Hand #228376168197:  Hold'em No Limit ($0.01/$0.02 USD) - 2021/07/18 0:59:35 PT [2021/07/18 3:59:35 ET]
Table 'Philia' 9-max Seat #9 is the button
Seat 1: zielonysnipe ($2.35 in chips) 
Seat 2: sleeper hipi ($7.91 in chips) 
Seat 3: dealembub ($2.02 in chips) 
Seat 4: Dorex2007 ($3.88 in chips) 
Seat 5: Lord7 Sergio ($2.40 in chips) 
Seat 6: Gora858 ($4.23 in chips) 
Seat 7: mimimouse6 ($3.24 in chips) 
Seat 9: NocnyFryzjer ($1.71 in chips) 
zielonysnipe: posts small blind $0.01
sleeper hipi: posts big blind $0.02
mendel777: sits out 
*** HOLE CARDS ***
Dealt to Dorex2007 [As Jc]
dealembub: folds 
Dorex2007: raises $0.02 to $0.04
Lord7 Sergio: calls $0.04
Gora858: calls $0.04
mimimouse6: folds 
NocnyFryzjer: folds 
zielonysnipe: folds 
sleeper hipi: folds 
*** FLOP *** [6s 9s 8c]
Dorex2007: checks 
Lord7 Sergio: bets $0.07
Gora858: calls $0.07
Dorex2007: calls $0.07
*** TURN *** [6s 9s 8c] [3c]
Dorex2007: checks 
Lord7 Sergio: bets $0.12
Gora858: calls $0.12
Dorex2007: folds 
*** RIVER *** [6s 9s 8c 3c] [Ts]
Lord7 Sergio: bets $0.29
Gora858: folds 
Uncalled bet ($0.29) returned to Lord7 Sergio
Lord7 Sergio collected $0.58 from pot
*** SUMMARY ***
Total pot $0.60 | Rake $0.02 
Board [6s 9s 8c 3c Ts]
Seat 1: zielonysnipe (small blind) folded before Flop
Seat 2: sleeper hipi (big blind) folded before Flop
Seat 3: dealembub folded before Flop (didn't bet)
Seat 4: Dorex2007 folded on the Turn
Seat 5: Lord7 Sergio collected ($0.58)
Seat 6: Gora858 folded on the River
Seat 7: mimimouse6 folded before Flop (didn't bet)
Seat 9: NocnyFryzjer (button) folded before Flop (didn't bet)



PokerStars Hand #228376177359:  Hold'em No Limit ($0.01/$0.02 USD) - 2021/07/18 1:00:36 PT [2021/07/18 4:00:36 ET]
Table 'Philia' 9-max Seat #1 is the button
Seat 1: zielonysnipe ($2.34 in chips) 
Seat 2: sleeper hipi ($7.89 in chips) 
Seat 3: dealembub ($2.02 in chips) 
Seat 4: Dorex2007 ($3.77 in chips) 
Seat 5: Lord7 Sergio ($2.75 in chips) 
Seat 6: Gora858 ($4 in chips) 
Seat 7: mimimouse6 ($3.24 in chips) 
Seat 9: NocnyFryzjer ($1.71 in chips) 
sleeper hipi: posts small blind $0.01
dealembub: posts big blind $0.02
mendel777: sits out 
*** HOLE CARDS ***
Dealt to Dorex2007 [3c Jc]
Dorex2007: folds 
Lord7 Sergio: raises $0.05 to $0.07
Gora858: folds 
mimimouse6: folds 
NocnyFryzjer: calls $0.07
zielonysnipe: folds 
sleeper hipi: folds 
dealembub: folds 
*** FLOP *** [Kd 3d 5c]
Lord7 Sergio: checks 
NocnyFryzjer: bets $0.08
Dorex2007 said, "Lord7 doesn't seem to have much luck  down 6.72 in 26 hands  that's got to be a record of some type"
Lord7 Sergio: calls $0.08
*** TURN *** [Kd 3d 5c] [Ts]
Lord7 Sergio: checks 
NocnyFryzjer: checks 
*** RIVER *** [Kd 3d 5c Ts] [2s]
Lord7 Sergio: checks 
NocnyFryzjer: bets $0.16
Lord7 Sergio: folds 
Uncalled bet ($0.16) returned to NocnyFryzjer
NocnyFryzjer collected $0.32 from pot
NocnyFryzjer: doesn't show hand 
*** SUMMARY ***
Total pot $0.33 | Rake $0.01 
Board [Kd 3d 5c Ts 2s]
Seat 1: zielonysnipe (button) folded before Flop (didn't bet)
Seat 2: sleeper hipi (small blind) folded before Flop
Seat 3: dealembub (big blind) folded before Flop
Seat 4: Dorex2007 folded before Flop (didn't bet)
Seat 5: Lord7 Sergio folded on the River
Seat 6: Gora858 folded before Flop (didn't bet)
Seat 7: mimimouse6 folded before Flop (didn't bet)
Seat 9: NocnyFryzjer collected ($0.32)



PokerStars Hand #228376187909:  Hold'em No Limit ($0.01/$0.02 USD) - 2021/07/18 1:01:42 PT [2021/07/18 4:01:42 ET]
Table 'Philia' 9-max Seat #2 is the button
Seat 1: zielonysnipe ($2.34 in chips) 
Seat 2: sleeper hipi ($7.88 in chips) 
Seat 4: Dorex2007 ($3.77 in chips) 
Seat 5: Lord7 Sergio ($2.60 in chips) 
Seat 6: Gora858 ($4 in chips) 
Seat 7: mimimouse6 ($3.24 in chips) 
Seat 9: NocnyFryzjer ($1.88 in chips) 
Dorex2007: posts small blind $0.01
Lord7 Sergio: posts big blind $0.02
mendel777: sits out 
*** HOLE CARDS ***
Dealt to Dorex2007 [9h Qd]
Gora858: raises $0.02 to $0.04
mimimouse6: folds 
NocnyFryzjer: folds 
zielonysnipe: folds 
sleeper hipi: calls $0.04
Dorex2007: folds 
Lord7 Sergio: folds 
*** FLOP *** [Kh Qh Js]
Gora858: bets $0.07
sleeper hipi: folds 
Uncalled bet ($0.07) returned to Gora858
Gora858 collected $0.11 from pot
*** SUMMARY ***
Total pot $0.11 | Rake $0 
Board [Kh Qh Js]
Seat 1: zielonysnipe folded before Flop (didn't bet)
Seat 2: sleeper hipi (button) folded on the Flop
Seat 4: Dorex2007 (small blind) folded before Flop
Seat 5: Lord7 Sergio (big blind) folded before Flop
Seat 6: Gora858 collected ($0.11)
Seat 7: mimimouse6 folded before Flop (didn't bet)
Seat 9: NocnyFryzjer folded before Flop (didn't bet)



PokerStars Hand #228376195582:  Hold'em No Limit ($0.01/$0.02 USD) - 2021/07/18 1:02:28 PT [2021/07/18 4:02:28 ET]
Table 'Philia' 9-max Seat #4 is the button
Seat 1: zielonysnipe ($2.34 in chips) 
Seat 2: sleeper hipi ($7.84 in chips) 
Seat 4: Dorex2007 ($3.76 in chips) 
Seat 5: Lord7 Sergio ($2.58 in chips) 
Seat 6: Gora858 ($4.07 in chips) 
Seat 7: mimimouse6 ($3.24 in chips) 
Seat 9: NocnyFryzjer ($1.88 in chips) 
Lord7 Sergio: posts small blind $0.01
Gora858: posts big blind $0.02
mendel777: sits out 
*** HOLE CARDS ***
Dealt to Dorex2007 [Jd 9h]
mimimouse6: folds 
NocnyFryzjer: folds 
zielonysnipe: raises $0.02 to $0.04
sleeper hipi: folds 
Dorex2007: folds 
Lord7 Sergio: folds 
Gora858: calls $0.02
*** FLOP *** [2s Ac 8d]
Gora858: bets $0.04
zielonysnipe: folds 
Uncalled bet ($0.04) returned to Gora858
Gora858 collected $0.09 from pot
*** SUMMARY ***
Total pot $0.09 | Rake $0 
Board [2s Ac 8d]
Seat 1: zielonysnipe folded on the Flop
Seat 2: sleeper hipi folded before Flop (didn't bet)
Seat 4: Dorex2007 (button) folded before Flop (didn't bet)
Seat 5: Lord7 Sergio (small blind) folded before Flop
Seat 6: Gora858 (big blind) collected ($0.09)
Seat 7: mimimouse6 folded before Flop (didn't bet)
Seat 9: NocnyFryzjer folded before Flop (didn't bet)



PokerStars Hand #228376205852:  Hold'em No Limit ($0.01/$0.02 USD) - 2021/07/18 1:03:29 PT [2021/07/18 4:03:29 ET]
Table 'Philia' 9-max Seat #5 is the button
Seat 1: zielonysnipe ($2.30 in chips) 
Seat 2: sleeper hipi ($7.84 in chips) 
Seat 3: dealembub ($2 in chips) 
Seat 4: Dorex2007 ($3.76 in chips) 
Seat 5: Lord7 Sergio ($2.57 in chips) 
Seat 6: Gora858 ($4.12 in chips) 
Seat 7: mimimouse6 ($3.24 in chips) 
Seat 9: NocnyFryzjer ($1.88 in chips) 
Gora858: posts small blind $0.01
mimimouse6: posts big blind $0.02
mendel777: sits out 
dealembub: posts small blind $0.01
*** HOLE CARDS ***
Dealt to Dorex2007 [3d 4s]
NocnyFryzjer: folds 
zielonysnipe: folds 
sleeper hipi: folds 
dealembub: calls $0.02
Dorex2007: folds 
Lord7 Sergio has timed out
Lord7 Sergio: folds 
Gora858: folds 
mimimouse6: checks 
*** FLOP *** [Qd Qc 7d]
mimimouse6: checks 
dealembub: checks 
*** TURN *** [Qd Qc 7d] [8c]
mimimouse6: bets $0.02
dealembub: calls $0.02
*** RIVER *** [Qd Qc 7d 8c] [5c]
mimimouse6: checks 
dealembub: bets $0.18
mimimouse6: folds 
Uncalled bet ($0.18) returned to dealembub
dealembub collected $0.10 from pot
dealembub: doesn't show hand 
*** SUMMARY ***
Total pot $0.10 | Rake $0 
Board [Qd Qc 7d 8c 5c]
Seat 1: zielonysnipe folded before Flop (didn't bet)
Seat 2: sleeper hipi folded before Flop (didn't bet)
Seat 3: dealembub collected ($0.10)
Seat 4: Dorex2007 folded before Flop (didn't bet)
Seat 5: Lord7 Sergio (button) folded before Flop (didn't bet)
Seat 6: Gora858 (small blind) folded before Flop
Seat 7: mimimouse6 (big blind) folded on the River
Seat 9: NocnyFryzjer folded before Flop (didn't bet)



PokerStars Hand #228376214004:  Hold'em No Limit ($0.01/$0.02 USD) - 2021/07/18 1:04:17 PT [2021/07/18 4:04:17 ET]
Table 'Philia' 9-max Seat #6 is the button
Seat 1: zielonysnipe ($2.30 in chips) 
Seat 2: sleeper hipi ($7.84 in chips) 
Seat 3: dealembub ($2.05 in chips) 
Seat 4: Dorex2007 ($3.76 in chips) 
Seat 6: Gora858 ($4.11 in chips) 
Seat 7: mimimouse6 ($3.20 in chips) 
Seat 8: mendel777 ($1.60 in chips) 
Seat 9: NocnyFryzjer ($1.88 in chips) 
mimimouse6: posts small blind $0.01
mendel777: posts big blind $0.02
*** HOLE CARDS ***
Dealt to Dorex2007 [2d Jh]
NocnyFryzjer: folds 
zielonysnipe: folds 
sleeper hipi: folds 
dealembub: calls $0.02
Dorex2007: folds 
Gora858: folds 
mimimouse6: calls $0.01
mendel777: raises $0.06 to $0.08
dealembub: calls $0.06
mimimouse6: calls $0.06
*** FLOP *** [Jc 6d 3h]
mimimouse6: bets $0.12
mendel777: folds 
dealembub: folds 
Uncalled bet ($0.12) returned to mimimouse6
mimimouse6 collected $0.23 from pot
mimimouse6: doesn't show hand 
*** SUMMARY ***
Total pot $0.24 | Rake $0.01 
Board [Jc 6d 3h]
Seat 1: zielonysnipe folded before Flop (didn't bet)
Seat 2: sleeper hipi folded before Flop (didn't bet)
Seat 3: dealembub folded on the Flop
Seat 4: Dorex2007 folded before Flop (didn't bet)
Seat 6: Gora858 (button) folded before Flop (didn't bet)
Seat 7: mimimouse6 (small blind) collected ($0.23)
Seat 8: mendel777 (big blind) folded on the Flop
Seat 9: NocnyFryzjer folded before Flop (didn't bet)



PokerStars Hand #228376220895:  Hold'em No Limit ($0.01/$0.02 USD) - 2021/07/18 1:04:58 PT [2021/07/18 4:04:58 ET]
Table 'Philia' 9-max Seat #7 is the button
Seat 1: zielonysnipe ($2.30 in chips) 
Seat 2: sleeper hipi ($7.84 in chips) 
Seat 3: dealembub ($1.97 in chips) 
Seat 4: Dorex2007 ($3.76 in chips) 
Seat 6: Gora858 ($4.11 in chips) 
Seat 7: mimimouse6 ($3.35 in chips) 
Seat 8: mendel777 ($1.60 in chips) 
Seat 9: NocnyFryzjer ($1.88 in chips) 
mendel777: posts small blind $0.01
NocnyFryzjer: posts big blind $0.02
*** HOLE CARDS ***
Dealt to Dorex2007 [Jc 8c]
zielonysnipe has timed out
zielonysnipe: folds 
sleeper hipi: raises $0.04 to $0.06
dealembub: calls $0.06
Dorex2007: folds 
Gora858: folds 
mimimouse6: folds 
mendel777: folds 
NocnyFryzjer: folds 
*** FLOP *** [Ah 2h 6d]
sleeper hipi: checks 
dealembub: bets $0.07
sleeper hipi: calls $0.07
*** TURN *** [Ah 2h 6d] [Qs]
sleeper hipi: checks 
dealembub: bets $0.28
sleeper hipi: calls $0.28
*** RIVER *** [Ah 2h 6d Qs] [Td]
sleeper hipi: checks 
dealembub: bets $0.82
zielonysnipe leaves the table
sleeper hipi: folds 
Uncalled bet ($0.82) returned to dealembub
dealembub collected $0.82 from pot
dealembub: doesn't show hand 
*** SUMMARY ***
Total pot $0.85 | Rake $0.03 
Board [Ah 2h 6d Qs Td]
Seat 1: zielonysnipe folded before Flop (didn't bet)
Seat 2: sleeper hipi folded on the River
Seat 3: dealembub collected ($0.82)
Seat 4: Dorex2007 folded before Flop (didn't bet)
Seat 6: Gora858 folded before Flop (didn't bet)
Seat 7: mimimouse6 (button) folded before Flop (didn't bet)
Seat 8: mendel777 (small blind) folded before Flop
Seat 9: NocnyFryzjer (big blind) folded before Flop



PokerStars Hand #228376234885:  Hold'em No Limit ($0.01/$0.02 USD) - 2021/07/18 1:06:20 PT [2021/07/18 4:06:20 ET]
Table 'Philia' 9-max Seat #8 is the button
Seat 2: sleeper hipi ($7.43 in chips) 
Seat 3: dealembub ($2.38 in chips) 
Seat 4: Dorex2007 ($3.76 in chips) 
Seat 5: Lord7 Sergio ($2.57 in chips) 
Seat 6: Gora858 ($4.11 in chips) 
Seat 7: mimimouse6 ($3.35 in chips) 
Seat 8: mendel777 ($1.60 in chips) 
Seat 9: NocnyFryzjer ($1.86 in chips) 
NocnyFryzjer: posts small blind $0.01
sleeper hipi: posts big blind $0.02
*** HOLE CARDS ***
Dealt to Dorex2007 [Qd Ts]
dealembub: raises $0.02 to $0.04
CitizenPU joins the table at seat #1 
Dorex2007: folds 
Lord7 Sergio: folds 
Gora858: folds 
mimimouse6: folds 
mendel777: folds 
NocnyFryzjer: folds 
sleeper hipi: calls $0.02
*** FLOP *** [Qh 4c 8d]
sleeper hipi: checks 
dealembub: checks 
*** TURN *** [Qh 4c 8d] [2h]
sleeper hipi: bets $0.07
dealembub: calls $0.07
*** RIVER *** [Qh 4c 8d 2h] [Js]
sleeper hipi: bets $0.22
dealembub: folds 
Uncalled bet ($0.22) returned to sleeper hipi
sleeper hipi collected $0.22 from pot
sleeper hipi: doesn't show hand 
*** SUMMARY ***
Total pot $0.23 | Rake $0.01 
Board [Qh 4c 8d 2h Js]
Seat 2: sleeper hipi (big blind) collected ($0.22)
Seat 3: dealembub folded on the River
Seat 4: Dorex2007 folded before Flop (didn't bet)
Seat 5: Lord7 Sergio folded before Flop (didn't bet)
Seat 6: Gora858 folded before Flop (didn't bet)
Seat 7: mimimouse6 folded before Flop (didn't bet)
Seat 8: mendel777 (button) folded before Flop (didn't bet)
Seat 9: NocnyFryzjer (small blind) folded before Flop



PokerStars Hand #228376241622:  Hold'em No Limit ($0.01/$0.02 USD) - 2021/07/18 1:06:59 PT [2021/07/18 4:06:59 ET]
Table 'Philia' 9-max Seat #9 is the button
Seat 2: sleeper hipi ($7.54 in chips) 
Seat 3: dealembub ($2.27 in chips) 
Seat 4: Dorex2007 ($3.76 in chips) 
Seat 5: Lord7 Sergio ($2.57 in chips) 
Seat 6: Gora858 ($4.11 in chips) 
Seat 7: mimimouse6 ($3.35 in chips) 
Seat 8: mendel777 ($1.60 in chips) 
Seat 9: NocnyFryzjer ($1.85 in chips) 
sleeper hipi: posts small blind $0.01
dealembub: posts big blind $0.02
*** HOLE CARDS ***
Dealt to Dorex2007 [Jh 8c]
Dorex2007: folds 
Lord7 Sergio: raises $0.08 to $0.10
Gora858: folds 
mimimouse6: folds 
mendel777: folds 
NocnyFryzjer: folds 
sleeper hipi: folds 
dealembub: folds 
Uncalled bet ($0.08) returned to Lord7 Sergio
Lord7 Sergio collected $0.05 from pot
Lord7 Sergio: doesn't show hand 
*** SUMMARY ***
Total pot $0.05 | Rake $0 
Seat 2: sleeper hipi (small blind) folded before Flop
Seat 3: dealembub (big blind) folded before Flop
Seat 4: Dorex2007 folded before Flop (didn't bet)
Seat 5: Lord7 Sergio collected ($0.05)
Seat 6: Gora858 folded before Flop (didn't bet)
Seat 7: mimimouse6 folded before Flop (didn't bet)
Seat 8: mendel777 folded before Flop (didn't bet)
Seat 9: NocnyFryzjer (button) folded before Flop (didn't bet)



PokerStars Hand #228376247466:  Hold'em No Limit ($0.01/$0.02 USD) - 2021/07/18 1:07:34 PT [2021/07/18 4:07:34 ET]
Table 'Philia' 9-max Seat #2 is the button
Seat 2: sleeper hipi ($7.53 in chips) 
Seat 3: dealembub ($2.25 in chips) 
Seat 4: Dorex2007 ($3.76 in chips) 
Seat 5: Lord7 Sergio ($2.60 in chips) 
Seat 6: Gora858 ($4.11 in chips) 
Seat 7: mimimouse6 ($3.35 in chips) 
Seat 8: mendel777 ($1.60 in chips) 
Seat 9: NocnyFryzjer ($1.85 in chips) 
dealembub: posts small blind $0.01
Dorex2007: posts big blind $0.02
CitizenPU: sits out 
*** HOLE CARDS ***
Dealt to Dorex2007 [4c 3s]
Lord7 Sergio: folds 
Lord7 Sergio leaves the table
Gora858: folds 
mimimouse6: folds 
mendel777: raises $0.04 to $0.06
NocnyFryzjer: folds 
sleeper hipi: folds 
Dorm619 joins the table at seat #5 
dealembub: calls $0.05
Dorex2007: folds 
*** FLOP *** [4s Qc 5h]
dealembub: bets $0.14
mendel777: folds 
Uncalled bet ($0.14) returned to dealembub
dealembub collected $0.14 from pot
dealembub: doesn't show hand 
*** SUMMARY ***
Total pot $0.14 | Rake $0 
Board [4s Qc 5h]
Seat 2: sleeper hipi (button) folded before Flop (didn't bet)
Seat 3: dealembub (small blind) collected ($0.14)
Seat 4: Dorex2007 (big blind) folded before Flop
Seat 5: Lord7 Sergio folded before Flop (didn't bet)
Seat 6: Gora858 folded before Flop (didn't bet)
Seat 7: mimimouse6 folded before Flop (didn't bet)
Seat 8: mendel777 folded on the Flop
Seat 9: NocnyFryzjer folded before Flop (didn't bet)



PokerStars Hand #228376253923:  Hold'em No Limit ($0.01/$0.02 USD) - 2021/07/18 1:08:11 PT [2021/07/18 4:08:11 ET]
Table 'Philia' 9-max Seat #3 is the button
Seat 2: sleeper hipi ($7.53 in chips) 
Seat 3: dealembub ($2.33 in chips) 
Seat 4: Dorex2007 ($3.74 in chips) 
Seat 5: Dorm619 ($2 in chips) 
Seat 6: Gora858 ($4.11 in chips) 
Seat 7: mimimouse6 ($3.35 in chips) 
Seat 8: mendel777 ($1.60 in chips) 
Seat 9: NocnyFryzjer ($1.85 in chips) 
Dorex2007: posts small blind $0.01
Dorm619: posts big blind $0.02
CitizenPU: sits out 
*** HOLE CARDS ***
Dealt to Dorex2007 [Jc 5d]
Gora858: folds 
mimimouse6: folds 
mendel777 has timed out
mendel777: folds 
NocnyFryzjer: folds 
sleeper hipi: folds 
dealembub: calls $0.02
Dorex2007: folds 
Dorm619: checks 
*** FLOP *** [5s Ad 3s]
Dorm619: checks 
dealembub: checks 
*** TURN *** [5s Ad 3s] [7d]
Dorm619: checks 
dealembub: checks 
*** RIVER *** [5s Ad 3s 7d] [9h]
Dorm619: bets $0.03
dealembub: calls $0.03
*** SHOW DOWN ***
Dorm619: shows [8h 2d] (high card Ace)
dealembub: shows [3c Kh] (a pair of Threes)
dealembub collected $0.11 from pot
*** SUMMARY ***
Total pot $0.11 | Rake $0 
Board [5s Ad 3s 7d 9h]
Seat 2: sleeper hipi folded before Flop (didn't bet)
Seat 3: dealembub (button) showed [3c Kh] and won ($0.11) with a pair of Threes
Seat 4: Dorex2007 (small blind) folded before Flop
Seat 5: Dorm619 (big blind) showed [8h 2d] and lost with high card Ace
Seat 6: Gora858 folded before Flop (didn't bet)
Seat 7: mimimouse6 folded before Flop (didn't bet)
Seat 8: mendel777 folded before Flop (didn't bet)
Seat 9: NocnyFryzjer folded before Flop (didn't bet)



PokerStars Hand #228376261707:  Hold'em No Limit ($0.01/$0.02 USD) - 2021/07/18 1:08:57 PT [2021/07/18 4:08:57 ET]
Table 'Philia' 9-max Seat #4 is the button
Seat 2: sleeper hipi ($7.53 in chips) 
Seat 3: dealembub ($2.39 in chips) 
Seat 4: Dorex2007 ($3.73 in chips) 
Seat 5: Dorm619 ($1.95 in chips) 
Seat 6: Gora858 ($4.11 in chips) 
Seat 7: mimimouse6 ($3.35 in chips) 
Seat 8: mendel777 ($1.60 in chips) 
Seat 9: NocnyFryzjer ($1.85 in chips) 
Dorm619: posts small blind $0.01
Gora858: posts big blind $0.02
CitizenPU: sits out 
*** HOLE CARDS ***
Dealt to Dorex2007 [4s 6h]
mimimouse6: folds 
mendel777: folds 
NocnyFryzjer: folds 
mimimouse6 leaves the table
sleeper hipi: folds 
dealembub: raises $0.02 to $0.04
Dorex2007: folds 
Dorm619: calls $0.03
Gora858: folds 
*** FLOP *** [3c 7h Th]
shuhrat19744 joins the table at seat #7 
Dorex2007 said, "you & 3's :)"
Dorm619: bets $0.05
dealembub: calls $0.05
*** TURN *** [3c 7h Th] [5c]
Dorm619: bets $0.10
dealembub: calls $0.10
*** RIVER *** [3c 7h Th 5c] [7c]
Dorm619: bets $0.20
dealembub: calls $0.20
*** SHOW DOWN ***
Dorm619: shows [Tc Td] (a full house, Tens full of Sevens)
dealembub: mucks hand 
Dorm619 collected $0.76 from pot
*** SUMMARY ***
Total pot $0.80 | Rake $0.04 
Board [3c 7h Th 5c 7c]
Seat 2: sleeper hipi folded before Flop (didn't bet)
Seat 3: dealembub mucked [9c 9h]
Seat 4: Dorex2007 (button) folded before Flop (didn't bet)
Seat 5: Dorm619 (small blind) showed [Tc Td] and won ($0.76) with a full house, Tens full of Sevens
Seat 6: Gora858 (big blind) folded before Flop
Seat 7: mimimouse6 folded before Flop (didn't bet)
Seat 8: mendel777 folded before Flop (didn't bet)
Seat 9: NocnyFryzjer folded before Flop (didn't bet)



PokerStars Hand #228376270943:  Hold'em No Limit ($0.01/$0.02 USD) - 2021/07/18 1:09:50 PT [2021/07/18 4:09:50 ET]
Table 'Philia' 9-max Seat #5 is the button
Seat 2: sleeper hipi ($7.53 in chips) 
Seat 3: dealembub ($2 in chips) 
Seat 4: Dorex2007 ($3.73 in chips) 
Seat 5: Dorm619 ($2.32 in chips) 
Seat 6: Gora858 ($4.09 in chips) 
Seat 7: shuhrat19744 ($2 in chips) 
Seat 8: mendel777 ($1.60 in chips) 
Seat 9: NocnyFryzjer ($1.85 in chips) 
Gora858: posts small blind $0.01
shuhrat19744: posts big blind $0.02
CitizenPU: sits out 
*** HOLE CARDS ***
Dealt to Dorex2007 [5d Qd]
mendel777: folds 
NocnyFryzjer: folds 
sleeper hipi: folds 
dealembub: folds 
Dorex2007: folds 
Dorm619: folds 
dealembub said, "ya i know...that was funny"
Gora858: raises $0.04 to $0.06
shuhrat19744: folds 
Uncalled bet ($0.04) returned to Gora858
Gora858 collected $0.04 from pot
*** SUMMARY ***
Total pot $0.04 | Rake $0 
Seat 2: sleeper hipi folded before Flop (didn't bet)
Seat 3: dealembub folded before Flop (didn't bet)
Seat 4: Dorex2007 folded before Flop (didn't bet)
Seat 5: Dorm619 (button) folded before Flop (didn't bet)
Seat 6: Gora858 (small blind) collected ($0.04)
Seat 7: shuhrat19744 (big blind) folded before Flop
Seat 8: mendel777 folded before Flop (didn't bet)
Seat 9: NocnyFryzjer folded before Flop (didn't bet)



PokerStars Hand #228376274441:  Hold'em No Limit ($0.01/$0.02 USD) - 2021/07/18 1:10:11 PT [2021/07/18 4:10:11 ET]
Table 'Philia' 9-max Seat #6 is the button
Seat 2: sleeper hipi ($7.53 in chips) 
Seat 3: dealembub ($2 in chips) 
Seat 4: Dorex2007 ($3.73 in chips) 
Seat 5: Dorm619 ($2.32 in chips) 
Seat 6: Gora858 ($4.11 in chips) 
Seat 7: shuhrat19744 ($2 in chips) 
Seat 8: mendel777 ($1.60 in chips) 
Seat 9: NocnyFryzjer ($1.85 in chips) 
shuhrat19744: posts small blind $0.01
mendel777: posts big blind $0.02
CitizenPU: sits out 
*** HOLE CARDS ***
Dealt to Dorex2007 [6h 8c]
NocnyFryzjer: folds 
sleeper hipi: raises $0.04 to $0.06
dealembub: raises $0.04 to $0.10
Dorex2007: folds 
Dorm619: folds 
Gora858: folds 
shuhrat19744: folds 
mendel777: folds 
sleeper hipi: raises $0.22 to $0.32
dealembub: calls $0.22
*** FLOP *** [As 9d 4s]
sleeper hipi: checks 
dealembub: bets $0.65
sleeper hipi: folds 
Uncalled bet ($0.65) returned to dealembub
dealembub collected $0.65 from pot
dealembub: doesn't show hand 
*** SUMMARY ***
Total pot $0.67 | Rake $0.02 
Board [As 9d 4s]
Seat 2: sleeper hipi folded on the Flop
Seat 3: dealembub collected ($0.65)
Seat 4: Dorex2007 folded before Flop (didn't bet)
Seat 5: Dorm619 folded before Flop (didn't bet)
Seat 6: Gora858 (button) folded before Flop (didn't bet)
Seat 7: shuhrat19744 (small blind) folded before Flop
Seat 8: mendel777 (big blind) folded before Flop
Seat 9: NocnyFryzjer folded before Flop (didn't bet)



PokerStars Hand #228376282101:  Hold'em No Limit ($0.01/$0.02 USD) - 2021/07/18 1:10:55 PT [2021/07/18 4:10:55 ET]
Table 'Philia' 9-max Seat #7 is the button
Seat 2: sleeper hipi ($7.21 in chips) 
Seat 3: dealembub ($2.33 in chips) 
Seat 4: Dorex2007 ($3.73 in chips) 
Seat 5: Dorm619 ($2.32 in chips) 
Seat 6: Gora858 ($4.11 in chips) 
Seat 7: shuhrat19744 ($2 in chips) 
Seat 8: mendel777 ($1.60 in chips) 
Seat 9: NocnyFryzjer ($1.85 in chips) 
mendel777: posts small blind $0.01
NocnyFryzjer: posts big blind $0.02
CitizenPU: sits out 
*** HOLE CARDS ***
Dealt to Dorex2007 [Ks 4c]
sleeper hipi: raises $0.04 to $0.06
dealembub: folds 
Dorex2007: folds 
Dorm619: folds 
Gora858: folds 
shuhrat19744: calls $0.06
mendel777: folds 
NocnyFryzjer: folds 
*** FLOP *** [2c 2d 3c]
dealembub said, "golf started now on tv"
sleeper hipi: bets $0.08
shuhrat19744: folds 
Uncalled bet ($0.08) returned to sleeper hipi
sleeper hipi collected $0.14 from pot
sleeper hipi: doesn't show hand 
Dorex2007 said, "lol"
*** SUMMARY ***
Total pot $0.15 | Rake $0.01 
Board [2c 2d 3c]
Seat 2: sleeper hipi collected ($0.14)
Seat 3: dealembub folded before Flop (didn't bet)
Seat 4: Dorex2007 folded before Flop (didn't bet)
Seat 5: Dorm619 folded before Flop (didn't bet)
Seat 6: Gora858 folded before Flop (didn't bet)
Seat 7: shuhrat19744 (button) folded on the Flop
Seat 8: mendel777 (small blind) folded before Flop
Seat 9: NocnyFryzjer (big blind) folded before Flop



PokerStars Hand #228376286266:  Hold'em No Limit ($0.01/$0.02 USD) - 2021/07/18 1:11:19 PT [2021/07/18 4:11:19 ET]
Table 'Philia' 9-max Seat #8 is the button
Seat 1: CitizenPU ($2 in chips) 
Seat 2: sleeper hipi ($7.29 in chips) 
Seat 3: dealembub ($2.33 in chips) 
Seat 4: Dorex2007 ($3.73 in chips) 
Seat 5: Dorm619 ($2.32 in chips) 
Seat 6: Gora858 ($4.11 in chips) 
Seat 7: shuhrat19744 ($2 in chips) 
Seat 8: mendel777 ($1.60 in chips) 
Seat 9: NocnyFryzjer ($1.83 in chips) 
NocnyFryzjer: posts small blind $0.01
CitizenPU: posts big blind $0.02
*** HOLE CARDS ***
Dealt to Dorex2007 [7s 8d]
dealembub said, "just folded those"
sleeper hipi: folds 
dealembub: calls $0.02
Dorex2007: folds 
Dorm619: raises $0.06 to $0.08
Dorex2007 said, "coming to the island next week for 4 days"
Gora858: folds 
shuhrat19744: folds 
mendel777: folds 
NocnyFryzjer: folds 
CitizenPU: folds 
dealembub: calls $0.06
*** FLOP *** [Qd Ah 6s]
dealembub: bets $0.18
Dorm619: calls $0.18
*** TURN *** [Qd Ah 6s] [5d]
dealembub said, "oh nice"
dealembub: bets $0.53
Dorex2007 said, "our kid is in the navy"
dealembub said, "oh cool"
Dorex2007 said, "going to do the tourist thing"
Dorm619: calls $0.53
*** RIVER *** [Qd Ah 6s 5d] [Kd]
dealembub: bets $1.54 and is all-in
Dorm619: folds 
Uncalled bet ($1.54) returned to dealembub
dealembub collected $1.55 from pot
dealembub: doesn't show hand 
*** SUMMARY ***
Total pot $1.61 | Rake $0.06 
Board [Qd Ah 6s 5d Kd]
Seat 1: CitizenPU (big blind) folded before Flop
Seat 2: sleeper hipi folded before Flop (didn't bet)
Seat 3: dealembub collected ($1.55)
Seat 4: Dorex2007 folded before Flop (didn't bet)
Seat 5: Dorm619 folded on the River
Seat 6: Gora858 folded before Flop (didn't bet)
Seat 7: shuhrat19744 folded before Flop (didn't bet)
Seat 8: mendel777 (button) folded before Flop (didn't bet)
Seat 9: NocnyFryzjer (small blind) folded before Flop



PokerStars Hand #228376302794:  Hold'em No Limit ($0.01/$0.02 USD) - 2021/07/18 1:12:55 PT [2021/07/18 4:12:55 ET]
Table 'Philia' 9-max Seat #9 is the button
Seat 1: CitizenPU ($2 in chips) 
Seat 2: sleeper hipi ($7.29 in chips) 
Seat 3: dealembub ($3.09 in chips) 
Seat 4: Dorex2007 ($3.73 in chips) 
Seat 5: Dorm619 ($1.53 in chips) 
Seat 6: Gora858 ($4.11 in chips) 
Seat 7: shuhrat19744 ($2 in chips) 
Seat 8: mendel777 ($1.60 in chips) 
Seat 9: NocnyFryzjer ($1.82 in chips) 
CitizenPU: posts small blind $0.01
sleeper hipi: posts big blind $0.02
*** HOLE CARDS ***
Dealt to Dorex2007 [9h 4h]
dealembub said, "i love it here"
dealembub: raises $0.02 to $0.04
Dorex2007: folds 
Dorm619: folds 
Gora858: calls $0.04
shuhrat19744: folds 
mendel777: calls $0.04
NocnyFryzjer: folds 
CitizenPU: folds 
sleeper hipi: calls $0.02
*** FLOP *** [Ad 4c Td]
sleeper hipi: checks 
dealembub: bets $0.16
Gora858: folds 
mendel777: raises $0.24 to $0.40
dealembub said, "i keep getting those little A frame cards"
sleeper hipi: folds 
dealembub: calls $0.24
*** TURN *** [Ad 4c Td] [7d]
dealembub: checks 
mendel777: checks 
*** RIVER *** [Ad 4c Td 7d] [Th]
dealembub: checks 
mendel777: checks 
*** SHOW DOWN ***
dealembub: shows [Ac 9s] (two pair, Aces and Tens)
mendel777: mucks hand 
dealembub collected $0.94 from pot
*** SUMMARY ***
Total pot $0.97 | Rake $0.03 
Board [Ad 4c Td 7d Th]
Seat 1: CitizenPU (small blind) folded before Flop
Seat 2: sleeper hipi (big blind) folded on the Flop
Seat 3: dealembub showed [Ac 9s] and won ($0.94) with two pair, Aces and Tens
Seat 4: Dorex2007 folded before Flop (didn't bet)
Seat 5: Dorm619 folded before Flop (didn't bet)
Seat 6: Gora858 folded on the Flop
Seat 7: shuhrat19744 folded before Flop (didn't bet)
Seat 8: mendel777 mucked [As 4s]
Seat 9: NocnyFryzjer (button) folded before Flop (didn't bet)



PokerStars Hand #228376313732:  Hold'em No Limit ($0.01/$0.02 USD) - 2021/07/18 1:13:59 PT [2021/07/18 4:13:59 ET]
Table 'Philia' 9-max Seat #1 is the button
Seat 1: CitizenPU ($2 in chips) 
Seat 2: sleeper hipi ($7.25 in chips) 
Seat 3: dealembub ($3.59 in chips) 
Seat 4: Dorex2007 ($3.73 in chips) 
Seat 5: Dorm619 ($1.53 in chips) 
Seat 6: Gora858 ($4.07 in chips) 
Seat 7: shuhrat19744 ($2 in chips) 
Seat 8: mendel777 ($1.60 in chips) 
Seat 9: NocnyFryzjer ($1.82 in chips) 
sleeper hipi: posts small blind $0.01
dealembub: posts big blind $0.02
*** HOLE CARDS ***
Dealt to Dorex2007 [3d 9d]
Dorex2007: folds 
Dorm619: raises $0.04 to $0.06
Gora858: folds 
shuhrat19744: calls $0.06
mendel777: folds 
NocnyFryzjer: folds 
CitizenPU: folds 
sleeper hipi: folds 
dealembub: folds 
*** FLOP *** [5h 7d Jc]
Dorm619: bets $0.09
shuhrat19744: raises $0.16 to $0.25
Dorm619: calls $0.16
*** TURN *** [5h 7d Jc] [4h]
Dorm619: checks 
dealembub said, "so i'm not saying i'm old but i do remember getting my first tablet from my parents at Christmas way back when"
shuhrat19744: bets $0.42
Dorm619: calls $0.42
*** RIVER *** [5h 7d Jc 4h] [Th]
Dorm619: checks 
dealembub said, "it was a flat stone with a chisel"
shuhrat19744: checks 
*** SHOW DOWN ***
Dorm619: shows [Ac Ad] (a pair of Aces)
shuhrat19744: mucks hand 
Dorm619 collected $1.43 from pot
*** SUMMARY ***
Total pot $1.49 | Rake $0.06 
Board [5h 7d Jc 4h Th]
Seat 1: CitizenPU (button) folded before Flop (didn't bet)
Seat 2: sleeper hipi (small blind) folded before Flop
Seat 3: dealembub (big blind) folded before Flop
Seat 4: Dorex2007 folded before Flop (didn't bet)
Seat 5: Dorm619 showed [Ac Ad] and won ($1.43) with a pair of Aces
Seat 6: Gora858 folded before Flop (didn't bet)
Seat 7: shuhrat19744 mucked [Ts 8s]
Seat 8: mendel777 folded before Flop (didn't bet)
Seat 9: NocnyFryzjer folded before Flop (didn't bet)



PokerStars Hand #228376326701:  Hold'em No Limit ($0.01/$0.02 USD) - 2021/07/18 1:15:15 PT [2021/07/18 4:15:15 ET]
Table 'Philia' 9-max Seat #2 is the button
Seat 1: CitizenPU ($2 in chips) 
Seat 2: sleeper hipi ($7.24 in chips) 
Seat 3: dealembub ($3.57 in chips) 
Seat 4: Dorex2007 ($3.73 in chips) 
Seat 5: Dorm619 ($2.23 in chips) 
Seat 6: Gora858 ($4.07 in chips) 
Seat 7: shuhrat19744 ($2 in chips) 
Seat 8: mendel777 ($1.60 in chips) 
Seat 9: NocnyFryzjer ($1.82 in chips) 
dealembub: posts small blind $0.01
Dorex2007: posts big blind $0.02
*** HOLE CARDS ***
Dealt to Dorex2007 [4c Td]
Dorm619: folds 
Gora858: folds 
shuhrat19744: folds 
mendel777: raises $0.04 to $0.06
NocnyFryzjer: folds 
CitizenPU: folds 
sleeper hipi: folds 
dealembub: raises $0.04 to $0.10
Dorex2007: folds 
mendel777: calls $0.04
*** FLOP *** [2h 7s 4d]
dealembub: checks 
mendel777: bets $0.11
dealembub: calls $0.11
*** TURN *** [2h 7s 4d] [Jd]
dealembub: checks 
mendel777: checks 
*** RIVER *** [2h 7s 4d Jd] [5s]
dealembub: checks 
mendel777: checks 
*** SHOW DOWN ***
dealembub: shows [Ad Kd] (high card Ace)
mendel777: shows [Ah 7h] (a pair of Sevens)
mendel777 collected $0.42 from pot
*** SUMMARY ***
Total pot $0.44 | Rake $0.02 
Board [2h 7s 4d Jd 5s]
Seat 1: CitizenPU folded before Flop (didn't bet)
Seat 2: sleeper hipi (button) folded before Flop (didn't bet)
Seat 3: dealembub (small blind) showed [Ad Kd] and lost with high card Ace
Seat 4: Dorex2007 (big blind) folded before Flop
Seat 5: Dorm619 folded before Flop (didn't bet)
Seat 6: Gora858 folded before Flop (didn't bet)
Seat 7: shuhrat19744 folded before Flop (didn't bet)
Seat 8: mendel777 showed [Ah 7h] and won ($0.42) with a pair of Sevens
Seat 9: NocnyFryzjer folded before Flop (didn't bet)



PokerStars Hand #228376332969:  Hold'em No Limit ($0.01/$0.02 USD) - 2021/07/18 1:15:52 PT [2021/07/18 4:15:52 ET]
Table 'Philia' 9-max Seat #3 is the button
Seat 1: CitizenPU ($2 in chips) 
Seat 2: sleeper hipi ($7.24 in chips) 
Seat 3: dealembub ($3.36 in chips) 
Seat 4: Dorex2007 ($3.71 in chips) 
Seat 5: Dorm619 ($2.23 in chips) 
Seat 6: Gora858 ($4.07 in chips) 
Seat 7: shuhrat19744 ($2 in chips) 
Seat 8: mendel777 ($1.81 in chips) 
Seat 9: NocnyFryzjer ($1.82 in chips) 
Dorex2007: posts small blind $0.01
Dorm619: posts big blind $0.02
*** HOLE CARDS ***
Dealt to Dorex2007 [Ac Tc]
Gora858: raises $0.02 to $0.04
shuhrat19744: folds 
mendel777: folds 
NocnyFryzjer: folds 
CitizenPU: folds 
sleeper hipi: folds 
dealembub: calls $0.04
Dorex2007: calls $0.03
Dorm619: calls $0.02
*** FLOP *** [9h 5s Jh]
Dorex2007: checks 
Dorm619: checks 
Gora858: bets $0.11
dealembub: calls $0.11
Dorex2007: folds 
Dorm619: folds 
*** TURN *** [9h 5s Jh] [Qs]
Gora858: bets $0.19
dealembub: raises $0.19 to $0.38
Gora858: calls $0.19
*** RIVER *** [9h 5s Jh Qs] [3s]
Gora858: bets $0.22
dealembub: raises $0.77 to $0.99
Gora858: calls $0.77
*** SHOW DOWN ***
dealembub: shows [Th 8s] (a straight, Eight to Queen)
Gora858: mucks hand 
dealembub collected $3.01 from pot
*** SUMMARY ***
Total pot $3.12 | Rake $0.11 
Board [9h 5s Jh Qs 3s]
Seat 1: CitizenPU folded before Flop (didn't bet)
Seat 2: sleeper hipi folded before Flop (didn't bet)
Seat 3: dealembub (button) showed [Th 8s] and won ($3.01) with a straight, Eight to Queen
Seat 4: Dorex2007 (small blind) folded on the Flop
Seat 5: Dorm619 (big blind) folded on the Flop
Seat 6: Gora858 mucked [Js Kc]
Seat 7: shuhrat19744 folded before Flop (didn't bet)
Seat 8: mendel777 folded before Flop (didn't bet)
Seat 9: NocnyFryzjer folded before Flop (didn't bet)



PokerStars Hand #228376362652:  Hold'em No Limit ($0.01/$0.02 USD) - 2021/07/18 1:18:41 PT [2021/07/18 4:18:41 ET]
Table 'Philia' 9-max Seat #4 is the button
Seat 1: CitizenPU ($2 in chips) 
Seat 2: sleeper hipi ($7.24 in chips) 
Seat 3: dealembub ($4.85 in chips) 
Seat 4: Dorex2007 ($3.67 in chips) 
Seat 5: Dorm619 ($2.19 in chips) 
Seat 6: Gora858 ($2.55 in chips) 
Seat 7: shuhrat19744 ($2 in chips) 
Seat 8: mendel777 ($1.81 in chips) 
Seat 9: NocnyFryzjer ($1.82 in chips) 
Dorm619: posts small blind $0.01
Gora858: posts big blind $0.02
*** HOLE CARDS ***
Dealt to Dorex2007 [Qs 5s]
shuhrat19744: raises $0.04 to $0.06
mendel777: folds 
NocnyFryzjer: folds 
CitizenPU: folds 
sleeper hipi: folds 
dealembub: calls $0.06
Dorex2007: folds 
Dorm619: folds 
Gora858: folds 
*** FLOP *** [2s 6d 8c]
shuhrat19744: bets $0.09
dealembub: raises $0.09 to $0.18
shuhrat19744: raises $1.76 to $1.94 and is all-in
dealembub: calls $1.76
*** TURN *** [2s 6d 8c] [7c]
*** RIVER *** [2s 6d 8c 7c] [7s]
*** SHOW DOWN ***
shuhrat19744: shows [Qh Qc] (two pair, Queens and Sevens)
dealembub: shows [Kc Ks] (two pair, Kings and Sevens)
dealembub cashed out the hand for $3.52 | Cash Out Fee $0.04
*** SUMMARY ***
Total pot $4.03 | Rake $0.14 
Board [2s 6d 8c 7c 7s]
Seat 1: CitizenPU folded before Flop (didn't bet)
Seat 2: sleeper hipi folded before Flop (didn't bet)
Seat 3: dealembub showed [Kc Ks] and won ($3.89) with two pair, Kings and Sevens (pot not awarded as player cashed out)
Seat 4: Dorex2007 (button) folded before Flop (didn't bet)
Seat 5: Dorm619 (small blind) folded before Flop
Seat 6: Gora858 (big blind) folded before Flop
Seat 7: shuhrat19744 showed [Qh Qc] and lost with two pair, Queens and Sevens
Seat 8: mendel777 folded before Flop (didn't bet)
Seat 9: NocnyFryzjer folded before Flop (didn't bet)



PokerStars Hand #228376370905:  Hold'em No Limit ($0.01/$0.02 USD) - 2021/07/18 1:19:30 PT [2021/07/18 4:19:30 ET]
Table 'Philia' 9-max Seat #5 is the button
Seat 1: CitizenPU ($2 in chips) 
Seat 2: sleeper hipi ($7.24 in chips) 
Seat 3: dealembub ($6.37 in chips) 
Seat 4: Dorex2007 ($3.67 in chips) 
Seat 5: Dorm619 ($2.18 in chips) 
Seat 6: Gora858 ($2.53 in chips) 
Seat 8: mendel777 ($1.81 in chips) 
Seat 9: NocnyFryzjer ($1.82 in chips) 
Gora858: posts small blind $0.01
shuhrat19744: is sitting out 
mendel777: posts big blind $0.02
*** HOLE CARDS ***
Dealt to Dorex2007 [6h Kd]
shuhrat19744 leaves the table
NocnyFryzjer: folds 
CitizenPU: folds 
sleeper hipi: folds 
dealembub: raises $0.02 to $0.04
Dorex2007: folds 
chappy540 joins the table at seat #7 
Dorm619: calls $0.04
Gora858: calls $0.03
mendel777: folds 
*** FLOP *** [Qs Kc Qh]
dealembub said, "did the  smart thing there"
Gora858: checks 
Dorex2007 said, "you turned hot all of a sudden"
dealembub: checks 
Dorm619: bets $0.07
Gora858: folds 
dealembub: calls $0.07
*** TURN *** [Qs Kc Qh] [2h]
dealembub: checks 
Dorm619: bets $0.14
dealembub: folds 
Uncalled bet ($0.14) returned to Dorm619
Dorm619 collected $0.27 from pot
Dorm619: doesn't show hand 
*** SUMMARY ***
Total pot $0.28 | Rake $0.01 
Board [Qs Kc Qh 2h]
Seat 1: CitizenPU folded before Flop (didn't bet)
Seat 2: sleeper hipi folded before Flop (didn't bet)
Seat 3: dealembub folded on the Turn
Seat 4: Dorex2007 folded before Flop (didn't bet)
Seat 5: Dorm619 (button) collected ($0.27)
Seat 6: Gora858 (small blind) folded on the Flop
Seat 8: mendel777 (big blind) folded before Flop
Seat 9: NocnyFryzjer folded before Flop (didn't bet)



PokerStars Hand #228376379664:  Hold'em No Limit ($0.01/$0.02 USD) - 2021/07/18 1:20:21 PT [2021/07/18 4:20:21 ET]
Table 'Philia' 9-max Seat #6 is the button
Seat 1: CitizenPU ($2 in chips) 
Seat 2: sleeper hipi ($7.24 in chips) 
Seat 3: dealembub ($6.26 in chips) 
Seat 4: Dorex2007 ($3.67 in chips) 
Seat 5: Dorm619 ($2.34 in chips) 
Seat 6: Gora858 ($2.49 in chips) 
Seat 8: mendel777 ($1.79 in chips) 
Seat 9: NocnyFryzjer ($1.82 in chips) 
mendel777: posts small blind $0.01
NocnyFryzjer: posts big blind $0.02
*** HOLE CARDS ***
Dealt to Dorex2007 [8h Kc]
CitizenPU: folds 
sleeper hipi: folds 
dealembub said, "amazing isn't it"
dealembub: calls $0.02
Dorex2007: folds 
Dorm619: raises $0.04 to $0.06
Gora858: folds 
mendel777: folds 
NocnyFryzjer: folds 
dealembub: calls $0.04
*** FLOP *** [Kd 2s Ts]
Dorex2007 said, "it is..nothing for 2 hours then everything for 10 minutes"
dealembub: checks 
Dorm619: checks 
*** TURN *** [Kd 2s Ts] [Th]
dealembub: checks 
Dorm619: bets $0.09
dealembub: folds 
Uncalled bet ($0.09) returned to Dorm619
Dorm619 collected $0.14 from pot
Dorm619: doesn't show hand 
*** SUMMARY ***
Total pot $0.15 | Rake $0.01 
Board [Kd 2s Ts Th]
Seat 1: CitizenPU folded before Flop (didn't bet)
Seat 2: sleeper hipi folded before Flop (didn't bet)
Seat 3: dealembub folded on the Turn
Seat 4: Dorex2007 folded before Flop (didn't bet)
Seat 5: Dorm619 collected ($0.14)
Seat 6: Gora858 (button) folded before Flop (didn't bet)
Seat 8: mendel777 (small blind) folded before Flop
Seat 9: NocnyFryzjer (big blind) folded before Flop



PokerStars Hand #228376386292:  Hold'em No Limit ($0.01/$0.02 USD) - 2021/07/18 1:20:59 PT [2021/07/18 4:20:59 ET]
Table 'Philia' 9-max Seat #8 is the button
Seat 1: CitizenPU ($2 in chips) 
Seat 2: sleeper hipi ($7.24 in chips) 
Seat 3: dealembub ($6.20 in chips) 
Seat 4: Dorex2007 ($3.67 in chips) 
Seat 5: Dorm619 ($2.42 in chips) 
Seat 6: Gora858 ($2.49 in chips) 
Seat 7: chappy540 ($2 in chips) 
Seat 8: mendel777 ($1.78 in chips) 
Seat 9: NocnyFryzjer ($1.80 in chips) 
NocnyFryzjer: posts small blind $0.01
CitizenPU: posts big blind $0.02
chappy540: posts big blind $0.02
*** HOLE CARDS ***
Dealt to Dorex2007 [2h Qh]
dealembub said, "yes"
sleeper hipi: folds 
dealembub: calls $0.02
Dorex2007: folds 
Dorm619: raises $0.04 to $0.06
Gora858: folds 
chappy540: raises $0.22 to $0.28
mendel777: folds 
NocnyFryzjer: folds 
CitizenPU: folds 
dealembub: folds 
Dorm619: calls $0.22
*** FLOP *** [7h Jh 2s]
dealembub said, "just gotta get in sync with the flop"
Dorm619: bets $0.30
chappy540: calls $0.30
*** TURN *** [7h Jh 2s] [4s]
Dorm619: bets $0.78
chappy540: calls $0.78
*** RIVER *** [7h Jh 2s 4s] [Kd]
Dorm619: bets $1.06 and is all-in
chappy540: calls $0.64 and is all-in
Uncalled bet ($0.42) returned to Dorm619
*** SHOW DOWN ***
Dorm619: shows [Ks Js] (two pair, Kings and Jacks)
chappy540: shows [As Ad] (a pair of Aces)
Dorm619 collected $3.87 from pot
*** SUMMARY ***
Total pot $4.05 | Rake $0.18 
Board [7h Jh 2s 4s Kd]
Seat 1: CitizenPU (big blind) folded before Flop
Seat 2: sleeper hipi folded before Flop (didn't bet)
Seat 3: dealembub folded before Flop
Seat 4: Dorex2007 folded before Flop (didn't bet)
Seat 5: Dorm619 showed [Ks Js] and won ($3.87) with two pair, Kings and Jacks
Seat 6: Gora858 folded before Flop (didn't bet)
Seat 7: chappy540 showed [As Ad] and lost with a pair of Aces
Seat 8: mendel777 (button) folded before Flop (didn't bet)
Seat 9: NocnyFryzjer (small blind) folded before Flop



PokerStars Hand #228376400140:  Hold'em No Limit ($0.01/$0.02 USD) - 2021/07/18 1:22:20 PT [2021/07/18 4:22:20 ET]
Table 'Philia' 9-max Seat #9 is the button
Seat 1: CitizenPU ($2 in chips) 
Seat 2: sleeper hipi ($7.24 in chips) 
Seat 3: dealembub ($6.18 in chips) 
Seat 4: Dorex2007 ($3.67 in chips) 
Seat 5: Dorm619 ($4.29 in chips) 
Seat 6: Gora858 ($2.49 in chips) 
Seat 8: mendel777 ($1.78 in chips) 
Seat 9: NocnyFryzjer ($1.79 in chips) 
CitizenPU: posts small blind $0.01
sleeper hipi: posts big blind $0.02
*** HOLE CARDS ***
Dealt to Dorex2007 [7h 5d]
dealembub: raises $0.02 to $0.04
Dorex2007: folds 
dealembub said, "nh dorm"
Dorm619: calls $0.04
Gora858: calls $0.04
mendel777: raises $0.19 to $0.23
NocnyFryzjer: folds 
CitizenPU: folds 
sleeper hipi: folds 
dealembub: folds 
Dorm619: calls $0.19
Gora858: calls $0.19
*** FLOP *** [4c 5h 2h]
Dorm619: checks 
Gora858: bets $0.37
mendel777: raises $1.18 to $1.55 and is all-in
Dorm619: folds 
Gora858: calls $1.18
*** TURN *** [4c 5h 2h] [Td]
*** RIVER *** [4c 5h 2h Td] [Ad]
*** SHOW DOWN ***
Gora858: shows [Qh Qc] (a pair of Queens)
mendel777: shows [Jd Jc] (a pair of Jacks)
Gora858 collected $3.72 from pot
*** SUMMARY ***
Total pot $3.86 | Rake $0.14 
Board [4c 5h 2h Td Ad]
Seat 1: CitizenPU (small blind) folded before Flop
Seat 2: sleeper hipi (big blind) folded before Flop
Seat 3: dealembub folded before Flop
Seat 4: Dorex2007 folded before Flop (didn't bet)
Seat 5: Dorm619 folded on the Flop
Seat 6: Gora858 showed [Qh Qc] and won ($3.72) with a pair of Queens
Seat 8: mendel777 showed [Jd Jc] and lost with a pair of Jacks
Seat 9: NocnyFryzjer (button) folded before Flop (didn't bet)



PokerStars Hand #228376416767:  Hold'em No Limit ($0.01/$0.02 USD) - 2021/07/18 1:23:55 PT [2021/07/18 4:23:55 ET]
Table 'Philia' 9-max Seat #1 is the button
Seat 1: CitizenPU ($2 in chips) 
Seat 2: sleeper hipi ($7.22 in chips) 
Seat 3: dealembub ($6.14 in chips) 
Seat 4: Dorex2007 ($3.67 in chips) 
Seat 5: Dorm619 ($4.06 in chips) 
Seat 6: Gora858 ($4.43 in chips) 
Seat 7: chappy540 ($2 in chips) 
Seat 8: mendel777 ($1.60 in chips) 
Seat 9: NocnyFryzjer ($1.79 in chips) 
sleeper hipi: posts small blind $0.01
dealembub: posts big blind $0.02
*** HOLE CARDS ***
Dealt to Dorex2007 [Qc Ah]
Dorex2007: raises $0.04 to $0.06
Dorm619: folds 
Gora858: folds 
chappy540: folds 
mendel777: folds 
NocnyFryzjer: folds 
CitizenPU: folds 
sleeper hipi: folds 
dealembub: folds 
Uncalled bet ($0.04) returned to Dorex2007
Dorex2007 collected $0.05 from pot
Dorex2007: doesn't show hand 
*** SUMMARY ***
Total pot $0.05 | Rake $0 
Seat 1: CitizenPU (button) folded before Flop (didn't bet)
Seat 2: sleeper hipi (small blind) folded before Flop
Seat 3: dealembub (big blind) folded before Flop
Seat 4: Dorex2007 collected ($0.05)
Seat 5: Dorm619 folded before Flop (didn't bet)
Seat 6: Gora858 folded before Flop (didn't bet)
Seat 7: chappy540 folded before Flop (didn't bet)
Seat 8: mendel777 folded before Flop (didn't bet)
Seat 9: NocnyFryzjer folded before Flop (didn't bet)



PokerStars Hand #228376421430:  Hold'em No Limit ($0.01/$0.02 USD) - 2021/07/18 1:24:22 PT [2021/07/18 4:24:22 ET]
Table 'Philia' 9-max Seat #2 is the button
Seat 1: CitizenPU ($2 in chips) 
Seat 2: sleeper hipi ($7.21 in chips) 
Seat 3: dealembub ($6.12 in chips) 
Seat 4: Dorex2007 ($3.70 in chips) 
Seat 5: Dorm619 ($4.06 in chips) 
Seat 6: Gora858 ($4.43 in chips) 
Seat 7: chappy540 ($2 in chips) 
Seat 8: mendel777 ($1.60 in chips) 
Seat 9: NocnyFryzjer ($1.79 in chips) 
dealembub: posts small blind $0.01
Dorex2007: posts big blind $0.02
*** HOLE CARDS ***
Dealt to Dorex2007 [5d Kh]
Dorm619: folds 
Gora858: folds 
chappy540: folds 
mendel777: raises $0.04 to $0.06
NocnyFryzjer: folds 
CitizenPU: raises $0.14 to $0.20
sleeper hipi: folds 
dealembub: folds 
Dorex2007: folds 
mendel777: folds 
Uncalled bet ($0.14) returned to CitizenPU
CitizenPU collected $0.15 from pot
CitizenPU: doesn't show hand 
*** SUMMARY ***
Total pot $0.15 | Rake $0 
Seat 1: CitizenPU collected ($0.15)
Seat 2: sleeper hipi (button) folded before Flop (didn't bet)
Seat 3: dealembub (small blind) folded before Flop
Seat 4: Dorex2007 (big blind) folded before Flop
Seat 5: Dorm619 folded before Flop (didn't bet)
Seat 6: Gora858 folded before Flop (didn't bet)
Seat 7: chappy540 folded before Flop (didn't bet)
Seat 8: mendel777 folded before Flop
Seat 9: NocnyFryzjer folded before Flop (didn't bet)



PokerStars Hand #228376425449:  Hold'em No Limit ($0.01/$0.02 USD) - 2021/07/18 1:24:45 PT [2021/07/18 4:24:45 ET]
Table 'Philia' 9-max Seat #3 is the button
Seat 1: CitizenPU ($2.09 in chips) 
Seat 2: sleeper hipi ($7.21 in chips) 
Seat 3: dealembub ($6.11 in chips) 
Seat 4: Dorex2007 ($3.68 in chips) 
Seat 5: Dorm619 ($4.06 in chips) 
Seat 6: Gora858 ($4.43 in chips) 
Seat 7: chappy540 ($2 in chips) 
Seat 8: mendel777 ($1.60 in chips) 
Seat 9: NocnyFryzjer ($1.79 in chips) 
Dorex2007: posts small blind $0.01
Dorm619: posts big blind $0.02
*** HOLE CARDS ***
Dealt to Dorex2007 [5c 7c]
Gora858: raises $0.02 to $0.04
chappy540: folds 
mendel777: folds 
NocnyFryzjer: folds 
CitizenPU: folds 
sleeper hipi: folds 
dealembub: folds 
Dorex2007: folds 
Dorm619: folds 
Uncalled bet ($0.02) returned to Gora858
Gora858 collected $0.05 from pot
*** SUMMARY ***
Total pot $0.05 | Rake $0 
Seat 1: CitizenPU folded before Flop (didn't bet)
Seat 2: sleeper hipi folded before Flop (didn't bet)
Seat 3: dealembub (button) folded before Flop (didn't bet)
Seat 4: Dorex2007 (small blind) folded before Flop
Seat 5: Dorm619 (big blind) folded before Flop
Seat 6: Gora858 collected ($0.05)
Seat 7: chappy540 folded before Flop (didn't bet)
Seat 8: mendel777 folded before Flop (didn't bet)
Seat 9: NocnyFryzjer folded before Flop (didn't bet)



PokerStars Hand #228376429779:  Hold'em No Limit ($0.01/$0.02 USD) - 2021/07/18 1:25:11 PT [2021/07/18 4:25:11 ET]
Table 'Philia' 9-max Seat #4 is the button
Seat 1: CitizenPU ($2.09 in chips) 
Seat 2: sleeper hipi ($7.21 in chips) 
Seat 3: dealembub ($6.11 in chips) 
Seat 4: Dorex2007 ($3.67 in chips) 
Seat 5: Dorm619 ($4.04 in chips) 
Seat 6: Gora858 ($4.46 in chips) 
Seat 7: chappy540 ($2 in chips) 
Seat 8: mendel777 ($1.60 in chips) 
Seat 9: NocnyFryzjer ($1.79 in chips) 
Dorm619: posts small blind $0.01
Gora858: posts big blind $0.02
*** HOLE CARDS ***
Dealt to Dorex2007 [Qc Th]
chappy540: folds 
mendel777: raises $0.04 to $0.06
NocnyFryzjer: folds 
CitizenPU: folds 
sleeper hipi: calls $0.06
dealembub: folds 
Dorex2007: folds 
Dorm619: folds 
Gora858: folds 
*** FLOP *** [3s 2h 2c]
mendel777: checks 
sleeper hipi: checks 
*** TURN *** [3s 2h 2c] [4c]
mendel777: checks 
sleeper hipi: bets $0.07
mendel777: folds 
Uncalled bet ($0.07) returned to sleeper hipi
sleeper hipi collected $0.14 from pot
sleeper hipi: doesn't show hand 
*** SUMMARY ***
Total pot $0.15 | Rake $0.01 
Board [3s 2h 2c 4c]
Seat 1: CitizenPU folded before Flop (didn't bet)
Seat 2: sleeper hipi collected ($0.14)
Seat 3: dealembub folded before Flop (didn't bet)
Seat 4: Dorex2007 (button) folded before Flop (didn't bet)
Seat 5: Dorm619 (small blind) folded before Flop
Seat 6: Gora858 (big blind) folded before Flop
Seat 7: chappy540 folded before Flop (didn't bet)
Seat 8: mendel777 folded on the Turn
Seat 9: NocnyFryzjer folded before Flop (didn't bet)



PokerStars Hand #228376438963:  Hold'em No Limit ($0.01/$0.02 USD) - 2021/07/18 1:26:04 PT [2021/07/18 4:26:04 ET]
Table 'Philia' 9-max Seat #5 is the button
Seat 1: CitizenPU ($2.09 in chips) 
Seat 2: sleeper hipi ($7.29 in chips) 
Seat 3: dealembub ($6.11 in chips) 
Seat 4: Dorex2007 ($3.67 in chips) 
Seat 5: Dorm619 ($4.03 in chips) 
Seat 6: Gora858 ($4.44 in chips) 
Seat 7: chappy540 ($2 in chips) 
Seat 8: mendel777 ($1.60 in chips) 
Seat 9: NocnyFryzjer ($1.79 in chips) 
Gora858: posts small blind $0.01
chappy540: posts big blind $0.02
*** HOLE CARDS ***
Dealt to Dorex2007 [6h 8c]
mendel777: folds 
NocnyFryzjer: folds 
CitizenPU: folds 
sleeper hipi: folds 
dealembub: raises $0.02 to $0.04
Dorex2007: folds 
Dorm619: calls $0.04
Gora858: folds 
chappy540: folds 
*** FLOP *** [3h 6d Qh]
dealembub: bets $0.11
Dorm619: calls $0.11
*** TURN *** [3h 6d Qh] [As]
dealembub: bets $0.32
Dorm619: calls $0.32
*** RIVER *** [3h 6d Qh As] [2s]
dealembub: checks 
Dorm619: bets $0.94
dealembub: folds 
Uncalled bet ($0.94) returned to Dorm619
Dorm619 collected $0.93 from pot
Dorm619: doesn't show hand 
*** SUMMARY ***
Total pot $0.97 | Rake $0.04 
Board [3h 6d Qh As 2s]
Seat 1: CitizenPU folded before Flop (didn't bet)
Seat 2: sleeper hipi folded before Flop (didn't bet)
Seat 3: dealembub folded on the River
Seat 4: Dorex2007 folded before Flop (didn't bet)
Seat 5: Dorm619 (button) collected ($0.93)
Seat 6: Gora858 (small blind) folded before Flop
Seat 7: chappy540 (big blind) folded before Flop
Seat 8: mendel777 folded before Flop (didn't bet)
Seat 9: NocnyFryzjer folded before Flop (didn't bet)



PokerStars Hand #228376451066:  Hold'em No Limit ($0.01/$0.02 USD) - 2021/07/18 1:27:14 PT [2021/07/18 4:27:14 ET]
Table 'Philia' 9-max Seat #6 is the button
Seat 1: CitizenPU ($2.09 in chips) 
Seat 2: sleeper hipi ($7.29 in chips) 
Seat 3: dealembub ($5.64 in chips) 
Seat 4: Dorex2007 ($3.67 in chips) 
Seat 5: Dorm619 ($4.49 in chips) 
Seat 6: Gora858 ($4.43 in chips) 
Seat 7: chappy540 ($1.98 in chips) 
Seat 8: mendel777 ($1.60 in chips) 
Seat 9: NocnyFryzjer ($1.79 in chips) 
chappy540: posts small blind $0.01
mendel777: posts big blind $0.02
*** HOLE CARDS ***
Dealt to Dorex2007 [4h Kc]
NocnyFryzjer: folds 
CitizenPU: folds 
sleeper hipi: folds 
dealembub: calls $0.02
Dorex2007: folds 
Dorm619: folds 
dealembub said, "probably had pkt 3's"
Gora858: folds 
chappy540: calls $0.01
mendel777: checks 
*** FLOP *** [2h 5s Qs]
chappy540: checks 
Dorex2007 said, "lol"
mendel777: checks 
dealembub: checks 
*** TURN *** [2h 5s Qs] [9h]
chappy540: checks 
mendel777: checks 
dealembub: checks 
*** RIVER *** [2h 5s Qs 9h] [Qc]
chappy540: checks 
mendel777: checks 
dealembub: checks 
*** SHOW DOWN ***
chappy540: shows [Th 8c] (a pair of Queens)
mendel777: shows [7h Ac] (a pair of Queens - Ace kicker)
dealembub: mucks hand 
mendel777 collected $0.06 from pot
*** SUMMARY ***
Total pot $0.06 | Rake $0 
Board [2h 5s Qs 9h Qc]
Seat 1: CitizenPU folded before Flop (didn't bet)
Seat 2: sleeper hipi folded before Flop (didn't bet)
Seat 3: dealembub mucked [Td 7d]
Seat 4: Dorex2007 folded before Flop (didn't bet)
Seat 5: Dorm619 folded before Flop (didn't bet)
Seat 6: Gora858 (button) folded before Flop (didn't bet)
Seat 7: chappy540 (small blind) showed [Th 8c] and lost with a pair of Queens
Seat 8: mendel777 (big blind) showed [7h Ac] and won ($0.06) with a pair of Queens
Seat 9: NocnyFryzjer folded before Flop (didn't bet)



PokerStars Hand #228376459474:  Hold'em No Limit ($0.01/$0.02 USD) - 2021/07/18 1:28:02 PT [2021/07/18 4:28:02 ET]
Table 'Philia' 9-max Seat #7 is the button
Seat 1: CitizenPU ($2.09 in chips) 
Seat 2: sleeper hipi ($7.29 in chips) 
Seat 3: dealembub ($5.62 in chips) 
Seat 4: Dorex2007 ($3.67 in chips) 
Seat 5: Dorm619 ($4.49 in chips) 
Seat 6: Gora858 ($4.43 in chips) 
Seat 7: chappy540 ($1.96 in chips) 
Seat 8: mendel777 ($1.64 in chips) 
Seat 9: NocnyFryzjer ($1.79 in chips) 
mendel777: posts small blind $0.01
NocnyFryzjer: posts big blind $0.02
*** HOLE CARDS ***
Dealt to Dorex2007 [Kd 5s]
CitizenPU: folds 
CitizenPU leaves the table
sleeper hipi: folds 
dealembub: calls $0.02
Dorex2007: folds 
naxal2012 joins the table at seat #1 
Dorm619: raises $0.04 to $0.06
Gora858: folds 
chappy540: folds 
mendel777: folds 
NocnyFryzjer: folds 
dealembub: calls $0.04
*** FLOP *** [Ts 7s 3s]
dealembub: bets $0.07
Dorm619: calls $0.07
*** TURN *** [Ts 7s 3s] [6c]
dealembub: bets $0.14
Dorm619: calls $0.14
*** RIVER *** [Ts 7s 3s 6c] [Js]
dealembub: checks 
Dorm619: checks 
*** SHOW DOWN ***
dealembub: shows [3c Ah] (a pair of Threes)
Dorm619: shows [9h Th] (a pair of Tens)
Dorm619 collected $0.55 from pot
*** SUMMARY ***
Total pot $0.57 | Rake $0.02 
Board [Ts 7s 3s 6c Js]
Seat 1: CitizenPU folded before Flop (didn't bet)
Seat 2: sleeper hipi folded before Flop (didn't bet)
Seat 3: dealembub showed [3c Ah] and lost with a pair of Threes
Seat 4: Dorex2007 folded before Flop (didn't bet)
Seat 5: Dorm619 showed [9h Th] and won ($0.55) with a pair of Tens
Seat 6: Gora858 folded before Flop (didn't bet)
Seat 7: chappy540 (button) folded before Flop (didn't bet)
Seat 8: mendel777 (small blind) folded before Flop
Seat 9: NocnyFryzjer (big blind) folded before Flop



PokerStars Hand #228376467347:  Hold'em No Limit ($0.01/$0.02 USD) - 2021/07/18 1:28:47 PT [2021/07/18 4:28:47 ET]
Table 'Philia' 9-max Seat #8 is the button
Seat 1: naxal2012 ($2 in chips) 
Seat 2: sleeper hipi ($7.29 in chips) 
Seat 3: dealembub ($5.35 in chips) 
Seat 4: Dorex2007 ($3.67 in chips) 
Seat 5: Dorm619 ($4.77 in chips) 
Seat 6: Gora858 ($4.43 in chips) 
Seat 7: chappy540 ($1.96 in chips) 
Seat 8: mendel777 ($1.63 in chips) 
Seat 9: NocnyFryzjer ($1.77 in chips) 
NocnyFryzjer: posts small blind $0.01
naxal2012: posts big blind $0.02
*** HOLE CARDS ***
Dealt to Dorex2007 [2d Tc]
sleeper hipi: folds 
dealembub: calls $0.02
Dorex2007: folds 
Dorm619: folds 
Gora858: folds 
chappy540: folds 
mendel777: folds 
NocnyFryzjer: folds 
naxal2012: checks 
*** FLOP *** [4d 4s 4c]
naxal2012: checks 
dealembub: checks 
*** TURN *** [4d 4s 4c] [7h]
naxal2012: checks 
dealembub: checks 
*** RIVER *** [4d 4s 4c 7h] [Qc]
naxal2012: checks 
dealembub: checks 
*** SHOW DOWN ***
naxal2012: shows [3s Ts] (three of a kind, Fours)
dealembub: shows [Ks 9h] (three of a kind, Fours - King kicker)
dealembub collected $0.05 from pot
*** SUMMARY ***
Total pot $0.05 | Rake $0 
Board [4d 4s 4c 7h Qc]
Seat 1: naxal2012 (big blind) showed [3s Ts] and lost with three of a kind, Fours
Seat 2: sleeper hipi folded before Flop (didn't bet)
Seat 3: dealembub showed [Ks 9h] and won ($0.05) with three of a kind, Fours
Seat 4: Dorex2007 folded before Flop (didn't bet)
Seat 5: Dorm619 folded before Flop (didn't bet)
Seat 6: Gora858 folded before Flop (didn't bet)
Seat 7: chappy540 folded before Flop (didn't bet)
Seat 8: mendel777 (button) folded before Flop (didn't bet)
Seat 9: NocnyFryzjer (small blind) folded before Flop



PokerStars Hand #228376474059:  Hold'em No Limit ($0.01/$0.02 USD) - 2021/07/18 1:29:26 PT [2021/07/18 4:29:26 ET]
Table 'Philia' 9-max Seat #9 is the button
Seat 1: naxal2012 ($2 in chips) 
Seat 2: sleeper hipi ($7.29 in chips) 
Seat 3: dealembub ($5.38 in chips) 
Seat 4: Dorex2007 ($3.67 in chips) 
Seat 5: Dorm619 ($4.77 in chips) 
Seat 6: Gora858 ($4.43 in chips) 
Seat 7: chappy540 ($1.96 in chips) 
Seat 8: mendel777 ($1.63 in chips) 
Seat 9: NocnyFryzjer ($1.76 in chips) 
naxal2012: posts small blind $0.01
sleeper hipi: posts big blind $0.02
*** HOLE CARDS ***
Dealt to Dorex2007 [5h Ac]
dealembub: folds 
Dorex2007: folds 
Dorm619: folds 
Gora858: folds 
chappy540: folds 
mendel777: folds 
NocnyFryzjer: raises $0.04 to $0.06
naxal2012: folds 
sleeper hipi: calls $0.04
*** FLOP *** [4d 2s 3h]
sleeper hipi: checks 
NocnyFryzjer: bets $0.07
sleeper hipi: folds 
Uncalled bet ($0.07) returned to NocnyFryzjer
NocnyFryzjer collected $0.13 from pot
NocnyFryzjer: doesn't show hand 
*** SUMMARY ***
Total pot $0.13 | Rake $0 
Board [4d 2s 3h]
Seat 1: naxal2012 (small blind) folded before Flop
Seat 2: sleeper hipi (big blind) folded on the Flop
Seat 3: dealembub folded before Flop (didn't bet)
Seat 4: Dorex2007 folded before Flop (didn't bet)
Seat 5: Dorm619 folded before Flop (didn't bet)
Seat 6: Gora858 folded before Flop (didn't bet)
Seat 7: chappy540 folded before Flop (didn't bet)
Seat 8: mendel777 folded before Flop (didn't bet)
Seat 9: NocnyFryzjer (button) collected ($0.13)



PokerStars Hand #228376484196:  Hold'em No Limit ($0.01/$0.02 USD) - 2021/07/18 1:30:24 PT [2021/07/18 4:30:24 ET]
Table 'Philia' 9-max Seat #1 is the button
Seat 1: naxal2012 ($2 in chips) 
Seat 2: sleeper hipi ($7.23 in chips) 
Seat 3: dealembub ($5.38 in chips) 
Seat 4: Dorex2007 ($3.67 in chips) 
Seat 5: Dorm619 ($4.77 in chips) 
Seat 6: Gora858 ($4.43 in chips) 
Seat 7: chappy540 ($1.96 in chips) 
Seat 8: mendel777 ($1.63 in chips) 
Seat 9: NocnyFryzjer ($1.83 in chips) 
sleeper hipi: posts small blind $0.01
dealembub: posts big blind $0.02
*** HOLE CARDS ***
Dealt to Dorex2007 [3c Kc]
Dorex2007: folds 
Dorm619: folds 
Gora858: folds 
chappy540: folds 
mendel777: folds 
NocnyFryzjer: raises $0.04 to $0.06
naxal2012: raises $0.13 to $0.19
sleeper hipi: folds 
dealembub: folds 
NocnyFryzjer: folds 
Uncalled bet ($0.13) returned to naxal2012
naxal2012 collected $0.15 from pot
*** SUMMARY ***
Total pot $0.15 | Rake $0 
Seat 1: naxal2012 (button) collected ($0.15)
Seat 2: sleeper hipi (small blind) folded before Flop
Seat 3: dealembub (big blind) folded before Flop
Seat 4: Dorex2007 folded before Flop (didn't bet)
Seat 5: Dorm619 folded before Flop (didn't bet)
Seat 6: Gora858 folded before Flop (didn't bet)
Seat 7: chappy540 folded before Flop (didn't bet)
Seat 8: mendel777 folded before Flop (didn't bet)
Seat 9: NocnyFryzjer folded before Flop



PokerStars Hand #228376492488:  Hold'em No Limit ($0.01/$0.02 USD) - 2021/07/18 1:31:11 PT [2021/07/18 4:31:11 ET]
Table 'Philia' 9-max Seat #2 is the button
Seat 1: naxal2012 ($2.09 in chips) 
Seat 2: sleeper hipi ($7.22 in chips) 
Seat 3: dealembub ($5.36 in chips) 
Seat 4: Dorex2007 ($3.67 in chips) 
Seat 5: Dorm619 ($4.77 in chips) 
Seat 6: Gora858 ($4.43 in chips) 
Seat 7: chappy540 ($1.96 in chips) 
Seat 8: mendel777 ($1.63 in chips) 
Seat 9: NocnyFryzjer ($1.77 in chips) 
dealembub: posts small blind $0.01
Dorex2007: posts big blind $0.02
*** HOLE CARDS ***
Dealt to Dorex2007 [Qd Kd]
Dorm619: folds 
Gora858: folds 
chappy540: folds 
mendel777: folds 
NocnyFryzjer: folds 
naxal2012: folds 
sleeper hipi: folds 
dealembub: calls $0.01
Dorex2007: raises $0.04 to $0.06
dealembub: folds 
Uncalled bet ($0.04) returned to Dorex2007
Dorex2007 collected $0.04 from pot
Dorex2007: doesn't show hand 
*** SUMMARY ***
Total pot $0.04 | Rake $0 
Seat 1: naxal2012 folded before Flop (didn't bet)
Seat 2: sleeper hipi (button) folded before Flop (didn't bet)
Seat 3: dealembub (small blind) folded before Flop
Seat 4: Dorex2007 (big blind) collected ($0.04)
Seat 5: Dorm619 folded before Flop (didn't bet)
Seat 6: Gora858 folded before Flop (didn't bet)
Seat 7: chappy540 folded before Flop (didn't bet)
Seat 8: mendel777 folded before Flop (didn't bet)
Seat 9: NocnyFryzjer folded before Flop (didn't bet)



PokerStars Hand #228376495821:  Hold'em No Limit ($0.01/$0.02 USD) - 2021/07/18 1:31:30 PT [2021/07/18 4:31:30 ET]
Table 'Philia' 9-max Seat #3 is the button
Seat 1: naxal2012 ($2.09 in chips) 
Seat 2: sleeper hipi ($7.22 in chips) 
Seat 3: dealembub ($5.34 in chips) 
Seat 4: Dorex2007 ($3.69 in chips) 
Seat 5: Dorm619 ($4.77 in chips) 
Seat 6: Gora858 ($4.43 in chips) 
Seat 7: chappy540 ($1.96 in chips) 
Seat 8: mendel777 ($1.63 in chips) 
Seat 9: NocnyFryzjer ($1.77 in chips) 
Dorex2007: posts small blind $0.01
Dorm619: posts big blind $0.02
*** HOLE CARDS ***
Dealt to Dorex2007 [3c 3s]
Gora858: folds 
chappy540: folds 
mendel777: folds 
NocnyFryzjer: folds 
Gora858 leaves the table
naxal2012: folds 
sleeper hipi: folds 
dealembub: calls $0.02
Dorex2007: calls $0.01
dealembub said, "is your son/daughter on a ship?"
Dorm619: checks 
*** FLOP *** [5s As 8d]
Dorex2007 said, "just got back"
Dorex2007: checks 
Dorm619: checks 
dealembub: checks 
*** TURN *** [5s As 8d] [Qd]
Dorex2007 said, "goes to the South china sea next month"
Dorex2007: checks 
dealembub said, "oh boy"
Dorm619: checks 
dealembub: checks 
*** RIVER *** [5s As 8d Qd] [Jc]
Dorex2007: checks 
Dorm619: checks 
dealembub: checks 
*** SHOW DOWN ***
Dorex2007: shows [3c 3s] (a pair of Threes)
Dorm619: shows [6c 5c] (a pair of Fives)
dealembub: shows [Ks 5h] (a pair of Fives - Ace+King kicker)
dealembub collected $0.06 from pot
*** SUMMARY ***
Total pot $0.06 | Rake $0 
Board [5s As 8d Qd Jc]
Seat 1: naxal2012 folded before Flop (didn't bet)
Seat 2: sleeper hipi folded before Flop (didn't bet)
Seat 3: dealembub (button) showed [Ks 5h] and won ($0.06) with a pair of Fives
Seat 4: Dorex2007 (small blind) showed [3c 3s] and lost with a pair of Threes
Seat 5: Dorm619 (big blind) showed [6c 5c] and lost with a pair of Fives
Seat 6: Gora858 folded before Flop (didn't bet)
Seat 7: chappy540 folded before Flop (didn't bet)
Seat 8: mendel777 folded before Flop (didn't bet)
Seat 9: NocnyFryzjer folded before Flop (didn't bet)



PokerStars Hand #228376505966:  Hold'em No Limit ($0.01/$0.02 USD) - 2021/07/18 1:32:27 PT [2021/07/18 4:32:27 ET]
Table 'Philia' 9-max Seat #4 is the button
Seat 1: naxal2012 ($2.09 in chips) 
Seat 2: sleeper hipi ($7.22 in chips) 
Seat 3: dealembub ($5.38 in chips) 
Seat 4: Dorex2007 ($3.67 in chips) 
Seat 5: Dorm619 ($4.75 in chips) 
Seat 7: chappy540 ($1.96 in chips) 
Seat 8: mendel777 ($1.63 in chips) 
Seat 9: NocnyFryzjer ($1.77 in chips) 
Dorm619: posts small blind $0.01
chappy540: posts big blind $0.02
*** HOLE CARDS ***
Dealt to Dorex2007 [5h 2h]
mendel777: folds 
NocnyFryzjer: folds 
Dorex2007 said, "had to play the 3's :)"
naxal2012: folds 
sleeper hipi: raises $0.04 to $0.06
dealembub: calls $0.06
Dorex2007: folds 
Dorm619: calls $0.05
chappy540: calls $0.04
*** FLOP *** [3h 9s 2c]
Dorm619: checks 
chappy540: checks 
sleeper hipi: checks 
dealembub: bets $0.24
Dorm619: folds 
chappy540: folds 
sleeper hipi: calls $0.24
*** TURN *** [3h 9s 2c] [As]
sleeper hipi: checks 
dealembub: bets $0.10
sleeper hipi: calls $0.10
*** RIVER *** [3h 9s 2c As] [Jh]
sleeper hipi: checks 
dealembub: checks 
*** SHOW DOWN ***
sleeper hipi: shows [Qc Jc] (a pair of Jacks)
dealembub: mucks hand 
sleeper hipi collected $0.89 from pot
*** SUMMARY ***
Total pot $0.92 | Rake $0.03 
Board [3h 9s 2c As Jh]
Seat 1: naxal2012 folded before Flop (didn't bet)
Seat 2: sleeper hipi showed [Qc Jc] and won ($0.89) with a pair of Jacks
Seat 3: dealembub mucked [Ts 9h]
Seat 4: Dorex2007 (button) folded before Flop (didn't bet)
Seat 5: Dorm619 (small blind) folded on the Flop
Seat 7: chappy540 (big blind) folded on the Flop
Seat 8: mendel777 folded before Flop (didn't bet)
Seat 9: NocnyFryzjer folded before Flop (didn't bet)



PokerStars Hand #228376519142:  Hold'em No Limit ($0.01/$0.02 USD) - 2021/07/18 1:33:40 PT [2021/07/18 4:33:40 ET]
Table 'Philia' 9-max Seat #5 is the button
Seat 1: naxal2012 ($2.09 in chips) 
Seat 2: sleeper hipi ($7.71 in chips) 
Seat 3: dealembub ($4.98 in chips) 
Seat 4: Dorex2007 ($3.67 in chips) 
Seat 5: Dorm619 ($4.69 in chips) 
Seat 7: chappy540 ($1.90 in chips) 
Seat 8: mendel777 ($1.63 in chips) 
Seat 9: NocnyFryzjer ($1.77 in chips) 
chappy540: posts small blind $0.01
mendel777: posts big blind $0.02
*** HOLE CARDS ***
Dealt to Dorex2007 [5c 4h]
NocnyFryzjer: folds 
naxal2012: folds 
sleeper hipi: folds 
dealembub: folds 
Dorex2007: folds 
Dorm619: folds 
ros095 joins the table at seat #6 
chappy540: folds 
Uncalled bet ($0.01) returned to mendel777
mendel777 collected $0.02 from pot
mendel777: doesn't show hand 
*** SUMMARY ***
Total pot $0.02 | Rake $0 
Seat 1: naxal2012 folded before Flop (didn't bet)
Seat 2: sleeper hipi folded before Flop (didn't bet)
Seat 3: dealembub folded before Flop (didn't bet)
Seat 4: Dorex2007 folded before Flop (didn't bet)
Seat 5: Dorm619 (button) folded before Flop (didn't bet)
Seat 7: chappy540 (small blind) folded before Flop
Seat 8: mendel777 (big blind) collected ($0.02)
Seat 9: NocnyFryzjer folded before Flop (didn't bet)



PokerStars Hand #228376521950:  Hold'em No Limit ($0.01/$0.02 USD) - 2021/07/18 1:33:56 PT [2021/07/18 4:33:56 ET]
Table 'Philia' 9-max Seat #7 is the button
Seat 1: naxal2012 ($2.09 in chips) 
Seat 2: sleeper hipi ($7.71 in chips) 
Seat 3: dealembub ($4.98 in chips) 
Seat 4: Dorex2007 ($3.67 in chips) 
Seat 5: Dorm619 ($4.69 in chips) 
Seat 7: chappy540 ($1.89 in chips) 
Seat 8: mendel777 ($1.64 in chips) 
Seat 9: NocnyFryzjer ($1.77 in chips) 
mendel777: posts small blind $0.01
NocnyFryzjer: posts big blind $0.02
ros095: sits out 
*** HOLE CARDS ***
Dealt to Dorex2007 [7d 5d]
dealembub said, "giving it back now"
naxal2012: folds 
sleeper hipi: raises $0.04 to $0.06
dealembub: raises $0.04 to $0.10
Dorex2007: folds 
Dorm619: folds 
chappy540: folds 
mendel777: folds 
NocnyFryzjer: folds 
sleeper hipi: calls $0.04
*** FLOP *** [3c Qd Td]
sleeper hipi: checks 
dealembub: bets $0.32
sleeper hipi: folds 
Uncalled bet ($0.32) returned to dealembub
dealembub collected $0.22 from pot
dealembub: doesn't show hand 
*** SUMMARY ***
Total pot $0.23 | Rake $0.01 
Board [3c Qd Td]
Seat 1: naxal2012 folded before Flop (didn't bet)
Seat 2: sleeper hipi folded on the Flop
Seat 3: dealembub collected ($0.22)
Seat 4: Dorex2007 folded before Flop (didn't bet)
Seat 5: Dorm619 folded before Flop (didn't bet)
Seat 7: chappy540 (button) folded before Flop (didn't bet)
Seat 8: mendel777 (small blind) folded before Flop
Seat 9: NocnyFryzjer (big blind) folded before Flop



PokerStars Hand #228376527666:  Hold'em No Limit ($0.01/$0.02 USD) - 2021/07/18 1:34:27 PT [2021/07/18 4:34:27 ET]
Table 'Philia' 9-max Seat #8 is the button
Seat 1: naxal2012 ($2.09 in chips) 
Seat 2: sleeper hipi ($7.61 in chips) 
Seat 3: dealembub ($5.10 in chips) 
Seat 4: Dorex2007 ($3.67 in chips) 
Seat 5: Dorm619 ($4.69 in chips) 
Seat 6: ros095 ($0.80 in chips) 
Seat 7: chappy540 ($1.89 in chips) 
Seat 8: mendel777 ($1.63 in chips) 
Seat 9: NocnyFryzjer ($1.75 in chips) 
NocnyFryzjer: posts small blind $0.01
naxal2012: posts big blind $0.02
ros095: posts big blind $0.02
*** HOLE CARDS ***
Dealt to Dorex2007 [7s Qd]
sleeper hipi: folds 
dealembub: raises $0.02 to $0.04
Dorex2007: folds 
Dorm619: calls $0.04
ros095: calls $0.02
chappy540: folds 
mendel777: folds 
NocnyFryzjer: folds 
naxal2012: calls $0.02
*** FLOP *** [5s 5d 9h]
naxal2012: checks 
dealembub: checks 
Dorm619: checks 
ros095: bets $0.10
naxal2012: calls $0.10
dealembub: folds 
Dorm619: calls $0.10
*** TURN *** [5s 5d 9h] [Jc]
naxal2012: checks 
Dorm619: checks 
ros095: bets $0.66 and is all-in
naxal2012: calls $0.66
Dorm619: folds 
*** RIVER *** [5s 5d 9h Jc] [7h]
*** SHOW DOWN ***
naxal2012: shows [2h 5c] (three of a kind, Fives)
ros095: shows [Ac 9c] (two pair, Nines and Fives)
naxal2012 collected $1.73 from pot
ros095 cashed out the hand for $0.07
*** SUMMARY ***
Total pot $1.79 | Rake $0.06 
Board [5s 5d 9h Jc 7h]
Seat 1: naxal2012 (big blind) showed [2h 5c] and won ($1.73) with three of a kind, Fives
Seat 2: sleeper hipi folded before Flop (didn't bet)
Seat 3: dealembub folded on the Flop
Seat 4: Dorex2007 folded before Flop (didn't bet)
Seat 5: Dorm619 folded on the Turn
Seat 6: ros095 showed [Ac 9c] and lost with two pair, Nines and Fives (cashed out).
Seat 7: chappy540 folded before Flop (didn't bet)
Seat 8: mendel777 (button) folded before Flop (didn't bet)
Seat 9: NocnyFryzjer (small blind) folded before Flop



PokerStars Hand #228376548720:  Hold'em No Limit ($0.01/$0.02 USD) - 2021/07/18 1:36:26 PT [2021/07/18 4:36:26 ET]
Table 'Philia' 9-max Seat #9 is the button
Seat 1: naxal2012 ($3.02 in chips) 
Seat 2: sleeper hipi ($7.61 in chips) 
Seat 3: dealembub ($5.06 in chips) 
Seat 4: Dorex2007 ($3.67 in chips) 
Seat 5: Dorm619 ($4.55 in chips) 
Seat 6: ros095 ($0.07 in chips) 
Seat 7: chappy540 ($1.89 in chips) 
Seat 8: mendel777 ($1.63 in chips) 
Seat 9: NocnyFryzjer ($1.74 in chips) 
naxal2012: posts small blind $0.01
sleeper hipi: posts big blind $0.02
*** HOLE CARDS ***
Dealt to Dorex2007 [6s Ts]
dealembub: raises $0.02 to $0.04
Dorex2007: folds 
Dorm619: folds 
ros095: folds 
chappy540: folds 
mendel777: folds 
ros095 leaves the table
NocnyFryzjer: folds 
naxal2012: folds 
bloody55hawk joins the table at seat #6 
sleeper hipi: calls $0.02
*** FLOP *** [Ac Ad Qs]
sleeper hipi: checks 
dealembub: bets $0.02
sleeper hipi: folds 
Uncalled bet ($0.02) returned to dealembub
dealembub collected $0.09 from pot
dealembub: doesn't show hand 
*** SUMMARY ***
Total pot $0.09 | Rake $0 
Board [Ac Ad Qs]
Seat 1: naxal2012 (small blind) folded before Flop
Seat 2: sleeper hipi (big blind) folded on the Flop
Seat 3: dealembub collected ($0.09)
Seat 4: Dorex2007 folded before Flop (didn't bet)
Seat 5: Dorm619 folded before Flop (didn't bet)
Seat 6: ros095 folded before Flop (didn't bet)
Seat 7: chappy540 folded before Flop (didn't bet)
Seat 8: mendel777 folded before Flop (didn't bet)
Seat 9: NocnyFryzjer (button) folded before Flop (didn't bet)



PokerStars Hand #228376556545:  Hold'em No Limit ($0.01/$0.02 USD) - 2021/07/18 1:37:10 PT [2021/07/18 4:37:10 ET]
Table 'Philia' 9-max Seat #1 is the button
Seat 1: naxal2012 ($3.01 in chips) 
Seat 2: sleeper hipi ($7.57 in chips) 
Seat 3: dealembub ($5.11 in chips) 
Seat 4: Dorex2007 ($3.67 in chips) 
Seat 5: Dorm619 ($4.55 in chips) 
Seat 7: chappy540 ($1.89 in chips) 
Seat 8: mendel777 ($1.63 in chips) 
Seat 9: NocnyFryzjer ($1.74 in chips) 
sleeper hipi: posts small blind $0.01
dealembub: posts big blind $0.02
bloody55hawk: sits out 
*** HOLE CARDS ***
Dealt to Dorex2007 [7d 4d]
Dorex2007: folds 
Dorm619: raises $0.04 to $0.06
chappy540: folds 
mendel777: folds 
NocnyFryzjer: folds 
naxal2012: folds 
sleeper hipi: folds 
dealembub: folds 
Uncalled bet ($0.04) returned to Dorm619
Dorm619 collected $0.05 from pot
Dorm619: doesn't show hand 
*** SUMMARY ***
Total pot $0.05 | Rake $0 
Seat 1: naxal2012 (button) folded before Flop (didn't bet)
Seat 2: sleeper hipi (small blind) folded before Flop
Seat 3: dealembub (big blind) folded before Flop
Seat 4: Dorex2007 folded before Flop (didn't bet)
Seat 5: Dorm619 collected ($0.05)
Seat 7: chappy540 folded before Flop (didn't bet)
Seat 8: mendel777 folded before Flop (didn't bet)
Seat 9: NocnyFryzjer folded before Flop (didn't bet)



PokerStars Hand #228376559412:  Hold'em No Limit ($0.01/$0.02 USD) - 2021/07/18 1:37:26 PT [2021/07/18 4:37:26 ET]
Table 'Philia' 9-max Seat #2 is the button
Seat 1: naxal2012 ($3.01 in chips) 
Seat 2: sleeper hipi ($7.56 in chips) 
Seat 3: dealembub ($5.09 in chips) 
Seat 4: Dorex2007 ($3.67 in chips) 
Seat 5: Dorm619 ($4.58 in chips) 
Seat 7: chappy540 ($1.89 in chips) 
Seat 8: mendel777 ($1.63 in chips) 
Seat 9: NocnyFryzjer ($1.74 in chips) 
dealembub: posts small blind $0.01
Dorex2007: posts big blind $0.02
bloody55hawk: sits out 
*** HOLE CARDS ***
Dealt to Dorex2007 [2s 2c]
Dorm619: raises $0.04 to $0.06
chappy540: folds 
mendel777: folds 
NocnyFryzjer: folds 
naxal2012: folds 
sleeper hipi: folds 
dealembub: calls $0.05
Dorex2007: calls $0.04
*** FLOP *** [Jc Qh Ks]
dealembub: checks 
Dorex2007: checks 
Dorm619: bets $0.12
dealembub: folds 
Dorex2007: folds 
Uncalled bet ($0.12) returned to Dorm619
Dorm619 collected $0.17 from pot
Dorm619: doesn't show hand 
*** SUMMARY ***
Total pot $0.18 | Rake $0.01 
Board [Jc Qh Ks]
Seat 1: naxal2012 folded before Flop (didn't bet)
Seat 2: sleeper hipi (button) folded before Flop (didn't bet)
Seat 3: dealembub (small blind) folded on the Flop
Seat 4: Dorex2007 (big blind) folded on the Flop
Seat 5: Dorm619 collected ($0.17)
Seat 7: chappy540 folded before Flop (didn't bet)
Seat 8: mendel777 folded before Flop (didn't bet)
Seat 9: NocnyFryzjer folded before Flop (didn't bet)



PokerStars Hand #228376566232:  Hold'em No Limit ($0.01/$0.02 USD) - 2021/07/18 1:38:04 PT [2021/07/18 4:38:04 ET]
Table 'Philia' 9-max Seat #3 is the button
Seat 1: naxal2012 ($3.01 in chips) 
Seat 2: sleeper hipi ($7.56 in chips) 
Seat 3: dealembub ($5.03 in chips) 
Seat 4: Dorex2007 ($3.61 in chips) 
Seat 5: Dorm619 ($4.69 in chips) 
Seat 7: chappy540 ($1.89 in chips) 
Seat 8: mendel777 ($1.63 in chips) 
Seat 9: NocnyFryzjer ($1.74 in chips) 
Dorex2007: posts small blind $0.01
Dorm619: posts big blind $0.02
bloody55hawk: sits out 
*** HOLE CARDS ***
Dealt to Dorex2007 [Ks 9c]
chappy540: calls $0.02
mendel777: folds 
NocnyFryzjer: folds 
naxal2012: raises $0.06 to $0.08
sleeper hipi: folds 
dealembub: folds 
Dorex2007: folds 
dealembub said, "needed the ten there"
Dorm619: calls $0.06
chappy540: calls $0.06
*** FLOP *** [Kc 7c Kd]
Dorex2007 said, "needed a 2. any 2"
Dorm619: checks 
chappy540: bets $0.18
Dorex2007 said, "i had suited 2's"
naxal2012: calls $0.18
Dorm619: folds 
*** TURN *** [Kc 7c Kd] [Kh]
dealembub said, "hard to get those"
chappy540: checks 
naxal2012: checks 
*** RIVER *** [Kc 7c Kd Kh] [2d]
chappy540: checks 
naxal2012: bets $0.39
chappy540: calls $0.39
*** SHOW DOWN ***
naxal2012: shows [Th Td] (a full house, Kings full of Tens)
chappy540: mucks hand 
naxal2012 collected $1.34 from pot
*** SUMMARY ***
Total pot $1.39 | Rake $0.05 
Board [Kc 7c Kd Kh 2d]
Seat 1: naxal2012 showed [Th Td] and won ($1.34) with a full house, Kings full of Tens
Seat 2: sleeper hipi folded before Flop (didn't bet)
Seat 3: dealembub (button) folded before Flop (didn't bet)
Seat 4: Dorex2007 (small blind) folded before Flop
Seat 5: Dorm619 (big blind) folded on the Flop
Seat 7: chappy540 mucked [8h 8c]
Seat 8: mendel777 folded before Flop (didn't bet)
Seat 9: NocnyFryzjer folded before Flop (didn't bet)



PokerStars Hand #228376579804:  Hold'em No Limit ($0.01/$0.02 USD) - 2021/07/18 1:39:19 PT [2021/07/18 4:39:19 ET]
Table 'Philia' 9-max Seat #4 is the button
Seat 1: naxal2012 ($3.70 in chips) 
Seat 2: sleeper hipi ($7.56 in chips) 
Seat 3: dealembub ($5.03 in chips) 
Seat 4: Dorex2007 ($3.60 in chips) 
Seat 5: Dorm619 ($4.61 in chips) 
Seat 6: bloody55hawk ($0.80 in chips) 
Seat 7: chappy540 ($1.24 in chips) 
Seat 8: mendel777 ($1.63 in chips) 
Seat 9: NocnyFryzjer ($1.74 in chips) 
Dorm619: posts small blind $0.01
bloody55hawk: posts big blind $0.02
*** HOLE CARDS ***
Dealt to Dorex2007 [6s 8d]
chappy540: calls $0.02
mendel777: folds 
Dorex2007 said, "f ck.... I had the 4th K"
NocnyFryzjer: folds 
naxal2012: folds 
sleeper hipi: raises $0.08 to $0.10
dealembub: folds 
Dorex2007: folds 
dealembub said, "oops"
Dorm619: folds 
bloody55hawk: folds 
chappy540: calls $0.08
*** FLOP *** [Ac Qh Jd]
chappy540: checks 
sleeper hipi: bets $0.12
chappy540: calls $0.12
*** TURN *** [Ac Qh Jd] [7h]
chappy540: checks 
sleeper hipi: bets $0.35
chappy540: folds 
Uncalled bet ($0.35) returned to sleeper hipi
sleeper hipi collected $0.45 from pot
sleeper hipi: doesn't show hand 
*** SUMMARY ***
Total pot $0.47 | Rake $0.02 
Board [Ac Qh Jd 7h]
Seat 1: naxal2012 folded before Flop (didn't bet)
Seat 2: sleeper hipi collected ($0.45)
Seat 3: dealembub folded before Flop (didn't bet)
Seat 4: Dorex2007 (button) folded before Flop (didn't bet)
Seat 5: Dorm619 (small blind) folded before Flop
Seat 6: bloody55hawk (big blind) folded before Flop
Seat 7: chappy540 folded on the Turn
Seat 8: mendel777 folded before Flop (didn't bet)
Seat 9: NocnyFryzjer folded before Flop (didn't bet)



PokerStars Hand #228376587924:  Hold'em No Limit ($0.01/$0.02 USD) - 2021/07/18 1:40:05 PT [2021/07/18 4:40:05 ET]
Table 'Philia' 9-max Seat #5 is the button
Seat 1: naxal2012 ($3.70 in chips) 
Seat 2: sleeper hipi ($7.79 in chips) 
Seat 3: dealembub ($5.03 in chips) 
Seat 4: Dorex2007 ($3.60 in chips) 
Seat 5: Dorm619 ($4.60 in chips) 
Seat 6: bloody55hawk ($0.80 in chips) 
Seat 7: chappy540 ($1.02 in chips) 
Seat 8: mendel777 ($1.63 in chips) 
Seat 9: NocnyFryzjer ($1.74 in chips) 
bloody55hawk: posts small blind $0.01
chappy540: posts big blind $0.02
*** HOLE CARDS ***
Dealt to Dorex2007 [Ts Qh]
mendel777: folds 
NocnyFryzjer: folds 
naxal2012: folds 
sleeper hipi: folds 
dealembub: folds 
Dorex2007: raises $0.04 to $0.06
Dorm619: raises $0.10 to $0.16
bloody55hawk: raises $0.64 to $0.80 and is all-in
chappy540: folds 
Dorex2007: folds 
Dorm619: folds 
Uncalled bet ($0.64) returned to bloody55hawk
bloody55hawk collected $0.40 from pot
bloody55hawk: doesn't show hand 
*** SUMMARY ***
Total pot $0.40 | Rake $0 
Seat 1: naxal2012 folded before Flop (didn't bet)
Seat 2: sleeper hipi folded before Flop (didn't bet)
Seat 3: dealembub folded before Flop (didn't bet)
Seat 4: Dorex2007 folded before Flop
Seat 5: Dorm619 (button) folded before Flop
Seat 6: bloody55hawk (small blind) collected ($0.40)
Seat 7: chappy540 (big blind) folded before Flop
Seat 8: mendel777 folded before Flop (didn't bet)
Seat 9: NocnyFryzjer folded before Flop (didn't bet)



PokerStars Hand #228376596215:  Hold'em No Limit ($0.01/$0.02 USD) - 2021/07/18 1:40:49 PT [2021/07/18 4:40:49 ET]
Table 'Philia' 9-max Seat #6 is the button
Seat 1: naxal2012 ($3.70 in chips) 
Seat 2: sleeper hipi ($7.79 in chips) 
Seat 3: dealembub ($5.03 in chips) 
Seat 4: Dorex2007 ($3.54 in chips) 
Seat 5: Dorm619 ($4.44 in chips) 
Seat 6: bloody55hawk ($1.04 in chips) 
Seat 7: chappy540 ($1 in chips) 
Seat 8: mendel777 ($1.63 in chips) 
Seat 9: NocnyFryzjer ($1.74 in chips) 
chappy540: posts small blind $0.01
mendel777: posts big blind $0.02
*** HOLE CARDS ***
Dealt to Dorex2007 [8h 4s]
NocnyFryzjer: folds 
naxal2012: folds 
sleeper hipi: folds 
dealembub: raises $0.04 to $0.06
Dorex2007: folds 
Dorm619: folds 
bloody55hawk: folds 
chappy540: calls $0.05
mendel777: folds 
*** FLOP *** [Ks 9d Qc]
chappy540: bets $0.14
dealembub: calls $0.14
*** TURN *** [Ks 9d Qc] [3c]
chappy540: bets $0.21
dealembub: folds 
Uncalled bet ($0.21) returned to chappy540
chappy540 collected $0.41 from pot
chappy540: doesn't show hand 
*** SUMMARY ***
Total pot $0.42 | Rake $0.01 
Board [Ks 9d Qc 3c]
Seat 1: naxal2012 folded before Flop (didn't bet)
Seat 2: sleeper hipi folded before Flop (didn't bet)
Seat 3: dealembub folded on the Turn
Seat 4: Dorex2007 folded before Flop (didn't bet)
Seat 5: Dorm619 folded before Flop (didn't bet)
Seat 6: bloody55hawk (button) folded before Flop (didn't bet)
Seat 7: chappy540 (small blind) collected ($0.41)
Seat 8: mendel777 (big blind) folded before Flop
Seat 9: NocnyFryzjer folded before Flop (didn't bet)



PokerStars Hand #228376605504:  Hold'em No Limit ($0.01/$0.02 USD) - 2021/07/18 1:41:40 PT [2021/07/18 4:41:40 ET]
Table 'Philia' 9-max Seat #7 is the button
Seat 1: naxal2012 ($3.70 in chips) 
Seat 2: sleeper hipi ($7.79 in chips) 
Seat 3: dealembub ($4.83 in chips) 
Seat 4: Dorex2007 ($3.54 in chips) 
Seat 5: Dorm619 ($4.44 in chips) 
Seat 6: bloody55hawk ($1.04 in chips) 
Seat 7: chappy540 ($1.21 in chips) 
Seat 8: mendel777 ($1.61 in chips) 
Seat 9: NocnyFryzjer ($1.74 in chips) 
mendel777: posts small blind $0.01
NocnyFryzjer: posts big blind $0.02
*** HOLE CARDS ***
Dealt to Dorex2007 [3c 8s]
naxal2012: raises $0.04 to $0.06
sleeper hipi: folds 
dealembub: folds 
Dorex2007: folds 
Dorm619: folds 
bloody55hawk: folds 
chappy540: calls $0.06
mendel777: raises $0.20 to $0.26
NocnyFryzjer: folds 
naxal2012: folds 
chappy540: folds 
Uncalled bet ($0.20) returned to mendel777
mendel777 collected $0.20 from pot
mendel777: doesn't show hand 
*** SUMMARY ***
Total pot $0.20 | Rake $0 
Seat 1: naxal2012 folded before Flop
Seat 2: sleeper hipi folded before Flop (didn't bet)
Seat 3: dealembub folded before Flop (didn't bet)
Seat 4: Dorex2007 folded before Flop (didn't bet)
Seat 5: Dorm619 folded before Flop (didn't bet)
Seat 6: bloody55hawk folded before Flop (didn't bet)
Seat 7: chappy540 (button) folded before Flop
Seat 8: mendel777 (small blind) collected ($0.20)
Seat 9: NocnyFryzjer (big blind) folded before Flop



PokerStars Hand #228376612113:  Hold'em No Limit ($0.01/$0.02 USD) - 2021/07/18 1:42:15 PT [2021/07/18 4:42:15 ET]
Table 'Philia' 9-max Seat #8 is the button
Seat 1: naxal2012 ($3.64 in chips) 
Seat 2: sleeper hipi ($7.79 in chips) 
Seat 3: dealembub ($4.83 in chips) 
Seat 4: Dorex2007 ($3.54 in chips) 
Seat 5: Dorm619 ($4.44 in chips) 
Seat 6: bloody55hawk ($1.04 in chips) 
Seat 7: chappy540 ($1.15 in chips) 
Seat 8: mendel777 ($1.75 in chips) 
Seat 9: NocnyFryzjer ($1.72 in chips) 
NocnyFryzjer: posts small blind $0.01
naxal2012: posts big blind $0.02
*** HOLE CARDS ***
Dealt to Dorex2007 [Ts 8d]
sleeper hipi: folds 
dealembub: folds 
Dorex2007: folds 
Dorm619: folds 
bloody55hawk: folds 
chappy540: folds 
mendel777: folds 
NocnyFryzjer: folds 
Uncalled bet ($0.01) returned to naxal2012
naxal2012 collected $0.02 from pot
*** SUMMARY ***
Total pot $0.02 | Rake $0 
Seat 1: naxal2012 (big blind) collected ($0.02)
Seat 2: sleeper hipi folded before Flop (didn't bet)
Seat 3: dealembub folded before Flop (didn't bet)
Seat 4: Dorex2007 folded before Flop (didn't bet)
Seat 5: Dorm619 folded before Flop (didn't bet)
Seat 6: bloody55hawk folded before Flop (didn't bet)
Seat 7: chappy540 folded before Flop (didn't bet)
Seat 8: mendel777 (button) folded before Flop (didn't bet)
Seat 9: NocnyFryzjer (small blind) folded before Flop



PokerStars Hand #228376616114:  Hold'em No Limit ($0.01/$0.02 USD) - 2021/07/18 1:42:36 PT [2021/07/18 4:42:36 ET]
Table 'Philia' 9-max Seat #9 is the button
Seat 1: naxal2012 ($3.65 in chips) 
Seat 2: sleeper hipi ($7.79 in chips) 
Seat 3: dealembub ($4.83 in chips) 
Seat 4: Dorex2007 ($3.54 in chips) 
Seat 5: Dorm619 ($4.44 in chips) 
Seat 6: bloody55hawk ($1.04 in chips) 
Seat 7: chappy540 ($1.15 in chips) 
Seat 8: mendel777 ($1.75 in chips) 
Seat 9: NocnyFryzjer ($1.71 in chips) 
naxal2012: posts small blind $0.01
sleeper hipi: posts big blind $0.02
*** HOLE CARDS ***
Dealt to Dorex2007 [4c 2h]
dealembub: calls $0.02
Dorex2007: folds 
Dorm619: folds 
bloody55hawk: folds 
chappy540: folds 
mendel777: raises $0.06 to $0.08
NocnyFryzjer: raises $0.12 to $0.20
naxal2012: folds 
sleeper hipi: folds 
dealembub: folds 
mendel777: folds 
Uncalled bet ($0.12) returned to NocnyFryzjer
NocnyFryzjer collected $0.21 from pot
NocnyFryzjer: doesn't show hand 
*** SUMMARY ***
Total pot $0.21 | Rake $0 
Seat 1: naxal2012 (small blind) folded before Flop
Seat 2: sleeper hipi (big blind) folded before Flop
Seat 3: dealembub folded before Flop
Seat 4: Dorex2007 folded before Flop (didn't bet)
Seat 5: Dorm619 folded before Flop (didn't bet)
Seat 6: bloody55hawk folded before Flop (didn't bet)
Seat 7: chappy540 folded before Flop (didn't bet)
Seat 8: mendel777 folded before Flop
Seat 9: NocnyFryzjer (button) collected ($0.21)



PokerStars Hand #228376622185:  Hold'em No Limit ($0.01/$0.02 USD) - 2021/07/18 1:43:09 PT [2021/07/18 4:43:09 ET]
Table 'Philia' 9-max Seat #1 is the button
Seat 1: naxal2012 ($3.64 in chips) 
Seat 2: sleeper hipi ($7.77 in chips) 
Seat 3: dealembub ($4.81 in chips) 
Seat 4: Dorex2007 ($3.54 in chips) 
Seat 5: Dorm619 ($4.44 in chips) 
Seat 6: bloody55hawk ($1.04 in chips) 
Seat 7: chappy540 ($2 in chips) 
Seat 8: mendel777 ($1.67 in chips) 
Seat 9: NocnyFryzjer ($1.84 in chips) 
sleeper hipi: posts small blind $0.01
dealembub: posts big blind $0.02
*** HOLE CARDS ***
Dealt to Dorex2007 [8h As]
Dorex2007: folds 
Dorm619: folds 
bloody55hawk: folds 
chappy540: calls $0.02
mendel777: folds 
NocnyFryzjer: folds 
naxal2012: folds 
sleeper hipi: calls $0.01
dealembub: checks 
*** FLOP *** [4d 9s 7c]
sleeper hipi: checks 
dealembub: bets $0.04
chappy540: folds 
sleeper hipi: raises $0.10 to $0.14
dealembub: folds 
Uncalled bet ($0.10) returned to sleeper hipi
sleeper hipi collected $0.14 from pot
sleeper hipi: doesn't show hand 
*** SUMMARY ***
Total pot $0.14 | Rake $0 
Board [4d 9s 7c]
Seat 1: naxal2012 (button) folded before Flop (didn't bet)
Seat 2: sleeper hipi (small blind) collected ($0.14)
Seat 3: dealembub (big blind) folded on the Flop
Seat 4: Dorex2007 folded before Flop (didn't bet)
Seat 5: Dorm619 folded before Flop (didn't bet)
Seat 6: bloody55hawk folded before Flop (didn't bet)
Seat 7: chappy540 folded on the Flop
Seat 8: mendel777 folded before Flop (didn't bet)
Seat 9: NocnyFryzjer folded before Flop (didn't bet)



PokerStars Hand #228376628690:  Hold'em No Limit ($0.01/$0.02 USD) - 2021/07/18 1:43:44 PT [2021/07/18 4:43:44 ET]
Table 'Philia' 9-max Seat #2 is the button
Seat 1: naxal2012 ($3.64 in chips) 
Seat 2: sleeper hipi ($7.85 in chips) 
Seat 3: dealembub ($4.75 in chips) 
Seat 4: Dorex2007 ($3.54 in chips) 
Seat 5: Dorm619 ($4.44 in chips) 
Seat 6: bloody55hawk ($1.04 in chips) 
Seat 7: chappy540 ($1.98 in chips) 
Seat 8: mendel777 ($1.67 in chips) 
Seat 9: NocnyFryzjer ($1.84 in chips) 
dealembub: posts small blind $0.01
Dorex2007: posts big blind $0.02
*** HOLE CARDS ***
Dealt to Dorex2007 [8s 8c]
Dorm619: folds 
bloody55hawk: raises $1.02 to $1.04 and is all-in
chappy540: folds 
mendel777: folds 
NocnyFryzjer: folds 
naxal2012: folds 
sleeper hipi: folds 
dealembub: folds 
Dorex2007: folds 
Uncalled bet ($1.02) returned to bloody55hawk
bloody55hawk collected $0.05 from pot
bloody55hawk: doesn't show hand 
*** SUMMARY ***
Total pot $0.05 | Rake $0 
Seat 1: naxal2012 folded before Flop (didn't bet)
Seat 2: sleeper hipi (button) folded before Flop (didn't bet)
Seat 3: dealembub (small blind) folded before Flop
Seat 4: Dorex2007 (big blind) folded before Flop
Seat 5: Dorm619 folded before Flop (didn't bet)
Seat 6: bloody55hawk collected ($0.05)
Seat 7: chappy540 folded before Flop (didn't bet)
Seat 8: mendel777 folded before Flop (didn't bet)
Seat 9: NocnyFryzjer folded before Flop (didn't bet)



PokerStars Hand #228376634461:  Hold'em No Limit ($0.01/$0.02 USD) - 2021/07/18 1:44:16 PT [2021/07/18 4:44:16 ET]
Table 'Philia' 9-max Seat #3 is the button
Seat 1: naxal2012 ($3.64 in chips) 
Seat 2: sleeper hipi ($7.85 in chips) 
Seat 3: dealembub ($4.74 in chips) 
Seat 4: Dorex2007 ($3.52 in chips) 
Seat 5: Dorm619 ($4.44 in chips) 
Seat 6: bloody55hawk ($1.07 in chips) 
Seat 7: chappy540 ($1.98 in chips) 
Seat 8: mendel777 ($1.67 in chips) 
Seat 9: NocnyFryzjer ($1.84 in chips) 
Dorex2007: posts small blind $0.01
Dorm619: posts big blind $0.02
*** HOLE CARDS ***
Dealt to Dorex2007 [Th Qc]
bloody55hawk: folds 
chappy540: folds 
dealembub said, "bloody55hawk  does that a lot"
mendel777: folds 
NocnyFryzjer: folds 
naxal2012: folds 
sleeper hipi: raises $0.04 to $0.06
dealembub: folds 
Dorex2007: folds 
Dorm619: folds 
Uncalled bet ($0.04) returned to sleeper hipi
sleeper hipi collected $0.05 from pot
sleeper hipi: doesn't show hand 
Dorex2007 said, "5% of all his hands"
*** SUMMARY ***
Total pot $0.05 | Rake $0 
Seat 1: naxal2012 folded before Flop (didn't bet)
Seat 2: sleeper hipi collected ($0.05)
Seat 3: dealembub (button) folded before Flop (didn't bet)
Seat 4: Dorex2007 (small blind) folded before Flop
Seat 5: Dorm619 (big blind) folded before Flop
Seat 6: bloody55hawk folded before Flop (didn't bet)
Seat 7: chappy540 folded before Flop (didn't bet)
Seat 8: mendel777 folded before Flop (didn't bet)
Seat 9: NocnyFryzjer folded before Flop (didn't bet)



PokerStars Hand #228376639783:  Hold'em No Limit ($0.01/$0.02 USD) - 2021/07/18 1:44:45 PT [2021/07/18 4:44:45 ET]
Table 'Philia' 9-max Seat #4 is the button
Seat 1: naxal2012 ($3.64 in chips) 
Seat 2: sleeper hipi ($7.88 in chips) 
Seat 3: dealembub ($4.74 in chips) 
Seat 4: Dorex2007 ($3.51 in chips) 
Seat 5: Dorm619 ($4.42 in chips) 
Seat 6: bloody55hawk ($1.07 in chips) 
Seat 7: chappy540 ($1.98 in chips) 
Seat 8: mendel777 ($1.67 in chips) 
Seat 9: NocnyFryzjer ($1.84 in chips) 
Dorm619: posts small blind $0.01
bloody55hawk: posts big blind $0.02
*** HOLE CARDS ***
Dealt to Dorex2007 [3h 3d]
dealembub said, "lol"
chappy540 has timed out
chappy540: folds 
mendel777: raises $0.04 to $0.06
NocnyFryzjer: folds 
naxal2012: folds 
sleeper hipi: folds 
dealembub: folds 
Dorex2007: calls $0.06
Dorm619: folds 
bloody55hawk: folds 
*** FLOP *** [Qd 2h Kd]
mendel777: bets $0.07
Dorex2007: folds 
Uncalled bet ($0.07) returned to mendel777
mendel777 collected $0.14 from pot
mendel777: doesn't show hand 
*** SUMMARY ***
Total pot $0.15 | Rake $0.01 
Board [Qd 2h Kd]
Seat 1: naxal2012 folded before Flop (didn't bet)
Seat 2: sleeper hipi folded before Flop (didn't bet)
Seat 3: dealembub folded before Flop (didn't bet)
Seat 4: Dorex2007 (button) folded on the Flop
Seat 5: Dorm619 (small blind) folded before Flop
Seat 6: bloody55hawk (big blind) folded before Flop
Seat 7: chappy540 folded before Flop (didn't bet)
Seat 8: mendel777 collected ($0.14)
Seat 9: NocnyFryzjer folded before Flop (didn't bet)



PokerStars Hand #228376645322:  Hold'em No Limit ($0.01/$0.02 USD) - 2021/07/18 1:45:14 PT [2021/07/18 4:45:14 ET]
Table 'Philia' 9-max Seat #5 is the button
Seat 1: naxal2012 ($3.64 in chips) 
Seat 2: sleeper hipi ($7.88 in chips) 
Seat 3: dealembub ($4.74 in chips) 
Seat 4: Dorex2007 ($3.45 in chips) 
Seat 5: Dorm619 ($4.41 in chips) 
Seat 6: bloody55hawk ($1.05 in chips) 
Seat 7: chappy540 ($1.98 in chips) 
Seat 8: mendel777 ($1.75 in chips) 
Seat 9: NocnyFryzjer ($1.84 in chips) 
bloody55hawk: posts small blind $0.01
chappy540: posts big blind $0.02
*** HOLE CARDS ***
Dealt to Dorex2007 [3h 7h]
mendel777: folds 
NocnyFryzjer: folds 
naxal2012: folds 
sleeper hipi: folds 
dealembub: folds 
Dorex2007: folds 
Dorm619: folds 
bloody55hawk: folds 
Uncalled bet ($0.01) returned to chappy540
chappy540 collected $0.02 from pot
chappy540: doesn't show hand 
*** SUMMARY ***
Total pot $0.02 | Rake $0 
Seat 1: naxal2012 folded before Flop (didn't bet)
Seat 2: sleeper hipi folded before Flop (didn't bet)
Seat 3: dealembub folded before Flop (didn't bet)
Seat 4: Dorex2007 folded before Flop (didn't bet)
Seat 5: Dorm619 (button) folded before Flop (didn't bet)
Seat 6: bloody55hawk (small blind) folded before Flop
Seat 7: chappy540 (big blind) collected ($0.02)
Seat 8: mendel777 folded before Flop (didn't bet)
Seat 9: NocnyFryzjer folded before Flop (didn't bet)



PokerStars Hand #228376649036:  Hold'em No Limit ($0.01/$0.02 USD) - 2021/07/18 1:45:34 PT [2021/07/18 4:45:34 ET]
Table 'Philia' 9-max Seat #6 is the button
Seat 1: naxal2012 ($3.64 in chips) 
Seat 2: sleeper hipi ($7.88 in chips) 
Seat 3: dealembub ($4.74 in chips) 
Seat 4: Dorex2007 ($3.45 in chips) 
Seat 5: Dorm619 ($4.41 in chips) 
Seat 6: bloody55hawk ($1.04 in chips) 
Seat 7: chappy540 ($1.99 in chips) 
Seat 8: mendel777 ($1.75 in chips) 
Seat 9: NocnyFryzjer ($1.84 in chips) 
chappy540: posts small blind $0.01
mendel777: posts big blind $0.02
*** HOLE CARDS ***
Dealt to Dorex2007 [Td Jh]
NocnyFryzjer: folds 
naxal2012: calls $0.02
sleeper hipi: raises $0.06 to $0.08
dealembub: folds 
Dorex2007: folds 
Dorm619: folds 
bloody55hawk: folds 
chappy540: folds 
mendel777: folds 
naxal2012: folds 
Uncalled bet ($0.06) returned to sleeper hipi
sleeper hipi collected $0.07 from pot
sleeper hipi: doesn't show hand 
*** SUMMARY ***
Total pot $0.07 | Rake $0 
Seat 1: naxal2012 folded before Flop
Seat 2: sleeper hipi collected ($0.07)
Seat 3: dealembub folded before Flop (didn't bet)
Seat 4: Dorex2007 folded before Flop (didn't bet)
Seat 5: Dorm619 folded before Flop (didn't bet)
Seat 6: bloody55hawk (button) folded before Flop (didn't bet)
Seat 7: chappy540 (small blind) folded before Flop
Seat 8: mendel777 (big blind) folded before Flop
Seat 9: NocnyFryzjer folded before Flop (didn't bet)



PokerStars Hand #228376655966:  Hold'em No Limit ($0.01/$0.02 USD) - 2021/07/18 1:46:11 PT [2021/07/18 4:46:11 ET]
Table 'Philia' 9-max Seat #7 is the button
Seat 1: naxal2012 ($3.62 in chips) 
Seat 2: sleeper hipi ($7.93 in chips) 
Seat 3: dealembub ($4.74 in chips) 
Seat 4: Dorex2007 ($3.45 in chips) 
Seat 5: Dorm619 ($4.41 in chips) 
Seat 6: bloody55hawk ($1.04 in chips) 
Seat 7: chappy540 ($1.98 in chips) 
Seat 8: mendel777 ($1.73 in chips) 
Seat 9: NocnyFryzjer ($1.84 in chips) 
mendel777: posts small blind $0.01
NocnyFryzjer: posts big blind $0.02
*** HOLE CARDS ***
Dealt to Dorex2007 [Jd As]
naxal2012: folds 
sleeper hipi: folds 
dealembub: calls $0.02
Dorex2007: calls $0.02
Dorm619: folds 
bloody55hawk: folds 
chappy540: folds 
mendel777: folds 
NocnyFryzjer: checks 
*** FLOP *** [6d 2d 8h]
NocnyFryzjer: checks 
dealembub: bets $0.10
Dorex2007: folds 
NocnyFryzjer: calls $0.10
*** TURN *** [6d 2d 8h] [Tc]
NocnyFryzjer: checks 
dealembub: bets $0.26
NocnyFryzjer: calls $0.26
*** RIVER *** [6d 2d 8h Tc] [4d]
NocnyFryzjer: checks 
dealembub: bets $0.78
NocnyFryzjer: calls $0.78
*** SHOW DOWN ***
dealembub: shows [3d Td] (a flush, Ten high)
NocnyFryzjer: mucks hand 
dealembub collected $2.27 from pot
*** SUMMARY ***
Total pot $2.35 | Rake $0.08 
Board [6d 2d 8h Tc 4d]
Seat 1: naxal2012 folded before Flop (didn't bet)
Seat 2: sleeper hipi folded before Flop (didn't bet)
Seat 3: dealembub showed [3d Td] and won ($2.27) with a flush, Ten high
Seat 4: Dorex2007 folded on the Flop
Seat 5: Dorm619 folded before Flop (didn't bet)
Seat 6: bloody55hawk folded before Flop (didn't bet)
Seat 7: chappy540 (button) folded before Flop (didn't bet)
Seat 8: mendel777 (small blind) folded before Flop
Seat 9: NocnyFryzjer (big blind) mucked [8d 4c]



PokerStars Hand #228376665770:  Hold'em No Limit ($0.01/$0.02 USD) - 2021/07/18 1:47:03 PT [2021/07/18 4:47:03 ET]
Table 'Philia' 9-max Seat #8 is the button
Seat 1: naxal2012 ($3.62 in chips) 
Seat 2: sleeper hipi ($7.93 in chips) 
Seat 3: dealembub ($5.85 in chips) 
Seat 4: Dorex2007 ($3.43 in chips) 
Seat 5: Dorm619 ($4.41 in chips) 
Seat 6: bloody55hawk ($1.04 in chips) 
Seat 7: chappy540 ($1.98 in chips) 
Seat 8: mendel777 ($1.72 in chips) 
Seat 9: NocnyFryzjer ($0.68 in chips) 
NocnyFryzjer: posts small blind $0.01
naxal2012: posts big blind $0.02
*** HOLE CARDS ***
Dealt to Dorex2007 [3d Ks]
sleeper hipi: folds 
dealembub: calls $0.02
Dorex2007: folds 
Dorm619: folds 
bloody55hawk: folds 
chappy540: folds 
mendel777: raises $0.06 to $0.08
NocnyFryzjer: folds 
naxal2012: folds 
dealembub: folds 
Uncalled bet ($0.06) returned to mendel777
mendel777 collected $0.07 from pot
mendel777: doesn't show hand 
*** SUMMARY ***
Total pot $0.07 | Rake $0 
Seat 1: naxal2012 (big blind) folded before Flop
Seat 2: sleeper hipi folded before Flop (didn't bet)
Seat 3: dealembub folded before Flop
Seat 4: Dorex2007 folded before Flop (didn't bet)
Seat 5: Dorm619 folded before Flop (didn't bet)
Seat 6: bloody55hawk folded before Flop (didn't bet)
Seat 7: chappy540 folded before Flop (didn't bet)
Seat 8: mendel777 (button) collected ($0.07)
Seat 9: NocnyFryzjer (small blind) folded before Flop



PokerStars Hand #228376670394:  Hold'em No Limit ($0.01/$0.02 USD) - 2021/07/18 1:47:27 PT [2021/07/18 4:47:27 ET]
Table 'Philia' 9-max Seat #9 is the button
Seat 1: naxal2012 ($3.60 in chips) 
Seat 4: Dorex2007 ($3.43 in chips) 
Seat 5: Dorm619 ($4.41 in chips) 
Seat 6: bloody55hawk ($1.04 in chips) 
Seat 7: chappy540 ($1.98 in chips) 
Seat 8: mendel777 ($1.77 in chips) 
Seat 9: NocnyFryzjer ($0.67 in chips) 
naxal2012: posts small blind $0.01
sleeper hipi: is sitting out 
sleeper hipi leaves the table
Dorex2007: posts big blind $0.02
*** HOLE CARDS ***
Dealt to Dorex2007 [As 7h]
Dorm619: folds 
bloody55hawk: folds 
chappy540: calls $0.02
mendel777: folds 
NocnyFryzjer: folds 
naxal2012: calls $0.01
Dorex2007: checks 
*** FLOP *** [2h 2d 9d]
naxal2012: checks 
dealembub said, "refill time"
Dorex2007: checks 
chappy540: checks 
*** TURN *** [2h 2d 9d] [5c]
naxal2012: checks 
Dorex2007: checks 
Khrenya joins the table at seat #2 
chappy540: checks 
*** RIVER *** [2h 2d 9d 5c] [3c]
naxal2012: checks 
Dorex2007: checks 
chappy540: checks 
*** SHOW DOWN ***
naxal2012: shows [Jd 4h] (a pair of Deuces)
Dorex2007: shows [As 7h] (a pair of Deuces - Ace kicker)
chappy540: mucks hand 
Dorex2007 collected $0.06 from pot
*** SUMMARY ***
Total pot $0.06 | Rake $0 
Board [2h 2d 9d 5c 3c]
Seat 1: naxal2012 (small blind) showed [Jd 4h] and lost with a pair of Deuces
Seat 4: Dorex2007 (big blind) showed [As 7h] and won ($0.06) with a pair of Deuces
Seat 5: Dorm619 folded before Flop (didn't bet)
Seat 6: bloody55hawk folded before Flop (didn't bet)
Seat 7: chappy540 mucked [Ah 6h]
Seat 8: mendel777 folded before Flop (didn't bet)
Seat 9: NocnyFryzjer (button) folded before Flop (didn't bet)



PokerStars Hand #228376690002:  Hold'em No Limit ($0.01/$0.02 USD) - 2021/07/18 1:48:28 PT [2021/07/18 4:48:28 ET]
Table 'Philia' 9-max Seat #1 is the button
Seat 1: naxal2012 ($3.58 in chips) 
Seat 4: Dorex2007 ($3.47 in chips) 
Seat 5: Dorm619 ($4.41 in chips) 
Seat 6: bloody55hawk ($1.04 in chips) 
Seat 7: chappy540 ($1.96 in chips) 
Seat 8: mendel777 ($1.77 in chips) 
Seat 9: NocnyFryzjer ($0.67 in chips) 
Dorex2007: posts small blind $0.01
Dorm619: posts big blind $0.02
*** HOLE CARDS ***
Dealt to Dorex2007 [2s 9s]
bloody55hawk: folds 
chappy540: folds 
mendel777: folds 
NocnyFryzjer: folds 
naxal2012: folds 
Dorex2007: folds 
Uncalled bet ($0.01) returned to Dorm619
Dorm619 collected $0.02 from pot
Dorm619: doesn't show hand 
*** SUMMARY ***
Total pot $0.02 | Rake $0 
Seat 1: naxal2012 (button) folded before Flop (didn't bet)
Seat 4: Dorex2007 (small blind) folded before Flop
Seat 5: Dorm619 (big blind) collected ($0.02)
Seat 6: bloody55hawk folded before Flop (didn't bet)
Seat 7: chappy540 folded before Flop (didn't bet)
Seat 8: mendel777 folded before Flop (didn't bet)
Seat 9: NocnyFryzjer folded before Flop (didn't bet)



PokerStars Hand #228376694024:  Hold'em No Limit ($0.01/$0.02 USD) - 2021/07/18 1:48:49 PT [2021/07/18 4:48:49 ET]
Table 'Philia' 9-max Seat #4 is the button
Seat 1: naxal2012 ($3.58 in chips) 
Seat 2: Khrenya ($2 in chips) 
Seat 4: Dorex2007 ($3.46 in chips) 
Seat 5: Dorm619 ($4.42 in chips) 
Seat 6: bloody55hawk ($1.04 in chips) 
Seat 7: chappy540 ($1.96 in chips) 
Seat 8: mendel777 ($1.77 in chips) 
Seat 9: NocnyFryzjer ($0.67 in chips) 
Dorm619: posts small blind $0.01
bloody55hawk: posts big blind $0.02
Khrenya: posts big blind $0.02
*** HOLE CARDS ***
Dealt to Dorex2007 [Qh Jh]
chappy540: folds 
mendel777: folds 
NocnyFryzjer: folds 
naxal2012: folds 
chappy540 leaves the table
Khrenya: checks 
Dorex2007: raises $0.02 to $0.04
Dorm619: calls $0.03
bloody55hawk: calls $0.02
Khrenya: calls $0.02
*** FLOP *** [7d 8c 9c]
Dorm619: checks 
bloody55hawk: checks 
rose9918 joins the table at seat #7 
Khrenya: checks 
Dorex2007: checks 
*** TURN *** [7d 8c 9c] [7c]
Dorm619: checks 
bloody55hawk: checks 
Khrenya: checks 
Dorex2007: bets $0.10
Dorm619: folds 
bloody55hawk: folds 
Khrenya: folds 
Uncalled bet ($0.10) returned to Dorex2007
Dorex2007 collected $0.15 from pot
Dorex2007: doesn't show hand 
*** SUMMARY ***
Total pot $0.16 | Rake $0.01 
Board [7d 8c 9c 7c]
Seat 1: naxal2012 folded before Flop (didn't bet)
Seat 2: Khrenya folded on the Turn
Seat 4: Dorex2007 (button) collected ($0.15)
Seat 5: Dorm619 (small blind) folded on the Turn
Seat 6: bloody55hawk (big blind) folded on the Turn
Seat 7: chappy540 folded before Flop (didn't bet)
Seat 8: mendel777 folded before Flop (didn't bet)
Seat 9: NocnyFryzjer folded before Flop (didn't bet)



PokerStars Hand #228376705357:  Hold'em No Limit ($0.01/$0.02 USD) - 2021/07/18 1:49:48 PT [2021/07/18 4:49:48 ET]
Table 'Philia' 9-max Seat #5 is the button
Seat 1: naxal2012 ($3.58 in chips) 
Seat 2: Khrenya ($1.96 in chips) 
Seat 4: Dorex2007 ($3.57 in chips) 
Seat 5: Dorm619 ($4.38 in chips) 
Seat 6: bloody55hawk ($1 in chips) 
Seat 7: rose9918 ($2 in chips) 
Seat 8: mendel777 ($1.77 in chips) 
Seat 9: NocnyFryzjer ($0.67 in chips) 
bloody55hawk: posts small blind $0.01
rose9918: posts big blind $0.02
*** HOLE CARDS ***
Dealt to Dorex2007 [4s 2h]
mendel777: folds 
NocnyFryzjer: folds 
naxal2012: folds 
Khrenya: raises $0.06 to $0.08
Dorex2007: folds 
Dorm619: folds 
bloody55hawk: folds 
rose9918: folds 
Uncalled bet ($0.06) returned to Khrenya
Khrenya collected $0.05 from pot
Khrenya: doesn't show hand 
*** SUMMARY ***
Total pot $0.05 | Rake $0 
Seat 1: naxal2012 folded before Flop (didn't bet)
Seat 2: Khrenya collected ($0.05)
Seat 4: Dorex2007 folded before Flop (didn't bet)
Seat 5: Dorm619 (button) folded before Flop (didn't bet)
Seat 6: bloody55hawk (small blind) folded before Flop
Seat 7: rose9918 (big blind) folded before Flop
Seat 8: mendel777 folded before Flop (didn't bet)
Seat 9: NocnyFryzjer folded before Flop (didn't bet)



PokerStars Hand #228376709341:  Hold'em No Limit ($0.01/$0.02 USD) - 2021/07/18 1:50:09 PT [2021/07/18 4:50:09 ET]
Table 'Philia' 9-max Seat #6 is the button
Seat 1: naxal2012 ($3.58 in chips) 
Seat 2: Khrenya ($1.99 in chips) 
Seat 4: Dorex2007 ($3.57 in chips) 
Seat 5: Dorm619 ($4.38 in chips) 
Seat 6: bloody55hawk ($0.99 in chips) 
Seat 7: rose9918 ($1.98 in chips) 
Seat 8: mendel777 ($1.77 in chips) 
Seat 9: NocnyFryzjer ($0.67 in chips) 
rose9918: posts small blind $0.01
mendel777: posts big blind $0.02
*** HOLE CARDS ***
Dealt to Dorex2007 [8c 9c]
NocnyFryzjer: folds 
naxal2012: folds 
Khrenya: folds 
Dorex2007: calls $0.02
Dorm619: folds 
bloody55hawk: raises $0.04 to $0.06
rose9918: folds 
mendel777: folds 
Dorex2007: calls $0.04
*** FLOP *** [Qc 2h 6h]
Dorex2007: checks 
bloody55hawk: bets $0.07
Dorex2007: folds 
Uncalled bet ($0.07) returned to bloody55hawk
bloody55hawk collected $0.14 from pot
bloody55hawk: doesn't show hand 
*** SUMMARY ***
Total pot $0.15 | Rake $0.01 
Board [Qc 2h 6h]
Seat 1: naxal2012 folded before Flop (didn't bet)
Seat 2: Khrenya folded before Flop (didn't bet)
Seat 4: Dorex2007 folded on the Flop
Seat 5: Dorm619 folded before Flop (didn't bet)
Seat 6: bloody55hawk (button) collected ($0.14)
Seat 7: rose9918 (small blind) folded before Flop
Seat 8: mendel777 (big blind) folded before Flop
Seat 9: NocnyFryzjer folded before Flop (didn't bet)



PokerStars Hand #228376716982:  Hold'em No Limit ($0.01/$0.02 USD) - 2021/07/18 1:50:48 PT [2021/07/18 4:50:48 ET]
Table 'Philia' 9-max Seat #7 is the button
Seat 1: naxal2012 ($3.58 in chips) 
Seat 2: Khrenya ($1.99 in chips) 
Seat 4: Dorex2007 ($3.51 in chips) 
Seat 5: Dorm619 ($4.38 in chips) 
Seat 6: bloody55hawk ($1.07 in chips) 
Seat 7: rose9918 ($1.97 in chips) 
Seat 8: mendel777 ($1.75 in chips) 
Seat 9: NocnyFryzjer ($0.67 in chips) 
mendel777: posts small blind $0.01
NocnyFryzjer: posts big blind $0.02
*** HOLE CARDS ***
Dealt to Dorex2007 [5s 7d]
naxal2012: raises $0.04 to $0.06
Khrenya: folds 
Dorex2007: folds 
Dorm619: folds 
bloody55hawk: folds 
rose9918: calls $0.06
mendel777: calls $0.05
NocnyFryzjer: folds 
*** FLOP *** [2h Tc 5h]
mendel777: bets $0.10
naxal2012: calls $0.10
rose9918: folds 
*** TURN *** [2h Tc 5h] [8h]
mendel777: checks 
naxal2012: checks 
*** RIVER *** [2h Tc 5h 8h] [Th]
mendel777: checks 
naxal2012: checks 
*** SHOW DOWN ***
mendel777: shows [Td Js] (three of a kind, Tens)
naxal2012: mucks hand 
mendel777 collected $0.39 from pot
*** SUMMARY ***
Total pot $0.40 | Rake $0.01 
Board [2h Tc 5h 8h Th]
Seat 1: naxal2012 mucked [Qd Qs]
Seat 2: Khrenya folded before Flop (didn't bet)
Seat 4: Dorex2007 folded before Flop (didn't bet)
Seat 5: Dorm619 folded before Flop (didn't bet)
Seat 6: bloody55hawk folded before Flop (didn't bet)
Seat 7: rose9918 (button) folded on the Flop
Seat 8: mendel777 (small blind) showed [Td Js] and won ($0.39) with three of a kind, Tens
Seat 9: NocnyFryzjer (big blind) folded before Flop



PokerStars Hand #228376731679:  Hold'em No Limit ($0.01/$0.02 USD) - 2021/07/18 1:52:06 PT [2021/07/18 4:52:06 ET]
Table 'Philia' 9-max Seat #8 is the button
Seat 1: naxal2012 ($3.42 in chips) 
Seat 2: Khrenya ($1.99 in chips) 
Seat 4: Dorex2007 ($3.51 in chips) 
Seat 5: Dorm619 ($4.38 in chips) 
Seat 6: bloody55hawk ($1.07 in chips) 
Seat 7: rose9918 ($1.91 in chips) 
Seat 8: mendel777 ($1.98 in chips) 
Seat 9: NocnyFryzjer ($0.65 in chips) 
NocnyFryzjer: posts small blind $0.01
naxal2012: posts big blind $0.02
*** HOLE CARDS ***
Dealt to Dorex2007 [6h Kc]
Khrenya: folds 
Dorex2007: folds 
Dorm619: folds 
bloody55hawk: folds 
rose9918: folds 
mendel777: raises $0.04 to $0.06
NocnyFryzjer: folds 
naxal2012: folds 
Uncalled bet ($0.04) returned to mendel777
mendel777 collected $0.05 from pot
mendel777: doesn't show hand 
*** SUMMARY ***
Total pot $0.05 | Rake $0 
Seat 1: naxal2012 (big blind) folded before Flop
Seat 2: Khrenya folded before Flop (didn't bet)
Seat 4: Dorex2007 folded before Flop (didn't bet)
Seat 5: Dorm619 folded before Flop (didn't bet)
Seat 6: bloody55hawk folded before Flop (didn't bet)
Seat 7: rose9918 folded before Flop (didn't bet)
Seat 8: mendel777 (button) collected ($0.05)
Seat 9: NocnyFryzjer (small blind) folded before Flop



PokerStars Hand #228376736808:  Hold'em No Limit ($0.01/$0.02 USD) - 2021/07/18 1:52:32 PT [2021/07/18 4:52:32 ET]
Table 'Philia' 9-max Seat #9 is the button
Seat 1: naxal2012 ($3.40 in chips) 
Seat 2: Khrenya ($1.99 in chips) 
Seat 4: Dorex2007 ($3.51 in chips) 
Seat 5: Dorm619 ($4.38 in chips) 
Seat 6: bloody55hawk ($1.07 in chips) 
Seat 7: rose9918 ($1.91 in chips) 
Seat 8: mendel777 ($2.01 in chips) 
Seat 9: NocnyFryzjer ($0.64 in chips) 
naxal2012: posts small blind $0.01
Khrenya: posts big blind $0.02
*** HOLE CARDS ***
Dealt to Dorex2007 [Ac Jc]
Dorex2007: raises $0.04 to $0.06
Dorm619: folds 
bloody55hawk: folds 
rose9918: folds 
mendel777: raises $0.10 to $0.16
NocnyFryzjer: folds 
naxal2012: folds 
Khrenya: folds 
Dorex2007: calls $0.10
*** FLOP *** [6h 8s 4d]
Dorex2007: checks 
mendel777: checks 
*** TURN *** [6h 8s 4d] [5d]
Dorex2007: bets $0.17
mendel777: folds 
Uncalled bet ($0.17) returned to Dorex2007
Dorex2007 collected $0.34 from pot
Dorex2007: doesn't show hand 
NocnyFryzjer leaves the table
*** SUMMARY ***
Total pot $0.35 | Rake $0.01 
Board [6h 8s 4d 5d]
Seat 1: naxal2012 (small blind) folded before Flop
Seat 2: Khrenya (big blind) folded before Flop
Seat 4: Dorex2007 collected ($0.34)
Seat 5: Dorm619 folded before Flop (didn't bet)
Seat 6: bloody55hawk folded before Flop (didn't bet)
Seat 7: rose9918 folded before Flop (didn't bet)
Seat 8: mendel777 folded on the Turn
Seat 9: NocnyFryzjer (button) folded before Flop (didn't bet)



PokerStars Hand #228376748527:  Hold'em No Limit ($0.01/$0.02 USD) - 2021/07/18 1:53:34 PT [2021/07/18 4:53:34 ET]
Table 'Philia' 9-max Seat #1 is the button
Seat 1: naxal2012 ($3.39 in chips) 
Seat 2: Khrenya ($1.97 in chips) 
Seat 4: Dorex2007 ($3.69 in chips) 
Seat 5: Dorm619 ($4.38 in chips) 
Seat 6: bloody55hawk ($1.07 in chips) 
Seat 7: rose9918 ($1.91 in chips) 
Seat 8: mendel777 ($1.85 in chips) 
Khrenya: posts small blind $0.01
Dorex2007: posts big blind $0.02
*** HOLE CARDS ***
Dealt to Dorex2007 [9s 6s]
Dorm619: folds 
bloody55hawk: folds 
rose9918: folds 
mendel777: folds 
naxal2012: folds 
Khrenya: calls $0.01
Dorex2007: checks 
*** FLOP *** [9d 9c 4c]
Khrenya: bets $0.04
Dorex2007: calls $0.04
*** TURN *** [9d 9c 4c] [Jd]
Khrenya: checks 
Dorex2007: bets $0.06
Khrenya: folds 
Uncalled bet ($0.06) returned to Dorex2007
Dorex2007 collected $0.12 from pot
Dorex2007: doesn't show hand 
*** SUMMARY ***
Total pot $0.12 | Rake $0 
Board [9d 9c 4c Jd]
Seat 1: naxal2012 (button) folded before Flop (didn't bet)
Seat 2: Khrenya (small blind) folded on the Turn
Seat 4: Dorex2007 (big blind) collected ($0.12)
Seat 5: Dorm619 folded before Flop (didn't bet)
Seat 6: bloody55hawk folded before Flop (didn't bet)
Seat 7: rose9918 folded before Flop (didn't bet)
Seat 8: mendel777 folded before Flop (didn't bet)



PokerStars Hand #228376756885:  Hold'em No Limit ($0.01/$0.02 USD) - 2021/07/18 1:54:18 PT [2021/07/18 4:54:18 ET]
Table 'Philia' 9-max Seat #2 is the button
Seat 1: naxal2012 ($3.39 in chips) 
Seat 2: Khrenya ($1.91 in chips) 
Seat 4: Dorex2007 ($3.75 in chips) 
Seat 5: Dorm619 ($4.38 in chips) 
Seat 6: bloody55hawk ($1.07 in chips) 
Seat 7: rose9918 ($1.91 in chips) 
Seat 8: mendel777 ($1.85 in chips) 
Dorex2007: posts small blind $0.01
Dorm619: posts big blind $0.02
*** HOLE CARDS ***
Dealt to Dorex2007 [6s Kh]
bloody55hawk: folds 
rose9918: folds 
mendel777: folds 
naxal2012: raises $0.04 to $0.06
Khrenya: folds 
Dorex2007: folds 
Dorm619: folds 
Uncalled bet ($0.04) returned to naxal2012
naxal2012 collected $0.05 from pot
*** SUMMARY ***
Total pot $0.05 | Rake $0 
Seat 1: naxal2012 collected ($0.05)
Seat 2: Khrenya (button) folded before Flop (didn't bet)
Seat 4: Dorex2007 (small blind) folded before Flop
Seat 5: Dorm619 (big blind) folded before Flop
Seat 6: bloody55hawk folded before Flop (didn't bet)
Seat 7: rose9918 folded before Flop (didn't bet)
Seat 8: mendel777 folded before Flop (didn't bet)



PokerStars Hand #228376762426:  Hold'em No Limit ($0.01/$0.02 USD) - 2021/07/18 1:54:47 PT [2021/07/18 4:54:47 ET]
Table 'Philia' 9-max Seat #4 is the button
Seat 1: naxal2012 ($3.42 in chips) 
Seat 2: Khrenya ($1.91 in chips) 
Seat 4: Dorex2007 ($3.74 in chips) 
Seat 5: Dorm619 ($4.36 in chips) 
Seat 6: bloody55hawk ($1.07 in chips) 
Seat 7: rose9918 ($1.91 in chips) 
Seat 8: mendel777 ($1.85 in chips) 
Dorm619: posts small blind $0.01
bloody55hawk: posts big blind $0.02
*** HOLE CARDS ***
Dealt to Dorex2007 [Js 7s]
rose9918: folds 
mendel777: raises $0.04 to $0.06
naxal2012: folds 
Khrenya: folds 
Dorex2007: folds 
Dorm619: folds 
bloody55hawk: calls $0.04
*** FLOP *** [Th Qc Qh]
bloody55hawk: checks 
mendel777: checks 
*** TURN *** [Th Qc Qh] [6d]
bloody55hawk: bets $0.07
mendel777: calls $0.07
*** RIVER *** [Th Qc Qh 6d] [6s]
C0te2585 joins the table at seat #9 
bloody55hawk: checks 
mendel777: checks 
*** SHOW DOWN ***
bloody55hawk: shows [Jh Kh] (two pair, Queens and Sixes)
mendel777: shows [Ad Jc] (two pair, Queens and Sixes - Ace kicker)
mendel777 collected $0.26 from pot
*** SUMMARY ***
Total pot $0.27 | Rake $0.01 
Board [Th Qc Qh 6d 6s]
Seat 1: naxal2012 folded before Flop (didn't bet)
Seat 2: Khrenya folded before Flop (didn't bet)
Seat 4: Dorex2007 (button) folded before Flop (didn't bet)
Seat 5: Dorm619 (small blind) folded before Flop
Seat 6: bloody55hawk (big blind) showed [Jh Kh] and lost with two pair, Queens and Sixes
Seat 7: rose9918 folded before Flop (didn't bet)
Seat 8: mendel777 showed [Ad Jc] and won ($0.26) with two pair, Queens and Sixes



PokerStars Hand #228376767772:  Hold'em No Limit ($0.01/$0.02 USD) - 2021/07/18 1:55:17 PT [2021/07/18 4:55:17 ET]
Table 'Philia' 9-max Seat #5 is the button
Seat 1: naxal2012 ($3.42 in chips) 
Seat 2: Khrenya ($1.91 in chips) 
Seat 4: Dorex2007 ($3.74 in chips) 
Seat 5: Dorm619 ($4.35 in chips) 
Seat 6: bloody55hawk ($0.94 in chips) 
Seat 7: rose9918 ($1.91 in chips) 
Seat 8: mendel777 ($1.98 in chips) 
bloody55hawk: posts small blind $0.01
rose9918: posts big blind $0.02
C0te2585: sits out 
*** HOLE CARDS ***
Dealt to Dorex2007 [Ah 3s]
mendel777: folds 
naxal2012: folds 
Khrenya: folds 
Dorex2007: folds 
Dorm619: folds 
bloody55hawk: folds 
Uncalled bet ($0.01) returned to rose9918
rose9918 collected $0.02 from pot
rose9918: doesn't show hand 
*** SUMMARY ***
Total pot $0.02 | Rake $0 
Seat 1: naxal2012 folded before Flop (didn't bet)
Seat 2: Khrenya folded before Flop (didn't bet)
Seat 4: Dorex2007 folded before Flop (didn't bet)
Seat 5: Dorm619 (button) folded before Flop (didn't bet)
Seat 6: bloody55hawk (small blind) folded before Flop
Seat 7: rose9918 (big blind) collected ($0.02)
Seat 8: mendel777 folded before Flop (didn't bet)



PokerStars Hand #228376770515:  Hold'em No Limit ($0.01/$0.02 USD) - 2021/07/18 1:55:34 PT [2021/07/18 4:55:34 ET]
Table 'Philia' 9-max Seat #6 is the button
Seat 1: naxal2012 ($3.42 in chips) 
Seat 2: Khrenya ($1.91 in chips) 
Seat 4: Dorex2007 ($3.74 in chips) 
Seat 5: Dorm619 ($4.35 in chips) 
Seat 6: bloody55hawk ($0.93 in chips) 
Seat 7: rose9918 ($1.92 in chips) 
Seat 8: mendel777 ($1.98 in chips) 
Seat 9: C0te2585 ($2 in chips) 
rose9918: posts small blind $0.01
mendel777: posts big blind $0.02
C0te2585: posts big blind $0.02
*** HOLE CARDS ***
Dealt to Dorex2007 [Qd 8d]
C0te2585: checks 
naxal2012: folds 
Khrenya: folds 
Dorex2007: folds 
Dorm619: folds 
bloody55hawk: folds 
rose9918: folds 
mendel777: checks 
*** FLOP *** [8s Qs Qh]
mendel777: checks 
C0te2585: checks 
*** TURN *** [8s Qs Qh] [9c]
mendel777: checks 
C0te2585: checks 
*** RIVER *** [8s Qs Qh 9c] [Ts]
mendel777: checks 
C0te2585: checks 
*** SHOW DOWN ***
mendel777: shows [5h 3s] (a pair of Queens)
C0te2585: shows [Kc 6s] (a pair of Queens - King kicker)
C0te2585 collected $0.05 from pot
*** SUMMARY ***
Total pot $0.05 | Rake $0 
Board [8s Qs Qh 9c Ts]
Seat 1: naxal2012 folded before Flop (didn't bet)
Seat 2: Khrenya folded before Flop (didn't bet)
Seat 4: Dorex2007 folded before Flop (didn't bet)
Seat 5: Dorm619 folded before Flop (didn't bet)
Seat 6: bloody55hawk (button) folded before Flop (didn't bet)
Seat 7: rose9918 (small blind) folded before Flop
Seat 8: mendel777 (big blind) showed [5h 3s] and lost with a pair of Queens
Seat 9: C0te2585 showed [Kc 6s] and won ($0.05) with a pair of Queens



PokerStars Hand #228376774630:  Hold'em No Limit ($0.01/$0.02 USD) - 2021/07/18 1:56:01 PT [2021/07/18 4:56:01 ET]
Table 'Philia' 9-max Seat #7 is the button
Seat 1: naxal2012 ($3.42 in chips) 
Seat 2: Khrenya ($1.91 in chips) 
Seat 3: dealembub ($5.83 in chips) 
Seat 4: Dorex2007 ($3.74 in chips) 
Seat 5: Dorm619 ($4.35 in chips) 
Seat 6: bloody55hawk ($0.93 in chips) 
Seat 7: rose9918 ($1.91 in chips) 
Seat 8: mendel777 ($1.96 in chips) 
Seat 9: C0te2585 ($2.03 in chips) 
mendel777: posts small blind $0.01
C0te2585: posts big blind $0.02
dealembub: posts small & big blinds $0.03
*** HOLE CARDS ***
Dealt to Dorex2007 [Th Ad]
naxal2012: folds 
Khrenya: folds 
dealembub said, "i noticed you don't see any chinese on here anymore.  for awhile there was quite a few"
dealembub: checks 
Dorex2007: calls $0.02
Dorm619: folds 
bloody55hawk: folds 
rose9918: folds 
mendel777: folds 
C0te2585: checks 
*** FLOP *** [8d 6c Js]
C0te2585: checks 
dealembub: checks 
Dorex2007 said, "i've not seen any. They're all at GG"
Dorex2007: checks 
*** TURN *** [8d 6c Js] [2h]
C0te2585: checks 
dealembub: checks 
Dorex2007: bets $0.08
C0te2585: folds 
dealembub: calls $0.08
*** RIVER *** [8d 6c Js 2h] [Qd]
dealembub: checks 
Dorex2007: checks 
*** SHOW DOWN ***
dealembub: shows [5h 4s] (high card Queen)
Dorex2007: shows [Th Ad] (high card Ace)
Dorex2007 collected $0.23 from pot
*** SUMMARY ***
Total pot $0.24 | Rake $0.01 
Board [8d 6c Js 2h Qd]
Seat 1: naxal2012 folded before Flop (didn't bet)
Seat 2: Khrenya folded before Flop (didn't bet)
Seat 3: dealembub showed [5h 4s] and lost with high card Queen
Seat 4: Dorex2007 showed [Th Ad] and won ($0.23) with high card Ace
Seat 5: Dorm619 folded before Flop (didn't bet)
Seat 6: bloody55hawk folded before Flop (didn't bet)
Seat 7: rose9918 (button) folded before Flop (didn't bet)
Seat 8: mendel777 (small blind) folded before Flop
Seat 9: C0te2585 (big blind) folded on the Turn



PokerStars Hand #228376781321:  Hold'em No Limit ($0.01/$0.02 USD) - 2021/07/18 1:56:42 PT [2021/07/18 4:56:42 ET]
Table 'Philia' 9-max Seat #8 is the button
Seat 1: naxal2012 ($3.42 in chips) 
Seat 2: Khrenya ($1.91 in chips) 
Seat 3: dealembub ($5.72 in chips) 
Seat 4: Dorex2007 ($3.87 in chips) 
Seat 5: Dorm619 ($4.35 in chips) 
Seat 6: bloody55hawk ($0.93 in chips) 
Seat 7: rose9918 ($1.91 in chips) 
Seat 8: mendel777 ($1.95 in chips) 
Seat 9: C0te2585 ($2.01 in chips) 
C0te2585: posts small blind $0.01
naxal2012: posts big blind $0.02
*** HOLE CARDS ***
Dealt to Dorex2007 [Js 5s]
Khrenya: folds 
dealembub: calls $0.02
Dorex2007: folds 
Dorm619: folds 
bloody55hawk: folds 
rose9918: folds 
mendel777: folds 
C0te2585: folds 
naxal2012: checks 
*** FLOP *** [Ac 8c 4h]
naxal2012: checks 
dealembub said, "what's GG?"
dealembub: checks 
*** TURN *** [Ac 8c 4h] [7h]
naxal2012: checks 
dealembub: checks 
*** RIVER *** [Ac 8c 4h 7h] [3h]
naxal2012: bets $0.02
dealembub: calls $0.02
*** SHOW DOWN ***
naxal2012: shows [3s 7s] (two pair, Sevens and Threes)
dealembub: mucks hand 
naxal2012 collected $0.09 from pot
*** SUMMARY ***
Total pot $0.09 | Rake $0 
Board [Ac 8c 4h 7h 3h]
Seat 1: naxal2012 (big blind) showed [3s 7s] and won ($0.09) with two pair, Sevens and Threes
Seat 2: Khrenya folded before Flop (didn't bet)
Seat 3: dealembub mucked [4d Qc]
Seat 4: Dorex2007 folded before Flop (didn't bet)
Seat 5: Dorm619 folded before Flop (didn't bet)
Seat 6: bloody55hawk folded before Flop (didn't bet)
Seat 7: rose9918 folded before Flop (didn't bet)
Seat 8: mendel777 (button) folded before Flop (didn't bet)
Seat 9: C0te2585 (small blind) folded before Flop



PokerStars Hand #228376787265:  Hold'em No Limit ($0.01/$0.02 USD) - 2021/07/18 1:57:18 PT [2021/07/18 4:57:18 ET]
Table 'Philia' 9-max Seat #9 is the button
Seat 1: naxal2012 ($3.47 in chips) 
Seat 2: Khrenya ($1.91 in chips) 
Seat 3: dealembub ($5.68 in chips) 
Seat 4: Dorex2007 ($3.87 in chips) 
Seat 5: Dorm619 ($4.35 in chips) 
Seat 6: bloody55hawk ($0.93 in chips) 
Seat 7: rose9918 ($1.91 in chips) 
Seat 8: mendel777 ($1.95 in chips) 
Seat 9: C0te2585 ($2 in chips) 
naxal2012: posts small blind $0.01
Khrenya: posts big blind $0.02
*** HOLE CARDS ***
Dealt to Dorex2007 [2d 7d]
dealembub: calls $0.02
Dorex2007: folds 
Dorm619: raises $0.04 to $0.06
bloody55hawk: folds 
rose9918: folds 
mendel777: folds 
C0te2585: calls $0.06
naxal2012: folds 
Dorex2007 said, "poket site from Asia"
Khrenya: calls $0.04
dealembub: folds 
*** FLOP *** [Qd 3c Kd]
dealembub said, "oh ok thx"
Khrenya: checks 
Dorex2007 said, "fishyer, but higher rake"
Dorm619: checks 
C0te2585: checks 
*** TURN *** [Qd 3c Kd] [5c]
Khrenya: checks 
Dorm619: bets $0.20
C0te2585: folds 
Khrenya: folds 
Uncalled bet ($0.20) returned to Dorm619
Dorm619 collected $0.20 from pot
Dorm619: doesn't show hand 
*** SUMMARY ***
Total pot $0.21 | Rake $0.01 
Board [Qd 3c Kd 5c]
Seat 1: naxal2012 (small blind) folded before Flop
Seat 2: Khrenya (big blind) folded on the Turn
Seat 3: dealembub folded before Flop
Seat 4: Dorex2007 folded before Flop (didn't bet)
Seat 5: Dorm619 collected ($0.20)
Seat 6: bloody55hawk folded before Flop (didn't bet)
Seat 7: rose9918 folded before Flop (didn't bet)
Seat 8: mendel777 folded before Flop (didn't bet)
Seat 9: C0te2585 (button) folded on the Turn



PokerStars Hand #228376796028:  Hold'em No Limit ($0.01/$0.02 USD) - 2021/07/18 1:58:12 PT [2021/07/18 4:58:12 ET]
Table 'Philia' 9-max Seat #1 is the button
Seat 1: naxal2012 ($3.46 in chips) 
Seat 2: Khrenya ($1.85 in chips) 
Seat 3: dealembub ($5.66 in chips) 
Seat 4: Dorex2007 ($3.87 in chips) 
Seat 5: Dorm619 ($4.49 in chips) 
Seat 6: bloody55hawk ($0.93 in chips) 
Seat 7: rose9918 ($1.91 in chips) 
Seat 8: mendel777 ($1.95 in chips) 
Seat 9: C0te2585 ($1.94 in chips) 
Khrenya: posts small blind $0.01
dealembub: posts big blind $0.02
*** HOLE CARDS ***
Dealt to Dorex2007 [7d 4h]
Dorex2007: folds 
Dorm619: raises $0.04 to $0.06
bloody55hawk: folds 
rose9918: folds 
mendel777: folds 
C0te2585: folds 
naxal2012: folds 
Khrenya: folds 
dealembub: folds 
Uncalled bet ($0.04) returned to Dorm619
Dorm619 collected $0.05 from pot
Dorm619: doesn't show hand 
*** SUMMARY ***
Total pot $0.05 | Rake $0 
Seat 1: naxal2012 (button) folded before Flop (didn't bet)
Seat 2: Khrenya (small blind) folded before Flop
Seat 3: dealembub (big blind) folded before Flop
Seat 4: Dorex2007 folded before Flop (didn't bet)
Seat 5: Dorm619 collected ($0.05)
Seat 6: bloody55hawk folded before Flop (didn't bet)
Seat 7: rose9918 folded before Flop (didn't bet)
Seat 8: mendel777 folded before Flop (didn't bet)
Seat 9: C0te2585 folded before Flop (didn't bet)



PokerStars Hand #228376800710:  Hold'em No Limit ($0.01/$0.02 USD) - 2021/07/18 1:58:41 PT [2021/07/18 4:58:41 ET]
Table 'Philia' 9-max Seat #2 is the button
Seat 1: naxal2012 ($3.46 in chips) 
Seat 2: Khrenya ($1.84 in chips) 
Seat 3: dealembub ($5.64 in chips) 
Seat 4: Dorex2007 ($3.87 in chips) 
Seat 5: Dorm619 ($4.52 in chips) 
Seat 6: bloody55hawk ($0.93 in chips) 
Seat 7: rose9918 ($1.91 in chips) 
Seat 8: mendel777 ($1.95 in chips) 
Seat 9: C0te2585 ($1.94 in chips) 
dealembub: posts small blind $0.01
Dorex2007: posts big blind $0.02
*** HOLE CARDS ***
Dealt to Dorex2007 [6s Tc]
Dorm619: folds 
bloody55hawk: folds 
rose9918: folds 
mendel777: folds 
C0te2585: calls $0.02
naxal2012: folds 
Khrenya: folds 
dealembub: calls $0.01
Dorex2007: checks 
*** FLOP *** [2c 6h 2h]
dealembub: checks 
Dorex2007: checks 
C0te2585: checks 
*** TURN *** [2c 6h 2h] [Qd]
dealembub: checks 
Dorex2007: checks 
C0te2585: checks 
*** RIVER *** [2c 6h 2h Qd] [4d]
dealembub: checks 
Dorex2007: checks 
C0te2585: checks 
*** SHOW DOWN ***
dealembub: shows [Ac 7h] (a pair of Deuces)
Dorex2007: shows [6s Tc] (two pair, Sixes and Deuces)
C0te2585: mucks hand 
Dorex2007 collected $0.06 from pot
*** SUMMARY ***
Total pot $0.06 | Rake $0 
Board [2c 6h 2h Qd 4d]
Seat 1: naxal2012 folded before Flop (didn't bet)
Seat 2: Khrenya (button) folded before Flop (didn't bet)
Seat 3: dealembub (small blind) showed [Ac 7h] and lost with a pair of Deuces
Seat 4: Dorex2007 (big blind) showed [6s Tc] and won ($0.06) with two pair, Sixes and Deuces
Seat 5: Dorm619 folded before Flop (didn't bet)
Seat 6: bloody55hawk folded before Flop (didn't bet)
Seat 7: rose9918 folded before Flop (didn't bet)
Seat 8: mendel777 folded before Flop (didn't bet)
Seat 9: C0te2585 mucked [8d Kd]



PokerStars Hand #228376807104:  Hold'em No Limit ($0.01/$0.02 USD) - 2021/07/18 1:59:20 PT [2021/07/18 4:59:20 ET]
Table 'Philia' 9-max Seat #3 is the button
Seat 1: naxal2012 ($3.46 in chips) 
Seat 2: Khrenya ($1.84 in chips) 
Seat 3: dealembub ($5.62 in chips) 
Seat 4: Dorex2007 ($3.91 in chips) 
Seat 5: Dorm619 ($4.52 in chips) 
Seat 6: bloody55hawk ($0.93 in chips) 
Seat 7: rose9918 ($1.91 in chips) 
Seat 8: mendel777 ($1.95 in chips) 
Seat 9: C0te2585 ($1.92 in chips) 
Dorex2007: posts small blind $0.01
Dorm619: posts big blind $0.02
*** HOLE CARDS ***
Dealt to Dorex2007 [Jd 3h]
bloody55hawk: folds 
rose9918: folds 
dealembub said, "thief"
mendel777: folds 
C0te2585: calls $0.02
naxal2012: folds 
Khrenya: calls $0.02
dealembub: folds 
Dorex2007: folds 
Dorm619: checks 
*** FLOP *** [Qc 9d 4s]
Dorex2007 said, "lol"
Dorm619: checks 
C0te2585: checks 
Khrenya: checks 
*** TURN *** [Qc 9d 4s] [7h]
Dorm619: bets $0.05
C0te2585: folds 
Khrenya: folds 
Uncalled bet ($0.05) returned to Dorm619
Dorm619 collected $0.07 from pot
Dorm619: doesn't show hand 
*** SUMMARY ***
Total pot $0.07 | Rake $0 
Board [Qc 9d 4s 7h]
Seat 1: naxal2012 folded before Flop (didn't bet)
Seat 2: Khrenya folded on the Turn
Seat 3: dealembub (button) folded before Flop (didn't bet)
Seat 4: Dorex2007 (small blind) folded before Flop
Seat 5: Dorm619 (big blind) collected ($0.07)
Seat 6: bloody55hawk folded before Flop (didn't bet)
Seat 7: rose9918 folded before Flop (didn't bet)
Seat 8: mendel777 folded before Flop (didn't bet)
Seat 9: C0te2585 folded on the Turn



PokerStars Hand #228376814200:  Hold'em No Limit ($0.01/$0.02 USD) - 2021/07/18 2:00:04 PT [2021/07/18 5:00:04 ET]
Table 'Philia' 9-max Seat #4 is the button
Seat 1: naxal2012 ($3.46 in chips) 
Seat 2: Khrenya ($1.82 in chips) 
Seat 3: dealembub ($5.62 in chips) 
Seat 4: Dorex2007 ($3.90 in chips) 
Seat 5: Dorm619 ($4.57 in chips) 
Seat 6: bloody55hawk ($0.93 in chips) 
Seat 7: rose9918 ($1.91 in chips) 
Seat 8: mendel777 ($1.95 in chips) 
Seat 9: C0te2585 ($1.90 in chips) 
Dorm619: posts small blind $0.01
bloody55hawk: posts big blind $0.02
*** HOLE CARDS ***
Dealt to Dorex2007 [3s 6c]
rose9918: folds 
mendel777: folds 
C0te2585: folds 
naxal2012: raises $0.04 to $0.06
Dorex2007 said, "now you only owe me 1.96"
Khrenya: raises $0.07 to $0.13
dealembub: calls $0.13
Dorex2007: folds 
Dorm619: folds 
bloody55hawk: folds 
naxal2012: calls $0.07
*** FLOP *** [Kd 7d 2s]
naxal2012: checks 
Khrenya: checks 
dealembub: checks 
*** TURN *** [Kd 7d 2s] [Jc]
naxal2012: checks 
Khrenya: checks 
dealembub: checks 
*** RIVER *** [Kd 7d 2s Jc] [7h]
naxal2012: checks 
Khrenya: bets $0.15
dealembub: folds 
naxal2012: folds 
Uncalled bet ($0.15) returned to Khrenya
Khrenya collected $0.41 from pot
Khrenya: doesn't show hand 
*** SUMMARY ***
Total pot $0.42 | Rake $0.01 
Board [Kd 7d 2s Jc 7h]
Seat 1: naxal2012 folded on the River
Seat 2: Khrenya collected ($0.41)
Seat 3: dealembub folded on the River
Seat 4: Dorex2007 (button) folded before Flop (didn't bet)
Seat 5: Dorm619 (small blind) folded before Flop
Seat 6: bloody55hawk (big blind) folded before Flop
Seat 7: rose9918 folded before Flop (didn't bet)
Seat 8: mendel777 folded before Flop (didn't bet)
Seat 9: C0te2585 folded before Flop (didn't bet)



PokerStars Hand #228376824584:  Hold'em No Limit ($0.01/$0.02 USD) - 2021/07/18 2:01:03 PT [2021/07/18 5:01:03 ET]
Table 'Philia' 9-max Seat #5 is the button
Seat 1: naxal2012 ($3.33 in chips) 
Seat 2: Khrenya ($2.10 in chips) 
Seat 3: dealembub ($5.49 in chips) 
Seat 4: Dorex2007 ($3.90 in chips) 
Seat 5: Dorm619 ($4.56 in chips) 
Seat 6: bloody55hawk ($0.91 in chips) 
Seat 7: rose9918 ($1.91 in chips) 
Seat 8: mendel777 ($1.95 in chips) 
Seat 9: C0te2585 ($1.90 in chips) 
bloody55hawk: posts small blind $0.01
rose9918: posts big blind $0.02
*** HOLE CARDS ***
Dealt to Dorex2007 [8c 3s]
mendel777: folds 
C0te2585: folds 
naxal2012: folds 
Khrenya: folds 
dealembub: raises $0.02 to $0.04
Dorex2007: folds 
Dorm619: calls $0.04
bloody55hawk: folds 
rose9918: calls $0.02
*** FLOP *** [6c 8h 5d]
rose9918: checks 
dealembub: checks 
Dorm619: bets $0.09
rose9918: folds 
dealembub: calls $0.09
*** TURN *** [6c 8h 5d] [Ah]
dealembub: bets $0.30
Dorm619: raises $0.50 to $0.80
dealembub: calls $0.50
*** RIVER *** [6c 8h 5d Ah] [Ts]
dealembub: bets $1.92
Dorm619: folds 
Uncalled bet ($1.92) returned to dealembub
dealembub collected $1.84 from pot
dealembub: doesn't show hand 
*** SUMMARY ***
Total pot $1.91 | Rake $0.07 
Board [6c 8h 5d Ah Ts]
Seat 1: naxal2012 folded before Flop (didn't bet)
Seat 2: Khrenya folded before Flop (didn't bet)
Seat 3: dealembub collected ($1.84)
Seat 4: Dorex2007 folded before Flop (didn't bet)
Seat 5: Dorm619 (button) folded on the River
Seat 6: bloody55hawk (small blind) folded before Flop
Seat 7: rose9918 (big blind) folded on the Flop
Seat 8: mendel777 folded before Flop (didn't bet)
Seat 9: C0te2585 folded before Flop (didn't bet)



PokerStars Hand #228376840061:  Hold'em No Limit ($0.01/$0.02 USD) - 2021/07/18 2:02:23 PT [2021/07/18 5:02:23 ET]
Table 'Philia' 9-max Seat #6 is the button
Seat 1: naxal2012 ($3.33 in chips) 
Seat 2: Khrenya ($2.10 in chips) 
Seat 3: dealembub ($6.40 in chips) 
Seat 4: Dorex2007 ($3.90 in chips) 
Seat 5: Dorm619 ($3.63 in chips) 
Seat 6: bloody55hawk ($0.90 in chips) 
Seat 7: rose9918 ($1.87 in chips) 
Seat 8: mendel777 ($1.95 in chips) 
Seat 9: C0te2585 ($1.90 in chips) 
rose9918: posts small blind $0.01
mendel777: posts big blind $0.02
*** HOLE CARDS ***
Dealt to Dorex2007 [3s 3h]
C0te2585: calls $0.02
naxal2012: folds 
Khrenya: folds 
dealembub: calls $0.02
Dorex2007: folds 
Dorm619: folds 
bloody55hawk: folds 
rose9918: folds 
mendel777: raises $0.07 to $0.09
C0te2585: folds 
dealembub: folds 
Uncalled bet ($0.07) returned to mendel777
mendel777 collected $0.07 from pot
mendel777: doesn't show hand 
*** SUMMARY ***
Total pot $0.07 | Rake $0 
Seat 1: naxal2012 folded before Flop (didn't bet)
Seat 2: Khrenya folded before Flop (didn't bet)
Seat 3: dealembub folded before Flop
Seat 4: Dorex2007 folded before Flop (didn't bet)
Seat 5: Dorm619 folded before Flop (didn't bet)
Seat 6: bloody55hawk (button) folded before Flop (didn't bet)
Seat 7: rose9918 (small blind) folded before Flop
Seat 8: mendel777 (big blind) collected ($0.07)
Seat 9: C0te2585 folded before Flop



PokerStars Hand #228376845070:  Hold'em No Limit ($0.01/$0.02 USD) - 2021/07/18 2:02:49 PT [2021/07/18 5:02:49 ET]
Table 'Philia' 9-max Seat #7 is the button
Seat 1: naxal2012 ($3.33 in chips) 
Seat 2: Khrenya ($2.10 in chips) 
Seat 3: dealembub ($6.38 in chips) 
Seat 4: Dorex2007 ($3.90 in chips) 
Seat 5: Dorm619 ($3.63 in chips) 
Seat 6: bloody55hawk ($0.90 in chips) 
Seat 7: rose9918 ($1.86 in chips) 
Seat 8: mendel777 ($2 in chips) 
Seat 9: C0te2585 ($1.88 in chips) 
mendel777: posts small blind $0.01
C0te2585: posts big blind $0.02
*** HOLE CARDS ***
Dealt to Dorex2007 [Qs 4d]
naxal2012: folds 
Khrenya: folds 
dealembub: folds 
Dorex2007: folds 
Dorm619: raises $0.04 to $0.06
bloody55hawk: calls $0.06
rose9918: folds 
mendel777: calls $0.05
C0te2585: calls $0.04
*** FLOP *** [2h Ts 5c]
mendel777: checks 
C0te2585: checks 
Dorm619: checks 
bloody55hawk: checks 
*** TURN *** [2h Ts 5c] [8s]
mendel777: checks 
C0te2585: checks 
Dorm619: checks 
bloody55hawk: checks 
*** RIVER *** [2h Ts 5c 8s] [Ad]
mendel777: checks 
C0te2585: checks 
Dorm619: checks 
bloody55hawk: checks 
*** SHOW DOWN ***
mendel777: shows [3s 2s] (a pair of Deuces)
C0te2585: shows [4s 4h] (a pair of Fours)
Dorm619: mucks hand 
bloody55hawk: mucks hand 
C0te2585 collected $0.23 from pot
*** SUMMARY ***
Total pot $0.24 | Rake $0.01 
Board [2h Ts 5c 8s Ad]
Seat 1: naxal2012 folded before Flop (didn't bet)
Seat 2: Khrenya folded before Flop (didn't bet)
Seat 3: dealembub folded before Flop (didn't bet)
Seat 4: Dorex2007 folded before Flop (didn't bet)
Seat 5: Dorm619 mucked [Kd Jh]
Seat 6: bloody55hawk mucked [Qd Ks]
Seat 7: rose9918 (button) folded before Flop (didn't bet)
Seat 8: mendel777 (small blind) showed [3s 2s] and lost with a pair of Deuces
Seat 9: C0te2585 (big blind) showed [4s 4h] and won ($0.23) with a pair of Fours



PokerStars Hand #228376855820:  Hold'em No Limit ($0.01/$0.02 USD) - 2021/07/18 2:03:44 PT [2021/07/18 5:03:44 ET]
Table 'Philia' 9-max Seat #8 is the button
Seat 1: naxal2012 ($3.33 in chips) 
Seat 2: Khrenya ($2.10 in chips) 
Seat 3: dealembub ($6.38 in chips) 
Seat 4: Dorex2007 ($3.90 in chips) 
Seat 5: Dorm619 ($3.57 in chips) 
Seat 6: bloody55hawk ($0.84 in chips) 
Seat 7: rose9918 ($1.86 in chips) 
Seat 8: mendel777 ($1.94 in chips) 
Seat 9: C0te2585 ($2.05 in chips) 
C0te2585: posts small blind $0.01
naxal2012: posts big blind $0.02
*** HOLE CARDS ***
Dealt to Dorex2007 [2s 9h]
Khrenya: folds 
dealembub: folds 
Dorex2007: folds 
Dorm619: folds 
bloody55hawk: folds 
rose9918: folds 
mendel777: raises $0.05 to $0.07
C0te2585: folds 
naxal2012: calls $0.05
*** FLOP *** [8h Td 6s]
naxal2012: checks 
mendel777: bets $0.10
naxal2012: folds 
Uncalled bet ($0.10) returned to mendel777
mendel777 collected $0.14 from pot
mendel777: doesn't show hand 
*** SUMMARY ***
Total pot $0.15 | Rake $0.01 
Board [8h Td 6s]
Seat 1: naxal2012 (big blind) folded on the Flop
Seat 2: Khrenya folded before Flop (didn't bet)
Seat 3: dealembub folded before Flop (didn't bet)
Seat 4: Dorex2007 folded before Flop (didn't bet)
Seat 5: Dorm619 folded before Flop (didn't bet)
Seat 6: bloody55hawk folded before Flop (didn't bet)
Seat 7: rose9918 folded before Flop (didn't bet)
Seat 8: mendel777 (button) collected ($0.14)
Seat 9: C0te2585 (small blind) folded before Flop



PokerStars Hand #228376861702:  Hold'em No Limit ($0.01/$0.02 USD) - 2021/07/18 2:04:14 PT [2021/07/18 5:04:14 ET]
Table 'Philia' 9-max Seat #9 is the button
Seat 1: naxal2012 ($3.26 in chips) 
Seat 2: Khrenya ($2.10 in chips) 
Seat 3: dealembub ($6.38 in chips) 
Seat 4: Dorex2007 ($3.90 in chips) 
Seat 5: Dorm619 ($3.57 in chips) 
Seat 6: bloody55hawk ($0.84 in chips) 
Seat 7: rose9918 ($1.86 in chips) 
Seat 8: mendel777 ($2.01 in chips) 
Seat 9: C0te2585 ($2.04 in chips) 
naxal2012: posts small blind $0.01
Khrenya: posts big blind $0.02
*** HOLE CARDS ***
Dealt to Dorex2007 [Ac 3c]
dealembub: folds 
Dorex2007: folds 
Dorm619: folds 
bloody55hawk: folds 
rose9918: folds 
mendel777: folds 
C0te2585: calls $0.02
naxal2012: calls $0.01
Khrenya: checks 
*** FLOP *** [6s Kd 7c]
naxal2012: checks 
Khrenya: bets $0.06
C0te2585: folds 
naxal2012: folds 
Uncalled bet ($0.06) returned to Khrenya
Khrenya collected $0.06 from pot
Khrenya: doesn't show hand 
*** SUMMARY ***
Total pot $0.06 | Rake $0 
Board [6s Kd 7c]
Seat 1: naxal2012 (small blind) folded on the Flop
Seat 2: Khrenya (big blind) collected ($0.06)
Seat 3: dealembub folded before Flop (didn't bet)
Seat 4: Dorex2007 folded before Flop (didn't bet)
Seat 5: Dorm619 folded before Flop (didn't bet)
Seat 6: bloody55hawk folded before Flop (didn't bet)
Seat 7: rose9918 folded before Flop (didn't bet)
Seat 8: mendel777 folded before Flop (didn't bet)
Seat 9: C0te2585 (button) folded on the Flop



PokerStars Hand #228376867418:  Hold'em No Limit ($0.01/$0.02 USD) - 2021/07/18 2:04:43 PT [2021/07/18 5:04:43 ET]
Table 'Philia' 9-max Seat #1 is the button
Seat 1: naxal2012 ($3.24 in chips) 
Seat 2: Khrenya ($2.14 in chips) 
Seat 3: dealembub ($6.38 in chips) 
Seat 4: Dorex2007 ($3.90 in chips) 
Seat 5: Dorm619 ($3.57 in chips) 
Seat 6: bloody55hawk ($0.84 in chips) 
Seat 7: rose9918 ($1.86 in chips) 
Seat 8: mendel777 ($2.01 in chips) 
Seat 9: C0te2585 ($2.02 in chips) 
Khrenya: posts small blind $0.01
dealembub: posts big blind $0.02
*** HOLE CARDS ***
Dealt to Dorex2007 [3s Td]
Dorex2007: folds 
Dorm619: raises $0.04 to $0.06
bloody55hawk: folds 
rose9918: folds 
mendel777: folds 
C0te2585: folds 
naxal2012: folds 
Khrenya: folds 
dealembub: calls $0.04
*** FLOP *** [9h 4d 5s]
dealembub: bets $0.02
Dorm619: calls $0.02
*** TURN *** [9h 4d 5s] [Ah]
dealembub: bets $0.30
Dorm619: calls $0.30
*** RIVER *** [9h 4d 5s Ah] [Ac]
dealembub: bets $0.74
Dorm619: calls $0.74
*** SHOW DOWN ***
dealembub: shows [5c As] (a full house, Aces full of Fives)
Dorm619: mucks hand 
dealembub collected $2.17 from pot
*** SUMMARY ***
Total pot $2.25 | Rake $0.08 
Board [9h 4d 5s Ah Ac]
Seat 1: naxal2012 (button) folded before Flop (didn't bet)
Seat 2: Khrenya (small blind) folded before Flop
Seat 3: dealembub (big blind) showed [5c As] and won ($2.17) with a full house, Aces full of Fives
Seat 4: Dorex2007 folded before Flop (didn't bet)
Seat 5: Dorm619 mucked [Ad Jc]
Seat 6: bloody55hawk folded before Flop (didn't bet)
Seat 7: rose9918 folded before Flop (didn't bet)
Seat 8: mendel777 folded before Flop (didn't bet)
Seat 9: C0te2585 folded before Flop (didn't bet)



PokerStars Hand #228376885663:  Hold'em No Limit ($0.01/$0.02 USD) - 2021/07/18 2:05:40 PT [2021/07/18 5:05:40 ET]
Table 'Philia' 9-max Seat #2 is the button
Seat 1: naxal2012 ($3.24 in chips) 
Seat 2: Khrenya ($2.13 in chips) 
Seat 3: dealembub ($7.43 in chips) 
Seat 4: Dorex2007 ($3.90 in chips) 
Seat 5: Dorm619 ($2.45 in chips) 
Seat 6: bloody55hawk ($0.84 in chips) 
Seat 7: rose9918 ($1.86 in chips) 
Seat 8: mendel777 ($2.01 in chips) 
Seat 9: C0te2585 ($2.02 in chips) 
dealembub: posts small blind $0.01
Dorex2007: posts big blind $0.02
*** HOLE CARDS ***
Dealt to Dorex2007 [8s As]
Dorm619: folds 
bloody55hawk: folds 
rose9918: folds 
mendel777: folds 
C0te2585: folds 
naxal2012: folds 
Khrenya: raises $0.08 to $0.10
dealembub: folds 
Dorex2007: calls $0.08
*** FLOP *** [Qd 9s Ah]
Dorex2007: checks 
Khrenya: checks 
*** TURN *** [Qd 9s Ah] [3c]
Dorex2007: bets $0.20
Khrenya: calls $0.20
*** RIVER *** [Qd 9s Ah 3c] [2s]
Dorex2007: checks 
Khrenya: bets $0.59
Dorex2007: folds 
Uncalled bet ($0.59) returned to Khrenya
Khrenya collected $0.59 from pot
Khrenya: doesn't show hand 
*** SUMMARY ***
Total pot $0.61 | Rake $0.02 
Board [Qd 9s Ah 3c 2s]
Seat 1: naxal2012 folded before Flop (didn't bet)
Seat 2: Khrenya (button) collected ($0.59)
Seat 3: dealembub (small blind) folded before Flop
Seat 4: Dorex2007 (big blind) folded on the River
Seat 5: Dorm619 folded before Flop (didn't bet)
Seat 6: bloody55hawk folded before Flop (didn't bet)
Seat 7: rose9918 folded before Flop (didn't bet)
Seat 8: mendel777 folded before Flop (didn't bet)
Seat 9: C0te2585 folded before Flop (didn't bet)



PokerStars Hand #228376897745:  Hold'em No Limit ($0.01/$0.02 USD) - 2021/07/18 2:06:41 PT [2021/07/18 5:06:41 ET]
Table 'Philia' 9-max Seat #3 is the button
Seat 1: naxal2012 ($3.24 in chips) 
Seat 2: Khrenya ($2.42 in chips) 
Seat 3: dealembub ($7.42 in chips) 
Seat 4: Dorex2007 ($3.60 in chips) 
Seat 5: Dorm619 ($2.45 in chips) 
Seat 6: bloody55hawk ($0.84 in chips) 
Seat 7: rose9918 ($1.86 in chips) 
Seat 8: mendel777 ($2.01 in chips) 
Seat 9: C0te2585 ($2.02 in chips) 
Dorex2007: posts small blind $0.01
Dorm619: posts big blind $0.02
*** HOLE CARDS ***
Dealt to Dorex2007 [Kd 3s]
bloody55hawk: folds 
rose9918: folds 
mendel777: folds 
C0te2585: calls $0.02
naxal2012: folds 
Khrenya: folds 
dealembub: calls $0.02
Dorex2007: folds 
Dorm619: checks 
*** FLOP *** [2c 3c 3h]
Dorm619: checks 
C0te2585: checks 
dealembub: checks 
*** TURN *** [2c 3c 3h] [Kh]
Dorm619: checks 
C0te2585: checks 
dealembub: checks 
*** RIVER *** [2c 3c 3h Kh] [4s]
Dorm619: bets $0.05
C0te2585: folds 
dealembub: folds 
Uncalled bet ($0.05) returned to Dorm619
Dorm619 collected $0.07 from pot
Dorm619: doesn't show hand 
*** SUMMARY ***
Total pot $0.07 | Rake $0 
Board [2c 3c 3h Kh 4s]
Seat 1: naxal2012 folded before Flop (didn't bet)
Seat 2: Khrenya folded before Flop (didn't bet)
Seat 3: dealembub (button) folded on the River
Seat 4: Dorex2007 (small blind) folded before Flop
Seat 5: Dorm619 (big blind) collected ($0.07)
Seat 6: bloody55hawk folded before Flop (didn't bet)
Seat 7: rose9918 folded before Flop (didn't bet)
Seat 8: mendel777 folded before Flop (didn't bet)
Seat 9: C0te2585 folded on the River



PokerStars Hand #228376905580:  Hold'em No Limit ($0.01/$0.02 USD) - 2021/07/18 2:07:21 PT [2021/07/18 5:07:21 ET]
Table 'Philia' 9-max Seat #4 is the button
Seat 1: naxal2012 ($3.24 in chips) 
Seat 2: Khrenya ($2.42 in chips) 
Seat 3: dealembub ($7.40 in chips) 
Seat 4: Dorex2007 ($3.59 in chips) 
Seat 5: Dorm619 ($2.50 in chips) 
Seat 6: bloody55hawk ($0.84 in chips) 
Seat 7: rose9918 ($1.86 in chips) 
Seat 8: mendel777 ($2.01 in chips) 
Seat 9: C0te2585 ($2 in chips) 
Dorm619: posts small blind $0.01
bloody55hawk: posts big blind $0.02
*** HOLE CARDS ***
Dealt to Dorex2007 [3s 7h]
Dorex2007 said, "folded K 3"
rose9918: folds 
dealembub said, "your kidding"
Dorex2007 said, "nope"
dealembub said, "i never fold kings"
mendel777: folds 
C0te2585: calls $0.02
naxal2012: folds 
Khrenya: folds 
dealembub: folds 
Dorex2007: folds 
Dorm619: folds 
bloody55hawk: raises $0.82 to $0.84 and is all-in
C0te2585: folds 
Uncalled bet ($0.82) returned to bloody55hawk
bloody55hawk collected $0.05 from pot
Dorex2007 said, "i'm about to go. don't want to get in a pissing match"
bloody55hawk: doesn't show hand 
dealembub said, "unless some guy goes super high"
*** SUMMARY ***
Total pot $0.05 | Rake $0 
Seat 1: naxal2012 folded before Flop (didn't bet)
Seat 2: Khrenya folded before Flop (didn't bet)
Seat 3: dealembub folded before Flop (didn't bet)
Seat 4: Dorex2007 (button) folded before Flop (didn't bet)
Seat 5: Dorm619 (small blind) folded before Flop
Seat 6: bloody55hawk (big blind) collected ($0.05)
Seat 7: rose9918 folded before Flop (didn't bet)
Seat 8: mendel777 folded before Flop (didn't bet)
Seat 9: C0te2585 folded before Flop



PokerStars Hand #228376913412:  Hold'em No Limit ($0.01/$0.02 USD) - 2021/07/18 2:08:01 PT [2021/07/18 5:08:01 ET]
Table 'Philia' 9-max Seat #5 is the button
Seat 1: naxal2012 ($3.24 in chips) 
Seat 2: Khrenya ($2.42 in chips) 
Seat 3: dealembub ($7.40 in chips) 
Seat 4: Dorex2007 ($3.59 in chips) 
Seat 5: Dorm619 ($2.49 in chips) 
Seat 6: bloody55hawk ($0.87 in chips) 
Seat 7: rose9918 ($1.86 in chips) 
Seat 8: mendel777 ($2.01 in chips) 
Seat 9: C0te2585 ($1.98 in chips) 
bloody55hawk: posts small blind $0.01
rose9918: posts big blind $0.02
*** HOLE CARDS ***
Dealt to Dorex2007 [Jc 3h]
mendel777: folds 
C0te2585: calls $0.02
naxal2012: raises $0.07 to $0.09
Khrenya: folds 
dealembub: calls $0.09
dealembub said, "ya its late for sure"
Dorex2007: folds 
Dorm619: folds 
bloody55hawk: folds 
rose9918: folds 
C0te2585: folds 
*** FLOP *** [5d Jd 9d]
naxal2012: bets $0.11
dealembub: folds 
Uncalled bet ($0.11) returned to naxal2012
naxal2012 collected $0.22 from pot
*** SUMMARY ***
Total pot $0.23 | Rake $0.01 
Board [5d Jd 9d]
Seat 1: naxal2012 collected ($0.22)
Seat 2: Khrenya folded before Flop (didn't bet)
Seat 3: dealembub folded on the Flop
Seat 4: Dorex2007 folded before Flop (didn't bet)
Seat 5: Dorm619 (button) folded before Flop (didn't bet)
Seat 6: bloody55hawk (small blind) folded before Flop
Seat 7: rose9918 (big blind) folded before Flop
Seat 8: mendel777 folded before Flop (didn't bet)
Seat 9: C0te2585 folded before Flop



PokerStars Hand #228376920095:  Hold'em No Limit ($0.01/$0.02 USD) - 2021/07/18 2:08:34 PT [2021/07/18 5:08:34 ET]
Table 'Philia' 9-max Seat #6 is the button
Seat 1: naxal2012 ($3.37 in chips) 
Seat 2: Khrenya ($2.42 in chips) 
Seat 3: dealembub ($7.31 in chips) 
Seat 4: Dorex2007 ($3.59 in chips) 
Seat 5: Dorm619 ($2.49 in chips) 
Seat 6: bloody55hawk ($0.86 in chips) 
Seat 7: rose9918 ($1.84 in chips) 
Seat 8: mendel777 ($2.01 in chips) 
Seat 9: C0te2585 ($1.96 in chips) 
rose9918: posts small blind $0.01
mendel777: posts big blind $0.02
*** HOLE CARDS ***
Dealt to Dorex2007 [7c 9d]
dealembub said, "had 3 3"
C0te2585: folds 
Dorex2007 said, "lol"
naxal2012: folds 
Khrenya: folds 
dealembub: calls $0.02
Dorex2007: folds 
Dorm619: folds 
bloody55hawk: raises $0.04 to $0.06
rose9918: folds 
mendel777: folds 
dealembub: calls $0.04
*** FLOP *** [3c 6h 7d]
dealembub: checks 
bloody55hawk: checks 
*** TURN *** [3c 6h 7d] [Qh]
dealembub: checks 
bloody55hawk: checks 
*** RIVER *** [3c 6h 7d Qh] [5h]
dealembub: checks 
bloody55hawk: checks 
*** SHOW DOWN ***
dealembub: shows [Ac 2d] (high card Ace)
bloody55hawk: mucks hand 
dealembub collected $0.14 from pot
*** SUMMARY ***
Total pot $0.15 | Rake $0.01 
Board [3c 6h 7d Qh 5h]
Seat 1: naxal2012 folded before Flop (didn't bet)
Seat 2: Khrenya folded before Flop (didn't bet)
Seat 3: dealembub showed [Ac 2d] and won ($0.14) with high card Ace
Seat 4: Dorex2007 folded before Flop (didn't bet)
Seat 5: Dorm619 folded before Flop (didn't bet)
Seat 6: bloody55hawk (button) mucked [Jc Kc]
Seat 7: rose9918 (small blind) folded before Flop
Seat 8: mendel777 (big blind) folded before Flop
Seat 9: C0te2585 folded before Flop (didn't bet)



PokerStars Hand #228376927764:  Hold'em No Limit ($0.01/$0.02 USD) - 2021/07/18 2:09:14 PT [2021/07/18 5:09:14 ET]
Table 'Philia' 9-max Seat #7 is the button
Seat 1: naxal2012 ($3.37 in chips) 
Seat 2: Khrenya ($2.42 in chips) 
Seat 3: dealembub ($7.39 in chips) 
Seat 4: Dorex2007 ($3.59 in chips) 
Seat 5: Dorm619 ($2.49 in chips) 
Seat 6: bloody55hawk ($0.80 in chips) 
Seat 7: rose9918 ($1.83 in chips) 
Seat 8: mendel777 ($1.99 in chips) 
Seat 9: C0te2585 ($1.96 in chips) 
mendel777: posts small blind $0.01
C0te2585: posts big blind $0.02
*** HOLE CARDS ***
Dealt to Dorex2007 [Js Ts]
naxal2012: folds 
Khrenya: folds 
dealembub: folds 
Dorex2007: raises $0.04 to $0.06
Dorm619: folds 
bloody55hawk: folds 
rose9918: folds 
mendel777: folds 
C0te2585: calls $0.04
*** FLOP *** [9d 4s 2c]
C0te2585: checks 
Dorex2007: bets $0.13
C0te2585: folds 
Uncalled bet ($0.13) returned to Dorex2007
Dorex2007 collected $0.13 from pot
Dorex2007: doesn't show hand 
*** SUMMARY ***
Total pot $0.13 | Rake $0 
Board [9d 4s 2c]
Seat 1: naxal2012 folded before Flop (didn't bet)
Seat 2: Khrenya folded before Flop (didn't bet)
Seat 3: dealembub folded before Flop (didn't bet)
Seat 4: Dorex2007 collected ($0.13)
Seat 5: Dorm619 folded before Flop (didn't bet)
Seat 6: bloody55hawk folded before Flop (didn't bet)
Seat 7: rose9918 (button) folded before Flop (didn't bet)
Seat 8: mendel777 (small blind) folded before Flop
Seat 9: C0te2585 (big blind) folded on the Flop



PokerStars Hand #228376932879:  Hold'em No Limit ($0.01/$0.02 USD) - 2021/07/18 2:09:39 PT [2021/07/18 5:09:39 ET]
Table 'Philia' 9-max Seat #8 is the button
Seat 1: naxal2012 ($3.37 in chips) 
Seat 2: Khrenya ($2.42 in chips) 
Seat 3: dealembub ($7.39 in chips) 
Seat 4: Dorex2007 ($3.66 in chips) 
Seat 5: Dorm619 ($2.49 in chips) 
Seat 6: bloody55hawk ($0.80 in chips) 
Seat 7: rose9918 ($1.83 in chips) 
Seat 8: mendel777 ($1.98 in chips) 
Seat 9: C0te2585 ($1.90 in chips) 
C0te2585: posts small blind $0.01
naxal2012: posts big blind $0.02
*** HOLE CARDS ***
Dealt to Dorex2007 [8c 3s]
Khrenya: folds 
dealembub: folds 
Dorex2007: folds 
Dorm619: folds 
bloody55hawk: folds 
rose9918: folds 
mendel777: folds 
C0te2585: calls $0.01
naxal2012: checks 
*** FLOP *** [6d 9h 2h]
C0te2585: checks 
naxal2012: checks 
*** TURN *** [6d 9h 2h] [Ad]
dealembub said, "i think i'll cash in...see where i'm at"
C0te2585: checks 
naxal2012: checks 
*** RIVER *** [6d 9h 2h Ad] [9c]
dealembub said, "nice seening you again"
C0te2585: bets $0.04
naxal2012: folds 
Uncalled bet ($0.04) returned to C0te2585
C0te2585 collected $0.04 from pot
C0te2585: doesn't show hand 
*** SUMMARY ***
Total pot $0.04 | Rake $0 
Board [6d 9h 2h Ad 9c]
Seat 1: naxal2012 (big blind) folded on the River
Seat 2: Khrenya folded before Flop (didn't bet)
Seat 3: dealembub folded before Flop (didn't bet)
Seat 4: Dorex2007 folded before Flop (didn't bet)
Seat 5: Dorm619 folded before Flop (didn't bet)
Seat 6: bloody55hawk folded before Flop (didn't bet)
Seat 7: rose9918 folded before Flop (didn't bet)
Seat 8: mendel777 (button) folded before Flop (didn't bet)
Seat 9: C0te2585 (small blind) collected ($0.04)



PokerStars Hand #228376941244:  Hold'em No Limit ($0.01/$0.02 USD) - 2021/07/18 2:10:21 PT [2021/07/18 5:10:21 ET]
Table 'Philia' 9-max Seat #9 is the button
Seat 1: naxal2012 ($3.35 in chips) 
Seat 2: Khrenya ($2.42 in chips) 
Seat 4: Dorex2007 ($3.66 in chips) 
Seat 5: Dorm619 ($2.49 in chips) 
Seat 6: bloody55hawk ($0.80 in chips) 
Seat 7: rose9918 ($1.83 in chips) 
Seat 8: mendel777 ($1.98 in chips) 
Seat 9: C0te2585 ($1.92 in chips) 
naxal2012: posts small blind $0.01
Khrenya: posts big blind $0.02
*** HOLE CARDS ***
Dealt to Dorex2007 [2d Qs]
Dorex2007: folds 
Dorm619: raises $0.04 to $0.06
bloody55hawk: folds 
rose9918: folds 
mendel777: calls $0.06
C0te2585: folds 
dealembub leaves the table
naxal2012: folds 
Khrenya: calls $0.04
*** FLOP *** [Js Td Ah]
Khrenya: checks 
igor6316 joins the table at seat #3 
C0te2585 leaves the table
Dorm619: bets $0.12
mendel777: calls $0.12
Khrenya: raises $0.12 to $0.24
dezname joins the table at seat #9 
Dorm619: calls $0.12
mendel777: calls $0.12
*** TURN *** [Js Td Ah] [Ts]
Khrenya: checks 
Dorm619: checks 
mendel777: checks 
*** RIVER *** [Js Td Ah Ts] [7d]
Khrenya: checks 
Dorm619: checks 
mendel777: checks 
*** SHOW DOWN ***
Khrenya: shows [Kd Ac] (two pair, Aces and Tens)
Dorm619: mucks hand 
mendel777: mucks hand 
Khrenya collected $0.88 from pot
*** SUMMARY ***
Total pot $0.91 | Rake $0.03 
Board [Js Td Ah Ts 7d]
Seat 1: naxal2012 (small blind) folded before Flop
Seat 2: Khrenya (big blind) showed [Kd Ac] and won ($0.88) with two pair, Aces and Tens
Seat 4: Dorex2007 folded before Flop (didn't bet)
Seat 5: Dorm619 mucked [5s As]
Seat 6: bloody55hawk folded before Flop (didn't bet)
Seat 7: rose9918 folded before Flop (didn't bet)
Seat 8: mendel777 mucked [Ad 8d]
Seat 9: C0te2585 (button) folded before Flop (didn't bet)



PokerStars Hand #228376955886:  Hold'em No Limit ($0.01/$0.02 USD) - 2021/07/18 2:11:36 PT [2021/07/18 5:11:36 ET]
Table 'Philia' 9-max Seat #1 is the button
Seat 1: naxal2012 ($3.34 in chips) 
Seat 2: Khrenya ($3 in chips) 
Seat 3: igor6316 ($0.80 in chips) 
Seat 4: Dorex2007 ($3.66 in chips) 
Seat 5: Dorm619 ($2.19 in chips) 
Seat 6: bloody55hawk ($0.80 in chips) 
Seat 7: rose9918 ($1.83 in chips) 
Seat 8: mendel777 ($1.68 in chips) 
Khrenya: posts small blind $0.01
igor6316: posts big blind $0.02
dezname: sits out 
*** HOLE CARDS ***
Dealt to Dorex2007 [8c Th]
Dorex2007: folds 
Dorm619: folds 
bloody55hawk: folds 
rose9918 is disconnected 
rose9918 has timed out while being disconnected
rose9918: folds 
mendel777: folds 
naxal2012: folds 
Khrenya: folds 
Uncalled bet ($0.01) returned to igor6316
igor6316 collected $0.02 from pot
*** SUMMARY ***
Total pot $0.02 | Rake $0 
Seat 1: naxal2012 (button) folded before Flop (didn't bet)
Seat 2: Khrenya (small blind) folded before Flop
Seat 3: igor6316 (big blind) collected ($0.02)
Seat 4: Dorex2007 folded before Flop (didn't bet)
Seat 5: Dorm619 folded before Flop (didn't bet)
Seat 6: bloody55hawk folded before Flop (didn't bet)
Seat 7: rose9918 folded before Flop (didn't bet)
Seat 8: mendel777 folded before Flop (didn't bet)



PokerStars Hand #228376964454:  Hold'em No Limit ($0.01/$0.02 USD) - 2021/07/18 2:12:20 PT [2021/07/18 5:12:20 ET]
Table 'Philia' 9-max Seat #2 is the button
Seat 1: naxal2012 ($3.34 in chips) 
Seat 2: Khrenya ($2.99 in chips) 
Seat 3: igor6316 ($0.81 in chips) 
Seat 4: Dorex2007 ($3.66 in chips) 
Seat 5: Dorm619 ($2.19 in chips) 
Seat 6: bloody55hawk ($0.80 in chips) 
Seat 7: rose9918 ($1.83 in chips) 
Seat 8: mendel777 ($1.68 in chips) 
igor6316: posts small blind $0.01
Dorex2007: posts big blind $0.02
dezname: sits out 
*** HOLE CARDS ***
Dealt to Dorex2007 [4s 8s]
Dorm619: folds 
bloody55hawk: folds 
rose9918 is disconnected 
rose9918 has timed out while disconnected
rose9918: folds 
mendel777: folds 
naxal2012: folds 
Khrenya: folds 
igor6316: calls $0.01
Dorex2007: checks 
*** FLOP *** [4d 6s Th]
igor6316: checks 
Dorex2007: bets $0.04
igor6316: folds 
Uncalled bet ($0.04) returned to Dorex2007
Dorex2007 collected $0.04 from pot
Dorex2007: doesn't show hand 
*** SUMMARY ***
Total pot $0.04 | Rake $0 
Board [4d 6s Th]
Seat 1: naxal2012 folded before Flop (didn't bet)
Seat 2: Khrenya (button) folded before Flop (didn't bet)
Seat 3: igor6316 (small blind) folded on the Flop
Seat 4: Dorex2007 (big blind) collected ($0.04)
Seat 5: Dorm619 folded before Flop (didn't bet)
Seat 6: bloody55hawk folded before Flop (didn't bet)
Seat 7: rose9918 folded before Flop (didn't bet)
Seat 8: mendel777 folded before Flop (didn't bet)



PokerStars Hand #228376973986:  Hold'em No Limit ($0.01/$0.02 USD) - 2021/07/18 2:13:08 PT [2021/07/18 5:13:08 ET]
Table 'Philia' 9-max Seat #3 is the button
Seat 1: naxal2012 ($3.34 in chips) 
Seat 2: Khrenya ($2.99 in chips) 
Seat 3: igor6316 ($0.79 in chips) 
Seat 4: Dorex2007 ($3.68 in chips) 
Seat 5: Dorm619 ($2.19 in chips) 
Seat 6: bloody55hawk ($0.80 in chips) 
Seat 8: mendel777 ($1.68 in chips) 
Dorex2007: posts small blind $0.01
Dorm619: posts big blind $0.02
dezname: sits out 
*** HOLE CARDS ***
Dealt to Dorex2007 [Ah 3s]
bloody55hawk: folds 
mendel777: raises $0.04 to $0.06
naxal2012: folds 
Khrenya: folds 
igor6316: folds 
Dorex2007: folds 
Dorm619: calls $0.04
*** FLOP *** [5h 8d 3h]
Dorm619: checks 
mendel777: bets $0.10
Dorm619: calls $0.10
*** TURN *** [5h 8d 3h] [As]
Dorm619: bets $0.21
mendel777: folds 
Uncalled bet ($0.21) returned to Dorm619
Dorm619 collected $0.32 from pot
Dorm619: doesn't show hand 
*** SUMMARY ***
Total pot $0.33 | Rake $0.01 
Board [5h 8d 3h As]
Seat 1: naxal2012 folded before Flop (didn't bet)
Seat 2: Khrenya folded before Flop (didn't bet)
Seat 3: igor6316 (button) folded before Flop (didn't bet)
Seat 4: Dorex2007 (small blind) folded before Flop
Seat 5: Dorm619 (big blind) collected ($0.32)
Seat 6: bloody55hawk folded before Flop (didn't bet)
Seat 8: mendel777 folded on the Turn



PokerStars Hand #228376985908:  Hold'em No Limit ($0.01/$0.02 USD) - 2021/07/18 2:14:09 PT [2021/07/18 5:14:09 ET]
Table 'Philia' 9-max Seat #4 is the button
Seat 1: naxal2012 ($3.34 in chips) 
Seat 2: Khrenya ($2.99 in chips) 
Seat 3: igor6316 ($0.79 in chips) 
Seat 4: Dorex2007 ($3.67 in chips) 
Seat 5: Dorm619 ($2.35 in chips) 
Seat 8: mendel777 ($1.60 in chips) 
Dorm619: posts small blind $0.01
bloody55hawk: is sitting out 
mendel777: posts big blind $0.02
dezname: sits out 
*** HOLE CARDS ***
Dealt to Dorex2007 [4d 5h]
naxal2012: folds 
Khrenya: folds 
igor6316: folds 
Dorex2007: folds 
Dorm619: calls $0.01
mendel777: raises $0.04 to $0.06
Dorm619: calls $0.04
*** FLOP *** [4s 8h 4h]
Dorm619: checks 
mendel777: bets $0.12
Dorm619: folds 
Uncalled bet ($0.12) returned to mendel777
mendel777 collected $0.12 from pot
mendel777: doesn't show hand 
*** SUMMARY ***
Total pot $0.12 | Rake $0 
Board [4s 8h 4h]
Seat 1: naxal2012 folded before Flop (didn't bet)
Seat 2: Khrenya folded before Flop (didn't bet)
Seat 3: igor6316 folded before Flop (didn't bet)
Seat 4: Dorex2007 (button) folded before Flop (didn't bet)
Seat 5: Dorm619 (small blind) folded on the Flop
Seat 8: mendel777 (big blind) collected ($0.12)



PokerStars Hand #228376992277:  Hold'em No Limit ($0.01/$0.02 USD) - 2021/07/18 2:14:41 PT [2021/07/18 5:14:41 ET]
Table 'Philia' 9-max Seat #5 is the button
Seat 1: naxal2012 ($3.34 in chips) 
Seat 2: Khrenya ($2.99 in chips) 
Seat 3: igor6316 ($0.79 in chips) 
Seat 4: Dorex2007 ($3.67 in chips) 
Seat 5: Dorm619 ($2.29 in chips) 
Seat 8: mendel777 ($1.66 in chips) 
Seat 9: dezname ($2 in chips) 
mendel777: posts small blind $0.01
dezname: posts big blind $0.02
*** HOLE CARDS ***
Dealt to Dorex2007 [2s 4s]
rose9918 leaves the table
naxal2012: raises $0.04 to $0.06
Khrenya: folds 
igor6316: folds 
Dorex2007: folds 
Dorm619: calls $0.06
mendel777: folds 
dezname: folds 
*** FLOP *** [Ad Qc 7h]
naxal2012: bets $0.07
Dorm619: calls $0.07
*** TURN *** [Ad Qc 7h] [8h]
naxal2012: checks 
Dorm619: bets $0.14
naxal2012: folds 
Uncalled bet ($0.14) returned to Dorm619
Dorm619 collected $0.28 from pot
Dorm619: doesn't show hand 
*** SUMMARY ***
Total pot $0.29 | Rake $0.01 
Board [Ad Qc 7h 8h]
Seat 1: naxal2012 folded on the Turn
Seat 2: Khrenya folded before Flop (didn't bet)
Seat 3: igor6316 folded before Flop (didn't bet)
Seat 4: Dorex2007 folded before Flop (didn't bet)
Seat 5: Dorm619 (button) collected ($0.28)
Seat 8: mendel777 (small blind) folded before Flop
Seat 9: dezname (big blind) folded before Flop



PokerStars Hand #228377001412:  Hold'em No Limit ($0.01/$0.02 USD) - 2021/07/18 2:15:26 PT [2021/07/18 5:15:26 ET]
Table 'Philia' 9-max Seat #8 is the button
Seat 1: naxal2012 ($3.21 in chips) 
Seat 2: Khrenya ($2.99 in chips) 
Seat 3: igor6316 ($0.79 in chips) 
Seat 4: Dorex2007 ($3.67 in chips) 
Seat 5: Dorm619 ($2.44 in chips) 
Seat 8: mendel777 ($1.65 in chips) 
Seat 9: dezname ($2 in chips) 
dezname: posts small blind $0.01
naxal2012: posts big blind $0.02
*** HOLE CARDS ***
Dealt to Dorex2007 [As 9d]
Khrenya: folds 
igor6316: folds 
Dorex2007: folds 
Dorm619: folds 
mendel777: folds 
dezname: folds 
Uncalled bet ($0.01) returned to naxal2012
naxal2012 collected $0.02 from pot
*** SUMMARY ***
Total pot $0.02 | Rake $0 
Seat 1: naxal2012 (big blind) collected ($0.02)
Seat 2: Khrenya folded before Flop (didn't bet)
Seat 3: igor6316 folded before Flop (didn't bet)
Seat 4: Dorex2007 folded before Flop (didn't bet)
Seat 5: Dorm619 folded before Flop (didn't bet)
Seat 8: mendel777 (button) folded before Flop (didn't bet)
Seat 9: dezname (small blind) folded before Flop



PokerStars Hand #228377003252:  Hold'em No Limit ($0.01/$0.02 USD) - 2021/07/18 2:15:36 PT [2021/07/18 5:15:36 ET]
Table 'Philia' 9-max Seat #9 is the button
Seat 1: naxal2012 ($3.22 in chips) 
Seat 2: Khrenya ($2.99 in chips) 
Seat 3: igor6316 ($0.79 in chips) 
Seat 4: Dorex2007 ($3.67 in chips) 
Seat 5: Dorm619 ($2.44 in chips) 
Seat 8: mendel777 ($1.65 in chips) 
Seat 9: dezname ($2 in chips) 
naxal2012: posts small blind $0.01
Khrenya: posts big blind $0.02
*** HOLE CARDS ***
Dealt to Dorex2007 [4s 8h]
igor6316: folds 
Dorex2007: folds 
Dorm619: folds 
mendel777: raises $0.04 to $0.06
dezname: folds 
naxal2012: folds 
Khrenya: calls $0.04
*** FLOP *** [7h Ts Qd]
Khrenya: checks 
mendel777: checks 
*** TURN *** [7h Ts Qd] [Jh]
Khrenya: checks 
mendel777: checks 
*** RIVER *** [7h Ts Qd Jh] [2c]
Khrenya: checks 
mendel777: checks 
*** SHOW DOWN ***
Khrenya: shows [8c 4c] (high card Queen)
mendel777: shows [8d 7d] (a pair of Sevens)
mendel777 collected $0.13 from pot
*** SUMMARY ***
Total pot $0.13 | Rake $0 
Board [7h Ts Qd Jh 2c]
Seat 1: naxal2012 (small blind) folded before Flop
Seat 2: Khrenya (big blind) showed [8c 4c] and lost with high card Queen
Seat 3: igor6316 folded before Flop (didn't bet)
Seat 4: Dorex2007 folded before Flop (didn't bet)
Seat 5: Dorm619 folded before Flop (didn't bet)
Seat 8: mendel777 showed [8d 7d] and won ($0.13) with a pair of Sevens
Seat 9: dezname (button) folded before Flop (didn't bet)



PokerStars Hand #228377011485:  Hold'em No Limit ($0.01/$0.02 USD) - 2021/07/18 2:16:17 PT [2021/07/18 5:16:17 ET]
Table 'Philia' 9-max Seat #1 is the button
Seat 1: naxal2012 ($3.21 in chips) 
Seat 2: Khrenya ($2.93 in chips) 
Seat 4: Dorex2007 ($3.67 in chips) 
Seat 5: Dorm619 ($2.44 in chips) 
Seat 8: mendel777 ($1.72 in chips) 
Seat 9: dezname ($2 in chips) 
Khrenya: posts small blind $0.01
igor6316: is sitting out 
Dorex2007: posts big blind $0.02
*** HOLE CARDS ***
Dealt to Dorex2007 [5d 4h]
igor6316 leaves the table
Dorm619: folds 
mendel777: folds 
dezname: folds 
naxal2012: folds 
Khrenya: calls $0.01
bloody55hawk leaves the table
Dorex2007: checks 
*** FLOP *** [Tc 9c 2d]
Khrenya: checks 
Dorex2007: checks 
*** TURN *** [Tc 9c 2d] [3h]
Khrenya: checks 
Dorex2007: checks 
*** RIVER *** [Tc 9c 2d 3h] [4d]
Khrenya: bets $0.04
Zhorik1990 joins the table at seat #6 
Dorex2007: folds 
Uncalled bet ($0.04) returned to Khrenya
Khrenya collected $0.04 from pot
Khrenya: doesn't show hand 
*** SUMMARY ***
Total pot $0.04 | Rake $0 
Board [Tc 9c 2d 3h 4d]
Seat 1: naxal2012 (button) folded before Flop (didn't bet)
Seat 2: Khrenya (small blind) collected ($0.04)
Seat 4: Dorex2007 (big blind) folded on the River
Seat 5: Dorm619 folded before Flop (didn't bet)
Seat 8: mendel777 folded before Flop (didn't bet)
Seat 9: dezname folded before Flop (didn't bet)



