PokerStars Hand #225355465025:  Hold'em No Limit ($0.01/$0.02 USD) - 2021/03/30 22:59:19 PT [2021/03/31 1:59:19 ET]
Table 'Janus VI' 9-max Seat #7 is the button
Seat 1: SylfredHuila ($0.61 in chips) 
Seat 2: TheoceanO ($3.02 in chips) 
Seat 3: Hejter1337 ($4.18 in chips) 
Seat 5: gnilpik ($0.76 in chips) 
Seat 7: elpaiva10 ($2.18 in chips) 
Seat 8: Player Him ($4.32 in chips) 
Seat 9: Dorex2007 ($1.50 in chips) 
Player Him: posts small blind $0.01
Dorex2007: posts big blind $0.02
*** HOLE CARDS ***
Dealt to Dorex2007 [Ah Js]
SylfredHuila: folds 
TheoceanO: folds 
Hejter1337: folds 
gnilpik: calls $0.02
SylfredHuila leaves the table
elpaiva10: folds 
Player Him: folds 
Dorex2007: checks 
*** FLOP *** [4s Qc Tc]
Dorex2007: checks 
gnilpik: checks 
*** TURN *** [4s Qc Tc] [Qd]
Dorex2007: checks 
gnilpik: bets $0.02
Dorex2007: calls $0.02
*** RIVER *** [4s Qc Tc Qd] [2h]
Dorex2007: checks 
gnilpik: bets $0.06
Dorex2007: folds 
Uncalled bet ($0.06) returned to gnilpik
gnilpik collected $0.09 from pot
gnilpik: doesn't show hand 
*** SUMMARY ***
Total pot $0.09 | Rake $0 
Board [4s Qc Tc Qd 2h]
Seat 1: SylfredHuila folded before Flop (didn't bet)
Seat 2: TheoceanO folded before Flop (didn't bet)
Seat 3: Hejter1337 folded before Flop (didn't bet)
Seat 5: gnilpik collected ($0.09)
Seat 7: elpaiva10 (button) folded before Flop (didn't bet)
Seat 8: Player Him (small blind) folded before Flop
Seat 9: Dorex2007 (big blind) folded on the River



PokerStars Hand #225355470858:  Hold'em No Limit ($0.01/$0.02 USD) - 2021/03/30 23:00:02 PT [2021/03/31 2:00:02 ET]
Table 'Janus VI' 9-max Seat #8 is the button
Seat 2: TheoceanO ($3.02 in chips) 
Seat 3: Hejter1337 ($4.18 in chips) 
Seat 5: gnilpik ($0.81 in chips) 
Seat 7: elpaiva10 ($2.18 in chips) 
Seat 8: Player Him ($4.31 in chips) 
Seat 9: Dorex2007 ($1.46 in chips) 
Dorex2007: posts small blind $0.01
TheoceanO: posts big blind $0.02
*** HOLE CARDS ***
Dealt to Dorex2007 [4c 9s]
Hejter1337: folds 
gnilpik: calls $0.02
elpaiva10: folds 
Player Him: folds 
Dorex2007: folds 
TheoceanO: checks 
*** FLOP *** [6c 2h As]
TheoceanO: checks 
gnilpik: checks 
*** TURN *** [6c 2h As] [Qd]
TheoceanO: bets $0.04
gnilpik: folds 
Uncalled bet ($0.04) returned to TheoceanO
TheoceanO collected $0.05 from pot
*** SUMMARY ***
Total pot $0.05 | Rake $0 
Board [6c 2h As Qd]
Seat 2: TheoceanO (big blind) collected ($0.05)
Seat 3: Hejter1337 folded before Flop (didn't bet)
Seat 5: gnilpik folded on the Turn
Seat 7: elpaiva10 folded before Flop (didn't bet)
Seat 8: Player Him (button) folded before Flop (didn't bet)
Seat 9: Dorex2007 (small blind) folded before Flop



PokerStars Hand #225355475072:  Hold'em No Limit ($0.01/$0.02 USD) - 2021/03/30 23:00:31 PT [2021/03/31 2:00:31 ET]
Table 'Janus VI' 9-max Seat #9 is the button
Seat 2: TheoceanO ($3.05 in chips) 
Seat 3: Hejter1337 ($4.18 in chips) 
Seat 5: gnilpik ($0.79 in chips) 
Seat 7: elpaiva10 ($2.18 in chips) 
Seat 8: Player Him ($4.31 in chips) 
Seat 9: Dorex2007 ($1.99 in chips) 
TheoceanO: posts small blind $0.01
Hejter1337: posts big blind $0.02
*** HOLE CARDS ***
Dealt to Dorex2007 [3c 7h]
gnilpik: folds 
gnilpik leaves the table
elpaiva10: folds 
Player Him: folds 
Dorex2007: folds 
TheoceanO: folds 
Uncalled bet ($0.01) returned to Hejter1337
Hejter1337 collected $0.02 from pot
Hejter1337: doesn't show hand 
*** SUMMARY ***
Total pot $0.02 | Rake $0 
Seat 2: TheoceanO (small blind) folded before Flop
Seat 3: Hejter1337 (big blind) collected ($0.02)
Seat 5: gnilpik folded before Flop (didn't bet)
Seat 7: elpaiva10 folded before Flop (didn't bet)
Seat 8: Player Him folded before Flop (didn't bet)
Seat 9: Dorex2007 (button) folded before Flop (didn't bet)



PokerStars Hand #225355476903:  Hold'em No Limit ($0.01/$0.02 USD) - 2021/03/30 23:00:44 PT [2021/03/31 2:00:44 ET]
Table 'Janus VI' 9-max Seat #2 is the button
Seat 2: TheoceanO ($3.04 in chips) 
Seat 3: Hejter1337 ($4.19 in chips) 
Seat 7: elpaiva10 ($2.18 in chips) 
Seat 8: Player Him ($4.31 in chips) 
Seat 9: Dorex2007 ($1.99 in chips) 
Hejter1337: posts small blind $0.01
elpaiva10: posts big blind $0.02
*** HOLE CARDS ***
Dealt to Dorex2007 [8d Th]
Player Him: folds 
Dorex2007: folds 
TheoceanO: folds 
Hejter1337: raises $0.02 to $0.04
elpaiva10: calls $0.02
*** FLOP *** [6h 9h 2d]
Hejter1337: bets $0.04
elpaiva10: calls $0.04
*** TURN *** [6h 9h 2d] [5d]
Hejter1337: bets $0.08
elpaiva10: folds 
Uncalled bet ($0.08) returned to Hejter1337
Hejter1337 collected $0.15 from pot
Hejter1337: doesn't show hand 
*** SUMMARY ***
Total pot $0.16 | Rake $0.01 
Board [6h 9h 2d 5d]
Seat 2: TheoceanO (button) folded before Flop (didn't bet)
Seat 3: Hejter1337 (small blind) collected ($0.15)
Seat 7: elpaiva10 (big blind) folded on the Turn
Seat 8: Player Him folded before Flop (didn't bet)
Seat 9: Dorex2007 folded before Flop (didn't bet)



PokerStars Hand #225355482922:  Hold'em No Limit ($0.01/$0.02 USD) - 2021/03/30 23:01:23 PT [2021/03/31 2:01:23 ET]
Table 'Janus VI' 9-max Seat #3 is the button
Seat 2: TheoceanO ($3.04 in chips) 
Seat 3: Hejter1337 ($4.26 in chips) 
Seat 7: elpaiva10 ($2.10 in chips) 
Seat 8: Player Him ($4.31 in chips) 
Seat 9: Dorex2007 ($1.99 in chips) 
elpaiva10: posts small blind $0.01
Player Him: posts big blind $0.02
*** HOLE CARDS ***
Dealt to Dorex2007 [4s 7c]
Dorex2007: raises $0.02 to $0.04
TheoceanO: folds 
Hejter1337: folds 
elpaiva10: folds 
Player Him: folds 
Uncalled bet ($0.02) returned to Dorex2007
Dorex2007 collected $0.05 from pot
Dorex2007: doesn't show hand 
*** SUMMARY ***
Total pot $0.05 | Rake $0 
Seat 2: TheoceanO folded before Flop (didn't bet)
Seat 3: Hejter1337 (button) folded before Flop (didn't bet)
Seat 7: elpaiva10 (small blind) folded before Flop
Seat 8: Player Him (big blind) folded before Flop
Seat 9: Dorex2007 collected ($0.05)



PokerStars Hand #225355485937:  Hold'em No Limit ($0.01/$0.02 USD) - 2021/03/30 23:01:42 PT [2021/03/31 2:01:42 ET]
Table 'Janus VI' 9-max Seat #7 is the button
Seat 2: TheoceanO ($3.04 in chips) 
Seat 3: Hejter1337 ($4.26 in chips) 
Seat 7: elpaiva10 ($2.09 in chips) 
Seat 8: Player Him ($4.29 in chips) 
Seat 9: Dorex2007 ($2.02 in chips) 
Player Him: posts small blind $0.01
Dorex2007: posts big blind $0.02
*** HOLE CARDS ***
Dealt to Dorex2007 [Qh Js]
TheoceanO: folds 
Hejter1337: folds 
elpaiva10: folds 
Player Him: folds 
Uncalled bet ($0.01) returned to Dorex2007
Dorex2007 collected $0.02 from pot
Dorex2007: doesn't show hand 
*** SUMMARY ***
Total pot $0.02 | Rake $0 
Seat 2: TheoceanO folded before Flop (didn't bet)
Seat 3: Hejter1337 folded before Flop (didn't bet)
Seat 7: elpaiva10 (button) folded before Flop (didn't bet)
Seat 8: Player Him (small blind) folded before Flop
Seat 9: Dorex2007 (big blind) collected ($0.02)



