PokerStars Hand #224825385214:  Hold'em No Limit ($0.01/$0.02 USD) - 2021/03/14 21:22:37 PT [2021/03/15 0:22:37 ET]
Table 'Piccolo IV' 9-max Seat #4 is the button
Seat 1: robot 27 ($2.91 in chips) 
Seat 2: Wayniak187 ($1.52 in chips) 
Seat 3: Fatalimerrr ($4.29 in chips) 
Seat 4: AngryRaises ($0.89 in chips) 
Seat 5: bluffbobby ($2.33 in chips) 
Seat 6: Dorex2007 ($1.50 in chips) 
Seat 7: fld11 ($0.69 in chips) 
Seat 8: KaraFara ($4.96 in chips) 
Seat 9: Guilhermanoo ($0.58 in chips) 
bluffbobby: posts small blind $0.01
Dorex2007: posts big blind $0.02
*** HOLE CARDS ***
Dealt to Dorex2007 [Jd 6c]
fld11: folds 
KaraFara: folds 
Guilhermanoo: folds 
robot 27: raises $0.05 to $0.07
Wayniak187: folds 
Fatalimerrr: folds 
AngryRaises: folds 
bluffbobby: folds 
Dorex2007: folds 
Uncalled bet ($0.05) returned to robot 27
robot 27 collected $0.05 from pot
robot 27: doesn't show hand 
*** SUMMARY ***
Total pot $0.05 | Rake $0 
Seat 1: robot 27 collected ($0.05)
Seat 2: Wayniak187 folded before Flop (didn't bet)
Seat 3: Fatalimerrr folded before Flop (didn't bet)
Seat 4: AngryRaises (button) folded before Flop (didn't bet)
Seat 5: bluffbobby (small blind) folded before Flop
Seat 6: Dorex2007 (big blind) folded before Flop
Seat 7: fld11 folded before Flop (didn't bet)
Seat 8: KaraFara folded before Flop (didn't bet)
Seat 9: Guilhermanoo folded before Flop (didn't bet)



PokerStars Hand #224825388148:  Hold'em No Limit ($0.01/$0.02 USD) - 2021/03/14 21:22:54 PT [2021/03/15 0:22:54 ET]
Table 'Piccolo IV' 9-max Seat #5 is the button
Seat 1: robot 27 ($2.94 in chips) 
Seat 2: Wayniak187 ($1.52 in chips) 
Seat 3: Fatalimerrr ($4.29 in chips) 
Seat 4: AngryRaises ($0.89 in chips) 
Seat 5: bluffbobby ($2.32 in chips) 
Seat 6: Dorex2007 ($1.48 in chips) 
Seat 7: fld11 ($0.69 in chips) 
Seat 8: KaraFara ($4.96 in chips) 
Seat 9: Guilhermanoo ($0.58 in chips) 
Dorex2007: posts small blind $0.01
fld11: posts big blind $0.02
*** HOLE CARDS ***
Dealt to Dorex2007 [Tc Jc]
KaraFara: folds 
Guilhermanoo: folds 
robot 27: folds 
Wayniak187 has timed out
Wayniak187: folds 
Fatalimerrr: folds 
AngryRaises: folds 
bluffbobby: raises $0.04 to $0.06
Dorex2007: folds 
fld11: folds 
Uncalled bet ($0.04) returned to bluffbobby
bluffbobby collected $0.05 from pot
bluffbobby: doesn't show hand 
*** SUMMARY ***
Total pot $0.05 | Rake $0 
Seat 1: robot 27 folded before Flop (didn't bet)
Seat 2: Wayniak187 folded before Flop (didn't bet)
Seat 3: Fatalimerrr folded before Flop (didn't bet)
Seat 4: AngryRaises folded before Flop (didn't bet)
Seat 5: bluffbobby (button) collected ($0.05)
Seat 6: Dorex2007 (small blind) folded before Flop
Seat 7: fld11 (big blind) folded before Flop
Seat 8: KaraFara folded before Flop (didn't bet)
Seat 9: Guilhermanoo folded before Flop (didn't bet)



PokerStars Hand #224825394572:  Hold'em No Limit ($0.01/$0.02 USD) - 2021/03/14 21:23:29 PT [2021/03/15 0:23:29 ET]
Table 'Piccolo IV' 9-max Seat #6 is the button
Seat 1: robot 27 ($2.94 in chips) 
Seat 3: Fatalimerrr ($4.29 in chips) 
Seat 4: AngryRaises ($0.89 in chips) 
Seat 5: bluffbobby ($2.35 in chips) 
Seat 6: Dorex2007 ($1.47 in chips) 
Seat 7: fld11 ($0.67 in chips) 
Seat 8: KaraFara ($4.96 in chips) 
Seat 9: Guilhermanoo ($0.58 in chips) 
fld11: posts small blind $0.01
KaraFara: posts big blind $0.02
*** HOLE CARDS ***
Dealt to Dorex2007 [8h 5c]
Guilhermanoo: folds 
robot 27: folds 
Fatalimerrr: raises $0.04 to $0.06
AngryRaises: folds 
bluffbobby: folds 
Dorex2007: folds 
fld11: calls $0.05
KaraFara: folds 
*** FLOP *** [Ks 2c Ts]
fld11: checks 
Fatalimerrr: bets $0.11
fld11: calls $0.11
*** TURN *** [Ks 2c Ts] [3h]
fld11: checks 
Fatalimerrr: bets $0.26
fld11: folds 
Uncalled bet ($0.26) returned to Fatalimerrr
Fatalimerrr collected $0.35 from pot
Fatalimerrr: doesn't show hand 
*** SUMMARY ***
Total pot $0.36 | Rake $0.01 
Board [Ks 2c Ts 3h]
Seat 1: robot 27 folded before Flop (didn't bet)
Seat 3: Fatalimerrr collected ($0.35)
Seat 4: AngryRaises folded before Flop (didn't bet)
Seat 5: bluffbobby folded before Flop (didn't bet)
Seat 6: Dorex2007 (button) folded before Flop (didn't bet)
Seat 7: fld11 (small blind) folded on the Turn
Seat 8: KaraFara (big blind) folded before Flop
Seat 9: Guilhermanoo folded before Flop (didn't bet)



PokerStars Hand #224825401289:  Hold'em No Limit ($0.01/$0.02 USD) - 2021/03/14 21:24:07 PT [2021/03/15 0:24:07 ET]
Table 'Piccolo IV' 9-max Seat #7 is the button
Seat 1: robot 27 ($2.94 in chips) 
Seat 3: Fatalimerrr ($4.47 in chips) 
Seat 4: AngryRaises ($0.89 in chips) 
Seat 5: bluffbobby ($2.35 in chips) 
Seat 6: Dorex2007 ($1.47 in chips) 
Seat 7: fld11 ($0.50 in chips) 
Seat 8: KaraFara ($4.94 in chips) 
Seat 9: Guilhermanoo ($0.58 in chips) 
KaraFara: posts small blind $0.01
Guilhermanoo: posts big blind $0.02
*** HOLE CARDS ***
Dealt to Dorex2007 [3h Jd]
robot 27: raises $0.02 to $0.04
Fatalimerrr: raises $0.08 to $0.12
AngryRaises: calls $0.12
bluffbobby: folds 
Dorex2007: folds 
fld11: calls $0.12
KaraFara: folds 
Guilhermanoo: folds 
robot 27: folds 
*** FLOP *** [8h 7c 5h]
Fatalimerrr: bets $0.14
AngryRaises: folds 
fld11: raises $0.24 to $0.38 and is all-in
Fatalimerrr: calls $0.24
*** TURN *** [8h 7c 5h] [As]
*** RIVER *** [8h 7c 5h As] [2d]
*** SHOW DOWN ***
Fatalimerrr: shows [Jh Kh] (high card Ace)
fld11: shows [9h 9s] (a pair of Nines)
fld11 collected $1.15 from pot
*** SUMMARY ***
Total pot $1.19 | Rake $0.04 
Board [8h 7c 5h As 2d]
Seat 1: robot 27 folded before Flop
Seat 3: Fatalimerrr showed [Jh Kh] and lost with high card Ace
Seat 4: AngryRaises folded on the Flop
Seat 5: bluffbobby folded before Flop (didn't bet)
Seat 6: Dorex2007 folded before Flop (didn't bet)
Seat 7: fld11 (button) showed [9h 9s] and won ($1.15) with a pair of Nines
Seat 8: KaraFara (small blind) folded before Flop
Seat 9: Guilhermanoo (big blind) folded before Flop



PokerStars Hand #224825415240:  Hold'em No Limit ($0.01/$0.02 USD) - 2021/03/14 21:24:49 PT [2021/03/15 0:24:49 ET]
Table 'Piccolo IV' 9-max Seat #8 is the button
Seat 1: robot 27 ($2.90 in chips) 
Seat 3: Fatalimerrr ($3.97 in chips) 
Seat 4: AngryRaises ($0.77 in chips) 
Seat 5: bluffbobby ($2.35 in chips) 
Seat 6: Dorex2007 ($1.47 in chips) 
Seat 7: fld11 ($1.15 in chips) 
Seat 8: KaraFara ($4.93 in chips) 
Seat 9: Guilhermanoo ($0.56 in chips) 
Guilhermanoo: posts small blind $0.01
robot 27: posts big blind $0.02
*** HOLE CARDS ***
Dealt to Dorex2007 [3d Jc]
Fatalimerrr: folds 
AngryRaises: folds 
bluffbobby: raises $0.06 to $0.08
Dorex2007: folds 
fld11: folds 
KaraFara: folds 
Guilhermanoo: folds 
robot 27: calls $0.06
*** FLOP *** [9s Jd Js]
robot 27: bets $0.16
bluffbobby: folds 
Uncalled bet ($0.16) returned to robot 27
robot 27 collected $0.16 from pot
robot 27: doesn't show hand 
*** SUMMARY ***
Total pot $0.17 | Rake $0.01 
Board [9s Jd Js]
Seat 1: robot 27 (big blind) collected ($0.16)
Seat 3: Fatalimerrr folded before Flop (didn't bet)
Seat 4: AngryRaises folded before Flop (didn't bet)
Seat 5: bluffbobby folded on the Flop
Seat 6: Dorex2007 folded before Flop (didn't bet)
Seat 7: fld11 folded before Flop (didn't bet)
Seat 8: KaraFara (button) folded before Flop (didn't bet)
Seat 9: Guilhermanoo (small blind) folded before Flop



PokerStars Hand #224825424072:  Hold'em No Limit ($0.01/$0.02 USD) - 2021/03/14 21:25:39 PT [2021/03/15 0:25:39 ET]
Table 'Piccolo IV' 9-max Seat #9 is the button
Seat 1: robot 27 ($2.98 in chips) 
Seat 2: Wayniak187 ($1.52 in chips) 
Seat 3: Fatalimerrr ($3.97 in chips) 
Seat 4: AngryRaises ($0.77 in chips) 
Seat 5: bluffbobby ($2.27 in chips) 
Seat 6: Dorex2007 ($1.47 in chips) 
Seat 7: fld11 ($1.15 in chips) 
Seat 8: KaraFara ($4.93 in chips) 
Seat 9: Guilhermanoo ($0.55 in chips) 
robot 27: posts small blind $0.01
Wayniak187: posts big blind $0.02
*** HOLE CARDS ***
Dealt to Dorex2007 [Jc Ac]
Fatalimerrr: folds 
AngryRaises: raises $0.05 to $0.07
bluffbobby: raises $0.17 to $0.24
Dorex2007: folds 
fld11: folds 
KaraFara: folds 
Guilhermanoo: folds 
robot 27: folds 
Wayniak187: folds 
AngryRaises: calls $0.17
*** FLOP *** [Qh 6h 2d]
AngryRaises: checks 
bluffbobby: bets $0.56
AngryRaises: calls $0.53 and is all-in
Uncalled bet ($0.03) returned to bluffbobby
*** TURN *** [Qh 6h 2d] [4d]
*** RIVER *** [Qh 6h 2d 4d] [2s]
*** SHOW DOWN ***
AngryRaises: shows [Kd Ad] (a pair of Deuces)
bluffbobby: shows [Jh As] (a pair of Deuces - lower kicker)
AngryRaises cashed out the hand for $1.26 | Cash Out Fee $0.01
*** SUMMARY ***
Total pot $1.57 | Rake $0.05 
Board [Qh 6h 2d 4d 2s]
Seat 1: robot 27 (small blind) folded before Flop
Seat 2: Wayniak187 (big blind) folded before Flop
Seat 3: Fatalimerrr folded before Flop (didn't bet)
Seat 4: AngryRaises showed [Kd Ad] and won ($1.52) with a pair of Deuces (pot not awarded as player cashed out)
Seat 5: bluffbobby showed [Jh As] and lost with a pair of Deuces
Seat 6: Dorex2007 folded before Flop (didn't bet)
Seat 7: fld11 folded before Flop (didn't bet)
Seat 8: KaraFara folded before Flop (didn't bet)
Seat 9: Guilhermanoo (button) folded before Flop (didn't bet)



PokerStars Hand #224825431976:  Hold'em No Limit ($0.01/$0.02 USD) - 2021/03/14 21:26:25 PT [2021/03/15 0:26:25 ET]
Table 'Piccolo IV' 9-max Seat #1 is the button
Seat 1: robot 27 ($2.97 in chips) 
Seat 2: Wayniak187 ($1.50 in chips) 
Seat 3: Fatalimerrr ($3.97 in chips) 
Seat 4: AngryRaises ($1.26 in chips) 
Seat 5: bluffbobby ($1.50 in chips) 
Seat 6: Dorex2007 ($1.47 in chips) 
Seat 7: fld11 ($1.15 in chips) 
Seat 8: KaraFara ($4.93 in chips) 
Seat 9: Guilhermanoo ($0.55 in chips) 
Wayniak187: posts small blind $0.01
Fatalimerrr: posts big blind $0.02
*** HOLE CARDS ***
Dealt to Dorex2007 [Js Qc]
AngryRaises: folds 
bluffbobby: folds 
Dorex2007: folds 
fld11: folds 
KaraFara: folds 
Guilhermanoo: calls $0.02
robot 27: folds 
Wayniak187: calls $0.01
Fatalimerrr: checks 
*** FLOP *** [8c 4c 3s]
Wayniak187: checks 
Fatalimerrr: checks 
Guilhermanoo: bets $0.04
Wayniak187: folds 
Fatalimerrr: folds 
Uncalled bet ($0.04) returned to Guilhermanoo
Guilhermanoo collected $0.06 from pot
Guilhermanoo: doesn't show hand 
*** SUMMARY ***
Total pot $0.06 | Rake $0 
Board [8c 4c 3s]
Seat 1: robot 27 (button) folded before Flop (didn't bet)
Seat 2: Wayniak187 (small blind) folded on the Flop
Seat 3: Fatalimerrr (big blind) folded on the Flop
Seat 4: AngryRaises folded before Flop (didn't bet)
Seat 5: bluffbobby folded before Flop (didn't bet)
Seat 6: Dorex2007 folded before Flop (didn't bet)
Seat 7: fld11 folded before Flop (didn't bet)
Seat 8: KaraFara folded before Flop (didn't bet)
Seat 9: Guilhermanoo collected ($0.06)



PokerStars Hand #224825440257:  Hold'em No Limit ($0.01/$0.02 USD) - 2021/03/14 21:27:12 PT [2021/03/15 0:27:12 ET]
Table 'Piccolo IV' 9-max Seat #2 is the button
Seat 1: robot 27 ($2.97 in chips) 
Seat 2: Wayniak187 ($1.48 in chips) 
Seat 3: Fatalimerrr ($3.95 in chips) 
Seat 4: AngryRaises ($1.26 in chips) 
Seat 5: bluffbobby ($1.50 in chips) 
Seat 6: Dorex2007 ($1.47 in chips) 
Seat 7: fld11 ($1.15 in chips) 
Seat 8: KaraFara ($4.93 in chips) 
Seat 9: Guilhermanoo ($0.59 in chips) 
Fatalimerrr: posts small blind $0.01
AngryRaises: posts big blind $0.02
*** HOLE CARDS ***
Dealt to Dorex2007 [3c 3h]
bluffbobby: folds 
Dorex2007: folds 
fld11: folds 
KaraFara: folds 
Guilhermanoo: raises $0.04 to $0.06
robot 27: calls $0.06
Wayniak187: folds 
Fatalimerrr: folds 
AngryRaises: folds 
*** FLOP *** [Ks 6h Th]
Guilhermanoo: checks 
robot 27: checks 
*** TURN *** [Ks 6h Th] [2s]
Guilhermanoo: checks 
robot 27: bets $0.07
Guilhermanoo: calls $0.07
*** RIVER *** [Ks 6h Th 2s] [Kd]
Guilhermanoo: checks 
robot 27: checks 
*** SHOW DOWN ***
Guilhermanoo: shows [Tc Td] (a full house, Tens full of Kings)
robot 27: mucks hand 
Guilhermanoo collected $0.28 from pot
*** SUMMARY ***
Total pot $0.29 | Rake $0.01 
Board [Ks 6h Th 2s Kd]
Seat 1: robot 27 mucked [Qs As]
Seat 2: Wayniak187 (button) folded before Flop (didn't bet)
Seat 3: Fatalimerrr (small blind) folded before Flop
Seat 4: AngryRaises (big blind) folded before Flop
Seat 5: bluffbobby folded before Flop (didn't bet)
Seat 6: Dorex2007 folded before Flop (didn't bet)
Seat 7: fld11 folded before Flop (didn't bet)
Seat 8: KaraFara folded before Flop (didn't bet)
Seat 9: Guilhermanoo showed [Tc Td] and won ($0.28) with a full house, Tens full of Kings



PokerStars Hand #224825452357:  Hold'em No Limit ($0.01/$0.02 USD) - 2021/03/14 21:28:23 PT [2021/03/15 0:28:23 ET]
Table 'Piccolo IV' 9-max Seat #3 is the button
Seat 1: robot 27 ($2.84 in chips) 
Seat 2: Wayniak187 ($1.48 in chips) 
Seat 3: Fatalimerrr ($3.94 in chips) 
Seat 4: AngryRaises ($1.24 in chips) 
Seat 5: bluffbobby ($1.50 in chips) 
Seat 6: Dorex2007 ($1.47 in chips) 
Seat 7: fld11 ($1.15 in chips) 
Seat 8: KaraFara ($4.93 in chips) 
Seat 9: Guilhermanoo ($0.74 in chips) 
AngryRaises: posts small blind $0.01
bluffbobby: posts big blind $0.02
*** HOLE CARDS ***
Dealt to Dorex2007 [3h 9s]
Dorex2007: folds 
fld11: folds 
KaraFara: calls $0.02
Guilhermanoo: folds 
robot 27: folds 
Guilhermanoo leaves the table
Wayniak187 has timed out
Wayniak187: folds 
Fatalimerrr: folds 
AngryRaises: calls $0.01
bluffbobby: checks 
*** FLOP *** [3c Jh 4s]
AngryRaises: bets $0.04
bluffbobby: folds 
KaraFara: calls $0.04
*** TURN *** [3c Jh 4s] [Qc]
AngryRaises: bets $0.06
KaraFara: folds 
Uncalled bet ($0.06) returned to AngryRaises
AngryRaises collected $0.14 from pot
AngryRaises: doesn't show hand 
*** SUMMARY ***
Total pot $0.14 | Rake $0 
Board [3c Jh 4s Qc]
Seat 1: robot 27 folded before Flop (didn't bet)
Seat 2: Wayniak187 folded before Flop (didn't bet)
Seat 3: Fatalimerrr (button) folded before Flop (didn't bet)
Seat 4: AngryRaises (small blind) collected ($0.14)
Seat 5: bluffbobby (big blind) folded on the Flop
Seat 6: Dorex2007 folded before Flop (didn't bet)
Seat 7: fld11 folded before Flop (didn't bet)
Seat 8: KaraFara folded on the Turn
Seat 9: Guilhermanoo folded before Flop (didn't bet)



PokerStars Hand #224825460303:  Hold'em No Limit ($0.01/$0.02 USD) - 2021/03/14 21:29:09 PT [2021/03/15 0:29:09 ET]
Table 'Piccolo IV' 9-max Seat #4 is the button
Seat 1: robot 27 ($2.84 in chips) 
Seat 2: Wayniak187 ($1.48 in chips) 
Seat 3: Fatalimerrr ($3.94 in chips) 
Seat 4: AngryRaises ($1.32 in chips) 
Seat 5: bluffbobby ($1.48 in chips) 
Seat 6: Dorex2007 ($1.47 in chips) 
Seat 7: fld11 ($1.15 in chips) 
Seat 8: KaraFara ($4.87 in chips) 
bluffbobby: posts small blind $0.01
Dorex2007: posts big blind $0.02
*** HOLE CARDS ***
Dealt to Dorex2007 [9c Qd]
fld11: folds 
KaraFara: calls $0.02
robot 27: folds 
Fedya465 joins the table at seat #9 
Wayniak187: folds 
Fatalimerrr: folds 
AngryRaises: folds 
bluffbobby: calls $0.01
Dorex2007: checks 
*** FLOP *** [3c 2c Qs]
bluffbobby: checks 
Dorex2007: bets $0.06
KaraFara: calls $0.06
bluffbobby: folds 
*** TURN *** [3c 2c Qs] [4s]
Dorex2007: bets $0.09
KaraFara: folds 
Uncalled bet ($0.09) returned to Dorex2007
Dorex2007 collected $0.17 from pot
Dorex2007: doesn't show hand 
*** SUMMARY ***
Total pot $0.18 | Rake $0.01 
Board [3c 2c Qs 4s]
Seat 1: robot 27 folded before Flop (didn't bet)
Seat 2: Wayniak187 folded before Flop (didn't bet)
Seat 3: Fatalimerrr folded before Flop (didn't bet)
Seat 4: AngryRaises (button) folded before Flop (didn't bet)
Seat 5: bluffbobby (small blind) folded on the Flop
Seat 6: Dorex2007 (big blind) collected ($0.17)
Seat 7: fld11 folded before Flop (didn't bet)
Seat 8: KaraFara folded on the Turn



PokerStars Hand #224825467997:  Hold'em No Limit ($0.01/$0.02 USD) - 2021/03/14 21:29:54 PT [2021/03/15 0:29:54 ET]
Table 'Piccolo IV' 9-max Seat #5 is the button
Seat 1: robot 27 ($2.84 in chips) 
Seat 2: Wayniak187 ($1.48 in chips) 
Seat 3: Fatalimerrr ($3.94 in chips) 
Seat 4: AngryRaises ($1.32 in chips) 
Seat 5: bluffbobby ($1.46 in chips) 
Seat 6: Dorex2007 ($1.56 in chips) 
Seat 8: KaraFara ($4.79 in chips) 
Dorex2007: posts small blind $0.01
fld11: is sitting out 
KaraFara: posts big blind $0.02
Fedya465: sits out 
*** HOLE CARDS ***
Dealt to Dorex2007 [Ad 4d]
fld11 leaves the table
robot 27: folds 
Wayniak187: raises $0.02 to $0.04
Fatalimerrr: folds 
AngryRaises: folds 
bluffbobby: folds 
Dorex2007: calls $0.03
KaraFara: folds 
*** FLOP *** [2h 6d As]
Dorex2007: bets $0.07
Wayniak187: folds 
Uncalled bet ($0.07) returned to Dorex2007
Dorex2007 collected $0.10 from pot
Dorex2007: doesn't show hand 
*** SUMMARY ***
Total pot $0.10 | Rake $0 
Board [2h 6d As]
Seat 1: robot 27 folded before Flop (didn't bet)
Seat 2: Wayniak187 folded on the Flop
Seat 3: Fatalimerrr folded before Flop (didn't bet)
Seat 4: AngryRaises folded before Flop (didn't bet)
Seat 5: bluffbobby (button) folded before Flop (didn't bet)
Seat 6: Dorex2007 (small blind) collected ($0.10)
Seat 8: KaraFara (big blind) folded before Flop



PokerStars Hand #224825475561:  Hold'em No Limit ($0.01/$0.02 USD) - 2021/03/14 21:30:38 PT [2021/03/15 0:30:38 ET]
Table 'Piccolo IV' 9-max Seat #6 is the button
Seat 1: robot 27 ($2.84 in chips) 
Seat 2: Wayniak187 ($1.44 in chips) 
Seat 3: Fatalimerrr ($3.94 in chips) 
Seat 4: AngryRaises ($1.32 in chips) 
Seat 5: bluffbobby ($1.46 in chips) 
Seat 6: Dorex2007 ($1.62 in chips) 
Seat 8: KaraFara ($4.77 in chips) 
Seat 9: Fedya465 ($2 in chips) 
KaraFara: posts small blind $0.01
Fedya465: posts big blind $0.02
*** HOLE CARDS ***
Dealt to Dorex2007 [7h 2d]
robot 27: folds 
Wayniak187 has timed out
Wayniak187: folds 
Fatalimerrr: folds 
AngryRaises: folds 
bluffbobby: folds 
Dorex2007: folds 
KaraFara: raises $0.02 to $0.04
Fedya465: folds 
Uncalled bet ($0.02) returned to KaraFara
KaraFara collected $0.04 from pot
KaraFara: doesn't show hand 
wcrudjr joins the table at seat #7 
*** SUMMARY ***
Total pot $0.04 | Rake $0 
Seat 1: robot 27 folded before Flop (didn't bet)
Seat 2: Wayniak187 folded before Flop (didn't bet)
Seat 3: Fatalimerrr folded before Flop (didn't bet)
Seat 4: AngryRaises folded before Flop (didn't bet)
Seat 5: bluffbobby folded before Flop (didn't bet)
Seat 6: Dorex2007 (button) folded before Flop (didn't bet)
Seat 8: KaraFara (small blind) collected ($0.04)
Seat 9: Fedya465 (big blind) folded before Flop



PokerStars Hand #224825481052:  Hold'em No Limit ($0.01/$0.02 USD) - 2021/03/14 21:31:10 PT [2021/03/15 0:31:10 ET]
Table 'Piccolo IV' 9-max Seat #8 is the button
Seat 1: robot 27 ($2.84 in chips) 
Seat 2: Wayniak187 ($1.44 in chips) 
Seat 3: Fatalimerrr ($3.94 in chips) 
Seat 4: AngryRaises ($1.32 in chips) 
Seat 5: bluffbobby ($1.46 in chips) 
Seat 6: Dorex2007 ($1.62 in chips) 
Seat 8: KaraFara ($4.79 in chips) 
Seat 9: Fedya465 ($1.98 in chips) 
Fedya465: posts small blind $0.01
robot 27: posts big blind $0.02
wcrudjr: sits out 
*** HOLE CARDS ***
Dealt to Dorex2007 [6h Ks]
Wayniak187 has timed out
Wayniak187: folds 
Fatalimerrr: raises $0.04 to $0.06
AngryRaises: folds 
bluffbobby: folds 
Dorex2007: folds 
KaraFara: folds 
Fedya465: folds 
robot 27: folds 
Uncalled bet ($0.04) returned to Fatalimerrr
Fatalimerrr collected $0.05 from pot
Fatalimerrr: doesn't show hand 
*** SUMMARY ***
Total pot $0.05 | Rake $0 
Seat 1: robot 27 (big blind) folded before Flop
Seat 2: Wayniak187 folded before Flop (didn't bet)
Seat 3: Fatalimerrr collected ($0.05)
Seat 4: AngryRaises folded before Flop (didn't bet)
Seat 5: bluffbobby folded before Flop (didn't bet)
Seat 6: Dorex2007 folded before Flop (didn't bet)
Seat 8: KaraFara (button) folded before Flop (didn't bet)
Seat 9: Fedya465 (small blind) folded before Flop



PokerStars Hand #224825487580:  Hold'em No Limit ($0.01/$0.02 USD) - 2021/03/14 21:31:48 PT [2021/03/15 0:31:48 ET]
Table 'Piccolo IV' 9-max Seat #9 is the button
Seat 1: robot 27 ($2.82 in chips) 
Seat 2: Wayniak187 ($1.44 in chips) 
Seat 3: Fatalimerrr ($3.97 in chips) 
Seat 4: AngryRaises ($1.32 in chips) 
Seat 5: bluffbobby ($1.46 in chips) 
Seat 6: Dorex2007 ($1.62 in chips) 
Seat 8: KaraFara ($4.79 in chips) 
Seat 9: Fedya465 ($1.97 in chips) 
robot 27: posts small blind $0.01
Wayniak187: posts big blind $0.02
wcrudjr: sits out 
*** HOLE CARDS ***
Dealt to Dorex2007 [3s 4d]
Fatalimerrr: folds 
AngryRaises: calls $0.02
bluffbobby: folds 
Dorex2007: folds 
KaraFara: raises $0.02 to $0.04
Fedya465: calls $0.04
robot 27: folds 
Wayniak187: folds 
AngryRaises: calls $0.02
*** FLOP *** [8d 3c Qh]
AngryRaises: checks 
KaraFara: bets $0.08
Fedya465: folds 
AngryRaises: folds 
Uncalled bet ($0.08) returned to KaraFara
KaraFara collected $0.14 from pot
KaraFara: doesn't show hand 
*** SUMMARY ***
Total pot $0.15 | Rake $0.01 
Board [8d 3c Qh]
Seat 1: robot 27 (small blind) folded before Flop
Seat 2: Wayniak187 (big blind) folded before Flop
Seat 3: Fatalimerrr folded before Flop (didn't bet)
Seat 4: AngryRaises folded on the Flop
Seat 5: bluffbobby folded before Flop (didn't bet)
Seat 6: Dorex2007 folded before Flop (didn't bet)
Seat 8: KaraFara collected ($0.14)
Seat 9: Fedya465 (button) folded on the Flop



PokerStars Hand #224825494513:  Hold'em No Limit ($0.01/$0.02 USD) - 2021/03/14 21:32:28 PT [2021/03/15 0:32:28 ET]
Table 'Piccolo IV' 9-max Seat #1 is the button
Seat 1: robot 27 ($2.81 in chips) 
Seat 2: Wayniak187 ($1.42 in chips) 
Seat 3: Fatalimerrr ($3.97 in chips) 
Seat 4: AngryRaises ($1.28 in chips) 
Seat 5: bluffbobby ($1.46 in chips) 
Seat 6: Dorex2007 ($1.62 in chips) 
Seat 8: KaraFara ($4.89 in chips) 
Seat 9: Fedya465 ($1.93 in chips) 
Wayniak187: posts small blind $0.01
Fatalimerrr: posts big blind $0.02
wcrudjr: sits out 
*** HOLE CARDS ***
Dealt to Dorex2007 [Ah 4c]
AngryRaises: folds 
bluffbobby: folds 
Dorex2007: folds 
KaraFara: folds 
Fedya465: folds 
robot 27: folds 
Wayniak187: folds 
Uncalled bet ($0.01) returned to Fatalimerrr
Fatalimerrr collected $0.02 from pot
Fatalimerrr: doesn't show hand 
*** SUMMARY ***
Total pot $0.02 | Rake $0 
Seat 1: robot 27 (button) folded before Flop (didn't bet)
Seat 2: Wayniak187 (small blind) folded before Flop
Seat 3: Fatalimerrr (big blind) collected ($0.02)
Seat 4: AngryRaises folded before Flop (didn't bet)
Seat 5: bluffbobby folded before Flop (didn't bet)
Seat 6: Dorex2007 folded before Flop (didn't bet)
Seat 8: KaraFara folded before Flop (didn't bet)
Seat 9: Fedya465 folded before Flop (didn't bet)



PokerStars Hand #224825498692:  Hold'em No Limit ($0.01/$0.02 USD) - 2021/03/14 21:32:53 PT [2021/03/15 0:32:53 ET]
Table 'Piccolo IV' 9-max Seat #2 is the button
Seat 1: robot 27 ($2.81 in chips) 
Seat 2: Wayniak187 ($1.41 in chips) 
Seat 3: Fatalimerrr ($3.98 in chips) 
Seat 4: AngryRaises ($1.28 in chips) 
Seat 5: bluffbobby ($1.46 in chips) 
Seat 6: Dorex2007 ($1.62 in chips) 
Seat 8: KaraFara ($4.89 in chips) 
Seat 9: Fedya465 ($1.93 in chips) 
Fatalimerrr: posts small blind $0.01
AngryRaises: posts big blind $0.02
wcrudjr: sits out 
*** HOLE CARDS ***
Dealt to Dorex2007 [3c Th]
bluffbobby: folds 
Dorex2007: folds 
KaraFara: folds 
Fedya465: folds 
robot 27: folds 
Wayniak187 has timed out
Wayniak187: folds 
Fatalimerrr: raises $0.03 to $0.05
AngryRaises: calls $0.03
*** FLOP *** [4c Qs 2c]
Fatalimerrr: bets $0.03
AngryRaises: folds 
Uncalled bet ($0.03) returned to Fatalimerrr
Fatalimerrr collected $0.10 from pot
Fatalimerrr: doesn't show hand 
*** SUMMARY ***
Total pot $0.10 | Rake $0 
Board [4c Qs 2c]
Seat 1: robot 27 folded before Flop (didn't bet)
Seat 2: Wayniak187 (button) folded before Flop (didn't bet)
Seat 3: Fatalimerrr (small blind) collected ($0.10)
Seat 4: AngryRaises (big blind) folded on the Flop
Seat 5: bluffbobby folded before Flop (didn't bet)
Seat 6: Dorex2007 folded before Flop (didn't bet)
Seat 8: KaraFara folded before Flop (didn't bet)
Seat 9: Fedya465 folded before Flop (didn't bet)



PokerStars Hand #224825507170:  Hold'em No Limit ($0.01/$0.02 USD) - 2021/03/14 21:33:43 PT [2021/03/15 0:33:43 ET]
Table 'Piccolo IV' 9-max Seat #3 is the button
Seat 1: robot 27 ($2.81 in chips) 
Seat 2: Wayniak187 ($1.41 in chips) 
Seat 3: Fatalimerrr ($4.03 in chips) 
Seat 4: AngryRaises ($1.23 in chips) 
Seat 5: bluffbobby ($1.46 in chips) 
Seat 6: Dorex2007 ($1.62 in chips) 
Seat 8: KaraFara ($4.89 in chips) 
Seat 9: Fedya465 ($1.93 in chips) 
AngryRaises: posts small blind $0.01
bluffbobby: posts big blind $0.02
wcrudjr: sits out 
*** HOLE CARDS ***
Dealt to Dorex2007 [3h Js]
Dorex2007: folds 
KaraFara: raises $0.02 to $0.04
Fedya465: folds 
robot 27: folds 
Wayniak187: folds 
Fatalimerrr: folds 
AngryRaises: calls $0.03
bluffbobby: calls $0.02
*** FLOP *** [8c 4c 2c]
AngryRaises: checks 
bluffbobby: bets $0.04
KaraFara: calls $0.04
AngryRaises: folds 
*** TURN *** [8c 4c 2c] [2s]
bluffbobby: bets $0.10
KaraFara: folds 
Uncalled bet ($0.10) returned to bluffbobby
bluffbobby collected $0.19 from pot
bluffbobby: doesn't show hand 
*** SUMMARY ***
Total pot $0.20 | Rake $0.01 
Board [8c 4c 2c 2s]
Seat 1: robot 27 folded before Flop (didn't bet)
Seat 2: Wayniak187 folded before Flop (didn't bet)
Seat 3: Fatalimerrr (button) folded before Flop (didn't bet)
Seat 4: AngryRaises (small blind) folded on the Flop
Seat 5: bluffbobby (big blind) collected ($0.19)
Seat 6: Dorex2007 folded before Flop (didn't bet)
Seat 8: KaraFara folded on the Turn
Seat 9: Fedya465 folded before Flop (didn't bet)



PokerStars Hand #224825518448:  Hold'em No Limit ($0.01/$0.02 USD) - 2021/03/14 21:34:47 PT [2021/03/15 0:34:47 ET]
Table 'Piccolo IV' 9-max Seat #4 is the button
Seat 1: robot 27 ($2.81 in chips) 
Seat 2: Wayniak187 ($1.41 in chips) 
Seat 3: Fatalimerrr ($4.03 in chips) 
Seat 4: AngryRaises ($1.19 in chips) 
Seat 5: bluffbobby ($1.57 in chips) 
Seat 6: Dorex2007 ($1.62 in chips) 
Seat 8: KaraFara ($4.81 in chips) 
Seat 9: Fedya465 ($1.93 in chips) 
bluffbobby: posts small blind $0.01
Dorex2007: posts big blind $0.02
wcrudjr: sits out 
*** HOLE CARDS ***
Dealt to Dorex2007 [7h 8d]
KaraFara: folds 
Fedya465: folds 
robot 27: raises $0.05 to $0.07
Wayniak187: folds 
Fatalimerrr: folds 
AngryRaises: folds 
bluffbobby: folds 
Dorex2007: folds 
Uncalled bet ($0.05) returned to robot 27
robot 27 collected $0.05 from pot
robot 27: doesn't show hand 
*** SUMMARY ***
Total pot $0.05 | Rake $0 
Seat 1: robot 27 collected ($0.05)
Seat 2: Wayniak187 folded before Flop (didn't bet)
Seat 3: Fatalimerrr folded before Flop (didn't bet)
Seat 4: AngryRaises (button) folded before Flop (didn't bet)
Seat 5: bluffbobby (small blind) folded before Flop
Seat 6: Dorex2007 (big blind) folded before Flop
Seat 8: KaraFara folded before Flop (didn't bet)
Seat 9: Fedya465 folded before Flop (didn't bet)



PokerStars Hand #224825525253:  Hold'em No Limit ($0.01/$0.02 USD) - 2021/03/14 21:35:26 PT [2021/03/15 0:35:26 ET]
Table 'Piccolo IV' 9-max Seat #5 is the button
Seat 1: robot 27 ($2.84 in chips) 
Seat 2: Wayniak187 ($1.41 in chips) 
Seat 3: Fatalimerrr ($4.03 in chips) 
Seat 4: AngryRaises ($1.19 in chips) 
Seat 5: bluffbobby ($1.56 in chips) 
Seat 6: Dorex2007 ($1.60 in chips) 
Seat 7: wcrudjr ($0.80 in chips) 
Seat 8: KaraFara ($4.81 in chips) 
Seat 9: Fedya465 ($1.93 in chips) 
Dorex2007: posts small blind $0.01
wcrudjr: posts big blind $0.02
*** HOLE CARDS ***
Dealt to Dorex2007 [Qd 8d]
KaraFara: raises $0.02 to $0.04
Fedya465: folds 
robot 27: calls $0.04
Wayniak187: folds 
Fatalimerrr: folds 
AngryRaises: folds 
bluffbobby: folds 
Dorex2007: folds 
wcrudjr: calls $0.02
*** FLOP *** [Ad Th Kd]
wcrudjr: checks 
KaraFara: checks 
robot 27: checks 
*** TURN *** [Ad Th Kd] [Tc]
wcrudjr: bets $0.04
KaraFara: calls $0.04
robot 27: calls $0.04
*** RIVER *** [Ad Th Kd Tc] [7c]
wcrudjr: checks 
KaraFara: checks 
robot 27: bets $0.24
wcrudjr: folds 
KaraFara: folds 
Uncalled bet ($0.24) returned to robot 27
robot 27 collected $0.24 from pot
robot 27: doesn't show hand 
*** SUMMARY ***
Total pot $0.25 | Rake $0.01 
Board [Ad Th Kd Tc 7c]
Seat 1: robot 27 collected ($0.24)
Seat 2: Wayniak187 folded before Flop (didn't bet)
Seat 3: Fatalimerrr folded before Flop (didn't bet)
Seat 4: AngryRaises folded before Flop (didn't bet)
Seat 5: bluffbobby (button) folded before Flop (didn't bet)
Seat 6: Dorex2007 (small blind) folded before Flop
Seat 7: wcrudjr (big blind) folded on the River
Seat 8: KaraFara folded on the River
Seat 9: Fedya465 folded before Flop (didn't bet)



PokerStars Hand #224825537866:  Hold'em No Limit ($0.01/$0.02 USD) - 2021/03/14 21:36:39 PT [2021/03/15 0:36:39 ET]
Table 'Piccolo IV' 9-max Seat #6 is the button
Seat 1: robot 27 ($3 in chips) 
Seat 2: Wayniak187 ($1.41 in chips) 
Seat 3: Fatalimerrr ($4.03 in chips) 
Seat 4: AngryRaises ($1.19 in chips) 
Seat 5: bluffbobby ($1.56 in chips) 
Seat 6: Dorex2007 ($1.59 in chips) 
Seat 7: wcrudjr ($0.72 in chips) 
Seat 8: KaraFara ($4.73 in chips) 
Seat 9: Fedya465 ($1.93 in chips) 
wcrudjr: posts small blind $0.01
KaraFara: posts big blind $0.02
*** HOLE CARDS ***
Dealt to Dorex2007 [3c 2s]
Fedya465: folds 
robot 27: folds 
Wayniak187 has timed out
Wayniak187: folds 
Fatalimerrr: folds 
AngryRaises has timed out
AngryRaises: folds 
bluffbobby: raises $0.04 to $0.06
Dorex2007: folds 
wcrudjr: folds 
KaraFara: folds 
Uncalled bet ($0.04) returned to bluffbobby
bluffbobby collected $0.05 from pot
bluffbobby: doesn't show hand 
*** SUMMARY ***
Total pot $0.05 | Rake $0 
Seat 1: robot 27 folded before Flop (didn't bet)
Seat 2: Wayniak187 folded before Flop (didn't bet)
Seat 3: Fatalimerrr folded before Flop (didn't bet)
Seat 4: AngryRaises folded before Flop (didn't bet)
Seat 5: bluffbobby collected ($0.05)
Seat 6: Dorex2007 (button) folded before Flop (didn't bet)
Seat 7: wcrudjr (small blind) folded before Flop
Seat 8: KaraFara (big blind) folded before Flop
Seat 9: Fedya465 folded before Flop (didn't bet)



PokerStars Hand #224825544664:  Hold'em No Limit ($0.01/$0.02 USD) - 2021/03/14 21:37:19 PT [2021/03/15 0:37:19 ET]
Table 'Piccolo IV' 9-max Seat #7 is the button
Seat 1: robot 27 ($3 in chips) 
Seat 3: Fatalimerrr ($4.03 in chips) 
Seat 4: AngryRaises ($1.19 in chips) 
Seat 5: bluffbobby ($1.59 in chips) 
Seat 6: Dorex2007 ($1.59 in chips) 
Seat 7: wcrudjr ($0.71 in chips) 
Seat 8: KaraFara ($4.71 in chips) 
Seat 9: Fedya465 ($1.93 in chips) 
KaraFara: posts small blind $0.01
Fedya465: posts big blind $0.02
*** HOLE CARDS ***
Dealt to Dorex2007 [Td Ad]
robot 27: folds 
Fatalimerrr: folds 
AngryRaises: folds 
bluffbobby: folds 
Dorex2007: raises $0.04 to $0.06
wcrudjr: folds 
KaraFara: folds 
Fedya465: folds 
Uncalled bet ($0.04) returned to Dorex2007
Dorex2007 collected $0.05 from pot
Dorex2007: doesn't show hand 
*** SUMMARY ***
Total pot $0.05 | Rake $0 
Seat 1: robot 27 folded before Flop (didn't bet)
Seat 3: Fatalimerrr folded before Flop (didn't bet)
Seat 4: AngryRaises folded before Flop (didn't bet)
Seat 5: bluffbobby folded before Flop (didn't bet)
Seat 6: Dorex2007 collected ($0.05)
Seat 7: wcrudjr (button) folded before Flop (didn't bet)
Seat 8: KaraFara (small blind) folded before Flop
Seat 9: Fedya465 (big blind) folded before Flop



PokerStars Hand #224825550287:  Hold'em No Limit ($0.01/$0.02 USD) - 2021/03/14 21:37:52 PT [2021/03/15 0:37:52 ET]
Table 'Piccolo IV' 9-max Seat #8 is the button
Seat 1: robot 27 ($3 in chips) 
Seat 2: Wayniak187 ($1.41 in chips) 
Seat 3: Fatalimerrr ($4.03 in chips) 
Seat 4: AngryRaises ($1.19 in chips) 
Seat 5: bluffbobby ($1.59 in chips) 
Seat 6: Dorex2007 ($1.62 in chips) 
Seat 7: wcrudjr ($0.71 in chips) 
Seat 8: KaraFara ($4.70 in chips) 
Seat 9: Fedya465 ($1.91 in chips) 
Fedya465: posts small blind $0.01
robot 27: posts big blind $0.02
*** HOLE CARDS ***
Dealt to Dorex2007 [Qd Ts]
Wayniak187: folds 
Fatalimerrr: folds 
AngryRaises: folds 
bluffbobby: folds 
Dorex2007: folds 
wcrudjr: raises $0.02 to $0.04
KaraFara: raises $0.08 to $0.12
Fedya465: folds 
robot 27: folds 
wcrudjr: folds 
Uncalled bet ($0.08) returned to KaraFara
KaraFara collected $0.11 from pot
KaraFara: doesn't show hand 
*** SUMMARY ***
Total pot $0.11 | Rake $0 
Seat 1: robot 27 (big blind) folded before Flop
Seat 2: Wayniak187 folded before Flop (didn't bet)
Seat 3: Fatalimerrr folded before Flop (didn't bet)
Seat 4: AngryRaises folded before Flop (didn't bet)
Seat 5: bluffbobby folded before Flop (didn't bet)
Seat 6: Dorex2007 folded before Flop (didn't bet)
Seat 7: wcrudjr folded before Flop
Seat 8: KaraFara (button) collected ($0.11)
Seat 9: Fedya465 (small blind) folded before Flop



PokerStars Hand #224825555409:  Hold'em No Limit ($0.01/$0.02 USD) - 2021/03/14 21:38:23 PT [2021/03/15 0:38:23 ET]
Table 'Piccolo IV' 9-max Seat #9 is the button
Seat 1: robot 27 ($2.98 in chips) 
Seat 2: Wayniak187 ($1.41 in chips) 
Seat 3: Fatalimerrr ($4.03 in chips) 
Seat 4: AngryRaises ($1.19 in chips) 
Seat 5: bluffbobby ($1.59 in chips) 
Seat 6: Dorex2007 ($1.62 in chips) 
Seat 7: wcrudjr ($0.67 in chips) 
Seat 8: KaraFara ($4.77 in chips) 
Seat 9: Fedya465 ($1.90 in chips) 
robot 27: posts small blind $0.01
Wayniak187: posts big blind $0.02
*** HOLE CARDS ***
Dealt to Dorex2007 [9c 5s]
Fatalimerrr: folds 
AngryRaises: folds 
bluffbobby: folds 
Dorex2007: folds 
wcrudjr: raises $0.04 to $0.06
KaraFara: folds 
Fedya465: folds 
robot 27: folds 
Wayniak187: calls $0.04
*** FLOP *** [8c Qd 9h]
Wayniak187: checks 
wcrudjr: checks 
*** TURN *** [8c Qd 9h] [5d]
Wayniak187: checks 
wcrudjr: bets $0.04
Wayniak187: folds 
Uncalled bet ($0.04) returned to wcrudjr
wcrudjr collected $0.13 from pot
*** SUMMARY ***
Total pot $0.13 | Rake $0 
Board [8c Qd 9h 5d]
Seat 1: robot 27 (small blind) folded before Flop
Seat 2: Wayniak187 (big blind) folded on the Turn
Seat 3: Fatalimerrr folded before Flop (didn't bet)
Seat 4: AngryRaises folded before Flop (didn't bet)
Seat 5: bluffbobby folded before Flop (didn't bet)
Seat 6: Dorex2007 folded before Flop (didn't bet)
Seat 7: wcrudjr collected ($0.13)
Seat 8: KaraFara folded before Flop (didn't bet)
Seat 9: Fedya465 (button) folded before Flop (didn't bet)



PokerStars Hand #224825565497:  Hold'em No Limit ($0.01/$0.02 USD) - 2021/03/14 21:39:23 PT [2021/03/15 0:39:23 ET]
Table 'Piccolo IV' 9-max Seat #1 is the button
Seat 1: robot 27 ($2.97 in chips) 
Seat 2: Wayniak187 ($1.35 in chips) 
Seat 3: Fatalimerrr ($4.03 in chips) 
Seat 4: AngryRaises ($1.19 in chips) 
Seat 5: bluffbobby ($1.59 in chips) 
Seat 6: Dorex2007 ($1.62 in chips) 
Seat 7: wcrudjr ($0.74 in chips) 
Seat 8: KaraFara ($4.77 in chips) 
Seat 9: Fedya465 ($1.90 in chips) 
Wayniak187: posts small blind $0.01
Fatalimerrr: posts big blind $0.02
*** HOLE CARDS ***
Dealt to Dorex2007 [As 2d]
AngryRaises: folds 
bluffbobby: folds 
Dorex2007: folds 
wcrudjr: folds 
KaraFara: folds 
Fedya465: raises $0.04 to $0.06
robot 27: folds 
Wayniak187: calls $0.05
Fatalimerrr: folds 
*** FLOP *** [7s 5d 6s]
Wayniak187: checks 
Fedya465: bets $0.12
Wayniak187: folds 
Uncalled bet ($0.12) returned to Fedya465
Fedya465 collected $0.14 from pot
wcrudjr leaves the table
*** SUMMARY ***
Total pot $0.14 | Rake $0 
Board [7s 5d 6s]
Seat 1: robot 27 (button) folded before Flop (didn't bet)
Seat 2: Wayniak187 (small blind) folded on the Flop
Seat 3: Fatalimerrr (big blind) folded before Flop
Seat 4: AngryRaises folded before Flop (didn't bet)
Seat 5: bluffbobby folded before Flop (didn't bet)
Seat 6: Dorex2007 folded before Flop (didn't bet)
Seat 7: wcrudjr folded before Flop (didn't bet)
Seat 8: KaraFara folded before Flop (didn't bet)
Seat 9: Fedya465 collected ($0.14)



PokerStars Hand #224825577409:  Hold'em No Limit ($0.01/$0.02 USD) - 2021/03/14 21:40:34 PT [2021/03/15 0:40:34 ET]
Table 'Piccolo IV' 9-max Seat #2 is the button
Seat 1: robot 27 ($2.97 in chips) 
Seat 2: Wayniak187 ($1.29 in chips) 
Seat 3: Fatalimerrr ($4.01 in chips) 
Seat 4: AngryRaises ($1.19 in chips) 
Seat 5: bluffbobby ($1.59 in chips) 
Seat 6: Dorex2007 ($1.62 in chips) 
Seat 8: KaraFara ($4.77 in chips) 
Seat 9: Fedya465 ($1.98 in chips) 
Fatalimerrr: posts small blind $0.01
AngryRaises: posts big blind $0.02
*** HOLE CARDS ***
Dealt to Dorex2007 [4d 4h]
bluffbobby: folds 
Dorex2007: folds 
KaraFara: folds 
Fedya465: calls $0.02
robot 27: folds 
Wayniak187: raises $0.07 to $0.09
Fatalimerrr: folds 
AngryRaises: folds 
Fedya465: folds 
Uncalled bet ($0.07) returned to Wayniak187
Wayniak187 collected $0.07 from pot
Wayniak187: doesn't show hand 
*** SUMMARY ***
Total pot $0.07 | Rake $0 
Seat 1: robot 27 folded before Flop (didn't bet)
Seat 2: Wayniak187 (button) collected ($0.07)
Seat 3: Fatalimerrr (small blind) folded before Flop
Seat 4: AngryRaises (big blind) folded before Flop
Seat 5: bluffbobby folded before Flop (didn't bet)
Seat 6: Dorex2007 folded before Flop (didn't bet)
Seat 8: KaraFara folded before Flop (didn't bet)
Seat 9: Fedya465 folded before Flop



PokerStars Hand #224825582633:  Hold'em No Limit ($0.01/$0.02 USD) - 2021/03/14 21:41:05 PT [2021/03/15 0:41:05 ET]
Table 'Piccolo IV' 9-max Seat #3 is the button
Seat 1: robot 27 ($2.97 in chips) 
Seat 2: Wayniak187 ($1.34 in chips) 
Seat 3: Fatalimerrr ($4 in chips) 
Seat 4: AngryRaises ($1.17 in chips) 
Seat 5: bluffbobby ($1.59 in chips) 
Seat 6: Dorex2007 ($1.62 in chips) 
Seat 8: KaraFara ($4.77 in chips) 
Seat 9: Fedya465 ($1.96 in chips) 
AngryRaises: posts small blind $0.01
bluffbobby: posts big blind $0.02
*** HOLE CARDS ***
Dealt to Dorex2007 [3c Ts]
Dorex2007: folds 
KaraFara: folds 
ser447787 joins the table at seat #7 
Fedya465: folds 
robot 27: folds 
Wayniak187: raises $0.04 to $0.06
Fatalimerrr: folds 
AngryRaises: calls $0.05
bluffbobby: folds 
*** FLOP *** [6c 8d 4c]
AngryRaises: checks 
Wayniak187: checks 
*** TURN *** [6c 8d 4c] [9s]
AngryRaises: checks 
Wayniak187: checks 
*** RIVER *** [6c 8d 4c 9s] [8h]
AngryRaises: checks 
Wayniak187: checks 
*** SHOW DOWN ***
AngryRaises: shows [2d Jd] (a pair of Eights)
Wayniak187: shows [Js Qs] (a pair of Eights - Queen kicker)
Wayniak187 collected $0.14 from pot
*** SUMMARY ***
Total pot $0.14 | Rake $0 
Board [6c 8d 4c 9s 8h]
Seat 1: robot 27 folded before Flop (didn't bet)
Seat 2: Wayniak187 showed [Js Qs] and won ($0.14) with a pair of Eights
Seat 3: Fatalimerrr (button) folded before Flop (didn't bet)
Seat 4: AngryRaises (small blind) showed [2d Jd] and lost with a pair of Eights
Seat 5: bluffbobby (big blind) folded before Flop
Seat 6: Dorex2007 folded before Flop (didn't bet)
Seat 8: KaraFara folded before Flop (didn't bet)
Seat 9: Fedya465 folded before Flop (didn't bet)



PokerStars Hand #224825591233:  Hold'em No Limit ($0.01/$0.02 USD) - 2021/03/14 21:41:55 PT [2021/03/15 0:41:55 ET]
Table 'Piccolo IV' 9-max Seat #4 is the button
Seat 1: robot 27 ($2.97 in chips) 
Seat 2: Wayniak187 ($1.42 in chips) 
Seat 3: Fatalimerrr ($4 in chips) 
Seat 4: AngryRaises ($1.11 in chips) 
Seat 5: bluffbobby ($1.57 in chips) 
Seat 6: Dorex2007 ($1.62 in chips) 
Seat 8: KaraFara ($4.77 in chips) 
Seat 9: Fedya465 ($1.96 in chips) 
bluffbobby: posts small blind $0.01
Dorex2007: posts big blind $0.02
ser447787: sits out 
*** HOLE CARDS ***
Dealt to Dorex2007 [Th 7h]
KaraFara: folds 
Fedya465: folds 
robot 27: folds 
Wayniak187: raises $0.02 to $0.04
Fatalimerrr: folds 
AngryRaises: calls $0.04
bluffbobby: folds 
Dorex2007: calls $0.02
*** FLOP *** [As 9d Qc]
Dorex2007: checks 
Wayniak187: bets $0.13
AngryRaises: folds 
Dorex2007: folds 
Uncalled bet ($0.13) returned to Wayniak187
Wayniak187 collected $0.13 from pot
Wayniak187: doesn't show hand 
*** SUMMARY ***
Total pot $0.13 | Rake $0 
Board [As 9d Qc]
Seat 1: robot 27 folded before Flop (didn't bet)
Seat 2: Wayniak187 collected ($0.13)
Seat 3: Fatalimerrr folded before Flop (didn't bet)
Seat 4: AngryRaises (button) folded on the Flop
Seat 5: bluffbobby (small blind) folded before Flop
Seat 6: Dorex2007 (big blind) folded on the Flop
Seat 8: KaraFara folded before Flop (didn't bet)
Seat 9: Fedya465 folded before Flop (didn't bet)



PokerStars Hand #224825598894:  Hold'em No Limit ($0.01/$0.02 USD) - 2021/03/14 21:42:39 PT [2021/03/15 0:42:39 ET]
Table 'Piccolo IV' 9-max Seat #5 is the button
Seat 1: robot 27 ($2.97 in chips) 
Seat 2: Wayniak187 ($1.51 in chips) 
Seat 3: Fatalimerrr ($4 in chips) 
Seat 4: AngryRaises ($1.07 in chips) 
Seat 5: bluffbobby ($1.56 in chips) 
Seat 6: Dorex2007 ($1.58 in chips) 
Seat 7: ser447787 ($2 in chips) 
Seat 8: KaraFara ($4.77 in chips) 
Seat 9: Fedya465 ($1.96 in chips) 
Dorex2007: posts small blind $0.01
ser447787: posts big blind $0.02
*** HOLE CARDS ***
Dealt to Dorex2007 [9h 3s]
KaraFara: folds 
Fedya465: folds 
robot 27: folds 
Wayniak187: folds 
Wayniak187 leaves the table
Fatalimerrr: folds 
AngryRaises: folds 
bluffbobby: raises $0.04 to $0.06
Dorex2007: folds 
ser447787: folds 
Uncalled bet ($0.04) returned to bluffbobby
bluffbobby collected $0.05 from pot
bluffbobby: doesn't show hand 
*** SUMMARY ***
Total pot $0.05 | Rake $0 
Seat 1: robot 27 folded before Flop (didn't bet)
Seat 2: Wayniak187 folded before Flop (didn't bet)
Seat 3: Fatalimerrr folded before Flop (didn't bet)
Seat 4: AngryRaises folded before Flop (didn't bet)
Seat 5: bluffbobby (button) collected ($0.05)
Seat 6: Dorex2007 (small blind) folded before Flop
Seat 7: ser447787 (big blind) folded before Flop
Seat 8: KaraFara folded before Flop (didn't bet)
Seat 9: Fedya465 folded before Flop (didn't bet)



PokerStars Hand #224825603689:  Hold'em No Limit ($0.01/$0.02 USD) - 2021/03/14 21:43:08 PT [2021/03/15 0:43:08 ET]
Table 'Piccolo IV' 9-max Seat #6 is the button
Seat 1: robot 27 ($2.97 in chips) 
Seat 3: Fatalimerrr ($4 in chips) 
Seat 4: AngryRaises ($1.07 in chips) 
Seat 5: bluffbobby ($1.59 in chips) 
Seat 6: Dorex2007 ($1.57 in chips) 
Seat 7: ser447787 ($2 in chips) 
Seat 8: KaraFara ($4.77 in chips) 
Seat 9: Fedya465 ($1.96 in chips) 
ser447787: posts small blind $0.01
KaraFara: posts big blind $0.02
*** HOLE CARDS ***
Dealt to Dorex2007 [As Js]
Fedya465: folds 
robot 27: folds 
Fatalimerrr: folds 
AngryRaises: folds 
bluffbobby: folds 
Dorex2007: raises $0.04 to $0.06
buggspray joins the table at seat #2 
ser447787: folds 
KaraFara: folds 
Uncalled bet ($0.04) returned to Dorex2007
Dorex2007 collected $0.05 from pot
Dorex2007: doesn't show hand 
*** SUMMARY ***
Total pot $0.05 | Rake $0 
Seat 1: robot 27 folded before Flop (didn't bet)
Seat 3: Fatalimerrr folded before Flop (didn't bet)
Seat 4: AngryRaises folded before Flop (didn't bet)
Seat 5: bluffbobby folded before Flop (didn't bet)
Seat 6: Dorex2007 (button) collected ($0.05)
Seat 7: ser447787 (small blind) folded before Flop
Seat 8: KaraFara (big blind) folded before Flop
Seat 9: Fedya465 folded before Flop (didn't bet)



PokerStars Hand #224825613690:  Hold'em No Limit ($0.01/$0.02 USD) - 2021/03/14 21:43:32 PT [2021/03/15 0:43:32 ET]
Table 'Piccolo IV' 9-max Seat #7 is the button
Seat 1: robot 27 ($2.97 in chips) 
Seat 3: Fatalimerrr ($4 in chips) 
Seat 4: AngryRaises ($1.07 in chips) 
Seat 5: bluffbobby ($1.59 in chips) 
Seat 6: Dorex2007 ($1.60 in chips) 
Seat 7: ser447787 ($2 in chips) 
Seat 8: KaraFara ($4.75 in chips) 
Seat 9: Fedya465 ($1.96 in chips) 
KaraFara: posts small blind $0.01
Fedya465: posts big blind $0.02
buggspray: sits out 
*** HOLE CARDS ***
Dealt to Dorex2007 [4s 3d]
robot 27: folds 
Fatalimerrr: raises $0.04 to $0.06
AngryRaises: folds 
bluffbobby: folds 
Dorex2007: folds 
ser447787: folds 
KaraFara: calls $0.05
Fedya465: folds 
*** FLOP *** [3s 9s As]
KaraFara: checks 
Fatalimerrr: checks 
*** TURN *** [3s 9s As] [Ah]
KaraFara: bets $0.08
Fatalimerrr: calls $0.08
*** RIVER *** [3s 9s As Ah] [9h]
KaraFara: bets $0.29
Fatalimerrr: raises $0.44 to $0.73
KaraFara: calls $0.44
*** SHOW DOWN ***
Fatalimerrr: shows [Jc Ac] (a full house, Aces full of Nines)
KaraFara: shows [Ad 4d] (a full house, Aces full of Nines)
KaraFara collected $0.85 from pot
Fatalimerrr collected $0.85 from pot
*** SUMMARY ***
Total pot $1.76 | Rake $0.06 
Board [3s 9s As Ah 9h]
Seat 1: robot 27 folded before Flop (didn't bet)
Seat 3: Fatalimerrr showed [Jc Ac] and won ($0.85) with a full house, Aces full of Nines
Seat 4: AngryRaises folded before Flop (didn't bet)
Seat 5: bluffbobby folded before Flop (didn't bet)
Seat 6: Dorex2007 folded before Flop (didn't bet)
Seat 7: ser447787 (button) folded before Flop (didn't bet)
Seat 8: KaraFara (small blind) showed [Ad 4d] and won ($0.85) with a full house, Aces full of Nines
Seat 9: Fedya465 (big blind) folded before Flop



PokerStars Hand #224825622223:  Hold'em No Limit ($0.01/$0.02 USD) - 2021/03/14 21:44:23 PT [2021/03/15 0:44:23 ET]
Table 'Piccolo IV' 9-max Seat #8 is the button
Seat 1: robot 27 ($2.97 in chips) 
Seat 3: Fatalimerrr ($3.98 in chips) 
Seat 4: AngryRaises ($1.07 in chips) 
Seat 5: bluffbobby ($1.59 in chips) 
Seat 6: Dorex2007 ($1.60 in chips) 
Seat 7: ser447787 ($2 in chips) 
Seat 8: KaraFara ($4.73 in chips) 
Seat 9: Fedya465 ($1.94 in chips) 
Fedya465: posts small blind $0.01
robot 27: posts big blind $0.02
buggspray: sits out 
*** HOLE CARDS ***
Dealt to Dorex2007 [5h Jc]
Fatalimerrr: folds 
AngryRaises: raises $0.02 to $0.04
bluffbobby: raises $0.11 to $0.15
Dorex2007: folds 
ser447787: folds 
KaraFara: calls $0.15
Fedya465: folds 
robot 27: folds 
AngryRaises: calls $0.11
*** FLOP *** [5d 9c Ts]
AngryRaises: checks 
bluffbobby: checks 
KaraFara: bets $0.28
AngryRaises: raises $0.64 to $0.92 and is all-in
bluffbobby: folds 
KaraFara: calls $0.64
robot 27 leaves the table
*** TURN *** [5d 9c Ts] [6h]
*** RIVER *** [5d 9c Ts 6h] [Kc]
*** SHOW DOWN ***
AngryRaises: shows [9s Tc] (two pair, Tens and Nines)
KaraFara: shows [Kh Kd] (three of a kind, Kings)
KaraFara collected $2.24 from pot
AngryRaises cashed out the hand for $1.62 | Cash Out Fee $0.02
*** SUMMARY ***
Total pot $2.32 | Rake $0.08 
Board [5d 9c Ts 6h Kc]
Seat 1: robot 27 (big blind) folded before Flop
Seat 3: Fatalimerrr folded before Flop (didn't bet)
Seat 4: AngryRaises showed [9s Tc] and lost with two pair, Tens and Nines (cashed out).
Seat 5: bluffbobby folded on the Flop
Seat 6: Dorex2007 folded before Flop (didn't bet)
Seat 7: ser447787 folded before Flop (didn't bet)
Seat 8: KaraFara (button) showed [Kh Kd] and won ($2.24) with three of a kind, Kings
Seat 9: Fedya465 (small blind) folded before Flop



PokerStars Hand #224825634082:  Hold'em No Limit ($0.01/$0.02 USD) - 2021/03/14 21:45:33 PT [2021/03/15 0:45:33 ET]
Table 'Piccolo IV' 9-max Seat #9 is the button
Seat 3: Fatalimerrr ($3.98 in chips) 
Seat 4: AngryRaises ($1.62 in chips) 
Seat 5: bluffbobby ($1.44 in chips) 
Seat 6: Dorex2007 ($1.60 in chips) 
Seat 7: ser447787 ($2 in chips) 
Seat 8: KaraFara ($5.90 in chips) 
Seat 9: Fedya465 ($1.93 in chips) 
Fatalimerrr: posts small blind $0.01
AngryRaises: posts big blind $0.02
*** HOLE CARDS ***
Dealt to Dorex2007 [2d Kd]
bluffbobby: folds 
ppeetteerr175 joins the table at seat #1 
Dorex2007: folds 
ser447787: folds 
KaraFara: folds 
Fedya465: calls $0.02
Fatalimerrr: folds 
AngryRaises: raises $0.04 to $0.06
Fedya465: folds 
Uncalled bet ($0.04) returned to AngryRaises
AngryRaises collected $0.05 from pot
AngryRaises: doesn't show hand 
*** SUMMARY ***
Total pot $0.05 | Rake $0 
Seat 3: Fatalimerrr (small blind) folded before Flop
Seat 4: AngryRaises (big blind) collected ($0.05)
Seat 5: bluffbobby folded before Flop (didn't bet)
Seat 6: Dorex2007 folded before Flop (didn't bet)
Seat 7: ser447787 folded before Flop (didn't bet)
Seat 8: KaraFara folded before Flop (didn't bet)
Seat 9: Fedya465 (button) folded before Flop



PokerStars Hand #224825638641:  Hold'em No Limit ($0.01/$0.02 USD) - 2021/03/14 21:46:00 PT [2021/03/15 0:46:00 ET]
Table 'Piccolo IV' 9-max Seat #3 is the button
Seat 2: buggspray ($1.60 in chips) 
Seat 3: Fatalimerrr ($3.97 in chips) 
Seat 4: AngryRaises ($1.65 in chips) 
Seat 5: bluffbobby ($1.44 in chips) 
Seat 6: Dorex2007 ($1.60 in chips) 
Seat 7: ser447787 ($2 in chips) 
Seat 8: KaraFara ($5.90 in chips) 
Seat 9: Fedya465 ($1.91 in chips) 
AngryRaises: posts small blind $0.01
bluffbobby: posts big blind $0.02
ppeetteerr175: sits out 
buggspray: posts big blind $0.02
*** HOLE CARDS ***
Dealt to Dorex2007 [5s Qc]
Dorex2007: folds 
ser447787: folds 
KaraFara: folds 
Fedya465: folds 
buggspray: raises $0.06 to $0.08
Fatalimerrr: folds 
AngryRaises: folds 
bluffbobby: folds 
Uncalled bet ($0.06) returned to buggspray
buggspray collected $0.05 from pot
buggspray: doesn't show hand 
*** SUMMARY ***
Total pot $0.05 | Rake $0 
Seat 2: buggspray collected ($0.05)
Seat 3: Fatalimerrr (button) folded before Flop (didn't bet)
Seat 4: AngryRaises (small blind) folded before Flop
Seat 5: bluffbobby (big blind) folded before Flop
Seat 6: Dorex2007 folded before Flop (didn't bet)
Seat 7: ser447787 folded before Flop (didn't bet)
Seat 8: KaraFara folded before Flop (didn't bet)
Seat 9: Fedya465 folded before Flop (didn't bet)



PokerStars Hand #224825641948:  Hold'em No Limit ($0.01/$0.02 USD) - 2021/03/14 21:46:20 PT [2021/03/15 0:46:20 ET]
Table 'Piccolo IV' 9-max Seat #4 is the button
Seat 2: buggspray ($1.63 in chips) 
Seat 3: Fatalimerrr ($3.97 in chips) 
Seat 4: AngryRaises ($1.64 in chips) 
Seat 5: bluffbobby ($1.42 in chips) 
Seat 6: Dorex2007 ($1.60 in chips) 
Seat 7: ser447787 ($2 in chips) 
Seat 8: KaraFara ($5.90 in chips) 
Seat 9: Fedya465 ($1.91 in chips) 
bluffbobby: posts small blind $0.01
Dorex2007: posts big blind $0.02
ppeetteerr175: sits out 
*** HOLE CARDS ***
Dealt to Dorex2007 [4h 8h]
ser447787: folds 
KaraFara: raises $0.02 to $0.04
Fedya465: folds 
buggspray: folds 
Fatalimerrr: folds 
AngryRaises: folds 
bluffbobby: folds 
Dorex2007: folds 
Uncalled bet ($0.02) returned to KaraFara
KaraFara collected $0.05 from pot
KaraFara: doesn't show hand 
*** SUMMARY ***
Total pot $0.05 | Rake $0 
Seat 2: buggspray folded before Flop (didn't bet)
Seat 3: Fatalimerrr folded before Flop (didn't bet)
Seat 4: AngryRaises (button) folded before Flop (didn't bet)
Seat 5: bluffbobby (small blind) folded before Flop
Seat 6: Dorex2007 (big blind) folded before Flop
Seat 7: ser447787 folded before Flop (didn't bet)
Seat 8: KaraFara collected ($0.05)
Seat 9: Fedya465 folded before Flop (didn't bet)



PokerStars Hand #224825644867:  Hold'em No Limit ($0.01/$0.02 USD) - 2021/03/14 21:46:38 PT [2021/03/15 0:46:38 ET]
Table 'Piccolo IV' 9-max Seat #5 is the button
Seat 2: buggspray ($1.63 in chips) 
Seat 3: Fatalimerrr ($3.97 in chips) 
Seat 4: AngryRaises ($1.64 in chips) 
Seat 5: bluffbobby ($1.41 in chips) 
Seat 6: Dorex2007 ($1.58 in chips) 
Seat 7: ser447787 ($2 in chips) 
Seat 8: KaraFara ($5.93 in chips) 
Seat 9: Fedya465 ($1.91 in chips) 
Dorex2007: posts small blind $0.01
ser447787: posts big blind $0.02
ppeetteerr175: sits out 
*** HOLE CARDS ***
Dealt to Dorex2007 [Ac 3c]
KaraFara: folds 
Fedya465: folds 
buggspray: folds 
Fatalimerrr: folds 
AngryRaises: raises $0.03 to $0.05
bluffbobby: folds 
Dorex2007: calls $0.04
ser447787: folds 
*** FLOP *** [Qs Kc 8d]
Dorex2007: checks 
AngryRaises: bets $0.06
Dorex2007: folds 
Uncalled bet ($0.06) returned to AngryRaises
AngryRaises collected $0.12 from pot
AngryRaises: doesn't show hand 
*** SUMMARY ***
Total pot $0.12 | Rake $0 
Board [Qs Kc 8d]
Seat 2: buggspray folded before Flop (didn't bet)
Seat 3: Fatalimerrr folded before Flop (didn't bet)
Seat 4: AngryRaises collected ($0.12)
Seat 5: bluffbobby (button) folded before Flop (didn't bet)
Seat 6: Dorex2007 (small blind) folded on the Flop
Seat 7: ser447787 (big blind) folded before Flop
Seat 8: KaraFara folded before Flop (didn't bet)
Seat 9: Fedya465 folded before Flop (didn't bet)



PokerStars Hand #224825651603:  Hold'em No Limit ($0.01/$0.02 USD) - 2021/03/14 21:47:19 PT [2021/03/15 0:47:19 ET]
Table 'Piccolo IV' 9-max Seat #6 is the button
Seat 2: buggspray ($1.63 in chips) 
Seat 3: Fatalimerrr ($3.97 in chips) 
Seat 4: AngryRaises ($1.71 in chips) 
Seat 5: bluffbobby ($1.41 in chips) 
Seat 6: Dorex2007 ($1.53 in chips) 
Seat 7: ser447787 ($2 in chips) 
Seat 8: KaraFara ($5.93 in chips) 
Seat 9: Fedya465 ($1.91 in chips) 
ser447787: posts small blind $0.01
KaraFara: posts big blind $0.02
ppeetteerr175: sits out 
*** HOLE CARDS ***
Dealt to Dorex2007 [Jc Kh]
Fedya465: raises $0.04 to $0.06
buggspray: folds 
Fatalimerrr: folds 
AngryRaises: folds 
bluffbobby: folds 
Dorex2007 has timed out
Dorex2007: folds 
ser447787: folds 
KaraFara: folds 
Uncalled bet ($0.04) returned to Fedya465
Fedya465 collected $0.05 from pot
*** SUMMARY ***
Total pot $0.05 | Rake $0 
Seat 2: buggspray folded before Flop (didn't bet)
Seat 3: Fatalimerrr folded before Flop (didn't bet)
Seat 4: AngryRaises folded before Flop (didn't bet)
Seat 5: bluffbobby folded before Flop (didn't bet)
Seat 6: Dorex2007 (button) folded before Flop (didn't bet)
Seat 7: ser447787 (small blind) folded before Flop
Seat 8: KaraFara (big blind) folded before Flop
Seat 9: Fedya465 collected ($0.05)



PokerStars Hand #224825656778:  Hold'em No Limit ($0.01/$0.02 USD) - 2021/03/14 21:47:50 PT [2021/03/15 0:47:50 ET]
Table 'Piccolo IV' 9-max Seat #7 is the button
Seat 2: buggspray ($1.63 in chips) 
Seat 3: Fatalimerrr ($3.97 in chips) 
Seat 4: AngryRaises ($1.71 in chips) 
Seat 5: bluffbobby ($1.41 in chips) 
Seat 6: Dorex2007 ($1.53 in chips) 
Seat 7: ser447787 ($2 in chips) 
Seat 8: KaraFara ($5.91 in chips) 
Seat 9: Fedya465 ($1.94 in chips) 
KaraFara: posts small blind $0.01
Fedya465: posts big blind $0.02
ppeetteerr175: sits out 
*** HOLE CARDS ***
Dealt to Dorex2007 [Tc Jc]
buggspray: folds 
Fatalimerrr: folds 
AngryRaises: folds 
bluffbobby: raises $0.04 to $0.06
Dorex2007: calls $0.06
ser447787: folds 
KaraFara: folds 
Fedya465: folds 
*** FLOP *** [6d 9s 5s]
bluffbobby: bets $0.09
Dorex2007: folds 
Uncalled bet ($0.09) returned to bluffbobby
bluffbobby collected $0.14 from pot
bluffbobby: doesn't show hand 
*** SUMMARY ***
Total pot $0.15 | Rake $0.01 
Board [6d 9s 5s]
Seat 2: buggspray folded before Flop (didn't bet)
Seat 3: Fatalimerrr folded before Flop (didn't bet)
Seat 4: AngryRaises folded before Flop (didn't bet)
Seat 5: bluffbobby collected ($0.14)
Seat 6: Dorex2007 folded on the Flop
Seat 7: ser447787 (button) folded before Flop (didn't bet)
Seat 8: KaraFara (small blind) folded before Flop
Seat 9: Fedya465 (big blind) folded before Flop



PokerStars Hand #224825663668:  Hold'em No Limit ($0.01/$0.02 USD) - 2021/03/14 21:48:32 PT [2021/03/15 0:48:32 ET]
Table 'Piccolo IV' 9-max Seat #8 is the button
Seat 1: ppeetteerr175 ($2 in chips) 
Seat 2: buggspray ($1.63 in chips) 
Seat 3: Fatalimerrr ($3.97 in chips) 
Seat 4: AngryRaises ($1.71 in chips) 
Seat 5: bluffbobby ($1.49 in chips) 
Seat 6: Dorex2007 ($1.47 in chips) 
Seat 7: ser447787 ($2 in chips) 
Seat 8: KaraFara ($5.90 in chips) 
Seat 9: Fedya465 ($1.92 in chips) 
Fedya465: posts small blind $0.01
ppeetteerr175: posts big blind $0.02
*** HOLE CARDS ***
Dealt to Dorex2007 [6s 8d]
buggspray: raises $0.04 to $0.06
Fatalimerrr: folds 
AngryRaises: calls $0.06
bluffbobby: folds 
Dorex2007: folds 
ser447787: folds 
KaraFara: folds 
Fedya465: folds 
ppeetteerr175: calls $0.04
*** FLOP *** [2c 7c As]
ppeetteerr175: checks 
buggspray: checks 
AngryRaises: checks 
*** TURN *** [2c 7c As] [5c]
ppeetteerr175: checks 
buggspray: bets $0.09
AngryRaises: calls $0.09
ppeetteerr175: folds 
*** RIVER *** [2c 7c As 5c] [Ah]
buggspray: checks 
AngryRaises: checks 
*** SHOW DOWN ***
buggspray: shows [Qd Kd] (a pair of Aces)
AngryRaises: shows [4c 5d] (two pair, Aces and Fives)
AngryRaises collected $0.36 from pot
*** SUMMARY ***
Total pot $0.37 | Rake $0.01 
Board [2c 7c As 5c Ah]
Seat 1: ppeetteerr175 (big blind) folded on the Turn
Seat 2: buggspray showed [Qd Kd] and lost with a pair of Aces
Seat 3: Fatalimerrr folded before Flop (didn't bet)
Seat 4: AngryRaises showed [4c 5d] and won ($0.36) with two pair, Aces and Fives
Seat 5: bluffbobby folded before Flop (didn't bet)
Seat 6: Dorex2007 folded before Flop (didn't bet)
Seat 7: ser447787 folded before Flop (didn't bet)
Seat 8: KaraFara (button) folded before Flop (didn't bet)
Seat 9: Fedya465 (small blind) folded before Flop



PokerStars Hand #224825669505:  Hold'em No Limit ($0.01/$0.02 USD) - 2021/03/14 21:49:08 PT [2021/03/15 0:49:08 ET]
Table 'Piccolo IV' 9-max Seat #9 is the button
Seat 1: ppeetteerr175 ($1.94 in chips) 
Seat 2: buggspray ($1.48 in chips) 
Seat 3: Fatalimerrr ($3.97 in chips) 
Seat 4: AngryRaises ($1.92 in chips) 
Seat 5: bluffbobby ($1.49 in chips) 
Seat 6: Dorex2007 ($1.47 in chips) 
Seat 7: ser447787 ($2 in chips) 
Seat 8: KaraFara ($5.90 in chips) 
Seat 9: Fedya465 ($1.91 in chips) 
ppeetteerr175: posts small blind $0.01
buggspray: posts big blind $0.02
*** HOLE CARDS ***
Dealt to Dorex2007 [Kc Qh]
Fatalimerrr: folds 
AngryRaises: calls $0.02
bluffbobby: folds 
Dorex2007: raises $0.04 to $0.06
ser447787: calls $0.06
KaraFara: calls $0.06
Fedya465: folds 
ppeetteerr175: folds 
buggspray: calls $0.04
AngryRaises: calls $0.04
*** FLOP *** [Td Ac Th]
buggspray: checks 
AngryRaises: checks 
Dorex2007: checks 
ser447787: checks 
KaraFara: bets $0.09
buggspray: raises $0.09 to $0.18
AngryRaises: folds 
Dorex2007: folds 
ser447787: folds 
KaraFara: calls $0.09
*** TURN *** [Td Ac Th] [4h]
buggspray: bets $0.65
KaraFara: folds 
Uncalled bet ($0.65) returned to buggspray
buggspray collected $0.65 from pot
buggspray: doesn't show hand 
*** SUMMARY ***
Total pot $0.67 | Rake $0.02 
Board [Td Ac Th 4h]
Seat 1: ppeetteerr175 (small blind) folded before Flop
Seat 2: buggspray (big blind) collected ($0.65)
Seat 3: Fatalimerrr folded before Flop (didn't bet)
Seat 4: AngryRaises folded on the Flop
Seat 5: bluffbobby folded before Flop (didn't bet)
Seat 6: Dorex2007 folded on the Flop
Seat 7: ser447787 folded on the Flop
Seat 8: KaraFara folded on the Turn
Seat 9: Fedya465 (button) folded before Flop (didn't bet)



PokerStars Hand #224825681718:  Hold'em No Limit ($0.01/$0.02 USD) - 2021/03/14 21:50:23 PT [2021/03/15 0:50:23 ET]
Table 'Piccolo IV' 9-max Seat #1 is the button
Seat 1: ppeetteerr175 ($1.93 in chips) 
Seat 2: buggspray ($1.89 in chips) 
Seat 3: Fatalimerrr ($3.97 in chips) 
Seat 4: AngryRaises ($1.86 in chips) 
Seat 5: bluffbobby ($1.49 in chips) 
Seat 6: Dorex2007 ($1.41 in chips) 
Seat 7: ser447787 ($2 in chips) 
Seat 8: KaraFara ($5.66 in chips) 
Seat 9: Fedya465 ($1.91 in chips) 
buggspray: posts small blind $0.01
Fatalimerrr: posts big blind $0.02
*** HOLE CARDS ***
Dealt to Dorex2007 [Qd 9d]
AngryRaises: folds 
bluffbobby: folds 
Dorex2007: raises $0.04 to $0.06
ser447787: folds 
KaraFara: folds 
Fedya465: folds 
ppeetteerr175: raises $0.04 to $0.10
buggspray: folds 
Fatalimerrr: folds 
Dorex2007: calls $0.04
*** FLOP *** [9c 6c 4c]
Dorex2007: bets $0.15
ppeetteerr175: calls $0.15
*** TURN *** [9c 6c 4c] [5h]
Dorex2007: checks 
ppeetteerr175: checks 
*** RIVER *** [9c 6c 4c 5h] [Ad]
Dorex2007: bets $0.26
ppeetteerr175: calls $0.26
*** SHOW DOWN ***
Dorex2007: shows [Qd 9d] (a pair of Nines)
ppeetteerr175: shows [Jc Ah] (a pair of Aces)
ppeetteerr175 collected $1.01 from pot
*** SUMMARY ***
Total pot $1.05 | Rake $0.04 
Board [9c 6c 4c 5h Ad]
Seat 1: ppeetteerr175 (button) showed [Jc Ah] and won ($1.01) with a pair of Aces
Seat 2: buggspray (small blind) folded before Flop
Seat 3: Fatalimerrr (big blind) folded before Flop
Seat 4: AngryRaises folded before Flop (didn't bet)
Seat 5: bluffbobby folded before Flop (didn't bet)
Seat 6: Dorex2007 showed [Qd 9d] and lost with a pair of Nines
Seat 7: ser447787 folded before Flop (didn't bet)
Seat 8: KaraFara folded before Flop (didn't bet)
Seat 9: Fedya465 folded before Flop (didn't bet)



PokerStars Hand #224825700591:  Hold'em No Limit ($0.01/$0.02 USD) - 2021/03/14 21:51:52 PT [2021/03/15 0:51:52 ET]
Table 'Piccolo IV' 9-max Seat #2 is the button
Seat 1: ppeetteerr175 ($2.43 in chips) 
Seat 2: buggspray ($1.88 in chips) 
Seat 3: Fatalimerrr ($3.95 in chips) 
Seat 4: AngryRaises ($1.86 in chips) 
Seat 5: bluffbobby ($1.49 in chips) 
Seat 6: Dorex2007 ($0.90 in chips) 
Seat 7: ser447787 ($2 in chips) 
Seat 8: KaraFara ($5.66 in chips) 
Fatalimerrr: posts small blind $0.01
AngryRaises: posts big blind $0.02
*** HOLE CARDS ***
Dealt to Dorex2007 [Td Th]
bluffbobby: folds 
Dorex2007: raises $0.04 to $0.06
ser447787: folds 
KaraFara: folds 
ppeetteerr175: folds 
buggspray: folds 
bluffbobby leaves the table
Fatalimerrr: raises $0.14 to $0.20
AngryRaises: folds 
Dorex2007: folds 
Uncalled bet ($0.14) returned to Fatalimerrr
Fatalimerrr collected $0.14 from pot
Fatalimerrr: doesn't show hand 
*** SUMMARY ***
Total pot $0.14 | Rake $0 
Seat 1: ppeetteerr175 folded before Flop (didn't bet)
Seat 2: buggspray (button) folded before Flop (didn't bet)
Seat 3: Fatalimerrr (small blind) collected ($0.14)
Seat 4: AngryRaises (big blind) folded before Flop
Seat 5: bluffbobby folded before Flop (didn't bet)
Seat 6: Dorex2007 folded before Flop
Seat 7: ser447787 folded before Flop (didn't bet)
Seat 8: KaraFara folded before Flop (didn't bet)



PokerStars Hand #224825705443:  Hold'em No Limit ($0.01/$0.02 USD) - 2021/03/14 21:52:22 PT [2021/03/15 0:52:22 ET]
Table 'Piccolo IV' 9-max Seat #3 is the button
Seat 1: ppeetteerr175 ($2.43 in chips) 
Seat 2: buggspray ($1.88 in chips) 
Seat 3: Fatalimerrr ($4.03 in chips) 
Seat 4: AngryRaises ($1.84 in chips) 
Seat 6: Dorex2007 ($1.64 in chips) 
Seat 7: ser447787 ($2 in chips) 
Seat 8: KaraFara ($5.66 in chips) 
AngryRaises: posts small blind $0.01
Dorex2007: posts big blind $0.02
*** HOLE CARDS ***
Dealt to Dorex2007 [3c 7c]
ser447787: folds 
nazzak391 joins the table at seat #5 
KaraFara: folds 
ppeetteerr175: calls $0.02
buggspray: folds 
Fatalimerrr: folds 
AngryRaises: folds 
Dorex2007: checks 
*** FLOP *** [Tc 3s Jh]
Dorex2007: checks 
ppeetteerr175: bets $0.02
Dorex2007: calls $0.02
*** TURN *** [Tc 3s Jh] [Ks]
Dorex2007: checks 
ppeetteerr175: bets $0.02
Dorex2007: calls $0.02
*** RIVER *** [Tc 3s Jh Ks] [7s]
Dorex2007: checks 
ppeetteerr175: checks 
*** SHOW DOWN ***
Dorex2007: shows [3c 7c] (two pair, Sevens and Threes)
ppeetteerr175: mucks hand 
Dorex2007 collected $0.13 from pot
*** SUMMARY ***
Total pot $0.13 | Rake $0 
Board [Tc 3s Jh Ks 7s]
Seat 1: ppeetteerr175 mucked [Jc Qh]
Seat 2: buggspray folded before Flop (didn't bet)
Seat 3: Fatalimerrr (button) folded before Flop (didn't bet)
Seat 4: AngryRaises (small blind) folded before Flop
Seat 6: Dorex2007 (big blind) showed [3c 7c] and won ($0.13) with two pair, Sevens and Threes
Seat 7: ser447787 folded before Flop (didn't bet)
Seat 8: KaraFara folded before Flop (didn't bet)



PokerStars Hand #224825711258:  Hold'em No Limit ($0.01/$0.02 USD) - 2021/03/14 21:52:58 PT [2021/03/15 0:52:58 ET]
Table 'Piccolo IV' 9-max Seat #4 is the button
Seat 1: ppeetteerr175 ($2.37 in chips) 
Seat 2: buggspray ($1.88 in chips) 
Seat 3: Fatalimerrr ($4.03 in chips) 
Seat 4: AngryRaises ($1.83 in chips) 
Seat 6: Dorex2007 ($1.71 in chips) 
Seat 7: ser447787 ($2 in chips) 
Seat 8: KaraFara ($5.66 in chips) 
Dorex2007: posts small blind $0.01
ser447787: posts big blind $0.02
*** HOLE CARDS ***
Dealt to Dorex2007 [6d 4h]
KaraFara: folds 
ppeetteerr175: raises $0.02 to $0.04
buggspray: folds 
Fatalimerrr: folds 
AngryRaises: folds 
Dorex2007: folds 
ser447787: folds 
Uncalled bet ($0.02) returned to ppeetteerr175
ppeetteerr175 collected $0.05 from pot
ppeetteerr175: doesn't show hand 
*** SUMMARY ***
Total pot $0.05 | Rake $0 
Seat 1: ppeetteerr175 collected ($0.05)
Seat 2: buggspray folded before Flop (didn't bet)
Seat 3: Fatalimerrr folded before Flop (didn't bet)
Seat 4: AngryRaises (button) folded before Flop (didn't bet)
Seat 6: Dorex2007 (small blind) folded before Flop
Seat 7: ser447787 (big blind) folded before Flop
Seat 8: KaraFara folded before Flop (didn't bet)



PokerStars Hand #224825713748:  Hold'em No Limit ($0.01/$0.02 USD) - 2021/03/14 21:53:14 PT [2021/03/15 0:53:14 ET]
Table 'Piccolo IV' 9-max Seat #6 is the button
Seat 1: ppeetteerr175 ($2.40 in chips) 
Seat 2: buggspray ($1.88 in chips) 
Seat 3: Fatalimerrr ($4.03 in chips) 
Seat 4: AngryRaises ($1.83 in chips) 
Seat 5: nazzak391 ($1.60 in chips) 
Seat 6: Dorex2007 ($1.70 in chips) 
Seat 7: ser447787 ($2 in chips) 
Seat 8: KaraFara ($5.66 in chips) 
ser447787: posts small blind $0.01
KaraFara: posts big blind $0.02
nazzak391: posts big blind $0.02
*** HOLE CARDS ***
Dealt to Dorex2007 [7d 6d]
ppeetteerr175: calls $0.02
buggspray: folds 
Fatalimerrr: folds 
AngryRaises: folds 
nazzak391: checks 
Dorex2007: calls $0.02
ser447787: raises $0.10 to $0.12
KaraFara: folds 
ppeetteerr175: folds 
nazzak391: folds 
Dorex2007: folds 
Uncalled bet ($0.10) returned to ser447787
ser447787 collected $0.10 from pot
*** SUMMARY ***
Total pot $0.10 | Rake $0 
Seat 1: ppeetteerr175 folded before Flop
Seat 2: buggspray folded before Flop (didn't bet)
Seat 3: Fatalimerrr folded before Flop (didn't bet)
Seat 4: AngryRaises folded before Flop (didn't bet)
Seat 5: nazzak391 folded before Flop (didn't bet)
Seat 6: Dorex2007 (button) folded before Flop
Seat 7: ser447787 (small blind) collected ($0.10)
Seat 8: KaraFara (big blind) folded before Flop



PokerStars Hand #224825717681:  Hold'em No Limit ($0.01/$0.02 USD) - 2021/03/14 21:53:38 PT [2021/03/15 0:53:38 ET]
Table 'Piccolo IV' 9-max Seat #7 is the button
Seat 1: ppeetteerr175 ($2.38 in chips) 
Seat 2: buggspray ($1.88 in chips) 
Seat 3: Fatalimerrr ($4.03 in chips) 
Seat 4: AngryRaises ($1.83 in chips) 
Seat 5: nazzak391 ($1.58 in chips) 
Seat 6: Dorex2007 ($1.68 in chips) 
Seat 7: ser447787 ($2.08 in chips) 
Seat 8: KaraFara ($5.64 in chips) 
KaraFara: posts small blind $0.01
ppeetteerr175: posts big blind $0.02
*** HOLE CARDS ***
Dealt to Dorex2007 [5h 7h]
buggspray: folds 
Fatalimerrr: raises $0.04 to $0.06
AngryRaises: folds 
nazzak391: calls $0.06
Dorex2007: folds 
ser447787: folds 
KaraFara: folds 
ppeetteerr175: calls $0.04
*** FLOP *** [As 8s 8h]
ppeetteerr175: checks 
Fatalimerrr: checks 
nazzak391: checks 
*** TURN *** [As 8s 8h] [Ks]
ppeetteerr175: checks 
Fatalimerrr: checks 
nazzak391: checks 
*** RIVER *** [As 8s 8h Ks] [Js]
ppeetteerr175: checks 
Fatalimerrr: checks 
nazzak391: checks 
*** SHOW DOWN ***
ppeetteerr175: shows [Jc 9d] (two pair, Jacks and Eights)
Fatalimerrr: shows [6s 6d] (a flush, Ace high)
nazzak391: mucks hand 
Fatalimerrr collected $0.18 from pot
*** SUMMARY ***
Total pot $0.19 | Rake $0.01 
Board [As 8s 8h Ks Js]
Seat 1: ppeetteerr175 (big blind) showed [Jc 9d] and lost with two pair, Jacks and Eights
Seat 2: buggspray folded before Flop (didn't bet)
Seat 3: Fatalimerrr showed [6s 6d] and won ($0.18) with a flush, Ace high
Seat 4: AngryRaises folded before Flop (didn't bet)
Seat 5: nazzak391 mucked [Qh 4h]
Seat 6: Dorex2007 folded before Flop (didn't bet)
Seat 7: ser447787 (button) folded before Flop (didn't bet)
Seat 8: KaraFara (small blind) folded before Flop



PokerStars Hand #224825723992:  Hold'em No Limit ($0.01/$0.02 USD) - 2021/03/14 21:54:17 PT [2021/03/15 0:54:17 ET]
Table 'Piccolo IV' 9-max Seat #8 is the button
Seat 1: ppeetteerr175 ($2.32 in chips) 
Seat 2: buggspray ($1.88 in chips) 
Seat 3: Fatalimerrr ($4.15 in chips) 
Seat 4: AngryRaises ($1.83 in chips) 
Seat 5: nazzak391 ($1.52 in chips) 
Seat 6: Dorex2007 ($1.68 in chips) 
Seat 7: ser447787 ($2.08 in chips) 
Seat 8: KaraFara ($5.63 in chips) 
ppeetteerr175: posts small blind $0.01
buggspray: posts big blind $0.02
*** HOLE CARDS ***
Dealt to Dorex2007 [2d Kd]
Fatalimerrr: folds 
Fedya465 leaves the table
AngryRaises: calls $0.02
nazzak391: folds 
Dorex2007: folds 
ser447787: folds 
KaraFara: folds 
ppeetteerr175: calls $0.01
buggspray: raises $0.06 to $0.08
AngryRaises: calls $0.06
ppeetteerr175: folds 
*** FLOP *** [6c 9c 4c]
buggspray: bets $0.17
AngryRaises: folds 
Uncalled bet ($0.17) returned to buggspray
buggspray collected $0.17 from pot
buggspray: doesn't show hand 
*** SUMMARY ***
Total pot $0.18 | Rake $0.01 
Board [6c 9c 4c]
Seat 1: ppeetteerr175 (small blind) folded before Flop
Seat 2: buggspray (big blind) collected ($0.17)
Seat 3: Fatalimerrr folded before Flop (didn't bet)
Seat 4: AngryRaises folded on the Flop
Seat 5: nazzak391 folded before Flop (didn't bet)
Seat 6: Dorex2007 folded before Flop (didn't bet)
Seat 7: ser447787 folded before Flop (didn't bet)
Seat 8: KaraFara (button) folded before Flop (didn't bet)



PokerStars Hand #224825729232:  Hold'em No Limit ($0.01/$0.02 USD) - 2021/03/14 21:54:49 PT [2021/03/15 0:54:49 ET]
Table 'Piccolo IV' 9-max Seat #1 is the button
Seat 1: ppeetteerr175 ($2.30 in chips) 
Seat 2: buggspray ($1.97 in chips) 
Seat 3: Fatalimerrr ($4.15 in chips) 
Seat 4: AngryRaises ($1.75 in chips) 
Seat 5: nazzak391 ($1.52 in chips) 
Seat 6: Dorex2007 ($1.68 in chips) 
Seat 7: ser447787 ($2.08 in chips) 
Seat 8: KaraFara ($5.63 in chips) 
buggspray: posts small blind $0.01
Fatalimerrr: posts big blind $0.02
*** HOLE CARDS ***
Dealt to Dorex2007 [2s 6c]
AngryRaises: folds 
nazzak391: folds 
Dorex2007: folds 
ser447787: folds 
KaraFara: raises $0.02 to $0.04
ppeetteerr175: calls $0.04
buggspray: calls $0.03
Fatalimerrr: calls $0.02
*** FLOP *** [5c Jh 7h]
buggspray: checks 
Fatalimerrr: checks 
KaraFara: bets $0.05
ppeetteerr175: folds 
buggspray: folds 
Fatalimerrr: folds 
Uncalled bet ($0.05) returned to KaraFara
KaraFara collected $0.15 from pot
KaraFara: doesn't show hand 
*** SUMMARY ***
Total pot $0.16 | Rake $0.01 
Board [5c Jh 7h]
Seat 1: ppeetteerr175 (button) folded on the Flop
Seat 2: buggspray (small blind) folded on the Flop
Seat 3: Fatalimerrr (big blind) folded on the Flop
Seat 4: AngryRaises folded before Flop (didn't bet)
Seat 5: nazzak391 folded before Flop (didn't bet)
Seat 6: Dorex2007 folded before Flop (didn't bet)
Seat 7: ser447787 folded before Flop (didn't bet)
Seat 8: KaraFara collected ($0.15)



PokerStars Hand #224825735676:  Hold'em No Limit ($0.01/$0.02 USD) - 2021/03/14 21:55:33 PT [2021/03/15 0:55:33 ET]
Table 'Piccolo IV' 9-max Seat #2 is the button
Seat 1: ppeetteerr175 ($2.26 in chips) 
Seat 2: buggspray ($1.93 in chips) 
Seat 3: Fatalimerrr ($4.11 in chips) 
Seat 4: AngryRaises ($1.75 in chips) 
Seat 5: nazzak391 ($1.52 in chips) 
Seat 6: Dorex2007 ($1.68 in chips) 
Seat 7: ser447787 ($2.08 in chips) 
Seat 8: KaraFara ($5.74 in chips) 
Fatalimerrr: posts small blind $0.01
AngryRaises: posts big blind $0.02
*** HOLE CARDS ***
Dealt to Dorex2007 [8c 3s]
nazzak391: folds 
Dorex2007: folds 
ser447787: folds 
KaraFara: folds 
ppeetteerr175: folds 
buggspray: folds 
Fatalimerrr: raises $0.03 to $0.05
AngryRaises: calls $0.03
*** FLOP *** [6d 7s Js]
Fatalimerrr: bets $0.03
AngryRaises: raises $0.03 to $0.06
Fatalimerrr: folds 
Uncalled bet ($0.03) returned to AngryRaises
AngryRaises collected $0.15 from pot
AngryRaises: doesn't show hand 
*** SUMMARY ***
Total pot $0.16 | Rake $0.01 
Board [6d 7s Js]
Seat 1: ppeetteerr175 folded before Flop (didn't bet)
Seat 2: buggspray (button) folded before Flop (didn't bet)
Seat 3: Fatalimerrr (small blind) folded on the Flop
Seat 4: AngryRaises (big blind) collected ($0.15)
Seat 5: nazzak391 folded before Flop (didn't bet)
Seat 6: Dorex2007 folded before Flop (didn't bet)
Seat 7: ser447787 folded before Flop (didn't bet)
Seat 8: KaraFara folded before Flop (didn't bet)



PokerStars Hand #224825739322:  Hold'em No Limit ($0.01/$0.02 USD) - 2021/03/14 21:56:00 PT [2021/03/15 0:56:00 ET]
Table 'Piccolo IV' 9-max Seat #3 is the button
Seat 1: ppeetteerr175 ($2.26 in chips) 
Seat 2: buggspray ($1.93 in chips) 
Seat 3: Fatalimerrr ($4.03 in chips) 
Seat 4: AngryRaises ($1.82 in chips) 
Seat 5: nazzak391 ($1.52 in chips) 
Seat 6: Dorex2007 ($1.68 in chips) 
Seat 7: ser447787 ($2.08 in chips) 
Seat 8: KaraFara ($5.74 in chips) 
AngryRaises: posts small blind $0.01
nazzak391: posts big blind $0.02
*** HOLE CARDS ***
Dealt to Dorex2007 [Kc Jd]
Dorex2007: folds 
ser447787: folds 
KaraFara: folds 
ppeetteerr175: raises $0.04 to $0.06
buggspray: folds 
Fatalimerrr: folds 
AngryRaises: folds 
nazzak391: calls $0.04
*** FLOP *** [Js Qc 5c]
nazzak391: checks 
ppeetteerr175: checks 
*** TURN *** [Js Qc 5c] [6s]
nazzak391: bets $0.07
ppeetteerr175: folds 
Uncalled bet ($0.07) returned to nazzak391
nazzak391 collected $0.13 from pot
nazzak391: doesn't show hand 
*** SUMMARY ***
Total pot $0.13 | Rake $0 
Board [Js Qc 5c 6s]
Seat 1: ppeetteerr175 folded on the Turn
Seat 2: buggspray folded before Flop (didn't bet)
Seat 3: Fatalimerrr (button) folded before Flop (didn't bet)
Seat 4: AngryRaises (small blind) folded before Flop
Seat 5: nazzak391 (big blind) collected ($0.13)
Seat 6: Dorex2007 folded before Flop (didn't bet)
Seat 7: ser447787 folded before Flop (didn't bet)
Seat 8: KaraFara folded before Flop (didn't bet)



PokerStars Hand #224825743684:  Hold'em No Limit ($0.01/$0.02 USD) - 2021/03/14 21:56:32 PT [2021/03/15 0:56:32 ET]
Table 'Piccolo IV' 9-max Seat #4 is the button
Seat 1: ppeetteerr175 ($2.20 in chips) 
Seat 2: buggspray ($1.93 in chips) 
Seat 3: Fatalimerrr ($4.03 in chips) 
Seat 4: AngryRaises ($1.81 in chips) 
Seat 5: nazzak391 ($1.59 in chips) 
Seat 6: Dorex2007 ($1.68 in chips) 
Seat 7: ser447787 ($2.08 in chips) 
Seat 8: KaraFara ($5.74 in chips) 
nazzak391: posts small blind $0.01
Dorex2007: posts big blind $0.02
*** HOLE CARDS ***
Dealt to Dorex2007 [Kd 8s]
ser447787: folds 
KaraFara: raises $0.02 to $0.04
ppeetteerr175: folds 
buggspray: folds 
Fatalimerrr: raises $0.11 to $0.15
AngryRaises: folds 
nazzak391: folds 
Dorex2007: folds 
KaraFara: folds 
Uncalled bet ($0.11) returned to Fatalimerrr
Fatalimerrr collected $0.11 from pot
Fatalimerrr: doesn't show hand 
*** SUMMARY ***
Total pot $0.11 | Rake $0 
Seat 1: ppeetteerr175 folded before Flop (didn't bet)
Seat 2: buggspray folded before Flop (didn't bet)
Seat 3: Fatalimerrr collected ($0.11)
Seat 4: AngryRaises (button) folded before Flop (didn't bet)
Seat 5: nazzak391 (small blind) folded before Flop
Seat 6: Dorex2007 (big blind) folded before Flop
Seat 7: ser447787 folded before Flop (didn't bet)
Seat 8: KaraFara folded before Flop



PokerStars Hand #224825746502:  Hold'em No Limit ($0.01/$0.02 USD) - 2021/03/14 21:56:53 PT [2021/03/15 0:56:53 ET]
Table 'Piccolo IV' 9-max Seat #5 is the button
Seat 1: ppeetteerr175 ($2.20 in chips) 
Seat 2: buggspray ($1.93 in chips) 
Seat 3: Fatalimerrr ($4.10 in chips) 
Seat 4: AngryRaises ($1.81 in chips) 
Seat 5: nazzak391 ($1.58 in chips) 
Seat 6: Dorex2007 ($1.66 in chips) 
Seat 7: ser447787 ($2.08 in chips) 
Seat 8: KaraFara ($5.70 in chips) 
Dorex2007: posts small blind $0.01
ser447787: posts big blind $0.02
*** HOLE CARDS ***
Dealt to Dorex2007 [3c 2h]
KaraFara: folds 
ppeetteerr175: folds 
buggspray: folds 
Fatalimerrr: folds 
AngryRaises: folds 
nazzak391: calls $0.02
Dorex2007: folds 
ser447787: checks 
*** FLOP *** [8c 8h 6d]
ser447787: checks 
nazzak391: checks 
*** TURN *** [8c 8h 6d] [Qs]
ser447787: checks 
nazzak391: checks 
*** RIVER *** [8c 8h 6d Qs] [8d]
ser447787: checks 
nazzak391: bets $0.02
ser447787: folds 
Uncalled bet ($0.02) returned to nazzak391
nazzak391 collected $0.05 from pot
nazzak391: doesn't show hand 
*** SUMMARY ***
Total pot $0.05 | Rake $0 
Board [8c 8h 6d Qs 8d]
Seat 1: ppeetteerr175 folded before Flop (didn't bet)
Seat 2: buggspray folded before Flop (didn't bet)
Seat 3: Fatalimerrr folded before Flop (didn't bet)
Seat 4: AngryRaises folded before Flop (didn't bet)
Seat 5: nazzak391 (button) collected ($0.05)
Seat 6: Dorex2007 (small blind) folded before Flop
Seat 7: ser447787 (big blind) folded on the River
Seat 8: KaraFara folded before Flop (didn't bet)



PokerStars Hand #224825750036:  Hold'em No Limit ($0.01/$0.02 USD) - 2021/03/14 21:57:18 PT [2021/03/15 0:57:18 ET]
Table 'Piccolo IV' 9-max Seat #6 is the button
Seat 1: ppeetteerr175 ($2.20 in chips) 
Seat 2: buggspray ($1.93 in chips) 
Seat 3: Fatalimerrr ($4.10 in chips) 
Seat 4: AngryRaises ($1.81 in chips) 
Seat 5: nazzak391 ($1.61 in chips) 
Seat 6: Dorex2007 ($1.65 in chips) 
Seat 7: ser447787 ($2.06 in chips) 
Seat 8: KaraFara ($5.70 in chips) 
ser447787: posts small blind $0.01
KaraFara: posts big blind $0.02
*** HOLE CARDS ***
Dealt to Dorex2007 [8c Qd]
ppeetteerr175: folds 
buggspray: folds 
Fatalimerrr: folds 
AngryRaises: raises $0.04 to $0.06
Bada 78 joins the table at seat #9 
nazzak391: folds 
Dorex2007: folds 
ser447787: folds 
KaraFara: calls $0.04
*** FLOP *** [3h 5h 8h]
KaraFara: checks 
AngryRaises: bets $0.04
KaraFara: folds 
Uncalled bet ($0.04) returned to AngryRaises
AngryRaises collected $0.13 from pot
AngryRaises: doesn't show hand 
*** SUMMARY ***
Total pot $0.13 | Rake $0 
Board [3h 5h 8h]
Seat 1: ppeetteerr175 folded before Flop (didn't bet)
Seat 2: buggspray folded before Flop (didn't bet)
Seat 3: Fatalimerrr folded before Flop (didn't bet)
Seat 4: AngryRaises collected ($0.13)
Seat 5: nazzak391 folded before Flop (didn't bet)
Seat 6: Dorex2007 (button) folded before Flop (didn't bet)
Seat 7: ser447787 (small blind) folded before Flop
Seat 8: KaraFara (big blind) folded on the Flop



PokerStars Hand #224825754128:  Hold'em No Limit ($0.01/$0.02 USD) - 2021/03/14 21:57:48 PT [2021/03/15 0:57:48 ET]
Table 'Piccolo IV' 9-max Seat #7 is the button
Seat 1: ppeetteerr175 ($2.20 in chips) 
Seat 2: buggspray ($1.93 in chips) 
Seat 3: Fatalimerrr ($4.10 in chips) 
Seat 4: AngryRaises ($1.88 in chips) 
Seat 5: nazzak391 ($1.61 in chips) 
Seat 6: Dorex2007 ($1.65 in chips) 
Seat 7: ser447787 ($2.05 in chips) 
Seat 8: KaraFara ($5.64 in chips) 
Seat 9: Bada 78 ($1 in chips) 
KaraFara: posts small blind $0.01
Bada 78: posts big blind $0.02
*** HOLE CARDS ***
Dealt to Dorex2007 [6d 2h]
ppeetteerr175: raises $0.02 to $0.04
buggspray: folds 
Fatalimerrr: folds 
AngryRaises: raises $0.04 to $0.08
nazzak391: folds 
Dorex2007: folds 
ser447787: folds 
KaraFara: folds 
Bada 78: calls $0.06
ppeetteerr175: calls $0.04
*** FLOP *** [4d 8h Jc]
Bada 78: bets $0.12
ppeetteerr175: folds 
AngryRaises: raises $0.12 to $0.24
Bada 78: calls $0.12
*** TURN *** [4d 8h Jc] [Kd]
Bada 78: bets $0.68 and is all-in
AngryRaises: calls $0.68
*** RIVER *** [4d 8h Jc Kd] [5d]
*** SHOW DOWN ***
Bada 78: shows [9d Ks] (a pair of Kings)
AngryRaises: shows [Ad Jd] (a flush, Ace high)
AngryRaises cashed out the hand for $0.58 | Cash Out Fee $0.01
*** SUMMARY ***
Total pot $2.09 | Rake $0.07 
Board [4d 8h Jc Kd 5d]
Seat 1: ppeetteerr175 folded on the Flop
Seat 2: buggspray folded before Flop (didn't bet)
Seat 3: Fatalimerrr folded before Flop (didn't bet)
Seat 4: AngryRaises showed [Ad Jd] and won ($2.02) with a flush, Ace high (pot not awarded as player cashed out)
Seat 5: nazzak391 folded before Flop (didn't bet)
Seat 6: Dorex2007 folded before Flop (didn't bet)
Seat 7: ser447787 (button) folded before Flop (didn't bet)
Seat 8: KaraFara (small blind) folded before Flop
Seat 9: Bada 78 (big blind) showed [9d Ks] and lost with a pair of Kings



PokerStars Hand #224825760636:  Hold'em No Limit ($0.01/$0.02 USD) - 2021/03/14 21:58:34 PT [2021/03/15 0:58:34 ET]
Table 'Piccolo IV' 9-max Seat #8 is the button
Seat 1: ppeetteerr175 ($2.12 in chips) 
Seat 2: buggspray ($1.93 in chips) 
Seat 3: Fatalimerrr ($4.10 in chips) 
Seat 4: AngryRaises ($1.46 in chips) 
Seat 5: nazzak391 ($1.61 in chips) 
Seat 6: Dorex2007 ($1.65 in chips) 
Seat 7: ser447787 ($2.05 in chips) 
Seat 8: KaraFara ($5.63 in chips) 
ppeetteerr175: posts small blind $0.01
buggspray: posts big blind $0.02
*** HOLE CARDS ***
Dealt to Dorex2007 [Qc 5h]
Fatalimerrr: folds 
AngryRaises: raises $0.05 to $0.07
nazzak391: folds 
Dorex2007: folds 
ser447787: folds 
KaraFara: calls $0.07
ppeetteerr175: folds 
buggspray: folds 
*** FLOP *** [9d Qd 2c]
AngryRaises: checks 
KaraFara: checks 
*** TURN *** [9d Qd 2c] [8h]
AngryRaises: checks 
KaraFara: checks 
*** RIVER *** [9d Qd 2c 8h] [5d]
AngryRaises: checks 
KaraFara: checks 
*** SHOW DOWN ***
AngryRaises: shows [Ad Ks] (high card Ace)
KaraFara: shows [Ts Td] (a pair of Tens)
KaraFara collected $0.16 from pot
*** SUMMARY ***
Total pot $0.17 | Rake $0.01 
Board [9d Qd 2c 8h 5d]
Seat 1: ppeetteerr175 (small blind) folded before Flop
Seat 2: buggspray (big blind) folded before Flop
Seat 3: Fatalimerrr folded before Flop (didn't bet)
Seat 4: AngryRaises showed [Ad Ks] and lost with high card Ace
Seat 5: nazzak391 folded before Flop (didn't bet)
Seat 6: Dorex2007 folded before Flop (didn't bet)
Seat 7: ser447787 folded before Flop (didn't bet)
Seat 8: KaraFara (button) showed [Ts Td] and won ($0.16) with a pair of Tens



PokerStars Hand #224825765613:  Hold'em No Limit ($0.01/$0.02 USD) - 2021/03/14 21:59:10 PT [2021/03/15 0:59:10 ET]
Table 'Piccolo IV' 9-max Seat #1 is the button
Seat 1: ppeetteerr175 ($2.11 in chips) 
Seat 2: buggspray ($1.91 in chips) 
Seat 3: Fatalimerrr ($4.10 in chips) 
Seat 4: AngryRaises ($1.39 in chips) 
Seat 5: nazzak391 ($1.61 in chips) 
Seat 6: Dorex2007 ($1.65 in chips) 
Seat 7: ser447787 ($2.05 in chips) 
Seat 8: KaraFara ($5.72 in chips) 
Seat 9: Bada 78 ($1 in chips) 
buggspray: posts small blind $0.01
Fatalimerrr: posts big blind $0.02
Bada 78: posts small blind $0.01
*** HOLE CARDS ***
Dealt to Dorex2007 [5h 2h]
AngryRaises: folds 
nazzak391: calls $0.02
Dorex2007: folds 
ser447787: folds 
KaraFara: folds 
Bada 78: calls $0.02
ppeetteerr175: calls $0.02
buggspray: calls $0.01
Fatalimerrr: checks 
*** FLOP *** [Kh 2s Tc]
buggspray: checks 
Fatalimerrr: checks 
nazzak391: checks 
Bada 78: checks 
ppeetteerr175: bets $0.06
buggspray: folds 
Fatalimerrr: folds 
nazzak391: folds 
Bada 78: folds 
Uncalled bet ($0.06) returned to ppeetteerr175
ppeetteerr175 collected $0.11 from pot
ppeetteerr175: doesn't show hand 
*** SUMMARY ***
Total pot $0.11 | Rake $0 
Board [Kh 2s Tc]
Seat 1: ppeetteerr175 (button) collected ($0.11)
Seat 2: buggspray (small blind) folded on the Flop
Seat 3: Fatalimerrr (big blind) folded on the Flop
Seat 4: AngryRaises folded before Flop (didn't bet)
Seat 5: nazzak391 folded on the Flop
Seat 6: Dorex2007 folded before Flop (didn't bet)
Seat 7: ser447787 folded before Flop (didn't bet)
Seat 8: KaraFara folded before Flop (didn't bet)
Seat 9: Bada 78 folded on the Flop



PokerStars Hand #224825771571:  Hold'em No Limit ($0.01/$0.02 USD) - 2021/03/14 21:59:53 PT [2021/03/15 0:59:53 ET]
Table 'Piccolo IV' 9-max Seat #2 is the button
Seat 1: ppeetteerr175 ($2.20 in chips) 
Seat 2: buggspray ($1.89 in chips) 
Seat 3: Fatalimerrr ($4.08 in chips) 
Seat 4: AngryRaises ($1.39 in chips) 
Seat 5: nazzak391 ($1.59 in chips) 
Seat 6: Dorex2007 ($1.65 in chips) 
Seat 7: ser447787 ($2.05 in chips) 
Seat 8: KaraFara ($5.72 in chips) 
Seat 9: Bada 78 ($0.97 in chips) 
Fatalimerrr: posts small blind $0.01
AngryRaises: posts big blind $0.02
*** HOLE CARDS ***
Dealt to Dorex2007 [2d 6d]
nazzak391: folds 
Dorex2007: folds 
ser447787: folds 
KaraFara: folds 
Bada 78 has timed out
Bada 78: folds 
ppeetteerr175: folds 
buggspray: folds 
Fatalimerrr: folds 
Uncalled bet ($0.01) returned to AngryRaises
AngryRaises collected $0.02 from pot
AngryRaises: doesn't show hand 
*** SUMMARY ***
Total pot $0.02 | Rake $0 
Seat 1: ppeetteerr175 folded before Flop (didn't bet)
Seat 2: buggspray (button) folded before Flop (didn't bet)
Seat 3: Fatalimerrr (small blind) folded before Flop
Seat 4: AngryRaises (big blind) collected ($0.02)
Seat 5: nazzak391 folded before Flop (didn't bet)
Seat 6: Dorex2007 folded before Flop (didn't bet)
Seat 7: ser447787 folded before Flop (didn't bet)
Seat 8: KaraFara folded before Flop (didn't bet)
Seat 9: Bada 78 folded before Flop (didn't bet)



PokerStars Hand #224825774758:  Hold'em No Limit ($0.01/$0.02 USD) - 2021/03/14 22:00:15 PT [2021/03/15 1:00:15 ET]
Table 'Piccolo IV' 9-max Seat #3 is the button
Seat 1: ppeetteerr175 ($2.20 in chips) 
Seat 2: buggspray ($1.89 in chips) 
Seat 3: Fatalimerrr ($4.07 in chips) 
Seat 4: AngryRaises ($1.40 in chips) 
Seat 5: nazzak391 ($1.59 in chips) 
Seat 6: Dorex2007 ($1.65 in chips) 
Seat 7: ser447787 ($2.05 in chips) 
Seat 8: KaraFara ($5.72 in chips) 
Seat 9: Bada 78 ($0.97 in chips) 
AngryRaises: posts small blind $0.01
nazzak391: posts big blind $0.02
*** HOLE CARDS ***
Dealt to Dorex2007 [5h 4h]
Dorex2007: folds 
ser447787: folds 
KaraFara: folds 
Bada 78: raises $0.04 to $0.06
ppeetteerr175: folds 
buggspray: folds 
Fatalimerrr: folds 
AngryRaises: folds 
nazzak391: folds 
Uncalled bet ($0.04) returned to Bada 78
Bada 78 collected $0.05 from pot
Bada 78: doesn't show hand 
*** SUMMARY ***
Total pot $0.05 | Rake $0 
Seat 1: ppeetteerr175 folded before Flop (didn't bet)
Seat 2: buggspray folded before Flop (didn't bet)
Seat 3: Fatalimerrr (button) folded before Flop (didn't bet)
Seat 4: AngryRaises (small blind) folded before Flop
Seat 5: nazzak391 (big blind) folded before Flop
Seat 6: Dorex2007 folded before Flop (didn't bet)
Seat 7: ser447787 folded before Flop (didn't bet)
Seat 8: KaraFara folded before Flop (didn't bet)
Seat 9: Bada 78 collected ($0.05)



PokerStars Hand #224825777292:  Hold'em No Limit ($0.01/$0.02 USD) - 2021/03/14 22:00:32 PT [2021/03/15 1:00:32 ET]
Table 'Piccolo IV' 9-max Seat #4 is the button
Seat 1: ppeetteerr175 ($2.20 in chips) 
Seat 2: buggspray ($1.89 in chips) 
Seat 3: Fatalimerrr ($4.07 in chips) 
Seat 4: AngryRaises ($1.39 in chips) 
Seat 5: nazzak391 ($1.57 in chips) 
Seat 6: Dorex2007 ($1.65 in chips) 
Seat 7: ser447787 ($2.05 in chips) 
Seat 8: KaraFara ($5.72 in chips) 
Seat 9: Bada 78 ($1 in chips) 
nazzak391: posts small blind $0.01
Dorex2007: posts big blind $0.02
*** HOLE CARDS ***
Dealt to Dorex2007 [7c Kc]
ser447787: folds 
KaraFara: folds 
Bada 78: folds 
ppeetteerr175: raises $0.02 to $0.04
buggspray: calls $0.04
Fatalimerrr: folds 
AngryRaises: calls $0.04
nazzak391: calls $0.03
Dorex2007: calls $0.02
*** FLOP *** [Ks 4c 5d]
nazzak391: checks 
Dorex2007: bets $0.19
ppeetteerr175: folds 
buggspray: folds 
AngryRaises: folds 
nazzak391: folds 
Uncalled bet ($0.19) returned to Dorex2007
Dorex2007 collected $0.19 from pot
Dorex2007: doesn't show hand 
*** SUMMARY ***
Total pot $0.20 | Rake $0.01 
Board [Ks 4c 5d]
Seat 1: ppeetteerr175 folded on the Flop
Seat 2: buggspray folded on the Flop
Seat 3: Fatalimerrr folded before Flop (didn't bet)
Seat 4: AngryRaises (button) folded on the Flop
Seat 5: nazzak391 (small blind) folded on the Flop
Seat 6: Dorex2007 (big blind) collected ($0.19)
Seat 7: ser447787 folded before Flop (didn't bet)
Seat 8: KaraFara folded before Flop (didn't bet)
Seat 9: Bada 78 folded before Flop (didn't bet)



PokerStars Hand #224825783273:  Hold'em No Limit ($0.01/$0.02 USD) - 2021/03/14 22:01:10 PT [2021/03/15 1:01:10 ET]
Table 'Piccolo IV' 9-max Seat #5 is the button
Seat 1: ppeetteerr175 ($2.16 in chips) 
Seat 2: buggspray ($1.85 in chips) 
Seat 3: Fatalimerrr ($4.07 in chips) 
Seat 4: AngryRaises ($1.35 in chips) 
Seat 5: nazzak391 ($1.53 in chips) 
Seat 6: Dorex2007 ($1.80 in chips) 
Seat 7: ser447787 ($2.05 in chips) 
Seat 8: KaraFara ($5.72 in chips) 
Seat 9: Bada 78 ($1 in chips) 
Dorex2007: posts small blind $0.01
ser447787: posts big blind $0.02
*** HOLE CARDS ***
Dealt to Dorex2007 [2s 4h]
KaraFara: folds 
Bada 78: folds 
ppeetteerr175: folds 
buggspray: folds 
Fatalimerrr: folds 
AngryRaises: folds 
nazzak391: calls $0.02
Dorex2007: calls $0.01
ser447787: checks 
*** FLOP *** [Ks Ah 8c]
Dorex2007: checks 
ser447787: checks 
nazzak391: checks 
*** TURN *** [Ks Ah 8c] [As]
Dorex2007: checks 
ser447787: checks 
nazzak391: checks 
*** RIVER *** [Ks Ah 8c As] [8s]
Dorex2007: bets $0.06
ser447787: folds 
nazzak391: calls $0.06
*** SHOW DOWN ***
Dorex2007: shows [2s 4h] (two pair, Aces and Eights)
nazzak391: shows [Js 9s] (a flush, Ace high)
nazzak391 collected $0.17 from pot
*** SUMMARY ***
Total pot $0.18 | Rake $0.01 
Board [Ks Ah 8c As 8s]
Seat 1: ppeetteerr175 folded before Flop (didn't bet)
Seat 2: buggspray folded before Flop (didn't bet)
Seat 3: Fatalimerrr folded before Flop (didn't bet)
Seat 4: AngryRaises folded before Flop (didn't bet)
Seat 5: nazzak391 (button) showed [Js 9s] and won ($0.17) with a flush, Ace high
Seat 6: Dorex2007 (small blind) showed [2s 4h] and lost with two pair, Aces and Eights
Seat 7: ser447787 (big blind) folded on the River
Seat 8: KaraFara folded before Flop (didn't bet)
Seat 9: Bada 78 folded before Flop (didn't bet)



PokerStars Hand #224825788200:  Hold'em No Limit ($0.01/$0.02 USD) - 2021/03/14 22:01:43 PT [2021/03/15 1:01:43 ET]
Table 'Piccolo IV' 9-max Seat #6 is the button
Seat 1: ppeetteerr175 ($2.16 in chips) 
Seat 2: buggspray ($1.85 in chips) 
Seat 3: Fatalimerrr ($4.07 in chips) 
Seat 4: AngryRaises ($1.35 in chips) 
Seat 5: nazzak391 ($1.62 in chips) 
Seat 6: Dorex2007 ($1.72 in chips) 
Seat 7: ser447787 ($2.03 in chips) 
Seat 8: KaraFara ($5.72 in chips) 
Seat 9: Bada 78 ($1 in chips) 
ser447787: posts small blind $0.01
KaraFara: posts big blind $0.02
*** HOLE CARDS ***
Dealt to Dorex2007 [Kc 5s]
Bada 78 has timed out
Bada 78: folds 
ppeetteerr175: raises $0.02 to $0.04
buggspray: calls $0.04
Fatalimerrr: folds 
AngryRaises: folds 
nazzak391: calls $0.04
Dorex2007: folds 
ser447787: folds 
KaraFara: calls $0.02
*** FLOP *** [Ac 2c Td]
KaraFara: bets $0.10
ppeetteerr175: folds 
buggspray: calls $0.10
nazzak391: folds 
*** TURN *** [Ac 2c Td] [Ts]
KaraFara: bets $0.11
buggspray: calls $0.11
*** RIVER *** [Ac 2c Td Ts] [6c]
KaraFara: checks 
buggspray: checks 
*** SHOW DOWN ***
KaraFara: shows [Js As] (two pair, Aces and Tens)
buggspray: shows [Ah Jc] (two pair, Aces and Tens)
KaraFara collected $0.29 from pot
buggspray collected $0.28 from pot
*** SUMMARY ***
Total pot $0.59 | Rake $0.02 
Board [Ac 2c Td Ts 6c]
Seat 1: ppeetteerr175 folded on the Flop
Seat 2: buggspray showed [Ah Jc] and won ($0.28) with two pair, Aces and Tens
Seat 3: Fatalimerrr folded before Flop (didn't bet)
Seat 4: AngryRaises folded before Flop (didn't bet)
Seat 5: nazzak391 folded on the Flop
Seat 6: Dorex2007 (button) folded before Flop (didn't bet)
Seat 7: ser447787 (small blind) folded before Flop
Seat 8: KaraFara (big blind) showed [Js As] and won ($0.29) with two pair, Aces and Tens
Seat 9: Bada 78 folded before Flop (didn't bet)



PokerStars Hand #224825795319:  Hold'em No Limit ($0.01/$0.02 USD) - 2021/03/14 22:02:29 PT [2021/03/15 1:02:29 ET]
Table 'Piccolo IV' 9-max Seat #7 is the button
Seat 1: ppeetteerr175 ($2.12 in chips) 
Seat 2: buggspray ($1.88 in chips) 
Seat 3: Fatalimerrr ($4.07 in chips) 
Seat 4: AngryRaises ($1.35 in chips) 
Seat 5: nazzak391 ($1.58 in chips) 
Seat 6: Dorex2007 ($2 in chips) 
Seat 7: ser447787 ($2.02 in chips) 
Seat 8: KaraFara ($5.76 in chips) 
KaraFara: posts small blind $0.01
ppeetteerr175: posts big blind $0.02
*** HOLE CARDS ***
Dealt to Dorex2007 [5d Th]
buggspray: folds 
Fatalimerrr: folds 
AngryRaises: calls $0.02
nazzak391: folds 
Dorex2007: folds 
ser447787: folds 
KaraFara: folds 
ppeetteerr175: checks 
*** FLOP *** [8h Kd Qc]
ppeetteerr175: checks 
AngryRaises: bets $0.06
ppeetteerr175: folds 
Uncalled bet ($0.06) returned to AngryRaises
AngryRaises collected $0.05 from pot
AngryRaises: doesn't show hand 
*** SUMMARY ***
Total pot $0.05 | Rake $0 
Board [8h Kd Qc]
Seat 1: ppeetteerr175 (big blind) folded on the Flop
Seat 2: buggspray folded before Flop (didn't bet)
Seat 3: Fatalimerrr folded before Flop (didn't bet)
Seat 4: AngryRaises collected ($0.05)
Seat 5: nazzak391 folded before Flop (didn't bet)
Seat 6: Dorex2007 folded before Flop (didn't bet)
Seat 7: ser447787 (button) folded before Flop (didn't bet)
Seat 8: KaraFara (small blind) folded before Flop



PokerStars Hand #224825800127:  Hold'em No Limit ($0.01/$0.02 USD) - 2021/03/14 22:02:59 PT [2021/03/15 1:02:59 ET]
Table 'Piccolo IV' 9-max Seat #8 is the button
Seat 1: ppeetteerr175 ($2.10 in chips) 
Seat 2: buggspray ($1.88 in chips) 
Seat 3: Fatalimerrr ($4.07 in chips) 
Seat 4: AngryRaises ($1.38 in chips) 
Seat 5: nazzak391 ($1.58 in chips) 
Seat 6: Dorex2007 ($2 in chips) 
Seat 7: ser447787 ($2.02 in chips) 
Seat 8: KaraFara ($5.75 in chips) 
ppeetteerr175: posts small blind $0.01
buggspray: posts big blind $0.02
*** HOLE CARDS ***
Dealt to Dorex2007 [7c 6h]
Fatalimerrr: folds 
AngryRaises: folds 
nazzak391: calls $0.02
Dorex2007: folds 
ser447787: folds 
KaraFara: folds 
ppeetteerr175: raises $0.04 to $0.06
buggspray: folds 
nazzak391: calls $0.04
*** FLOP *** [8d 4c 2d]
ppeetteerr175: checks 
nazzak391: checks 
*** TURN *** [8d 4c 2d] [5d]
ppeetteerr175: bets $0.02
nazzak391: folds 
Uncalled bet ($0.02) returned to ppeetteerr175
ppeetteerr175 collected $0.14 from pot
ppeetteerr175: doesn't show hand 
*** SUMMARY ***
Total pot $0.14 | Rake $0 
Board [8d 4c 2d 5d]
Seat 1: ppeetteerr175 (small blind) collected ($0.14)
Seat 2: buggspray (big blind) folded before Flop
Seat 3: Fatalimerrr folded before Flop (didn't bet)
Seat 4: AngryRaises folded before Flop (didn't bet)
Seat 5: nazzak391 folded on the Turn
Seat 6: Dorex2007 folded before Flop (didn't bet)
Seat 7: ser447787 folded before Flop (didn't bet)
Seat 8: KaraFara (button) folded before Flop (didn't bet)



PokerStars Hand #224825812592:  Hold'em No Limit ($0.01/$0.02 USD) - 2021/03/14 22:03:30 PT [2021/03/15 1:03:30 ET]
Table 'Piccolo IV' 9-max Seat #1 is the button
Seat 1: ppeetteerr175 ($2.18 in chips) 
Seat 2: buggspray ($1.86 in chips) 
Seat 3: Fatalimerrr ($4.07 in chips) 
Seat 4: AngryRaises ($1.38 in chips) 
Seat 5: nazzak391 ($1.52 in chips) 
Seat 6: Dorex2007 ($2 in chips) 
Seat 7: ser447787 ($2.02 in chips) 
Seat 8: KaraFara ($5.75 in chips) 
Seat 9: Bada 78 ($1 in chips) 
buggspray: posts small blind $0.01
Fatalimerrr: posts big blind $0.02
Bada 78: posts small & big blinds $0.03
*** HOLE CARDS ***
Dealt to Dorex2007 [Qd 6s]
AngryRaises: folds 
nazzak391: calls $0.02
Dorex2007: folds 
ser447787: folds 
KaraFara: folds 
Bada 78: checks 
ppeetteerr175: calls $0.02
buggspray: calls $0.01
Fatalimerrr: checks 
*** FLOP *** [4c Js Td]
buggspray: checks 
Fatalimerrr: bets $0.04
nazzak391: folds 
Bada 78: folds 
ppeetteerr175: calls $0.04
buggspray: folds 
*** TURN *** [4c Js Td] [7d]
Fatalimerrr: bets $0.06
ppeetteerr175: raises $0.06 to $0.12
Fatalimerrr: calls $0.06
*** RIVER *** [4c Js Td 7d] [6d]
Fatalimerrr: checks 
ppeetteerr175: bets $0.02
Fatalimerrr: folds 
Uncalled bet ($0.02) returned to ppeetteerr175
Bada 78 is disconnected 
ppeetteerr175 collected $0.41 from pot
ppeetteerr175: doesn't show hand 
*** SUMMARY ***
Total pot $0.43 | Rake $0.02 
Board [4c Js Td 7d 6d]
Seat 1: ppeetteerr175 (button) collected ($0.41)
Seat 2: buggspray (small blind) folded on the Flop
Seat 3: Fatalimerrr (big blind) folded on the River
Seat 4: AngryRaises folded before Flop (didn't bet)
Seat 5: nazzak391 folded on the Flop
Seat 6: Dorex2007 folded before Flop (didn't bet)
Seat 7: ser447787 folded before Flop (didn't bet)
Seat 8: KaraFara folded before Flop (didn't bet)
Seat 9: Bada 78 folded on the Flop (didn't bet)



PokerStars Hand #224825826235:  Hold'em No Limit ($0.01/$0.02 USD) - 2021/03/14 22:04:57 PT [2021/03/15 1:04:57 ET]
Table 'Piccolo IV' 9-max Seat #2 is the button
Seat 1: ppeetteerr175 ($2.41 in chips) 
Seat 2: buggspray ($1.84 in chips) 
Seat 3: Fatalimerrr ($3.89 in chips) 
Seat 4: AngryRaises ($1.38 in chips) 
Seat 5: nazzak391 ($1.50 in chips) 
Seat 6: Dorex2007 ($2 in chips) 
Seat 7: ser447787 ($2.02 in chips) 
Seat 8: KaraFara ($5.75 in chips) 
Seat 9: Bada 78 ($0.97 in chips) 
Fatalimerrr: posts small blind $0.01
AngryRaises: posts big blind $0.02
*** HOLE CARDS ***
Dealt to Dorex2007 [3s Th]
nazzak391: folds 
Dorex2007: folds 
ser447787 has timed out
ser447787: folds 
KaraFara: folds 
Bada 78: folds 
ppeetteerr175: folds 
buggspray: folds 
Fatalimerrr: folds 
Uncalled bet ($0.01) returned to AngryRaises
AngryRaises collected $0.02 from pot
AngryRaises: doesn't show hand 
*** SUMMARY ***
Total pot $0.02 | Rake $0 
Seat 1: ppeetteerr175 folded before Flop (didn't bet)
Seat 2: buggspray (button) folded before Flop (didn't bet)
Seat 3: Fatalimerrr (small blind) folded before Flop
Seat 4: AngryRaises (big blind) collected ($0.02)
Seat 5: nazzak391 folded before Flop (didn't bet)
Seat 6: Dorex2007 folded before Flop (didn't bet)
Seat 7: ser447787 folded before Flop (didn't bet)
Seat 8: KaraFara folded before Flop (didn't bet)
Seat 9: Bada 78 folded before Flop (didn't bet)



PokerStars Hand #224825830569:  Hold'em No Limit ($0.01/$0.02 USD) - 2021/03/14 22:05:25 PT [2021/03/15 1:05:25 ET]
Table 'Piccolo IV' 9-max Seat #3 is the button
Seat 1: ppeetteerr175 ($2.41 in chips) 
Seat 2: buggspray ($1.84 in chips) 
Seat 3: Fatalimerrr ($3.88 in chips) 
Seat 4: AngryRaises ($1.39 in chips) 
Seat 5: nazzak391 ($1.50 in chips) 
Seat 6: Dorex2007 ($2 in chips) 
Seat 8: KaraFara ($5.75 in chips) 
Seat 9: Bada 78 ($0.97 in chips) 
AngryRaises: posts small blind $0.01
nazzak391: posts big blind $0.02
*** HOLE CARDS ***
Dealt to Dorex2007 [8c 6d]
Dorex2007: folds 
KaraFara: folds 
Bada 78: folds 
ppeetteerr175: folds 
buggspray: raises $0.02 to $0.04
Fatalimerrr: folds 
AngryRaises: calls $0.03
nazzak391: calls $0.02
*** FLOP *** [Ks Kc 2s]
AngryRaises: checks 
nazzak391: checks 
buggspray: bets $0.02
AngryRaises: calls $0.02
nazzak391: folds 
*** TURN *** [Ks Kc 2s] [9c]
AngryRaises: bets $0.02
buggspray: calls $0.02
*** RIVER *** [Ks Kc 2s 9c] [4s]
AngryRaises: bets $0.02
buggspray: raises $0.12 to $0.14
AngryRaises: folds 
Uncalled bet ($0.12) returned to buggspray
buggspray collected $0.23 from pot
buggspray: doesn't show hand 
*** SUMMARY ***
Total pot $0.24 | Rake $0.01 
Board [Ks Kc 2s 9c 4s]
Seat 1: ppeetteerr175 folded before Flop (didn't bet)
Seat 2: buggspray collected ($0.23)
Seat 3: Fatalimerrr (button) folded before Flop (didn't bet)
Seat 4: AngryRaises (small blind) folded on the River
Seat 5: nazzak391 (big blind) folded on the Flop
Seat 6: Dorex2007 folded before Flop (didn't bet)
Seat 8: KaraFara folded before Flop (didn't bet)
Seat 9: Bada 78 folded before Flop (didn't bet)



PokerStars Hand #224825838217:  Hold'em No Limit ($0.01/$0.02 USD) - 2021/03/14 22:06:14 PT [2021/03/15 1:06:14 ET]
Table 'Piccolo IV' 9-max Seat #4 is the button
Seat 1: ppeetteerr175 ($2.41 in chips) 
Seat 2: buggspray ($1.97 in chips) 
Seat 3: Fatalimerrr ($3.88 in chips) 
Seat 4: AngryRaises ($1.29 in chips) 
Seat 5: nazzak391 ($1.46 in chips) 
Seat 6: Dorex2007 ($2 in chips) 
Seat 7: ser447787 ($2.02 in chips) 
Seat 8: KaraFara ($5.75 in chips) 
Seat 9: Bada 78 ($0.97 in chips) 
nazzak391: posts small blind $0.01
Dorex2007: posts big blind $0.02
*** HOLE CARDS ***
Dealt to Dorex2007 [7s 4s]
ser447787: folds 
KaraFara: folds 
Bada 78: folds 
Bada 78 leaves the table
ppeetteerr175: folds 
buggspray: folds 
Fatalimerrr: folds 
AngryRaises: folds 
nazzak391: calls $0.01
Dorex2007: checks 
*** FLOP *** [3c 5d Kd]
nazzak391: checks 
Dorex2007: checks 
*** TURN *** [3c 5d Kd] [Jd]
izak380 joins the table at seat #9 
nazzak391: checks 
Dorex2007: bets $0.04
nazzak391: calls $0.04
*** RIVER *** [3c 5d Kd Jd] [6c]
nazzak391: checks 
Dorex2007: checks 
*** SHOW DOWN ***
nazzak391: shows [7h Js] (a pair of Jacks)
Dorex2007: shows [7s 4s] (a straight, Three to Seven)
Dorex2007 collected $0.12 from pot
*** SUMMARY ***
Total pot $0.12 | Rake $0 
Board [3c 5d Kd Jd 6c]
Seat 1: ppeetteerr175 folded before Flop (didn't bet)
Seat 2: buggspray folded before Flop (didn't bet)
Seat 3: Fatalimerrr folded before Flop (didn't bet)
Seat 4: AngryRaises (button) folded before Flop (didn't bet)
Seat 5: nazzak391 (small blind) showed [7h Js] and lost with a pair of Jacks
Seat 6: Dorex2007 (big blind) showed [7s 4s] and won ($0.12) with a straight, Three to Seven
Seat 7: ser447787 folded before Flop (didn't bet)
Seat 8: KaraFara folded before Flop (didn't bet)
Seat 9: Bada 78 folded before Flop (didn't bet)



PokerStars Hand #224825843334:  Hold'em No Limit ($0.01/$0.02 USD) - 2021/03/14 22:06:46 PT [2021/03/15 1:06:46 ET]
Table 'Piccolo IV' 9-max Seat #5 is the button
Seat 1: ppeetteerr175 ($2.41 in chips) 
Seat 2: buggspray ($1.97 in chips) 
Seat 3: Fatalimerrr ($3.88 in chips) 
Seat 4: AngryRaises ($1.29 in chips) 
Seat 5: nazzak391 ($1.40 in chips) 
Seat 6: Dorex2007 ($2.06 in chips) 
Seat 7: ser447787 ($2.02 in chips) 
Seat 8: KaraFara ($5.75 in chips) 
Dorex2007: posts small blind $0.01
ser447787: posts big blind $0.02
izak380: sits out 
*** HOLE CARDS ***
Dealt to Dorex2007 [4h As]
KaraFara: folds 
ppeetteerr175: folds 
buggspray: folds 
Fatalimerrr: folds 
AngryRaises: calls $0.02
nazzak391: calls $0.02
Dorex2007: calls $0.01
ser447787: checks 
*** FLOP *** [6c 8h 2c]
Dorex2007: checks 
ser447787: checks 
AngryRaises: checks 
nazzak391: checks 
*** TURN *** [6c 8h 2c] [6s]
Dorex2007: checks 
ser447787: checks 
AngryRaises: bets $0.04
nazzak391: folds 
Dorex2007: folds 
ser447787: folds 
Uncalled bet ($0.04) returned to AngryRaises
AngryRaises collected $0.08 from pot
AngryRaises: doesn't show hand 
*** SUMMARY ***
Total pot $0.08 | Rake $0 
Board [6c 8h 2c 6s]
Seat 1: ppeetteerr175 folded before Flop (didn't bet)
Seat 2: buggspray folded before Flop (didn't bet)
Seat 3: Fatalimerrr folded before Flop (didn't bet)
Seat 4: AngryRaises collected ($0.08)
Seat 5: nazzak391 (button) folded on the Turn
Seat 6: Dorex2007 (small blind) folded on the Turn
Seat 7: ser447787 (big blind) folded on the Turn
Seat 8: KaraFara folded before Flop (didn't bet)



PokerStars Hand #224825851572:  Hold'em No Limit ($0.01/$0.02 USD) - 2021/03/14 22:07:40 PT [2021/03/15 1:07:40 ET]
Table 'Piccolo IV' 9-max Seat #6 is the button
Seat 1: ppeetteerr175 ($2.41 in chips) 
Seat 2: buggspray ($1.97 in chips) 
Seat 3: Fatalimerrr ($3.88 in chips) 
Seat 4: AngryRaises ($1.35 in chips) 
Seat 5: nazzak391 ($1.38 in chips) 
Seat 6: Dorex2007 ($2.04 in chips) 
Seat 7: ser447787 ($2 in chips) 
Seat 8: KaraFara ($5.75 in chips) 
ser447787: posts small blind $0.01
KaraFara: posts big blind $0.02
izak380: sits out 
*** HOLE CARDS ***
Dealt to Dorex2007 [3h Tc]
ppeetteerr175: raises $0.02 to $0.04
buggspray: folds 
Fatalimerrr: calls $0.04
AngryRaises: calls $0.04
nazzak391: calls $0.04
Dorex2007: folds 
ser447787: folds 
KaraFara: folds 
*** FLOP *** [Jc 4h Ks]
ppeetteerr175: bets $0.02
Fatalimerrr: calls $0.02
AngryRaises: calls $0.02
nazzak391: calls $0.02
*** TURN *** [Jc 4h Ks] [5c]
ppeetteerr175: checks 
Fatalimerrr: checks 
AngryRaises: checks 
nazzak391: checks 
*** RIVER *** [Jc 4h Ks 5c] [6h]
ppeetteerr175: bets $0.02
Fatalimerrr: folds 
AngryRaises: folds 
nazzak391: folds 
Uncalled bet ($0.02) returned to ppeetteerr175
nazzak391 leaves the table
ppeetteerr175 collected $0.26 from pot
ppeetteerr175: doesn't show hand 
*** SUMMARY ***
Total pot $0.27 | Rake $0.01 
Board [Jc 4h Ks 5c 6h]
Seat 1: ppeetteerr175 collected ($0.26)
Seat 2: buggspray folded before Flop (didn't bet)
Seat 3: Fatalimerrr folded on the River
Seat 4: AngryRaises folded on the River
Seat 5: nazzak391 folded on the River
Seat 6: Dorex2007 (button) folded before Flop (didn't bet)
Seat 7: ser447787 (small blind) folded before Flop
Seat 8: KaraFara (big blind) folded before Flop



PokerStars Hand #224825859335:  Hold'em No Limit ($0.01/$0.02 USD) - 2021/03/14 22:08:29 PT [2021/03/15 1:08:29 ET]
Table 'Piccolo IV' 9-max Seat #7 is the button
Seat 1: ppeetteerr175 ($2.61 in chips) 
Seat 2: buggspray ($1.97 in chips) 
Seat 3: Fatalimerrr ($3.82 in chips) 
Seat 4: AngryRaises ($1.29 in chips) 
Seat 6: Dorex2007 ($2.04 in chips) 
Seat 7: ser447787 ($2 in chips) 
Seat 8: KaraFara ($5.73 in chips) 
Seat 9: izak380 ($1.60 in chips) 
KaraFara: posts small blind $0.01
izak380: posts big blind $0.02
*** HOLE CARDS ***
Dealt to Dorex2007 [Js Qs]
ppeetteerr175: folds 
buggspray: folds 
Fatalimerrr: folds 
AngryRaises: folds 
Dorex2007: raises $0.04 to $0.06
ser447787: folds 
KaraFara: folds 
izak380: calls $0.04
*** FLOP *** [9c 8h 6h]
izak380: bets $0.02
Dorex2007: raises $0.02 to $0.04
izak380: raises $0.02 to $0.06
Dorex2007: calls $0.02
*** TURN *** [9c 8h 6h] [4h]
izak380: bets $0.44
Dorex2007: folds 
Uncalled bet ($0.44) returned to izak380
izak380 collected $0.24 from pot
izak380: doesn't show hand 
*** SUMMARY ***
Total pot $0.25 | Rake $0.01 
Board [9c 8h 6h 4h]
Seat 1: ppeetteerr175 folded before Flop (didn't bet)
Seat 2: buggspray folded before Flop (didn't bet)
Seat 3: Fatalimerrr folded before Flop (didn't bet)
Seat 4: AngryRaises folded before Flop (didn't bet)
Seat 6: Dorex2007 folded on the Turn
Seat 7: ser447787 (button) folded before Flop (didn't bet)
Seat 8: KaraFara (small blind) folded before Flop
Seat 9: izak380 (big blind) collected ($0.24)



PokerStars Hand #224825865859:  Hold'em No Limit ($0.01/$0.02 USD) - 2021/03/14 22:09:11 PT [2021/03/15 1:09:11 ET]
Table 'Piccolo IV' 9-max Seat #8 is the button
Seat 1: ppeetteerr175 ($2.61 in chips) 
Seat 2: buggspray ($1.97 in chips) 
Seat 3: Fatalimerrr ($3.82 in chips) 
Seat 4: AngryRaises ($1.29 in chips) 
Seat 6: Dorex2007 ($1.92 in chips) 
Seat 7: ser447787 ($2 in chips) 
Seat 8: KaraFara ($5.72 in chips) 
Seat 9: izak380 ($1.72 in chips) 
izak380: posts small blind $0.01
ppeetteerr175: posts big blind $0.02
*** HOLE CARDS ***
Dealt to Dorex2007 [6d 2d]
buggspray: folds 
Fatalimerrr: folds 
AngryRaises: folds 
Dorex2007: folds 
ser447787: raises $0.04 to $0.06
KaraFara: folds 
izak380: folds 
ppeetteerr175: folds 
Uncalled bet ($0.04) returned to ser447787
ser447787 collected $0.05 from pot
*** SUMMARY ***
Total pot $0.05 | Rake $0 
Seat 1: ppeetteerr175 (big blind) folded before Flop
Seat 2: buggspray folded before Flop (didn't bet)
Seat 3: Fatalimerrr folded before Flop (didn't bet)
Seat 4: AngryRaises folded before Flop (didn't bet)
Seat 6: Dorex2007 folded before Flop (didn't bet)
Seat 7: ser447787 collected ($0.05)
Seat 8: KaraFara (button) folded before Flop (didn't bet)
Seat 9: izak380 (small blind) folded before Flop



PokerStars Hand #224825869025:  Hold'em No Limit ($0.01/$0.02 USD) - 2021/03/14 22:09:31 PT [2021/03/15 1:09:31 ET]
Table 'Piccolo IV' 9-max Seat #9 is the button
Seat 1: ppeetteerr175 ($2.59 in chips) 
Seat 2: buggspray ($1.97 in chips) 
Seat 3: Fatalimerrr ($3.82 in chips) 
Seat 4: AngryRaises ($1.29 in chips) 
Seat 6: Dorex2007 ($1.92 in chips) 
Seat 7: ser447787 ($2.03 in chips) 
Seat 8: KaraFara ($5.72 in chips) 
Seat 9: izak380 ($1.71 in chips) 
ppeetteerr175: posts small blind $0.01
buggspray: posts big blind $0.02
*** HOLE CARDS ***
Dealt to Dorex2007 [Kc Ac]
Fatalimerrr: folds 
AngryRaises: folds 
Dorex2007: raises $0.04 to $0.06
ser447787: folds 
KaraFara: folds 
izak380: calls $0.06
ppeetteerr175: folds 
buggspray: folds 
*** FLOP *** [Th Qh 5d]
Dorex2007: bets $0.09
izak380: calls $0.09
*** TURN *** [Th Qh 5d] [Js]
Dorex2007: bets $0.16
peakyblinders82 joins the table at seat #5 
izak380: calls $0.16
*** RIVER *** [Th Qh 5d Js] [8s]
Dorex2007: bets $0.42
izak380: calls $0.42
*** SHOW DOWN ***
Dorex2007: shows [Kc Ac] (a straight, Ten to Ace)
izak380: mucks hand 
Dorex2007 collected $1.44 from pot
*** SUMMARY ***
Total pot $1.49 | Rake $0.05 
Board [Th Qh 5d Js 8s]
Seat 1: ppeetteerr175 (small blind) folded before Flop
Seat 2: buggspray (big blind) folded before Flop
Seat 3: Fatalimerrr folded before Flop (didn't bet)
Seat 4: AngryRaises folded before Flop (didn't bet)
Seat 6: Dorex2007 showed [Kc Ac] and won ($1.44) with a straight, Ten to Ace
Seat 7: ser447787 folded before Flop (didn't bet)
Seat 8: KaraFara folded before Flop (didn't bet)
Seat 9: izak380 (button) mucked [2s 2h]



PokerStars Hand #224825877583:  Hold'em No Limit ($0.01/$0.02 USD) - 2021/03/14 22:10:26 PT [2021/03/15 1:10:26 ET]
Table 'Piccolo IV' 9-max Seat #1 is the button
Seat 1: ppeetteerr175 ($2.58 in chips) 
Seat 2: buggspray ($1.95 in chips) 
Seat 3: Fatalimerrr ($3.82 in chips) 
Seat 4: AngryRaises ($1.29 in chips) 
Seat 6: Dorex2007 ($2.63 in chips) 
Seat 7: ser447787 ($2.03 in chips) 
Seat 8: KaraFara ($5.72 in chips) 
Seat 9: izak380 ($0.98 in chips) 
buggspray: posts small blind $0.01
Fatalimerrr: posts big blind $0.02
peakyblinders82: sits out 
*** HOLE CARDS ***
Dealt to Dorex2007 [9s Jd]
AngryRaises: folds 
Dorex2007: folds 
ser447787: folds 
KaraFara: folds 
izak380: folds 
izak380 leaves the table
ppeetteerr175: folds 
buggspray: folds 
Uncalled bet ($0.01) returned to Fatalimerrr
Fatalimerrr collected $0.02 from pot
Fatalimerrr: doesn't show hand 
*** SUMMARY ***
Total pot $0.02 | Rake $0 
Seat 1: ppeetteerr175 (button) folded before Flop (didn't bet)
Seat 2: buggspray (small blind) folded before Flop
Seat 3: Fatalimerrr (big blind) collected ($0.02)
Seat 4: AngryRaises folded before Flop (didn't bet)
Seat 6: Dorex2007 folded before Flop (didn't bet)
Seat 7: ser447787 folded before Flop (didn't bet)
Seat 8: KaraFara folded before Flop (didn't bet)
Seat 9: izak380 folded before Flop (didn't bet)



PokerStars Hand #224825879883:  Hold'em No Limit ($0.01/$0.02 USD) - 2021/03/14 22:10:41 PT [2021/03/15 1:10:41 ET]
Table 'Piccolo IV' 9-max Seat #2 is the button
Seat 1: ppeetteerr175 ($2.58 in chips) 
Seat 2: buggspray ($1.94 in chips) 
Seat 3: Fatalimerrr ($3.83 in chips) 
Seat 4: AngryRaises ($1.29 in chips) 
Seat 6: Dorex2007 ($2.63 in chips) 
Seat 7: ser447787 ($2.03 in chips) 
Seat 8: KaraFara ($5.72 in chips) 
Fatalimerrr: posts small blind $0.01
AngryRaises: posts big blind $0.02
peakyblinders82: sits out 
*** HOLE CARDS ***
Dealt to Dorex2007 [4h 4s]
Dorex2007 said, "Really??"
Dorex2007: folds 
ser447787: folds 
KaraFara: folds 
frankeefr813 joins the table at seat #9 
ppeetteerr175: folds 
buggspray: raises $0.04 to $0.06
Fatalimerrr: folds 
AngryRaises: raises $0.13 to $0.19
buggspray: calls $0.13
*** FLOP *** [6s Qs As]
AngryRaises: bets $0.19
buggspray: folds 
Uncalled bet ($0.19) returned to AngryRaises
AngryRaises collected $0.38 from pot
AngryRaises: doesn't show hand 
*** SUMMARY ***
Total pot $0.39 | Rake $0.01 
Board [6s Qs As]
Seat 1: ppeetteerr175 folded before Flop (didn't bet)
Seat 2: buggspray (button) folded on the Flop
Seat 3: Fatalimerrr (small blind) folded before Flop
Seat 4: AngryRaises (big blind) collected ($0.38)
Seat 6: Dorex2007 folded before Flop (didn't bet)
Seat 7: ser447787 folded before Flop (didn't bet)
Seat 8: KaraFara folded before Flop (didn't bet)



PokerStars Hand #224825884278:  Hold'em No Limit ($0.01/$0.02 USD) - 2021/03/14 22:11:10 PT [2021/03/15 1:11:10 ET]
Table 'Piccolo IV' 9-max Seat #3 is the button
Seat 1: ppeetteerr175 ($2.58 in chips) 
Seat 2: buggspray ($1.75 in chips) 
Seat 3: Fatalimerrr ($3.82 in chips) 
Seat 4: AngryRaises ($1.48 in chips) 
Seat 5: peakyblinders82 ($1.76 in chips) 
Seat 6: Dorex2007 ($2.63 in chips) 
Seat 7: ser447787 ($2.03 in chips) 
Seat 8: KaraFara ($5.72 in chips) 
Seat 9: frankeefr813 ($0.80 in chips) 
AngryRaises: posts small blind $0.01
peakyblinders82: posts big blind $0.02
frankeefr813: posts big blind $0.02
*** HOLE CARDS ***
Dealt to Dorex2007 [Ts Kd]
Dorex2007 has timed out
Dorex2007: folds 
ser447787: folds 
KaraFara: folds 
frankeefr813: checks 
ppeetteerr175: folds 
buggspray: folds 
Fatalimerrr: calls $0.02
AngryRaises: folds 
peakyblinders82: checks 
*** FLOP *** [8c 7s Th]
peakyblinders82: checks 
frankeefr813: checks 
Fatalimerrr: bets $0.02
peakyblinders82: folds 
KaraFara leaves the table
frankeefr813: calls $0.02
*** TURN *** [8c 7s Th] [6c]
frankeefr813: checks 
Fatalimerrr: checks 
*** RIVER *** [8c 7s Th 6c] [4s]
frankeefr813: checks 
Fatalimerrr: checks 
*** SHOW DOWN ***
frankeefr813: shows [Jd Ah] (high card Ace)
Fatalimerrr: shows [7h Jh] (a pair of Sevens)
Fatalimerrr collected $0.11 from pot
*** SUMMARY ***
Total pot $0.11 | Rake $0 
Board [8c 7s Th 6c 4s]
Seat 1: ppeetteerr175 folded before Flop (didn't bet)
Seat 2: buggspray folded before Flop (didn't bet)
Seat 3: Fatalimerrr (button) showed [7h Jh] and won ($0.11) with a pair of Sevens
Seat 4: AngryRaises (small blind) folded before Flop
Seat 5: peakyblinders82 (big blind) folded on the Flop
Seat 6: Dorex2007 folded before Flop (didn't bet)
Seat 7: ser447787 folded before Flop (didn't bet)
Seat 8: KaraFara folded before Flop (didn't bet)
Seat 9: frankeefr813 showed [Jd Ah] and lost with high card Ace



PokerStars Hand #224825894073:  Hold'em No Limit ($0.01/$0.02 USD) - 2021/03/14 22:12:13 PT [2021/03/15 1:12:13 ET]
Table 'Piccolo IV' 9-max Seat #4 is the button
Seat 1: ppeetteerr175 ($2.58 in chips) 
Seat 2: buggspray ($1.75 in chips) 
Seat 3: Fatalimerrr ($3.89 in chips) 
Seat 4: AngryRaises ($1.47 in chips) 
Seat 5: peakyblinders82 ($1.74 in chips) 
Seat 6: Dorex2007 ($2.63 in chips) 
Seat 7: ser447787 ($2.03 in chips) 
Seat 9: frankeefr813 ($0.76 in chips) 
peakyblinders82: posts small blind $0.01
Dorex2007: posts big blind $0.02
*** HOLE CARDS ***
Dealt to Dorex2007 [As 8d]
ser447787: folds 
frankeefr813: folds 
ppeetteerr175: raises $0.02 to $0.04
buggspray: folds 
Fatalimerrr: folds 
AngryRaises: calls $0.04
peakyblinders82: calls $0.03
Dorex2007: calls $0.02
*** FLOP *** [5h Kd 2d]
peakyblinders82: bets $0.02
Dorex2007: folds 
ppeetteerr175: calls $0.02
AngryRaises: raises $0.17 to $0.19
peakyblinders82: calls $0.17
ppeetteerr175: folds 
*** TURN *** [5h Kd 2d] [7s]
peakyblinders82: bets $0.27
AngryRaises: raises $0.27 to $0.54
peakyblinders82: calls $0.27
*** RIVER *** [5h Kd 2d 7s] [Qc]
peakyblinders82: bets $0.79
edoschenko joins the table at seat #8 
AngryRaises: folds 
Uncalled bet ($0.79) returned to peakyblinders82
peakyblinders82 collected $1.58 from pot
peakyblinders82: doesn't show hand 
*** SUMMARY ***
Total pot $1.64 | Rake $0.06 
Board [5h Kd 2d 7s Qc]
Seat 1: ppeetteerr175 folded on the Flop
Seat 2: buggspray folded before Flop (didn't bet)
Seat 3: Fatalimerrr folded before Flop (didn't bet)
Seat 4: AngryRaises (button) folded on the River
Seat 5: peakyblinders82 (small blind) collected ($1.58)
Seat 6: Dorex2007 (big blind) folded on the Flop
Seat 7: ser447787 folded before Flop (didn't bet)
Seat 9: frankeefr813 folded before Flop (didn't bet)



PokerStars Hand #224825912172:  Hold'em No Limit ($0.01/$0.02 USD) - 2021/03/14 22:14:10 PT [2021/03/15 1:14:10 ET]
Table 'Piccolo IV' 9-max Seat #5 is the button
Seat 1: ppeetteerr175 ($2.52 in chips) 
Seat 2: buggspray ($1.75 in chips) 
Seat 3: Fatalimerrr ($3.89 in chips) 
Seat 4: AngryRaises ($0.70 in chips) 
Seat 5: peakyblinders82 ($2.55 in chips) 
Seat 6: Dorex2007 ($2.59 in chips) 
Seat 7: ser447787 ($2.03 in chips) 
Seat 9: frankeefr813 ($0.76 in chips) 
Dorex2007: posts small blind $0.01
ser447787: posts big blind $0.02
edoschenko: sits out 
*** HOLE CARDS ***
Dealt to Dorex2007 [7h 7d]
frankeefr813: folds 
ppeetteerr175: folds 
buggspray: folds 
Fatalimerrr: folds 
AngryRaises: folds 
peakyblinders82: calls $0.02
Dorex2007: calls $0.01
ser447787: checks 
*** FLOP *** [6s 2d Kd]
Dorex2007: bets $0.06
ser447787: folds 
peakyblinders82: folds 
Uncalled bet ($0.06) returned to Dorex2007
Dorex2007 collected $0.06 from pot
Dorex2007: doesn't show hand 
*** SUMMARY ***
Total pot $0.06 | Rake $0 
Board [6s 2d Kd]
Seat 1: ppeetteerr175 folded before Flop (didn't bet)
Seat 2: buggspray folded before Flop (didn't bet)
Seat 3: Fatalimerrr folded before Flop (didn't bet)
Seat 4: AngryRaises folded before Flop (didn't bet)
Seat 5: peakyblinders82 (button) folded on the Flop
Seat 6: Dorex2007 (small blind) collected ($0.06)
Seat 7: ser447787 (big blind) folded on the Flop
Seat 9: frankeefr813 folded before Flop (didn't bet)



PokerStars Hand #224825924241:  Hold'em No Limit ($0.01/$0.02 USD) - 2021/03/14 22:14:39 PT [2021/03/15 1:14:39 ET]
Table 'Piccolo IV' 9-max Seat #6 is the button
Seat 1: ppeetteerr175 ($2.52 in chips) 
Seat 2: buggspray ($1.75 in chips) 
Seat 3: Fatalimerrr ($3.89 in chips) 
Seat 4: AngryRaises ($0.70 in chips) 
Seat 5: peakyblinders82 ($2.53 in chips) 
Seat 6: Dorex2007 ($2.63 in chips) 
Seat 7: ser447787 ($2.01 in chips) 
Seat 8: edoschenko ($1.60 in chips) 
Seat 9: frankeefr813 ($0.76 in chips) 
ser447787: posts small blind $0.01
edoschenko: posts big blind $0.02
*** HOLE CARDS ***
Dealt to Dorex2007 [6d Th]
frankeefr813: folds 
ppeetteerr175: folds 
buggspray: folds 
Fatalimerrr: folds 
AngryRaises: raises $0.05 to $0.07
peakyblinders82: folds 
Dorex2007: folds 
ser447787: folds 
edoschenko: folds 
Uncalled bet ($0.05) returned to AngryRaises
AngryRaises collected $0.05 from pot
AngryRaises: doesn't show hand 
*** SUMMARY ***
Total pot $0.05 | Rake $0 
Seat 1: ppeetteerr175 folded before Flop (didn't bet)
Seat 2: buggspray folded before Flop (didn't bet)
Seat 3: Fatalimerrr folded before Flop (didn't bet)
Seat 4: AngryRaises collected ($0.05)
Seat 5: peakyblinders82 folded before Flop (didn't bet)
Seat 6: Dorex2007 (button) folded before Flop (didn't bet)
Seat 7: ser447787 (small blind) folded before Flop
Seat 8: edoschenko (big blind) folded before Flop
Seat 9: frankeefr813 folded before Flop (didn't bet)



PokerStars Hand #224825928319:  Hold'em No Limit ($0.01/$0.02 USD) - 2021/03/14 22:15:05 PT [2021/03/15 1:15:05 ET]
Table 'Piccolo IV' 9-max Seat #7 is the button
Seat 1: ppeetteerr175 ($2.52 in chips) 
Seat 2: buggspray ($1.75 in chips) 
Seat 3: Fatalimerrr ($3.89 in chips) 
Seat 4: AngryRaises ($0.73 in chips) 
Seat 5: peakyblinders82 ($2.53 in chips) 
Seat 6: Dorex2007 ($2.63 in chips) 
Seat 7: ser447787 ($2 in chips) 
Seat 8: edoschenko ($1.58 in chips) 
Seat 9: frankeefr813 ($0.76 in chips) 
edoschenko: posts small blind $0.01
frankeefr813: posts big blind $0.02
*** HOLE CARDS ***
Dealt to Dorex2007 [Jc As]
ppeetteerr175: folds 
buggspray: folds 
Fatalimerrr: folds 
AngryRaises: folds 
peakyblinders82: calls $0.02
Dorex2007: raises $0.04 to $0.06
ser447787: folds 
edoschenko: folds 
frankeefr813: folds 
peakyblinders82: calls $0.04
*** FLOP *** [5d 4c Qc]
peakyblinders82: bets $0.07
Dorex2007: folds 
Uncalled bet ($0.07) returned to peakyblinders82
peakyblinders82 collected $0.14 from pot
peakyblinders82: doesn't show hand 
*** SUMMARY ***
Total pot $0.15 | Rake $0.01 
Board [5d 4c Qc]
Seat 1: ppeetteerr175 folded before Flop (didn't bet)
Seat 2: buggspray folded before Flop (didn't bet)
Seat 3: Fatalimerrr folded before Flop (didn't bet)
Seat 4: AngryRaises folded before Flop (didn't bet)
Seat 5: peakyblinders82 collected ($0.14)
Seat 6: Dorex2007 folded on the Flop
Seat 7: ser447787 (button) folded before Flop (didn't bet)
Seat 8: edoschenko (small blind) folded before Flop
Seat 9: frankeefr813 (big blind) folded before Flop



PokerStars Hand #224825934158:  Hold'em No Limit ($0.01/$0.02 USD) - 2021/03/14 22:15:43 PT [2021/03/15 1:15:43 ET]
Table 'Piccolo IV' 9-max Seat #8 is the button
Seat 1: ppeetteerr175 ($2.52 in chips) 
Seat 2: buggspray ($1.75 in chips) 
Seat 3: Fatalimerrr ($3.89 in chips) 
Seat 4: AngryRaises ($0.73 in chips) 
Seat 5: peakyblinders82 ($2.61 in chips) 
Seat 6: Dorex2007 ($2.57 in chips) 
Seat 7: ser447787 ($2 in chips) 
Seat 8: edoschenko ($1.57 in chips) 
Seat 9: frankeefr813 ($0.74 in chips) 
frankeefr813: posts small blind $0.01
ppeetteerr175: posts big blind $0.02
*** HOLE CARDS ***
Dealt to Dorex2007 [Ac 5s]
buggspray: folds 
Fatalimerrr: raises $0.04 to $0.06
AngryRaises: folds 
peakyblinders82: calls $0.06
Dorex2007: folds 
ser447787: folds 
edoschenko: folds 
frankeefr813: calls $0.05
ppeetteerr175: folds 
*** FLOP *** [7s 9d 7c]
frankeefr813: checks 
Fatalimerrr: bets $0.04
peakyblinders82: folds 
frankeefr813: folds 
Uncalled bet ($0.04) returned to Fatalimerrr
Fatalimerrr collected $0.19 from pot
Fatalimerrr: doesn't show hand 
*** SUMMARY ***
Total pot $0.20 | Rake $0.01 
Board [7s 9d 7c]
Seat 1: ppeetteerr175 (big blind) folded before Flop
Seat 2: buggspray folded before Flop (didn't bet)
Seat 3: Fatalimerrr collected ($0.19)
Seat 4: AngryRaises folded before Flop (didn't bet)
Seat 5: peakyblinders82 folded on the Flop
Seat 6: Dorex2007 folded before Flop (didn't bet)
Seat 7: ser447787 folded before Flop (didn't bet)
Seat 8: edoschenko (button) folded before Flop (didn't bet)
Seat 9: frankeefr813 (small blind) folded on the Flop



PokerStars Hand #224825939519:  Hold'em No Limit ($0.01/$0.02 USD) - 2021/03/14 22:16:17 PT [2021/03/15 1:16:17 ET]
Table 'Piccolo IV' 9-max Seat #9 is the button
Seat 1: ppeetteerr175 ($2.50 in chips) 
Seat 2: buggspray ($1.75 in chips) 
Seat 3: Fatalimerrr ($4.02 in chips) 
Seat 4: AngryRaises ($0.73 in chips) 
Seat 5: peakyblinders82 ($2.55 in chips) 
Seat 6: Dorex2007 ($2.57 in chips) 
Seat 7: ser447787 ($2 in chips) 
Seat 8: edoschenko ($1.57 in chips) 
Seat 9: frankeefr813 ($0.68 in chips) 
ppeetteerr175: posts small blind $0.01
buggspray: posts big blind $0.02
*** HOLE CARDS ***
Dealt to Dorex2007 [Kc Qh]
Fatalimerrr: folds 
Fatalimerrr leaves the table
AngryRaises: calls $0.02
peakyblinders82: folds 
Dorex2007: raises $0.04 to $0.06
ser447787: folds 
edoschenko: folds 
frankeefr813: folds 
ppeetteerr175: folds 
buggspray: folds 
AngryRaises: calls $0.04
*** FLOP *** [2d 2s 5c]
AngryRaises: checks 
Dorex2007: checks 
*** TURN *** [2d 2s 5c] [2c]
AngryRaises: checks 
Dorex2007: bets $0.14
AngryRaises: calls $0.14
*** RIVER *** [2d 2s 5c 2c] [9h]
AngryRaises: bets $0.53 and is all-in
Dorex2007: folds 
Uncalled bet ($0.53) returned to AngryRaises
AngryRaises collected $0.41 from pot
AngryRaises: doesn't show hand 
*** SUMMARY ***
Total pot $0.43 | Rake $0.02 
Board [2d 2s 5c 2c 9h]
Seat 1: ppeetteerr175 (small blind) folded before Flop
Seat 2: buggspray (big blind) folded before Flop
Seat 3: Fatalimerrr folded before Flop (didn't bet)
Seat 4: AngryRaises collected ($0.41)
Seat 5: peakyblinders82 folded before Flop (didn't bet)
Seat 6: Dorex2007 folded on the River
Seat 7: ser447787 folded before Flop (didn't bet)
Seat 8: edoschenko folded before Flop (didn't bet)
Seat 9: frankeefr813 (button) folded before Flop (didn't bet)



PokerStars Hand #224825948704:  Hold'em No Limit ($0.01/$0.02 USD) - 2021/03/14 22:17:16 PT [2021/03/15 1:17:16 ET]
Table 'Piccolo IV' 9-max Seat #1 is the button
Seat 1: ppeetteerr175 ($2.49 in chips) 
Seat 2: buggspray ($1.73 in chips) 
Seat 4: AngryRaises ($0.94 in chips) 
Seat 5: peakyblinders82 ($2.55 in chips) 
Seat 6: Dorex2007 ($2.37 in chips) 
Seat 7: ser447787 ($2 in chips) 
Seat 9: frankeefr813 ($0.68 in chips) 
buggspray: posts small blind $0.01
AngryRaises: posts big blind $0.02
*** HOLE CARDS ***
Dealt to Dorex2007 [As 4c]
PABLOZAL10 joins the table at seat #3 
peakyblinders82: folds 
Dorex2007: folds 
ser447787: folds 
frankeefr813: raises $0.02 to $0.04
ppeetteerr175: folds 
buggspray: calls $0.03
AngryRaises: calls $0.02
*** FLOP *** [3d Jd 8d]
buggspray: checks 
AngryRaises: checks 
frankeefr813: bets $0.12
buggspray: folds 
AngryRaises: calls $0.12
*** TURN *** [3d Jd 8d] [Ah]
AngryRaises: checks 
frankeefr813: bets $0.35
AngryRaises: folds 
Uncalled bet ($0.35) returned to frankeefr813
frankeefr813 collected $0.35 from pot
frankeefr813: doesn't show hand 
*** SUMMARY ***
Total pot $0.36 | Rake $0.01 
Board [3d Jd 8d Ah]
Seat 1: ppeetteerr175 (button) folded before Flop (didn't bet)
Seat 2: buggspray (small blind) folded on the Flop
Seat 4: AngryRaises (big blind) folded on the Turn
Seat 5: peakyblinders82 folded before Flop (didn't bet)
Seat 6: Dorex2007 folded before Flop (didn't bet)
Seat 7: ser447787 folded before Flop (didn't bet)
Seat 9: frankeefr813 collected ($0.35)



PokerStars Hand #224825954881:  Hold'em No Limit ($0.01/$0.02 USD) - 2021/03/14 22:17:56 PT [2021/03/15 1:17:56 ET]
Table 'Piccolo IV' 9-max Seat #2 is the button
Seat 1: ppeetteerr175 ($2.49 in chips) 
Seat 2: buggspray ($1.69 in chips) 
Seat 4: AngryRaises ($0.78 in chips) 
Seat 5: peakyblinders82 ($2.55 in chips) 
Seat 6: Dorex2007 ($2.37 in chips) 
Seat 7: ser447787 ($2 in chips) 
Seat 8: edoschenko ($1.57 in chips) 
Seat 9: frankeefr813 ($0.87 in chips) 
AngryRaises: posts small blind $0.01
peakyblinders82: posts big blind $0.02
*** HOLE CARDS ***
Dealt to Dorex2007 [Jh 7d]
Dorex2007: folds 
ser447787: folds 
edoschenko: folds 
frankeefr813: folds 
ppeetteerr175: calls $0.02
buggspray: folds 
AngryRaises: folds 
peakyblinders82: checks 
*** FLOP *** [Qd Ad Kc]
peakyblinders82: bets $0.02
ppeetteerr175: folds 
Uncalled bet ($0.02) returned to peakyblinders82
peakyblinders82 collected $0.05 from pot
peakyblinders82: doesn't show hand 
*** SUMMARY ***
Total pot $0.05 | Rake $0 
Board [Qd Ad Kc]
Seat 1: ppeetteerr175 folded on the Flop
Seat 2: buggspray (button) folded before Flop (didn't bet)
Seat 4: AngryRaises (small blind) folded before Flop
Seat 5: peakyblinders82 (big blind) collected ($0.05)
Seat 6: Dorex2007 folded before Flop (didn't bet)
Seat 7: ser447787 folded before Flop (didn't bet)
Seat 8: edoschenko folded before Flop (didn't bet)
Seat 9: frankeefr813 folded before Flop (didn't bet)



PokerStars Hand #224825960316:  Hold'em No Limit ($0.01/$0.02 USD) - 2021/03/14 22:18:30 PT [2021/03/15 1:18:30 ET]
Table 'Piccolo IV' 9-max Seat #4 is the button
Seat 1: ppeetteerr175 ($2.47 in chips) 
Seat 2: buggspray ($1.69 in chips) 
Seat 4: AngryRaises ($0.77 in chips) 
Seat 5: peakyblinders82 ($2.58 in chips) 
Seat 6: Dorex2007 ($2.37 in chips) 
Seat 7: ser447787 ($2 in chips) 
Seat 8: edoschenko ($1.57 in chips) 
Seat 9: frankeefr813 ($0.87 in chips) 
peakyblinders82: posts small blind $0.01
Dorex2007: posts big blind $0.02
PABLOZAL10: sits out 
*** HOLE CARDS ***
Dealt to Dorex2007 [Ah Td]
ser447787: folds 
edoschenko: raises $0.06 to $0.08
frankeefr813: folds 
ppeetteerr175: folds 
buggspray: folds 
AngryRaises: folds 
peakyblinders82: calls $0.07
Dorex2007: calls $0.06
*** FLOP *** [8h 8d 2s]
peakyblinders82: checks 
Dorex2007: bets $0.23
edoschenko: folds 
peakyblinders82: folds 
Uncalled bet ($0.23) returned to Dorex2007
Dorex2007 collected $0.23 from pot
Dorex2007: doesn't show hand 
*** SUMMARY ***
Total pot $0.24 | Rake $0.01 
Board [8h 8d 2s]
Seat 1: ppeetteerr175 folded before Flop (didn't bet)
Seat 2: buggspray folded before Flop (didn't bet)
Seat 4: AngryRaises (button) folded before Flop (didn't bet)
Seat 5: peakyblinders82 (small blind) folded on the Flop
Seat 6: Dorex2007 (big blind) collected ($0.23)
Seat 7: ser447787 folded before Flop (didn't bet)
Seat 8: edoschenko folded on the Flop
Seat 9: frankeefr813 folded before Flop (didn't bet)



PokerStars Hand #224825966101:  Hold'em No Limit ($0.01/$0.02 USD) - 2021/03/14 22:19:07 PT [2021/03/15 1:19:07 ET]
Table 'Piccolo IV' 9-max Seat #5 is the button
Seat 1: ppeetteerr175 ($2.47 in chips) 
Seat 2: buggspray ($1.69 in chips) 
Seat 4: AngryRaises ($0.77 in chips) 
Seat 5: peakyblinders82 ($2.50 in chips) 
Seat 6: Dorex2007 ($2.52 in chips) 
Seat 7: ser447787 ($2 in chips) 
Seat 8: edoschenko ($1.49 in chips) 
Seat 9: frankeefr813 ($0.87 in chips) 
Dorex2007: posts small blind $0.01
ser447787: posts big blind $0.02
PABLOZAL10: sits out 
*** HOLE CARDS ***
Dealt to Dorex2007 [3c Td]
edoschenko: folds 
frankeefr813: calls $0.02
ppeetteerr175: calls $0.02
buggspray: calls $0.02
AngryRaises: folds 
peakyblinders82: folds 
Dorex2007: folds 
ser447787: checks 
*** FLOP *** [6d Ad Ac]
ser447787: checks 
frankeefr813: bets $0.09
ppeetteerr175: raises $0.09 to $0.18
buggspray: folds 
ser447787: folds 
frankeefr813: folds 
Uncalled bet ($0.09) returned to ppeetteerr175
ppeetteerr175 collected $0.26 from pot
ppeetteerr175: doesn't show hand 
*** SUMMARY ***
Total pot $0.27 | Rake $0.01 
Board [6d Ad Ac]
Seat 1: ppeetteerr175 collected ($0.26)
Seat 2: buggspray folded on the Flop
Seat 4: AngryRaises folded before Flop (didn't bet)
Seat 5: peakyblinders82 (button) folded before Flop (didn't bet)
Seat 6: Dorex2007 (small blind) folded before Flop
Seat 7: ser447787 (big blind) folded on the Flop
Seat 8: edoschenko folded before Flop (didn't bet)
Seat 9: frankeefr813 folded on the Flop



PokerStars Hand #224825972708:  Hold'em No Limit ($0.01/$0.02 USD) - 2021/03/14 22:19:50 PT [2021/03/15 1:19:50 ET]
Table 'Piccolo IV' 9-max Seat #6 is the button
Seat 1: ppeetteerr175 ($2.62 in chips) 
Seat 2: buggspray ($1.67 in chips) 
Seat 4: AngryRaises ($0.77 in chips) 
Seat 5: peakyblinders82 ($2.50 in chips) 
Seat 6: Dorex2007 ($2.51 in chips) 
Seat 7: ser447787 ($2 in chips) 
Seat 8: edoschenko ($1.49 in chips) 
Seat 9: frankeefr813 ($0.76 in chips) 
ser447787: posts small blind $0.01
edoschenko: posts big blind $0.02
PABLOZAL10: sits out 
*** HOLE CARDS ***
Dealt to Dorex2007 [8s 8c]
frankeefr813: calls $0.02
ppeetteerr175: calls $0.02
buggspray: calls $0.02
AngryRaises: folds 
peakyblinders82: folds 
Dorex2007: calls $0.02
ser447787: folds 
edoschenko: checks 
*** FLOP *** [Ks 5d Ad]
edoschenko: checks 
frankeefr813: bets $0.11
ppeetteerr175: folds 
buggspray: folds 
Dorex2007: folds 
edoschenko: folds 
Uncalled bet ($0.11) returned to frankeefr813
frankeefr813 collected $0.11 from pot
frankeefr813: doesn't show hand 
*** SUMMARY ***
Total pot $0.11 | Rake $0 
Board [Ks 5d Ad]
Seat 1: ppeetteerr175 folded on the Flop
Seat 2: buggspray folded on the Flop
Seat 4: AngryRaises folded before Flop (didn't bet)
Seat 5: peakyblinders82 folded before Flop (didn't bet)
Seat 6: Dorex2007 (button) folded on the Flop
Seat 7: ser447787 (small blind) folded before Flop
Seat 8: edoschenko (big blind) folded on the Flop
Seat 9: frankeefr813 collected ($0.11)



PokerStars Hand #224825980539:  Hold'em No Limit ($0.01/$0.02 USD) - 2021/03/14 22:20:40 PT [2021/03/15 1:20:40 ET]
Table 'Piccolo IV' 9-max Seat #7 is the button
Seat 1: ppeetteerr175 ($2.60 in chips) 
Seat 2: buggspray ($1.65 in chips) 
Seat 4: AngryRaises ($0.77 in chips) 
Seat 5: peakyblinders82 ($2.50 in chips) 
Seat 6: Dorex2007 ($2.49 in chips) 
Seat 7: ser447787 ($2 in chips) 
Seat 8: edoschenko ($1.47 in chips) 
Seat 9: frankeefr813 ($0.85 in chips) 
edoschenko: posts small blind $0.01
frankeefr813: posts big blind $0.02
PABLOZAL10: sits out 
*** HOLE CARDS ***
Dealt to Dorex2007 [7s 3d]
ppeetteerr175: calls $0.02
buggspray: folds 
AngryRaises: calls $0.02
peakyblinders82: calls $0.02
Dorex2007: folds 
ser447787: raises $0.11 to $0.13
edoschenko: folds 
frankeefr813: calls $0.11
ppeetteerr175: folds 
AngryRaises: calls $0.11
peakyblinders82: calls $0.11
*** FLOP *** [3s 9d 8h]
frankeefr813: bets $0.06
AngryRaises: raises $0.06 to $0.12
peakyblinders82: calls $0.12
ser447787: folds 
frankeefr813: calls $0.06
*** TURN *** [3s 9d 8h] [2s]
frankeefr813: checks 
AngryRaises: bets $0.52 and is all-in
peakyblinders82: calls $0.52
frankeefr813: folds 
*** RIVER *** [3s 9d 8h 2s] [Tc]
*** SHOW DOWN ***
AngryRaises: shows [Jd 9h] (a pair of Nines)
peakyblinders82: shows [Ad 8c] (a pair of Eights)
AngryRaises collected $1.88 from pot
peakyblinders82 cashed out the hand for $0.21
*** SUMMARY ***
Total pot $1.95 | Rake $0.07 
Board [3s 9d 8h 2s Tc]
Seat 1: ppeetteerr175 folded before Flop
Seat 2: buggspray folded before Flop (didn't bet)
Seat 4: AngryRaises showed [Jd 9h] and won ($1.88) with a pair of Nines
Seat 5: peakyblinders82 showed [Ad 8c] and lost with a pair of Eights (cashed out).
Seat 6: Dorex2007 folded before Flop (didn't bet)
Seat 7: ser447787 (button) folded on the Flop
Seat 8: edoschenko (small blind) folded before Flop
Seat 9: frankeefr813 (big blind) folded on the Turn



PokerStars Hand #224825991298:  Hold'em No Limit ($0.01/$0.02 USD) - 2021/03/14 22:21:49 PT [2021/03/15 1:21:49 ET]
Table 'Piccolo IV' 9-max Seat #8 is the button
Seat 1: ppeetteerr175 ($2.58 in chips) 
Seat 2: buggspray ($1.65 in chips) 
Seat 4: AngryRaises ($1.88 in chips) 
Seat 5: peakyblinders82 ($1.94 in chips) 
Seat 6: Dorex2007 ($2.49 in chips) 
Seat 7: ser447787 ($2 in chips) 
Seat 8: edoschenko ($1.46 in chips) 
Seat 9: frankeefr813 ($0.60 in chips) 
frankeefr813: posts small blind $0.01
ppeetteerr175: posts big blind $0.02
PABLOZAL10: sits out 
*** HOLE CARDS ***
Dealt to Dorex2007 [2d 4c]
buggspray: folds 
AngryRaises: folds 
peakyblinders82 has timed out
peakyblinders82: folds 
Dorex2007: folds 
ser447787: folds 
edoschenko: folds 
frankeefr813: folds 
Uncalled bet ($0.01) returned to ppeetteerr175
ppeetteerr175 collected $0.02 from pot
ppeetteerr175: doesn't show hand 
*** SUMMARY ***
Total pot $0.02 | Rake $0 
Seat 1: ppeetteerr175 (big blind) collected ($0.02)
Seat 2: buggspray folded before Flop (didn't bet)
Seat 4: AngryRaises folded before Flop (didn't bet)
Seat 5: peakyblinders82 folded before Flop (didn't bet)
Seat 6: Dorex2007 folded before Flop (didn't bet)
Seat 7: ser447787 folded before Flop (didn't bet)
Seat 8: edoschenko (button) folded before Flop (didn't bet)
Seat 9: frankeefr813 (small blind) folded before Flop



PokerStars Hand #224825994771:  Hold'em No Limit ($0.01/$0.02 USD) - 2021/03/14 22:22:11 PT [2021/03/15 1:22:11 ET]
Table 'Piccolo IV' 9-max Seat #9 is the button
Seat 1: ppeetteerr175 ($2.59 in chips) 
Seat 2: buggspray ($1.65 in chips) 
Seat 4: AngryRaises ($1.88 in chips) 
Seat 5: peakyblinders82 ($1.94 in chips) 
Seat 6: Dorex2007 ($2.49 in chips) 
Seat 7: ser447787 ($2 in chips) 
Seat 8: edoschenko ($1.46 in chips) 
Seat 9: frankeefr813 ($0.59 in chips) 
ppeetteerr175: posts small blind $0.01
buggspray: posts big blind $0.02
PABLOZAL10: sits out 
*** HOLE CARDS ***
Dealt to Dorex2007 [7s 4h]
AngryRaises: folds 
peakyblinders82: folds 
Dorex2007: folds 
ser447787: raises $0.05 to $0.07
edoschenko: folds 
frankeefr813: folds 
ppeetteerr175: folds 
buggspray: folds 
Uncalled bet ($0.05) returned to ser447787
ser447787 collected $0.05 from pot
*** SUMMARY ***
Total pot $0.05 | Rake $0 
Seat 1: ppeetteerr175 (small blind) folded before Flop
Seat 2: buggspray (big blind) folded before Flop
Seat 4: AngryRaises folded before Flop (didn't bet)
Seat 5: peakyblinders82 folded before Flop (didn't bet)
Seat 6: Dorex2007 folded before Flop (didn't bet)
Seat 7: ser447787 collected ($0.05)
Seat 8: edoschenko folded before Flop (didn't bet)
Seat 9: frankeefr813 (button) folded before Flop (didn't bet)



PokerStars Hand #224825997803:  Hold'em No Limit ($0.01/$0.02 USD) - 2021/03/14 22:22:31 PT [2021/03/15 1:22:31 ET]
Table 'Piccolo IV' 9-max Seat #1 is the button
Seat 1: ppeetteerr175 ($2.58 in chips) 
Seat 2: buggspray ($1.63 in chips) 
Seat 3: PABLOZAL10 ($2 in chips) 
Seat 4: AngryRaises ($1.88 in chips) 
Seat 5: peakyblinders82 ($1.94 in chips) 
Seat 6: Dorex2007 ($2.49 in chips) 
Seat 7: ser447787 ($2.03 in chips) 
Seat 8: edoschenko ($1.46 in chips) 
Seat 9: frankeefr813 ($0.59 in chips) 
buggspray: posts small blind $0.01
PABLOZAL10: posts big blind $0.02
*** HOLE CARDS ***
Dealt to Dorex2007 [7h 2d]
AngryRaises: folds 
peakyblinders82: calls $0.02
Dorex2007: folds 
ser447787: folds 
edoschenko: raises $0.10 to $0.12
frankeefr813: calls $0.12
ppeetteerr175: folds 
buggspray: folds 
PABLOZAL10: folds 
peakyblinders82: calls $0.10
*** FLOP *** [8h 6c 8c]
peakyblinders82: checks 
edoschenko: bets $0.19
frankeefr813: folds 
peakyblinders82: folds 
Uncalled bet ($0.19) returned to edoschenko
edoschenko collected $0.38 from pot
edoschenko: doesn't show hand 
*** SUMMARY ***
Total pot $0.39 | Rake $0.01 
Board [8h 6c 8c]
Seat 1: ppeetteerr175 (button) folded before Flop (didn't bet)
Seat 2: buggspray (small blind) folded before Flop
Seat 3: PABLOZAL10 (big blind) folded before Flop
Seat 4: AngryRaises folded before Flop (didn't bet)
Seat 5: peakyblinders82 folded on the Flop
Seat 6: Dorex2007 folded before Flop (didn't bet)
Seat 7: ser447787 folded before Flop (didn't bet)
Seat 8: edoschenko collected ($0.38)
Seat 9: frankeefr813 folded on the Flop



PokerStars Hand #224826005319:  Hold'em No Limit ($0.01/$0.02 USD) - 2021/03/14 22:23:19 PT [2021/03/15 1:23:19 ET]
Table 'Piccolo IV' 9-max Seat #2 is the button
Seat 1: ppeetteerr175 ($2.58 in chips) 
Seat 2: buggspray ($1.62 in chips) 
Seat 3: PABLOZAL10 ($1.98 in chips) 
Seat 4: AngryRaises ($1.88 in chips) 
Seat 5: peakyblinders82 ($1.82 in chips) 
Seat 6: Dorex2007 ($2.49 in chips) 
Seat 7: ser447787 ($2.03 in chips) 
Seat 8: edoschenko ($1.72 in chips) 
Seat 9: frankeefr813 ($0.47 in chips) 
PABLOZAL10: posts small blind $0.01
AngryRaises: posts big blind $0.02
*** HOLE CARDS ***
Dealt to Dorex2007 [Js Jd]
peakyblinders82: folds 
Dorex2007: raises $0.06 to $0.08
ser447787: folds 
edoschenko: folds 
frankeefr813: calls $0.08
ppeetteerr175: folds 
buggspray: calls $0.08
PABLOZAL10: folds 
AngryRaises: raises $0.33 to $0.41
Dorex2007: calls $0.33
frankeefr813: raises $0.06 to $0.47 and is all-in
buggspray: calls $0.39
AngryRaises: calls $0.06
Dorex2007: calls $0.06
*** FLOP *** [6d 7c Qd]
AngryRaises: bets $1.41 and is all-in
Dorex2007: folds 
buggspray: calls $1.15 and is all-in
Uncalled bet ($0.26) returned to AngryRaises
buggspray has timed out
*** TURN *** [6d 7c Qd] [5h]
*** RIVER *** [6d 7c Qd 5h] [4d]
*** SHOW DOWN ***
AngryRaises: shows [Kd Kh] (a pair of Kings)
buggspray: shows [Ad Ks] (high card Ace)
frankeefr813: shows [Ts Jc] (high card Queen)
AngryRaises cashed out the hand for $3.23 | Cash Out Fee $0.03
*** SUMMARY ***
Total pot $4.19 Main pot $1.82. Side pot $2.22. | Rake $0.15 
Board [6d 7c Qd 5h 4d]
Seat 1: ppeetteerr175 folded before Flop (didn't bet)
Seat 2: buggspray (button) showed [Ad Ks] and lost with high card Ace
Seat 3: PABLOZAL10 (small blind) folded before Flop
Seat 4: AngryRaises (big blind) showed [Kd Kh] and won ($4.04) with a pair of Kings (pot not awarded as player cashed out)
Seat 5: peakyblinders82 folded before Flop (didn't bet)
Seat 6: Dorex2007 folded on the Flop
Seat 7: ser447787 folded before Flop (didn't bet)
Seat 8: edoschenko folded before Flop (didn't bet)
Seat 9: frankeefr813 showed [Ts Jc] and lost with high card Queen



PokerStars Hand #224826020551:  Hold'em No Limit ($0.01/$0.02 USD) - 2021/03/14 22:24:57 PT [2021/03/15 1:24:57 ET]
Table 'Piccolo IV' 9-max Seat #3 is the button
Seat 1: ppeetteerr175 ($2.58 in chips) 
Seat 3: PABLOZAL10 ($1.97 in chips) 
Seat 4: AngryRaises ($3.49 in chips) 
Seat 5: peakyblinders82 ($1.82 in chips) 
Seat 6: Dorex2007 ($2.02 in chips) 
Seat 7: ser447787 ($2.03 in chips) 
Seat 8: edoschenko ($1.72 in chips) 
AngryRaises: posts small blind $0.01
frankeefr813 leaves the table
peakyblinders82: posts big blind $0.02
*** HOLE CARDS ***
Dealt to Dorex2007 [7d 7s]
Dorex2007: raises $0.04 to $0.06
ser447787: folds 
edoschenko: folds 
ppeetteerr175: folds 
PABLOZAL10: folds 
AngryRaises: calls $0.05
peakyblinders82: folds 
*** FLOP *** [Ts 5h 4h]
AngryRaises: checks 
Dorex2007: bets $0.14
AngryRaises: folds 
Uncalled bet ($0.14) returned to Dorex2007
Dorex2007 collected $0.14 from pot
Dorex2007: doesn't show hand 
*** SUMMARY ***
Total pot $0.14 | Rake $0 
Board [Ts 5h 4h]
Seat 1: ppeetteerr175 folded before Flop (didn't bet)
Seat 3: PABLOZAL10 (button) folded before Flop (didn't bet)
Seat 4: AngryRaises (small blind) folded on the Flop
Seat 5: peakyblinders82 (big blind) folded before Flop
Seat 6: Dorex2007 collected ($0.14)
Seat 7: ser447787 folded before Flop (didn't bet)
Seat 8: edoschenko folded before Flop (didn't bet)



PokerStars Hand #224826033921:  Hold'em No Limit ($0.01/$0.02 USD) - 2021/03/14 22:25:25 PT [2021/03/15 1:25:25 ET]
Table 'Piccolo IV' 9-max Seat #4 is the button
Seat 1: ppeetteerr175 ($2.58 in chips) 
Seat 2: buggspray ($2 in chips) 
Seat 3: PABLOZAL10 ($1.97 in chips) 
Seat 4: AngryRaises ($3.43 in chips) 
Seat 5: peakyblinders82 ($1.80 in chips) 
Seat 6: Dorex2007 ($2.10 in chips) 
Seat 7: ser447787 ($2.03 in chips) 
Seat 8: edoschenko ($1.72 in chips) 
peakyblinders82: posts small blind $0.01
Dorex2007: posts big blind $0.02
*** HOLE CARDS ***
Dealt to Dorex2007 [8c Ac]
ser447787: folds 
edoschenko: folds 
ppeetteerr175: folds 
buggspray: folds 
PABLOZAL10: folds 
AngryRaises: folds 
peakyblinders82: raises $0.02 to $0.04
Dorex2007: calls $0.02
*** FLOP *** [2h Qh Jd]
peakyblinders82: checks 
Dorex2007: checks 
*** TURN *** [2h Qh Jd] [Td]
peakyblinders82: bets $0.04
Dorex2007: calls $0.04
*** RIVER *** [2h Qh Jd Td] [Ad]
peakyblinders82: bets $0.15
Dorex2007: calls $0.15
*** SHOW DOWN ***
peakyblinders82: shows [Qd Jh] (two pair, Queens and Jacks)
Dorex2007: mucks hand 
peakyblinders82 collected $0.44 from pot
*** SUMMARY ***
Total pot $0.46 | Rake $0.02 
Board [2h Qh Jd Td Ad]
Seat 1: ppeetteerr175 folded before Flop (didn't bet)
Seat 2: buggspray folded before Flop (didn't bet)
Seat 3: PABLOZAL10 folded before Flop (didn't bet)
Seat 4: AngryRaises (button) folded before Flop (didn't bet)
Seat 5: peakyblinders82 (small blind) showed [Qd Jh] and won ($0.44) with two pair, Queens and Jacks
Seat 6: Dorex2007 (big blind) mucked [8c Ac]
Seat 7: ser447787 folded before Flop (didn't bet)
Seat 8: edoschenko folded before Flop (didn't bet)



PokerStars Hand #224826040153:  Hold'em No Limit ($0.01/$0.02 USD) - 2021/03/14 22:26:06 PT [2021/03/15 1:26:06 ET]
Table 'Piccolo IV' 9-max Seat #5 is the button
Seat 1: ppeetteerr175 ($2.58 in chips) 
Seat 2: buggspray ($2 in chips) 
Seat 3: PABLOZAL10 ($1.97 in chips) 
Seat 4: AngryRaises ($3.43 in chips) 
Seat 5: peakyblinders82 ($2.01 in chips) 
Seat 6: Dorex2007 ($1.87 in chips) 
Seat 7: ser447787 ($2.03 in chips) 
Seat 8: edoschenko ($1.72 in chips) 
Dorex2007: posts small blind $0.01
ser447787: posts big blind $0.02
*** HOLE CARDS ***
Dealt to Dorex2007 [Qc Ah]
edoschenko: folds 
ppeetteerr175: folds 
buggspray: folds 
Cesnielumige joins the table at seat #9 
PABLOZAL10: folds 
AngryRaises: raises $0.02 to $0.04
peakyblinders82: folds 
Dorex2007: raises $0.10 to $0.14
ser447787: folds 
AngryRaises: calls $0.10
*** FLOP *** [9s 4h Jh]
Dorex2007: bets $0.29
AngryRaises: calls $0.29
*** TURN *** [9s 4h Jh] [As]
Dorex2007: bets $1.44 and is all-in
AngryRaises: calls $1.44
*** RIVER *** [9s 4h Jh As] [Ad]
*** SHOW DOWN ***
Dorex2007: shows [Qc Ah] (three of a kind, Aces)
AngryRaises: shows [Ac 9c] (a full house, Aces full of Nines)
AngryRaises cashed out the hand for $3.10 | Cash Out Fee $0.03
*** SUMMARY ***
Total pot $3.76 | Rake $0.13 
Board [9s 4h Jh As Ad]
Seat 1: ppeetteerr175 folded before Flop (didn't bet)
Seat 2: buggspray folded before Flop (didn't bet)
Seat 3: PABLOZAL10 folded before Flop (didn't bet)
Seat 4: AngryRaises showed [Ac 9c] and won ($3.63) with a full house, Aces full of Nines (pot not awarded as player cashed out)
Seat 5: peakyblinders82 (button) folded before Flop (didn't bet)
Seat 6: Dorex2007 (small blind) showed [Qc Ah] and lost with three of a kind, Aces
Seat 7: ser447787 (big blind) folded before Flop
Seat 8: edoschenko folded before Flop (didn't bet)



PokerStars Hand #224826050084:  Hold'em No Limit ($0.01/$0.02 USD) - 2021/03/14 22:27:10 PT [2021/03/15 1:27:10 ET]
Table 'Piccolo IV' 9-max Seat #8 is the button
Seat 1: ppeetteerr175 ($2.58 in chips) 
Seat 2: buggspray ($2 in chips) 
Seat 3: PABLOZAL10 ($1.97 in chips) 
Seat 4: AngryRaises ($4.66 in chips) 
Seat 5: peakyblinders82 ($2.01 in chips) 
Seat 6: Dorex2007 ($2 in chips) 
Seat 7: ser447787 ($2.01 in chips) 
Seat 8: edoschenko ($1.71 in chips) 
Seat 9: Cesnielumige ($2.01 in chips) 
Cesnielumige: posts small blind $0.01
ppeetteerr175: posts big blind $0.02
*** HOLE CARDS ***
Dealt to Dorex2007 [Jh Th]
buggspray: raises $0.02 to $0.04
PABLOZAL10: folds 
AngryRaises: folds 
peakyblinders82: folds 
Dorex2007: raises $0.04 to $0.08
ser447787: folds 
edoschenko: folds 
Cesnielumige: folds 
ppeetteerr175: folds 
buggspray: calls $0.04
*** FLOP *** [6h 3s Ac]
buggspray: checks 
Dorex2007: checks 
*** TURN *** [6h 3s Ac] [Td]
buggspray: checks 
Dorex2007: bets $0.12
buggspray: folds 
Uncalled bet ($0.12) returned to Dorex2007
Dorex2007 collected $0.18 from pot
Dorex2007: doesn't show hand 
*** SUMMARY ***
Total pot $0.19 | Rake $0.01 
Board [6h 3s Ac Td]
Seat 1: ppeetteerr175 (big blind) folded before Flop
Seat 2: buggspray folded on the Turn
Seat 3: PABLOZAL10 folded before Flop (didn't bet)
Seat 4: AngryRaises folded before Flop (didn't bet)
Seat 5: peakyblinders82 folded before Flop (didn't bet)
Seat 6: Dorex2007 collected ($0.18)
Seat 7: ser447787 folded before Flop (didn't bet)
Seat 8: edoschenko (button) folded before Flop (didn't bet)
Seat 9: Cesnielumige (small blind) folded before Flop



PokerStars Hand #224826058244:  Hold'em No Limit ($0.01/$0.02 USD) - 2021/03/14 22:28:04 PT [2021/03/15 1:28:04 ET]
Table 'Piccolo IV' 9-max Seat #9 is the button
Seat 1: ppeetteerr175 ($2.56 in chips) 
Seat 2: buggspray ($1.92 in chips) 
Seat 3: PABLOZAL10 ($1.97 in chips) 
Seat 4: AngryRaises ($4.66 in chips) 
Seat 5: peakyblinders82 ($2.01 in chips) 
Seat 6: Dorex2007 ($2.10 in chips) 
Seat 7: ser447787 ($2.01 in chips) 
Seat 8: edoschenko ($1.71 in chips) 
Seat 9: Cesnielumige ($2 in chips) 
ppeetteerr175: posts small blind $0.01
buggspray: posts big blind $0.02
*** HOLE CARDS ***
Dealt to Dorex2007 [Td Js]
PABLOZAL10: folds 
AngryRaises: folds 
peakyblinders82: calls $0.02
Dorex2007: folds 
ser447787: folds 
edoschenko: folds 
Cesnielumige: folds 
ppeetteerr175: calls $0.01
buggspray: checks 
*** FLOP *** [Ad Ks Qc]
ppeetteerr175: bets $0.02
buggspray: folds 
peakyblinders82: calls $0.02
*** TURN *** [Ad Ks Qc] [Jh]
ppeetteerr175: bets $0.02
peakyblinders82: calls $0.02
*** RIVER *** [Ad Ks Qc Jh] [Ts]
ppeetteerr175: checks 
peakyblinders82: checks 
*** SHOW DOWN ***
ppeetteerr175: shows [Ah Jd] (a straight, Ten to Ace)
peakyblinders82: shows [9s Qh] (a straight, Ten to Ace)
ppeetteerr175 collected $0.07 from pot
peakyblinders82 collected $0.07 from pot
*** SUMMARY ***
Total pot $0.14 | Rake $0 
Board [Ad Ks Qc Jh Ts]
Seat 1: ppeetteerr175 (small blind) showed [Ah Jd] and won ($0.07) with a straight, Ten to Ace
Seat 2: buggspray (big blind) folded on the Flop
Seat 3: PABLOZAL10 folded before Flop (didn't bet)
Seat 4: AngryRaises folded before Flop (didn't bet)
Seat 5: peakyblinders82 showed [9s Qh] and won ($0.07) with a straight, Ten to Ace
Seat 6: Dorex2007 folded before Flop (didn't bet)
Seat 7: ser447787 folded before Flop (didn't bet)
Seat 8: edoschenko folded before Flop (didn't bet)
Seat 9: Cesnielumige (button) folded before Flop (didn't bet)



PokerStars Hand #224826065500:  Hold'em No Limit ($0.01/$0.02 USD) - 2021/03/14 22:28:51 PT [2021/03/15 1:28:51 ET]
Table 'Piccolo IV' 9-max Seat #1 is the button
Seat 1: ppeetteerr175 ($2.57 in chips) 
Seat 2: buggspray ($1.90 in chips) 
Seat 3: PABLOZAL10 ($1.97 in chips) 
Seat 4: AngryRaises ($4.66 in chips) 
Seat 5: peakyblinders82 ($2.02 in chips) 
Seat 6: Dorex2007 ($2.10 in chips) 
Seat 7: ser447787 ($2.01 in chips) 
Seat 8: edoschenko ($1.71 in chips) 
Seat 9: Cesnielumige ($2 in chips) 
buggspray: posts small blind $0.01
PABLOZAL10: posts big blind $0.02
*** HOLE CARDS ***
Dealt to Dorex2007 [Jd Ad]
AngryRaises: folds 
peakyblinders82: folds 
Dorex2007: raises $0.04 to $0.06
ser447787: folds 
edoschenko: folds 
Cesnielumige: folds 
ppeetteerr175: calls $0.06
buggspray: folds 
PABLOZAL10: folds 
*** FLOP *** [Ah Td Tc]
Dorex2007: bets $0.14
ppeetteerr175: folds 
Uncalled bet ($0.14) returned to Dorex2007
Dorex2007 collected $0.14 from pot
Dorex2007: doesn't show hand 
*** SUMMARY ***
Total pot $0.15 | Rake $0.01 
Board [Ah Td Tc]
Seat 1: ppeetteerr175 (button) folded on the Flop
Seat 2: buggspray (small blind) folded before Flop
Seat 3: PABLOZAL10 (big blind) folded before Flop
Seat 4: AngryRaises folded before Flop (didn't bet)
Seat 5: peakyblinders82 folded before Flop (didn't bet)
Seat 6: Dorex2007 collected ($0.14)
Seat 7: ser447787 folded before Flop (didn't bet)
Seat 8: edoschenko folded before Flop (didn't bet)
Seat 9: Cesnielumige folded before Flop (didn't bet)



PokerStars Hand #224826071779:  Hold'em No Limit ($0.01/$0.02 USD) - 2021/03/14 22:29:33 PT [2021/03/15 1:29:33 ET]
Table 'Piccolo IV' 9-max Seat #2 is the button
Seat 1: ppeetteerr175 ($2.51 in chips) 
Seat 2: buggspray ($1.89 in chips) 
Seat 3: PABLOZAL10 ($1.95 in chips) 
Seat 4: AngryRaises ($4.66 in chips) 
Seat 5: peakyblinders82 ($2.02 in chips) 
Seat 6: Dorex2007 ($2.18 in chips) 
Seat 7: ser447787 ($2.01 in chips) 
Seat 8: edoschenko ($1.71 in chips) 
Seat 9: Cesnielumige ($2 in chips) 
PABLOZAL10: posts small blind $0.01
AngryRaises: posts big blind $0.02
*** HOLE CARDS ***
Dealt to Dorex2007 [7d 7s]
peakyblinders82: calls $0.02
Dorex2007: calls $0.02
ser447787: folds 
edoschenko: folds 
Cesnielumige: folds 
ppeetteerr175: calls $0.02
buggspray: folds 
PABLOZAL10: calls $0.01
AngryRaises: checks 
*** FLOP *** [Th Ks 9c]
PABLOZAL10: checks 
AngryRaises: checks 
peakyblinders82: checks 
Dorex2007: checks 
ppeetteerr175: checks 
*** TURN *** [Th Ks 9c] [5d]
PABLOZAL10: checks 
AngryRaises: checks 
peakyblinders82: checks 
Dorex2007: checks 
ppeetteerr175: checks 
*** RIVER *** [Th Ks 9c 5d] [7c]
PABLOZAL10: checks 
AngryRaises: checks 
peakyblinders82: checks 
Dorex2007: bets $0.10
ppeetteerr175: folds 
PABLOZAL10: folds 
AngryRaises: folds 
peakyblinders82: folds 
Uncalled bet ($0.10) returned to Dorex2007
Dorex2007 collected $0.10 from pot
Dorex2007: doesn't show hand 
*** SUMMARY ***
Total pot $0.10 | Rake $0 
Board [Th Ks 9c 5d 7c]
Seat 1: ppeetteerr175 folded on the River
Seat 2: buggspray (button) folded before Flop (didn't bet)
Seat 3: PABLOZAL10 (small blind) folded on the River
Seat 4: AngryRaises (big blind) folded on the River
Seat 5: peakyblinders82 folded on the River
Seat 6: Dorex2007 collected ($0.10)
Seat 7: ser447787 folded before Flop (didn't bet)
Seat 8: edoschenko folded before Flop (didn't bet)
Seat 9: Cesnielumige folded before Flop (didn't bet)



PokerStars Hand #224826086163:  Hold'em No Limit ($0.01/$0.02 USD) - 2021/03/14 22:31:08 PT [2021/03/15 1:31:08 ET]
Table 'Piccolo IV' 9-max Seat #3 is the button
Seat 1: ppeetteerr175 ($2.49 in chips) 
Seat 2: buggspray ($1.89 in chips) 
Seat 3: PABLOZAL10 ($1.93 in chips) 
Seat 4: AngryRaises ($4.64 in chips) 
Seat 5: peakyblinders82 ($2 in chips) 
Seat 6: Dorex2007 ($2.26 in chips) 
Seat 7: ser447787 ($2.01 in chips) 
Seat 8: edoschenko ($1.71 in chips) 
Seat 9: Cesnielumige ($2 in chips) 
AngryRaises: posts small blind $0.01
peakyblinders82: posts big blind $0.02
*** HOLE CARDS ***
Dealt to Dorex2007 [2h Ks]
Dorex2007: folds 
ser447787: folds 
edoschenko: folds 
Cesnielumige: folds 
ppeetteerr175: folds 
buggspray: raises $0.02 to $0.04
PABLOZAL10: folds 
AngryRaises: calls $0.03
peakyblinders82: folds 
*** FLOP *** [3d Ad 3c]
AngryRaises: checks 
buggspray: checks 
*** TURN *** [3d Ad 3c] [6c]
AngryRaises: bets $0.02
buggspray: raises $0.14 to $0.16
AngryRaises: calls $0.14
*** RIVER *** [3d Ad 3c 6c] [8h]
AngryRaises: checks 
buggspray: bets $1.69 and is all-in
AngryRaises: folds 
Uncalled bet ($1.69) returned to buggspray
buggspray collected $0.41 from pot
buggspray: doesn't show hand 
*** SUMMARY ***
Total pot $0.42 | Rake $0.01 
Board [3d Ad 3c 6c 8h]
Seat 1: ppeetteerr175 folded before Flop (didn't bet)
Seat 2: buggspray collected ($0.41)
Seat 3: PABLOZAL10 (button) folded before Flop (didn't bet)
Seat 4: AngryRaises (small blind) folded on the River
Seat 5: peakyblinders82 (big blind) folded before Flop
Seat 6: Dorex2007 folded before Flop (didn't bet)
Seat 7: ser447787 folded before Flop (didn't bet)
Seat 8: edoschenko folded before Flop (didn't bet)
Seat 9: Cesnielumige folded before Flop (didn't bet)



PokerStars Hand #224826091468:  Hold'em No Limit ($0.01/$0.02 USD) - 2021/03/14 22:31:43 PT [2021/03/15 1:31:43 ET]
Table 'Piccolo IV' 9-max Seat #4 is the button
Seat 1: ppeetteerr175 ($2.49 in chips) 
Seat 2: buggspray ($2.10 in chips) 
Seat 3: PABLOZAL10 ($1.93 in chips) 
Seat 4: AngryRaises ($4.44 in chips) 
Seat 5: peakyblinders82 ($1.98 in chips) 
Seat 6: Dorex2007 ($2.26 in chips) 
Seat 7: ser447787 ($2.01 in chips) 
Seat 8: edoschenko ($1.71 in chips) 
Seat 9: Cesnielumige ($2 in chips) 
peakyblinders82: posts small blind $0.01
Dorex2007: posts big blind $0.02
*** HOLE CARDS ***
Dealt to Dorex2007 [Ks 8d]
ser447787: raises $0.05 to $0.07
edoschenko: folds 
Cesnielumige: folds 
ppeetteerr175: folds 
buggspray: folds 
PABLOZAL10: folds 
AngryRaises: folds 
peakyblinders82: folds 
Dorex2007: folds 
Uncalled bet ($0.05) returned to ser447787
ser447787 collected $0.05 from pot
*** SUMMARY ***
Total pot $0.05 | Rake $0 
Seat 1: ppeetteerr175 folded before Flop (didn't bet)
Seat 2: buggspray folded before Flop (didn't bet)
Seat 3: PABLOZAL10 folded before Flop (didn't bet)
Seat 4: AngryRaises (button) folded before Flop (didn't bet)
Seat 5: peakyblinders82 (small blind) folded before Flop
Seat 6: Dorex2007 (big blind) folded before Flop
Seat 7: ser447787 collected ($0.05)
Seat 8: edoschenko folded before Flop (didn't bet)
Seat 9: Cesnielumige folded before Flop (didn't bet)



PokerStars Hand #224826095416:  Hold'em No Limit ($0.01/$0.02 USD) - 2021/03/14 22:32:09 PT [2021/03/15 1:32:09 ET]
Table 'Piccolo IV' 9-max Seat #5 is the button
Seat 1: ppeetteerr175 ($2.49 in chips) 
Seat 2: buggspray ($2.10 in chips) 
Seat 3: PABLOZAL10 ($1.93 in chips) 
Seat 4: AngryRaises ($4.44 in chips) 
Seat 5: peakyblinders82 ($1.97 in chips) 
Seat 6: Dorex2007 ($2.24 in chips) 
Seat 7: ser447787 ($2.04 in chips) 
Seat 8: edoschenko ($1.71 in chips) 
Seat 9: Cesnielumige ($2 in chips) 
Dorex2007: posts small blind $0.01
ser447787: posts big blind $0.02
*** HOLE CARDS ***
Dealt to Dorex2007 [8s 2d]
edoschenko: folds 
Cesnielumige: folds 
ppeetteerr175: folds 
buggspray: folds 
PABLOZAL10: raises $0.02 to $0.04
AngryRaises: folds 
peakyblinders82: calls $0.04
Dorex2007: folds 
ser447787: folds 
*** FLOP *** [Tc 2h Qs]
PABLOZAL10: bets $0.06
peakyblinders82: calls $0.06
*** TURN *** [Tc 2h Qs] [Kd]
PABLOZAL10: bets $0.06
peakyblinders82: raises $0.06 to $0.12
PABLOZAL10: calls $0.06
*** RIVER *** [Tc 2h Qs Kd] [7s]
PABLOZAL10: checks 
peakyblinders82: bets $0.22
PABLOZAL10: folds 
Uncalled bet ($0.22) returned to peakyblinders82
peakyblinders82 collected $0.45 from pot
peakyblinders82: doesn't show hand 
*** SUMMARY ***
Total pot $0.47 | Rake $0.02 
Board [Tc 2h Qs Kd 7s]
Seat 1: ppeetteerr175 folded before Flop (didn't bet)
Seat 2: buggspray folded before Flop (didn't bet)
Seat 3: PABLOZAL10 folded on the River
Seat 4: AngryRaises folded before Flop (didn't bet)
Seat 5: peakyblinders82 (button) collected ($0.45)
Seat 6: Dorex2007 (small blind) folded before Flop
Seat 7: ser447787 (big blind) folded before Flop
Seat 8: edoschenko folded before Flop (didn't bet)
Seat 9: Cesnielumige folded before Flop (didn't bet)



PokerStars Hand #224826104181:  Hold'em No Limit ($0.01/$0.02 USD) - 2021/03/14 22:33:07 PT [2021/03/15 1:33:07 ET]
Table 'Piccolo IV' 9-max Seat #6 is the button
Seat 1: ppeetteerr175 ($2.49 in chips) 
Seat 2: buggspray ($2.10 in chips) 
Seat 3: PABLOZAL10 ($1.71 in chips) 
Seat 4: AngryRaises ($4.44 in chips) 
Seat 5: peakyblinders82 ($2.20 in chips) 
Seat 6: Dorex2007 ($2.23 in chips) 
Seat 7: ser447787 ($2.02 in chips) 
Seat 8: edoschenko ($1.71 in chips) 
Seat 9: Cesnielumige ($2 in chips) 
ser447787: posts small blind $0.01
edoschenko: posts big blind $0.02
*** HOLE CARDS ***
Dealt to Dorex2007 [7d 6d]
Cesnielumige: folds 
ppeetteerr175: raises $0.02 to $0.04
buggspray: folds 
PABLOZAL10: folds 
AngryRaises: calls $0.04
peakyblinders82: folds 
Dorex2007: folds 
ser447787: calls $0.03
edoschenko: folds 
*** FLOP *** [Qc 2h Qh]
ser447787: checks 
ppeetteerr175: bets $0.02
AngryRaises: folds 
ser447787: calls $0.02
*** TURN *** [Qc 2h Qh] [5c]
ser447787: checks 
ppeetteerr175: bets $0.09
ser447787: calls $0.09
*** RIVER *** [Qc 2h Qh 5c] [Ks]
ser447787: checks 
ppeetteerr175: bets $0.35
ser447787: folds 
Uncalled bet ($0.35) returned to ppeetteerr175
ppeetteerr175 collected $0.35 from pot
ppeetteerr175: doesn't show hand 
*** SUMMARY ***
Total pot $0.36 | Rake $0.01 
Board [Qc 2h Qh 5c Ks]
Seat 1: ppeetteerr175 collected ($0.35)
Seat 2: buggspray folded before Flop (didn't bet)
Seat 3: PABLOZAL10 folded before Flop (didn't bet)
Seat 4: AngryRaises folded on the Flop
Seat 5: peakyblinders82 folded before Flop (didn't bet)
Seat 6: Dorex2007 (button) folded before Flop (didn't bet)
Seat 7: ser447787 (small blind) folded on the River
Seat 8: edoschenko (big blind) folded before Flop
Seat 9: Cesnielumige folded before Flop (didn't bet)



PokerStars Hand #224826124638:  Hold'em No Limit ($0.01/$0.02 USD) - 2021/03/14 22:34:24 PT [2021/03/15 1:34:24 ET]
Table 'Piccolo IV' 9-max Seat #7 is the button
Seat 1: ppeetteerr175 ($2.69 in chips) 
Seat 2: buggspray ($2.10 in chips) 
Seat 3: PABLOZAL10 ($1.71 in chips) 
Seat 4: AngryRaises ($4.40 in chips) 
Seat 5: peakyblinders82 ($2.20 in chips) 
Seat 6: Dorex2007 ($2.23 in chips) 
Seat 7: ser447787 ($2 in chips) 
Seat 8: edoschenko ($1.69 in chips) 
Seat 9: Cesnielumige ($2 in chips) 
edoschenko: posts small blind $0.01
Cesnielumige: posts big blind $0.02
*** HOLE CARDS ***
Dealt to Dorex2007 [4s Tc]
ppeetteerr175: folds 
buggspray: folds 
PABLOZAL10: folds 
AngryRaises: folds 
peakyblinders82: calls $0.02
Dorex2007: folds 
ser447787: folds 
edoschenko: folds 
Cesnielumige: checks 
*** FLOP *** [7c Qc Jc]
Cesnielumige: checks 
peakyblinders82: checks 
*** TURN *** [7c Qc Jc] [2c]
Cesnielumige: checks 
peakyblinders82: checks 
*** RIVER *** [7c Qc Jc 2c] [3h]
Cesnielumige: checks 
peakyblinders82: checks 
*** SHOW DOWN ***
Cesnielumige: shows [As 7d] (a pair of Sevens)
peakyblinders82: shows [Kh 4c] (a flush, Queen high)
peakyblinders82 collected $0.05 from pot
*** SUMMARY ***
Total pot $0.05 | Rake $0 
Board [7c Qc Jc 2c 3h]
Seat 1: ppeetteerr175 folded before Flop (didn't bet)
Seat 2: buggspray folded before Flop (didn't bet)
Seat 3: PABLOZAL10 folded before Flop (didn't bet)
Seat 4: AngryRaises folded before Flop (didn't bet)
Seat 5: peakyblinders82 showed [Kh 4c] and won ($0.05) with a flush, Queen high
Seat 6: Dorex2007 folded before Flop (didn't bet)
Seat 7: ser447787 (button) folded before Flop (didn't bet)
Seat 8: edoschenko (small blind) folded before Flop
Seat 9: Cesnielumige (big blind) showed [As 7d] and lost with a pair of Sevens



PokerStars Hand #224826130996:  Hold'em No Limit ($0.01/$0.02 USD) - 2021/03/14 22:35:06 PT [2021/03/15 1:35:06 ET]
Table 'Piccolo IV' 9-max Seat #8 is the button
Seat 1: ppeetteerr175 ($2.69 in chips) 
Seat 2: buggspray ($2.10 in chips) 
Seat 3: PABLOZAL10 ($1.71 in chips) 
Seat 4: AngryRaises ($4.40 in chips) 
Seat 5: peakyblinders82 ($2.23 in chips) 
Seat 6: Dorex2007 ($2.23 in chips) 
Seat 7: ser447787 ($2 in chips) 
Seat 8: edoschenko ($1.68 in chips) 
Seat 9: Cesnielumige ($1.98 in chips) 
Cesnielumige: posts small blind $0.01
ppeetteerr175: posts big blind $0.02
*** HOLE CARDS ***
Dealt to Dorex2007 [Ts 8s]
buggspray: raises $0.02 to $0.04
PABLOZAL10: folds 
AngryRaises: calls $0.04
peakyblinders82: calls $0.04
Dorex2007: folds 
ser447787: folds 
edoschenko: folds 
Cesnielumige: calls $0.03
ppeetteerr175: calls $0.02
*** FLOP *** [9c Js 3c]
Cesnielumige: checks 
ppeetteerr175: checks 
buggspray: checks 
AngryRaises: checks 
peakyblinders82: checks 
*** TURN *** [9c Js 3c] [Ad]
Cesnielumige: checks 
ppeetteerr175: checks 
buggspray: checks 
AngryRaises: checks 
peakyblinders82: bets $0.09
Cesnielumige: folds 
ppeetteerr175: folds 
buggspray: folds 
AngryRaises: calls $0.09
*** RIVER *** [9c Js 3c Ad] [4c]
AngryRaises: checks 
peakyblinders82: checks 
*** SHOW DOWN ***
AngryRaises: shows [8h Ah] (a pair of Aces)
peakyblinders82: mucks hand 
AngryRaises collected $0.37 from pot
*** SUMMARY ***
Total pot $0.38 | Rake $0.01 
Board [9c Js 3c Ad 4c]
Seat 1: ppeetteerr175 (big blind) folded on the Turn
Seat 2: buggspray folded on the Turn
Seat 3: PABLOZAL10 folded before Flop (didn't bet)
Seat 4: AngryRaises showed [8h Ah] and won ($0.37) with a pair of Aces
Seat 5: peakyblinders82 mucked [6c 6d]
Seat 6: Dorex2007 folded before Flop (didn't bet)
Seat 7: ser447787 folded before Flop (didn't bet)
Seat 8: edoschenko (button) folded before Flop (didn't bet)
Seat 9: Cesnielumige (small blind) folded on the Turn



PokerStars Hand #224826140010:  Hold'em No Limit ($0.01/$0.02 USD) - 2021/03/14 22:36:08 PT [2021/03/15 1:36:08 ET]
Table 'Piccolo IV' 9-max Seat #9 is the button
Seat 1: ppeetteerr175 ($2.65 in chips) 
Seat 3: PABLOZAL10 ($1.71 in chips) 
Seat 4: AngryRaises ($4.64 in chips) 
Seat 5: peakyblinders82 ($2.10 in chips) 
Seat 6: Dorex2007 ($2.23 in chips) 
Seat 7: ser447787 ($2 in chips) 
Seat 8: edoschenko ($1.68 in chips) 
Seat 9: Cesnielumige ($1.94 in chips) 
ppeetteerr175: posts small blind $0.01
buggspray: is sitting out 
PABLOZAL10: posts big blind $0.02
*** HOLE CARDS ***
Dealt to Dorex2007 [8s 7h]
AngryRaises: folds 
peakyblinders82: folds 
Dorex2007: folds 
ser447787: folds 
edoschenko: folds 
Cesnielumige: folds 
ppeetteerr175: calls $0.01
PABLOZAL10: checks 
*** FLOP *** [2c 3h Td]
ppeetteerr175: checks 
PABLOZAL10: checks 
*** TURN *** [2c 3h Td] [Ks]
ppeetteerr175: checks 
PABLOZAL10: checks 
*** RIVER *** [2c 3h Td Ks] [4d]
ppeetteerr175: checks 
PABLOZAL10: checks 
*** SHOW DOWN ***
ppeetteerr175: shows [6c 9c] (high card King)
PABLOZAL10: shows [Jc 5d] (high card King - Jack kicker)
PABLOZAL10 collected $0.04 from pot
*** SUMMARY ***
Total pot $0.04 | Rake $0 
Board [2c 3h Td Ks 4d]
Seat 1: ppeetteerr175 (small blind) showed [6c 9c] and lost with high card King
Seat 3: PABLOZAL10 (big blind) showed [Jc 5d] and won ($0.04) with high card King
Seat 4: AngryRaises folded before Flop (didn't bet)
Seat 5: peakyblinders82 folded before Flop (didn't bet)
Seat 6: Dorex2007 folded before Flop (didn't bet)
Seat 7: ser447787 folded before Flop (didn't bet)
Seat 8: edoschenko folded before Flop (didn't bet)
Seat 9: Cesnielumige (button) folded before Flop (didn't bet)



PokerStars Hand #224826145093:  Hold'em No Limit ($0.01/$0.02 USD) - 2021/03/14 22:36:42 PT [2021/03/15 1:36:42 ET]
Table 'Piccolo IV' 9-max Seat #1 is the button
Seat 1: ppeetteerr175 ($2.63 in chips) 
Seat 3: PABLOZAL10 ($1.73 in chips) 
Seat 4: AngryRaises ($4.64 in chips) 
Seat 5: peakyblinders82 ($2.10 in chips) 
Seat 6: Dorex2007 ($2.23 in chips) 
Seat 7: ser447787 ($2 in chips) 
Seat 8: edoschenko ($1.68 in chips) 
Seat 9: Cesnielumige ($1.94 in chips) 
PABLOZAL10: posts small blind $0.01
AngryRaises: posts big blind $0.02
*** HOLE CARDS ***
Dealt to Dorex2007 [Th 7h]
peakyblinders82: raises $0.02 to $0.04
Dorex2007: folds 
ser447787: folds 
edoschenko: folds 
Cesnielumige: folds 
ppeetteerr175: folds 
PABLOZAL10: calls $0.03
AngryRaises: folds 
*** FLOP *** [4s 5d 4c]
PABLOZAL10: checks 
peakyblinders82: bets $0.05
PABLOZAL10: calls $0.05
*** TURN *** [4s 5d 4c] [9s]
PABLOZAL10: checks 
peakyblinders82: bets $0.09
PABLOZAL10: folds 
Uncalled bet ($0.09) returned to peakyblinders82
peakyblinders82 collected $0.19 from pot
peakyblinders82: doesn't show hand 
*** SUMMARY ***
Total pot $0.20 | Rake $0.01 
Board [4s 5d 4c 9s]
Seat 1: ppeetteerr175 (button) folded before Flop (didn't bet)
Seat 3: PABLOZAL10 (small blind) folded on the Turn
Seat 4: AngryRaises (big blind) folded before Flop
Seat 5: peakyblinders82 collected ($0.19)
Seat 6: Dorex2007 folded before Flop (didn't bet)
Seat 7: ser447787 folded before Flop (didn't bet)
Seat 8: edoschenko folded before Flop (didn't bet)
Seat 9: Cesnielumige folded before Flop (didn't bet)



PokerStars Hand #224826152043:  Hold'em No Limit ($0.01/$0.02 USD) - 2021/03/14 22:37:28 PT [2021/03/15 1:37:28 ET]
Table 'Piccolo IV' 9-max Seat #3 is the button
Seat 1: ppeetteerr175 ($2.63 in chips) 
Seat 3: PABLOZAL10 ($1.64 in chips) 
Seat 4: AngryRaises ($4.62 in chips) 
Seat 5: peakyblinders82 ($2.20 in chips) 
Seat 6: Dorex2007 ($2.23 in chips) 
Seat 7: ser447787 ($2 in chips) 
Seat 8: edoschenko ($1.68 in chips) 
Seat 9: Cesnielumige ($1.94 in chips) 
AngryRaises: posts small blind $0.01
peakyblinders82: posts big blind $0.02
*** HOLE CARDS ***
Dealt to Dorex2007 [4s 5d]
Dorex2007: folds 
ser447787: folds 
edoschenko: folds 
Cesnielumige: folds 
ppeetteerr175: folds 
PABLOZAL10: raises $0.04 to $0.06
AngryRaises: folds 
peakyblinders82: calls $0.04
*** FLOP *** [Kd Qh 3s]
peakyblinders82: checks 
PABLOZAL10: bets $0.07
peakyblinders82: folds 
Uncalled bet ($0.07) returned to PABLOZAL10
PABLOZAL10 collected $0.13 from pot
PABLOZAL10: doesn't show hand 
*** SUMMARY ***
Total pot $0.13 | Rake $0 
Board [Kd Qh 3s]
Seat 1: ppeetteerr175 folded before Flop (didn't bet)
Seat 3: PABLOZAL10 (button) collected ($0.13)
Seat 4: AngryRaises (small blind) folded before Flop
Seat 5: peakyblinders82 (big blind) folded on the Flop
Seat 6: Dorex2007 folded before Flop (didn't bet)
Seat 7: ser447787 folded before Flop (didn't bet)
Seat 8: edoschenko folded before Flop (didn't bet)
Seat 9: Cesnielumige folded before Flop (didn't bet)



PokerStars Hand #224826156466:  Hold'em No Limit ($0.01/$0.02 USD) - 2021/03/14 22:37:57 PT [2021/03/15 1:37:57 ET]
Table 'Piccolo IV' 9-max Seat #4 is the button
Seat 1: ppeetteerr175 ($2.63 in chips) 
Seat 3: PABLOZAL10 ($1.71 in chips) 
Seat 4: AngryRaises ($4.61 in chips) 
Seat 5: peakyblinders82 ($2.14 in chips) 
Seat 6: Dorex2007 ($2.23 in chips) 
Seat 7: ser447787 ($2 in chips) 
Seat 8: edoschenko ($1.68 in chips) 
Seat 9: Cesnielumige ($1.94 in chips) 
peakyblinders82: posts small blind $0.01
Dorex2007: posts big blind $0.02
*** HOLE CARDS ***
Dealt to Dorex2007 [8c Qd]
ser447787: folds 
edoschenko: folds 
Cesnielumige: raises $0.06 to $0.08
ppeetteerr175: folds 
PABLOZAL10: folds 
AngryRaises: raises $4.53 to $4.61 and is all-in
peakyblinders82: folds 
Dorex2007: folds 
Cesnielumige: folds 
Uncalled bet ($4.53) returned to AngryRaises
AngryRaises collected $0.19 from pot
AngryRaises: doesn't show hand 
*** SUMMARY ***
Total pot $0.19 | Rake $0 
Seat 1: ppeetteerr175 folded before Flop (didn't bet)
Seat 3: PABLOZAL10 folded before Flop (didn't bet)
Seat 4: AngryRaises (button) collected ($0.19)
Seat 5: peakyblinders82 (small blind) folded before Flop
Seat 6: Dorex2007 (big blind) folded before Flop
Seat 7: ser447787 folded before Flop (didn't bet)
Seat 8: edoschenko folded before Flop (didn't bet)
Seat 9: Cesnielumige folded before Flop



PokerStars Hand #224826162739:  Hold'em No Limit ($0.01/$0.02 USD) - 2021/03/14 22:38:39 PT [2021/03/15 1:38:39 ET]
Table 'Piccolo IV' 9-max Seat #5 is the button
Seat 1: ppeetteerr175 ($2.63 in chips) 
Seat 3: PABLOZAL10 ($1.71 in chips) 
Seat 4: AngryRaises ($4.72 in chips) 
Seat 5: peakyblinders82 ($2.13 in chips) 
Seat 6: Dorex2007 ($2.21 in chips) 
Seat 7: ser447787 ($2 in chips) 
Seat 8: edoschenko ($1.68 in chips) 
Seat 9: Cesnielumige ($1.86 in chips) 
Dorex2007: posts small blind $0.01
ser447787: posts big blind $0.02
*** HOLE CARDS ***
Dealt to Dorex2007 [Qd 3c]
edoschenko: folds 
Cesnielumige: folds 
ppeetteerr175: calls $0.02
PABLOZAL10: folds 
AngryRaises: calls $0.02
peakyblinders82: folds 
Dorex2007: folds 
ser447787: checks 
*** FLOP *** [Ad 4d As]
ser447787: checks 
ppeetteerr175: bets $0.07
buggspray leaves the table
AngryRaises: folds 
ser447787: folds 
Uncalled bet ($0.07) returned to ppeetteerr175
ppeetteerr175 collected $0.07 from pot
ppeetteerr175: doesn't show hand 
Azznak joins the table at seat #2 
*** SUMMARY ***
Total pot $0.07 | Rake $0 
Board [Ad 4d As]
Seat 1: ppeetteerr175 collected ($0.07)
Seat 3: PABLOZAL10 folded before Flop (didn't bet)
Seat 4: AngryRaises folded on the Flop
Seat 5: peakyblinders82 (button) folded before Flop (didn't bet)
Seat 6: Dorex2007 (small blind) folded before Flop
Seat 7: ser447787 (big blind) folded on the Flop
Seat 8: edoschenko folded before Flop (didn't bet)
Seat 9: Cesnielumige folded before Flop (didn't bet)



PokerStars Hand #224826168768:  Hold'em No Limit ($0.01/$0.02 USD) - 2021/03/14 22:39:19 PT [2021/03/15 1:39:19 ET]
Table 'Piccolo IV' 9-max Seat #6 is the button
Seat 1: ppeetteerr175 ($2.68 in chips) 
Seat 3: PABLOZAL10 ($1.71 in chips) 
Seat 4: AngryRaises ($4.70 in chips) 
Seat 5: peakyblinders82 ($2.13 in chips) 
Seat 6: Dorex2007 ($2.20 in chips) 
Seat 7: ser447787 ($2 in chips) 
Seat 8: edoschenko ($1.68 in chips) 
Seat 9: Cesnielumige ($1.86 in chips) 
ser447787: posts small blind $0.01
edoschenko: posts big blind $0.02
Azznak: sits out 
*** HOLE CARDS ***
Dealt to Dorex2007 [4d 2h]
Cesnielumige: folds 
ppeetteerr175: folds 
PABLOZAL10: folds 
AngryRaises: folds 
peakyblinders82: raises $0.02 to $0.04
Dorex2007: folds 
ser447787: folds 
edoschenko: calls $0.02
*** FLOP *** [Kh Jc 6d]
edoschenko: checks 
peakyblinders82: bets $0.04
edoschenko: folds 
Uncalled bet ($0.04) returned to peakyblinders82
peakyblinders82 collected $0.09 from pot
peakyblinders82: doesn't show hand 
*** SUMMARY ***
Total pot $0.09 | Rake $0 
Board [Kh Jc 6d]
Seat 1: ppeetteerr175 folded before Flop (didn't bet)
Seat 3: PABLOZAL10 folded before Flop (didn't bet)
Seat 4: AngryRaises folded before Flop (didn't bet)
Seat 5: peakyblinders82 collected ($0.09)
Seat 6: Dorex2007 (button) folded before Flop (didn't bet)
Seat 7: ser447787 (small blind) folded before Flop
Seat 8: edoschenko (big blind) folded on the Flop
Seat 9: Cesnielumige folded before Flop (didn't bet)



PokerStars Hand #224826175515:  Hold'em No Limit ($0.01/$0.02 USD) - 2021/03/14 22:40:04 PT [2021/03/15 1:40:04 ET]
Table 'Piccolo IV' 9-max Seat #7 is the button
Seat 1: ppeetteerr175 ($2.68 in chips) 
Seat 3: PABLOZAL10 ($1.71 in chips) 
Seat 4: AngryRaises ($4.70 in chips) 
Seat 5: peakyblinders82 ($2.18 in chips) 
Seat 6: Dorex2007 ($2.20 in chips) 
Seat 7: ser447787 ($2 in chips) 
Seat 8: edoschenko ($1.64 in chips) 
Seat 9: Cesnielumige ($1.86 in chips) 
edoschenko: posts small blind $0.01
Cesnielumige: posts big blind $0.02
Azznak: sits out 
*** HOLE CARDS ***
Dealt to Dorex2007 [9c 6s]
ppeetteerr175: folds 
PABLOZAL10: folds 
AngryRaises: folds 
peakyblinders82: calls $0.02
Dorex2007: folds 
ser447787: folds 
edoschenko: folds 
Cesnielumige: checks 
*** FLOP *** [2c 3h 9d]
Cesnielumige: checks 
peakyblinders82: checks 
*** TURN *** [2c 3h 9d] [7s]
Cesnielumige: checks 
peakyblinders82: bets $0.02
Cesnielumige: folds 
Uncalled bet ($0.02) returned to peakyblinders82
peakyblinders82 collected $0.05 from pot
peakyblinders82: doesn't show hand 
*** SUMMARY ***
Total pot $0.05 | Rake $0 
Board [2c 3h 9d 7s]
Seat 1: ppeetteerr175 folded before Flop (didn't bet)
Seat 3: PABLOZAL10 folded before Flop (didn't bet)
Seat 4: AngryRaises folded before Flop (didn't bet)
Seat 5: peakyblinders82 collected ($0.05)
Seat 6: Dorex2007 folded before Flop (didn't bet)
Seat 7: ser447787 (button) folded before Flop (didn't bet)
Seat 8: edoschenko (small blind) folded before Flop
Seat 9: Cesnielumige (big blind) folded on the Turn



PokerStars Hand #224826180035:  Hold'em No Limit ($0.01/$0.02 USD) - 2021/03/14 22:40:35 PT [2021/03/15 1:40:35 ET]
Table 'Piccolo IV' 9-max Seat #8 is the button
Seat 1: ppeetteerr175 ($2.68 in chips) 
Seat 3: PABLOZAL10 ($1.71 in chips) 
Seat 4: AngryRaises ($4.70 in chips) 
Seat 5: peakyblinders82 ($2.21 in chips) 
Seat 6: Dorex2007 ($2.20 in chips) 
Seat 7: ser447787 ($2 in chips) 
Seat 8: edoschenko ($1.63 in chips) 
Seat 9: Cesnielumige ($1.84 in chips) 
Cesnielumige: posts small blind $0.01
ppeetteerr175: posts big blind $0.02
Azznak: sits out 
*** HOLE CARDS ***
Dealt to Dorex2007 [8c 7h]
PABLOZAL10: folds 
AngryRaises: folds 
peakyblinders82: calls $0.02
Dorex2007: folds 
ser447787: folds 
edoschenko: raises $0.10 to $0.12
Cesnielumige: folds 
ppeetteerr175: folds 
peakyblinders82: calls $0.10
*** FLOP *** [9c 7c Qd]
peakyblinders82: checks 
edoschenko: checks 
*** TURN *** [9c 7c Qd] [Th]
peakyblinders82: checks 
edoschenko: checks 
*** RIVER *** [9c 7c Qd Th] [6d]
peakyblinders82: checks 
edoschenko: checks 
*** SHOW DOWN ***
peakyblinders82: shows [5h 6h] (a pair of Sixes)
edoschenko: mucks hand 
peakyblinders82 collected $0.26 from pot
*** SUMMARY ***
Total pot $0.27 | Rake $0.01 
Board [9c 7c Qd Th 6d]
Seat 1: ppeetteerr175 (big blind) folded before Flop
Seat 3: PABLOZAL10 folded before Flop (didn't bet)
Seat 4: AngryRaises folded before Flop (didn't bet)
Seat 5: peakyblinders82 showed [5h 6h] and won ($0.26) with a pair of Sixes
Seat 6: Dorex2007 folded before Flop (didn't bet)
Seat 7: ser447787 folded before Flop (didn't bet)
Seat 8: edoschenko (button) mucked [As Kh]
Seat 9: Cesnielumige (small blind) folded before Flop



PokerStars Hand #224826188633:  Hold'em No Limit ($0.01/$0.02 USD) - 2021/03/14 22:41:32 PT [2021/03/15 1:41:32 ET]
Table 'Piccolo IV' 9-max Seat #9 is the button
Seat 1: ppeetteerr175 ($2.66 in chips) 
Seat 2: Azznak ($2 in chips) 
Seat 3: PABLOZAL10 ($1.71 in chips) 
Seat 4: AngryRaises ($4.70 in chips) 
Seat 5: peakyblinders82 ($2.35 in chips) 
Seat 6: Dorex2007 ($2.20 in chips) 
Seat 7: ser447787 ($2 in chips) 
Seat 8: edoschenko ($1.51 in chips) 
Seat 9: Cesnielumige ($1.83 in chips) 
ppeetteerr175: posts small blind $0.01
Azznak: posts big blind $0.02
*** HOLE CARDS ***
Dealt to Dorex2007 [9d 4c]
PABLOZAL10: folds 
AngryRaises: folds 
peakyblinders82: folds 
Dorex2007: folds 
ser447787: folds 
edoschenko: folds 
Cesnielumige: raises $0.04 to $0.06
ppeetteerr175: folds 
Azznak: folds 
Uncalled bet ($0.04) returned to Cesnielumige
Cesnielumige collected $0.05 from pot
Cesnielumige: doesn't show hand 
*** SUMMARY ***
Total pot $0.05 | Rake $0 
Seat 1: ppeetteerr175 (small blind) folded before Flop
Seat 2: Azznak (big blind) folded before Flop
Seat 3: PABLOZAL10 folded before Flop (didn't bet)
Seat 4: AngryRaises folded before Flop (didn't bet)
Seat 5: peakyblinders82 folded before Flop (didn't bet)
Seat 6: Dorex2007 folded before Flop (didn't bet)
Seat 7: ser447787 folded before Flop (didn't bet)
Seat 8: edoschenko folded before Flop (didn't bet)
Seat 9: Cesnielumige (button) collected ($0.05)



PokerStars Hand #224826193324:  Hold'em No Limit ($0.01/$0.02 USD) - 2021/03/14 22:42:03 PT [2021/03/15 1:42:03 ET]
Table 'Piccolo IV' 9-max Seat #1 is the button
Seat 1: ppeetteerr175 ($2.65 in chips) 
Seat 2: Azznak ($1.98 in chips) 
Seat 3: PABLOZAL10 ($1.71 in chips) 
Seat 4: AngryRaises ($4.70 in chips) 
Seat 5: peakyblinders82 ($2.35 in chips) 
Seat 6: Dorex2007 ($2.20 in chips) 
Seat 7: ser447787 ($2 in chips) 
Seat 8: edoschenko ($1.51 in chips) 
Seat 9: Cesnielumige ($1.86 in chips) 
Azznak: posts small blind $0.01
PABLOZAL10: posts big blind $0.02
*** HOLE CARDS ***
Dealt to Dorex2007 [3s 5h]
AngryRaises: folds 
peakyblinders82: calls $0.02
Dorex2007: folds 
ser447787: folds 
AngryRaises leaves the table
edoschenko: folds 
Cesnielumige: folds 
ppeetteerr175: raises $0.02 to $0.04
Azznak: folds 
PABLOZAL10: calls $0.02
peakyblinders82: calls $0.02
*** FLOP *** [Js 8h Ac]
PABLOZAL10: checks 
peakyblinders82: bets $0.02
ppeetteerr175: calls $0.02
PABLOZAL10: folds 
*** TURN *** [Js 8h Ac] [6h]
peakyblinders82: bets $0.08
ppeetteerr175: folds 
Uncalled bet ($0.08) returned to peakyblinders82
peakyblinders82 collected $0.16 from pot
peakyblinders82: doesn't show hand 
*** SUMMARY ***
Total pot $0.17 | Rake $0.01 
Board [Js 8h Ac 6h]
Seat 1: ppeetteerr175 (button) folded on the Turn
Seat 2: Azznak (small blind) folded before Flop
Seat 3: PABLOZAL10 (big blind) folded on the Flop
Seat 4: AngryRaises folded before Flop (didn't bet)
Seat 5: peakyblinders82 collected ($0.16)
Seat 6: Dorex2007 folded before Flop (didn't bet)
Seat 7: ser447787 folded before Flop (didn't bet)
Seat 8: edoschenko folded before Flop (didn't bet)
Seat 9: Cesnielumige folded before Flop (didn't bet)



PokerStars Hand #224826200689:  Hold'em No Limit ($0.01/$0.02 USD) - 2021/03/14 22:42:54 PT [2021/03/15 1:42:54 ET]
Table 'Piccolo IV' 9-max Seat #2 is the button
Seat 1: ppeetteerr175 ($2.59 in chips) 
Seat 2: Azznak ($1.97 in chips) 
Seat 3: PABLOZAL10 ($1.67 in chips) 
Seat 6: Dorex2007 ($2.20 in chips) 
Seat 7: ser447787 ($2 in chips) 
Seat 8: edoschenko ($1.51 in chips) 
Seat 9: Cesnielumige ($1.86 in chips) 
PABLOZAL10: posts small blind $0.01
peakyblinders82: is sitting out 
Dorex2007: posts big blind $0.02
*** HOLE CARDS ***
Dealt to Dorex2007 [3c 7s]
ser447787: folds 
edoschenko: raises $0.08 to $0.10
Cesnielumige: calls $0.10
ppeetteerr175: folds 
Azznak: folds 
PABLOZAL10: folds 
Dorex2007: folds 
*** FLOP *** [2h 6h Kd]
peakyblinders82 leaves the table
edoschenko: bets $0.11
Cesnielumige: folds 
Uncalled bet ($0.11) returned to edoschenko
edoschenko collected $0.22 from pot
edoschenko: doesn't show hand 
*** SUMMARY ***
Total pot $0.23 | Rake $0.01 
Board [2h 6h Kd]
Seat 1: ppeetteerr175 folded before Flop (didn't bet)
Seat 2: Azznak (button) folded before Flop (didn't bet)
Seat 3: PABLOZAL10 (small blind) folded before Flop
Seat 6: Dorex2007 (big blind) folded before Flop
Seat 7: ser447787 folded before Flop (didn't bet)
Seat 8: edoschenko collected ($0.22)
Seat 9: Cesnielumige folded on the Flop



PokerStars Hand #224826204589:  Hold'em No Limit ($0.01/$0.02 USD) - 2021/03/14 22:43:20 PT [2021/03/15 1:43:20 ET]
Table 'Piccolo IV' 9-max Seat #3 is the button
Seat 1: ppeetteerr175 ($2.59 in chips) 
Seat 2: Azznak ($1.97 in chips) 
Seat 3: PABLOZAL10 ($1.66 in chips) 
Seat 6: Dorex2007 ($2.18 in chips) 
Seat 7: ser447787 ($2 in chips) 
Seat 8: edoschenko ($1.63 in chips) 
Seat 9: Cesnielumige ($1.76 in chips) 
Dorex2007: posts small blind $0.01
ser447787: posts big blind $0.02
*** HOLE CARDS ***
Dealt to Dorex2007 [4d 9h]
edoschenko: folds 
Cesnielumige: calls $0.02
ppeetteerr175: folds 
Azznak: folds 
PABLOZAL10: calls $0.02
Dorex2007: folds 
ser447787: checks 
*** FLOP *** [Jd Ts 2c]
ser447787: checks 
Cesnielumige: checks 
PABLOZAL10: checks 
*** TURN *** [Jd Ts 2c] [3h]
ser447787: checks 
Cesnielumige: bets $0.04
PABLOZAL10: calls $0.04
ser447787: folds 
*** RIVER *** [Jd Ts 2c 3h] [7s]
Cesnielumige: checks 
PABLOZAL10: checks 
*** SHOW DOWN ***
Cesnielumige: shows [Tc 9c] (a pair of Tens)
PABLOZAL10: shows [9d Th] (a pair of Tens)
Cesnielumige collected $0.07 from pot
PABLOZAL10 collected $0.07 from pot
*** SUMMARY ***
Total pot $0.15 | Rake $0.01 
Board [Jd Ts 2c 3h 7s]
Seat 1: ppeetteerr175 folded before Flop (didn't bet)
Seat 2: Azznak folded before Flop (didn't bet)
Seat 3: PABLOZAL10 (button) showed [9d Th] and won ($0.07) with a pair of Tens
Seat 6: Dorex2007 (small blind) folded before Flop
Seat 7: ser447787 (big blind) folded on the Turn
Seat 8: edoschenko folded before Flop (didn't bet)
Seat 9: Cesnielumige showed [Tc 9c] and won ($0.07) with a pair of Tens



PokerStars Hand #224826211823:  Hold'em No Limit ($0.01/$0.02 USD) - 2021/03/14 22:44:10 PT [2021/03/15 1:44:10 ET]
Table 'Piccolo IV' 9-max Seat #6 is the button
Seat 1: ppeetteerr175 ($2.59 in chips) 
Seat 2: Azznak ($1.97 in chips) 
Seat 3: PABLOZAL10 ($1.67 in chips) 
Seat 6: Dorex2007 ($2.17 in chips) 
Seat 7: ser447787 ($2 in chips) 
Seat 8: edoschenko ($1.63 in chips) 
Seat 9: Cesnielumige ($1.77 in chips) 
ser447787: posts small blind $0.01
edoschenko: posts big blind $0.02
*** HOLE CARDS ***
Dealt to Dorex2007 [Td 2d]
Cesnielumige: folds 
ppeetteerr175: folds 
Azznak: folds 
PABLOZAL10: raises $0.02 to $0.04
Dorex2007: folds 
ser447787: folds 
edoschenko: folds 
Uncalled bet ($0.02) returned to PABLOZAL10
PABLOZAL10 collected $0.05 from pot
PABLOZAL10: doesn't show hand 
*** SUMMARY ***
Total pot $0.05 | Rake $0 
Seat 1: ppeetteerr175 folded before Flop (didn't bet)
Seat 2: Azznak folded before Flop (didn't bet)
Seat 3: PABLOZAL10 collected ($0.05)
Seat 6: Dorex2007 (button) folded before Flop (didn't bet)
Seat 7: ser447787 (small blind) folded before Flop
Seat 8: edoschenko (big blind) folded before Flop
Seat 9: Cesnielumige folded before Flop (didn't bet)



PokerStars Hand #224826214093:  Hold'em No Limit ($0.01/$0.02 USD) - 2021/03/14 22:44:25 PT [2021/03/15 1:44:25 ET]
Table 'Piccolo IV' 9-max Seat #7 is the button
Seat 1: ppeetteerr175 ($2.59 in chips) 
Seat 2: Azznak ($1.97 in chips) 
Seat 3: PABLOZAL10 ($1.70 in chips) 
Seat 6: Dorex2007 ($2.17 in chips) 
Seat 7: ser447787 ($2 in chips) 
Seat 8: edoschenko ($1.61 in chips) 
Seat 9: Cesnielumige ($1.77 in chips) 
edoschenko: posts small blind $0.01
Cesnielumige: posts big blind $0.02
*** HOLE CARDS ***
Dealt to Dorex2007 [9s 7c]
ppeetteerr175: folds 
Azznak: folds 
PABLOZAL10: folds 
Dorex2007: folds 
ser447787: folds 
edoschenko: raises $0.06 to $0.08
Cesnielumige: folds 
Uncalled bet ($0.06) returned to edoschenko
edoschenko collected $0.04 from pot
edoschenko: doesn't show hand 
*** SUMMARY ***
Total pot $0.04 | Rake $0 
Seat 1: ppeetteerr175 folded before Flop (didn't bet)
Seat 2: Azznak folded before Flop (didn't bet)
Seat 3: PABLOZAL10 folded before Flop (didn't bet)
Seat 6: Dorex2007 folded before Flop (didn't bet)
Seat 7: ser447787 (button) folded before Flop (didn't bet)
Seat 8: edoschenko (small blind) collected ($0.04)
Seat 9: Cesnielumige (big blind) folded before Flop



PokerStars Hand #224826215915:  Hold'em No Limit ($0.01/$0.02 USD) - 2021/03/14 22:44:37 PT [2021/03/15 1:44:37 ET]
Table 'Piccolo IV' 9-max Seat #8 is the button
Seat 1: ppeetteerr175 ($2.59 in chips) 
Seat 2: Azznak ($1.97 in chips) 
Seat 3: PABLOZAL10 ($1.70 in chips) 
Seat 6: Dorex2007 ($2.17 in chips) 
Seat 7: ser447787 ($2 in chips) 
Seat 8: edoschenko ($1.63 in chips) 
Seat 9: Cesnielumige ($1.75 in chips) 
Cesnielumige: posts small blind $0.01
ppeetteerr175: posts big blind $0.02
*** HOLE CARDS ***
Dealt to Dorex2007 [4c Ks]
Azznak: folds 
PABLOZAL10 has timed out
PABLOZAL10: folds 
Dorex2007: folds 
ser447787: raises $0.05 to $0.07
edoschenko: folds 
Cesnielumige: folds 
kiling1 joins the table at seat #4 
ppeetteerr175: folds 
Uncalled bet ($0.05) returned to ser447787
ser447787 collected $0.05 from pot
ezviktor joins the table at seat #5 
*** SUMMARY ***
Total pot $0.05 | Rake $0 
Seat 1: ppeetteerr175 (big blind) folded before Flop
Seat 2: Azznak folded before Flop (didn't bet)
Seat 3: PABLOZAL10 folded before Flop (didn't bet)
Seat 6: Dorex2007 folded before Flop (didn't bet)
Seat 7: ser447787 collected ($0.05)
Seat 8: edoschenko (button) folded before Flop (didn't bet)
Seat 9: Cesnielumige (small blind) folded before Flop



PokerStars Hand #224826220525:  Hold'em No Limit ($0.01/$0.02 USD) - 2021/03/14 22:45:08 PT [2021/03/15 1:45:08 ET]
Table 'Piccolo IV' 9-max Seat #9 is the button
Seat 1: ppeetteerr175 ($2.57 in chips) 
Seat 2: Azznak ($1.97 in chips) 
Seat 3: PABLOZAL10 ($1.70 in chips) 
Seat 6: Dorex2007 ($2.17 in chips) 
Seat 7: ser447787 ($2.03 in chips) 
Seat 8: edoschenko ($1.63 in chips) 
Seat 9: Cesnielumige ($1.74 in chips) 
ppeetteerr175: posts small blind $0.01
Azznak: posts big blind $0.02
kiling1: sits out 
ezviktor: sits out 
*** HOLE CARDS ***
Dealt to Dorex2007 [7c Th]
PABLOZAL10: folds 
Dorex2007: folds 
ser447787: folds 
edoschenko: folds 
Cesnielumige: calls $0.02
ppeetteerr175: calls $0.01
Azznak: checks 
*** FLOP *** [6h 8c 9h]
ppeetteerr175: checks 
Azznak: checks 
Cesnielumige: checks 
*** TURN *** [6h 8c 9h] [Jc]
ppeetteerr175: checks 
Azznak: checks 
Cesnielumige: bets $0.06
ppeetteerr175: folds 
Azznak: folds 
Uncalled bet ($0.06) returned to Cesnielumige
Cesnielumige collected $0.06 from pot
Cesnielumige: doesn't show hand 
*** SUMMARY ***
Total pot $0.06 | Rake $0 
Board [6h 8c 9h Jc]
Seat 1: ppeetteerr175 (small blind) folded on the Turn
Seat 2: Azznak (big blind) folded on the Turn
Seat 3: PABLOZAL10 folded before Flop (didn't bet)
Seat 6: Dorex2007 folded before Flop (didn't bet)
Seat 7: ser447787 folded before Flop (didn't bet)
Seat 8: edoschenko folded before Flop (didn't bet)
Seat 9: Cesnielumige (button) collected ($0.06)



PokerStars Hand #224826227289:  Hold'em No Limit ($0.01/$0.02 USD) - 2021/03/14 22:45:54 PT [2021/03/15 1:45:54 ET]
Table 'Piccolo IV' 9-max Seat #1 is the button
Seat 1: ppeetteerr175 ($2.55 in chips) 
Seat 2: Azznak ($1.95 in chips) 
Seat 3: PABLOZAL10 ($1.70 in chips) 
Seat 6: Dorex2007 ($2.17 in chips) 
Seat 7: ser447787 ($2.03 in chips) 
Seat 8: edoschenko ($1.63 in chips) 
Seat 9: Cesnielumige ($1.78 in chips) 
Azznak: posts small blind $0.01
PABLOZAL10: posts big blind $0.02
kiling1: sits out 
ezviktor: sits out 
*** HOLE CARDS ***
Dealt to Dorex2007 [Jd Jh]
Dorex2007: raises $0.06 to $0.08
ser447787: calls $0.08
edoschenko: folds 
Cesnielumige: folds 
ppeetteerr175: calls $0.08
Azznak: calls $0.07
PABLOZAL10: calls $0.06
*** FLOP *** [Ts 4c Ks]
Azznak: checks 
PABLOZAL10: checks 
Dorex2007: checks 
ser447787: checks 
ppeetteerr175: checks 
*** TURN *** [Ts 4c Ks] [6s]
Azznak: bets $0.39
PABLOZAL10: calls $0.39
Dorex2007: folds 
ser447787: calls $0.39
ppeetteerr175: folds 
*** RIVER *** [Ts 4c Ks 6s] [Ah]
Azznak: checks 
PABLOZAL10: checks 
ser447787: checks 
*** SHOW DOWN ***
Azznak: shows [As Qd] (a pair of Aces)
PABLOZAL10: mucks hand 
ser447787: shows [6h 6d] (three of a kind, Sixes)
ser447787 collected $1.52 from pot
*** SUMMARY ***
Total pot $1.57 | Rake $0.05 
Board [Ts 4c Ks 6s Ah]
Seat 1: ppeetteerr175 (button) folded on the Turn
Seat 2: Azznak (small blind) showed [As Qd] and lost with a pair of Aces
Seat 3: PABLOZAL10 (big blind) mucked [7s 9d]
Seat 6: Dorex2007 folded on the Turn
Seat 7: ser447787 showed [6h 6d] and won ($1.52) with three of a kind, Sixes
Seat 8: edoschenko folded before Flop (didn't bet)
Seat 9: Cesnielumige folded before Flop (didn't bet)



PokerStars Hand #224826239212:  Hold'em No Limit ($0.01/$0.02 USD) - 2021/03/14 22:47:15 PT [2021/03/15 1:47:15 ET]
Table 'Piccolo IV' 9-max Seat #2 is the button
Seat 1: ppeetteerr175 ($2.47 in chips) 
Seat 2: Azznak ($2 in chips) 
Seat 3: PABLOZAL10 ($1.23 in chips) 
Seat 4: kiling1 ($2 in chips) 
Seat 6: Dorex2007 ($2.09 in chips) 
Seat 7: ser447787 ($3.08 in chips) 
Seat 8: edoschenko ($1.63 in chips) 
Seat 9: Cesnielumige ($1.78 in chips) 
PABLOZAL10: posts small blind $0.01
kiling1: posts big blind $0.02
ezviktor: sits out 
*** HOLE CARDS ***
Dealt to Dorex2007 [As 8d]
Dorex2007: folds 
ser447787: folds 
edoschenko: folds 
Cesnielumige: folds 
ppeetteerr175: folds 
Azznak: folds 
PABLOZAL10: calls $0.01
kiling1: checks 
*** FLOP *** [3h Qs 7c]
PABLOZAL10: bets $0.04
kiling1: calls $0.04
*** TURN *** [3h Qs 7c] [5h]
PABLOZAL10: bets $0.16
kiling1: folds 
Uncalled bet ($0.16) returned to PABLOZAL10
PABLOZAL10 collected $0.12 from pot
PABLOZAL10: doesn't show hand 
*** SUMMARY ***
Total pot $0.12 | Rake $0 
Board [3h Qs 7c 5h]
Seat 1: ppeetteerr175 folded before Flop (didn't bet)
Seat 2: Azznak (button) folded before Flop (didn't bet)
Seat 3: PABLOZAL10 (small blind) collected ($0.12)
Seat 4: kiling1 (big blind) folded on the Turn
Seat 6: Dorex2007 folded before Flop (didn't bet)
Seat 7: ser447787 folded before Flop (didn't bet)
Seat 8: edoschenko folded before Flop (didn't bet)
Seat 9: Cesnielumige folded before Flop (didn't bet)



PokerStars Hand #224826247703:  Hold'em No Limit ($0.01/$0.02 USD) - 2021/03/14 22:48:12 PT [2021/03/15 1:48:12 ET]
Table 'Piccolo IV' 9-max Seat #3 is the button
Seat 1: ppeetteerr175 ($2.47 in chips) 
Seat 2: Azznak ($2 in chips) 
Seat 3: PABLOZAL10 ($1.29 in chips) 
Seat 4: kiling1 ($1.94 in chips) 
Seat 5: ezviktor ($0.80 in chips) 
Seat 6: Dorex2007 ($2.09 in chips) 
Seat 7: ser447787 ($3.08 in chips) 
Seat 8: edoschenko ($1.63 in chips) 
Seat 9: Cesnielumige ($1.78 in chips) 
kiling1: posts small blind $0.01
ezviktor: posts big blind $0.02
*** HOLE CARDS ***
Dealt to Dorex2007 [2h Kd]
Dorex2007: folds 
ser447787: folds 
edoschenko: raises $0.04 to $0.06
Cesnielumige: folds 
ppeetteerr175: folds 
Azznak: folds 
PABLOZAL10: folds 
kiling1: folds 
ezviktor: folds 
Uncalled bet ($0.04) returned to edoschenko
edoschenko collected $0.05 from pot
edoschenko: doesn't show hand 
*** SUMMARY ***
Total pot $0.05 | Rake $0 
Seat 1: ppeetteerr175 folded before Flop (didn't bet)
Seat 2: Azznak folded before Flop (didn't bet)
Seat 3: PABLOZAL10 (button) folded before Flop (didn't bet)
Seat 4: kiling1 (small blind) folded before Flop
Seat 5: ezviktor (big blind) folded before Flop
Seat 6: Dorex2007 folded before Flop (didn't bet)
Seat 7: ser447787 folded before Flop (didn't bet)
Seat 8: edoschenko collected ($0.05)
Seat 9: Cesnielumige folded before Flop (didn't bet)



PokerStars Hand #224826253292:  Hold'em No Limit ($0.01/$0.02 USD) - 2021/03/14 22:48:51 PT [2021/03/15 1:48:51 ET]
Table 'Piccolo IV' 9-max Seat #4 is the button
Seat 1: ppeetteerr175 ($2.47 in chips) 
Seat 2: Azznak ($2 in chips) 
Seat 3: PABLOZAL10 ($1.29 in chips) 
Seat 4: kiling1 ($1.93 in chips) 
Seat 5: ezviktor ($0.80 in chips) 
Seat 6: Dorex2007 ($2.09 in chips) 
Seat 7: ser447787 ($3.08 in chips) 
Seat 8: edoschenko ($1.66 in chips) 
Seat 9: Cesnielumige ($1.78 in chips) 
ezviktor: posts small blind $0.01
Dorex2007: posts big blind $0.02
*** HOLE CARDS ***
Dealt to Dorex2007 [Qh Ts]
ser447787: folds 
edoschenko: folds 
Cesnielumige: calls $0.02
ppeetteerr175: raises $0.08 to $0.10
Azznak: folds 
PABLOZAL10: folds 
kiling1: folds 
ezviktor: folds 
Dorex2007: calls $0.08
Cesnielumige: folds 
*** FLOP *** [Qd Qs Th]
Dorex2007: checks 
ppeetteerr175: bets $0.11
Dorex2007: calls $0.11
*** TURN *** [Qd Qs Th] [3d]
Dorex2007: checks 
ppeetteerr175: checks 
*** RIVER *** [Qd Qs Th 3d] [Ad]
Dorex2007: checks 
ppeetteerr175: bets $0.22
Dorex2007: raises $0.22 to $0.44
ppeetteerr175: calls $0.22
*** SHOW DOWN ***
Dorex2007: shows [Qh Ts] (a full house, Queens full of Tens)
ppeetteerr175: mucks hand 
Dorex2007 collected $1.28 from pot
*** SUMMARY ***
Total pot $1.33 | Rake $0.05 
Board [Qd Qs Th 3d Ad]
Seat 1: ppeetteerr175 mucked [Ah Kh]
Seat 2: Azznak folded before Flop (didn't bet)
Seat 3: PABLOZAL10 folded before Flop (didn't bet)
Seat 4: kiling1 (button) folded before Flop (didn't bet)
Seat 5: ezviktor (small blind) folded before Flop
Seat 6: Dorex2007 (big blind) showed [Qh Ts] and won ($1.28) with a full house, Queens full of Tens
Seat 7: ser447787 folded before Flop (didn't bet)
Seat 8: edoschenko folded before Flop (didn't bet)
Seat 9: Cesnielumige folded before Flop



PokerStars Hand #224826264738:  Hold'em No Limit ($0.01/$0.02 USD) - 2021/03/14 22:50:08 PT [2021/03/15 1:50:08 ET]
Table 'Piccolo IV' 9-max Seat #5 is the button
Seat 1: ppeetteerr175 ($1.82 in chips) 
Seat 2: Azznak ($2 in chips) 
Seat 3: PABLOZAL10 ($1.29 in chips) 
Seat 4: kiling1 ($1.93 in chips) 
Seat 5: ezviktor ($0.80 in chips) 
Seat 6: Dorex2007 ($2.72 in chips) 
Seat 7: ser447787 ($3.08 in chips) 
Seat 8: edoschenko ($1.66 in chips) 
Seat 9: Cesnielumige ($1.76 in chips) 
Dorex2007: posts small blind $0.01
ser447787: posts big blind $0.02
*** HOLE CARDS ***
Dealt to Dorex2007 [4c 2h]
edoschenko: raises $0.06 to $0.08
Cesnielumige: folds 
ppeetteerr175: folds 
Azznak: folds 
PABLOZAL10: folds 
kiling1: calls $0.08
ezviktor: folds 
Dorex2007: folds 
ser447787: folds 
*** FLOP *** [Qs 4h 3h]
edoschenko: checks 
kiling1: checks 
*** TURN *** [Qs 4h 3h] [9h]
edoschenko: checks 
kiling1: checks 
*** RIVER *** [Qs 4h 3h 9h] [Ah]
edoschenko: checks 
kiling1: checks 
*** SHOW DOWN ***
edoschenko: shows [Ac Jd] (a pair of Aces)
kiling1: shows [9d 8h] (a flush, Ace high)
kiling1 collected $0.18 from pot
*** SUMMARY ***
Total pot $0.19 | Rake $0.01 
Board [Qs 4h 3h 9h Ah]
Seat 1: ppeetteerr175 folded before Flop (didn't bet)
Seat 2: Azznak folded before Flop (didn't bet)
Seat 3: PABLOZAL10 folded before Flop (didn't bet)
Seat 4: kiling1 showed [9d 8h] and won ($0.18) with a flush, Ace high
Seat 5: ezviktor (button) folded before Flop (didn't bet)
Seat 6: Dorex2007 (small blind) folded before Flop
Seat 7: ser447787 (big blind) folded before Flop
Seat 8: edoschenko showed [Ac Jd] and lost with a pair of Aces
Seat 9: Cesnielumige folded before Flop (didn't bet)



PokerStars Hand #224826275869:  Hold'em No Limit ($0.01/$0.02 USD) - 2021/03/14 22:51:24 PT [2021/03/15 1:51:24 ET]
Table 'Piccolo IV' 9-max Seat #6 is the button
Seat 1: ppeetteerr175 ($1.82 in chips) 
Seat 2: Azznak ($2 in chips) 
Seat 3: PABLOZAL10 ($1.29 in chips) 
Seat 4: kiling1 ($2.03 in chips) 
Seat 5: ezviktor ($0.80 in chips) 
Seat 6: Dorex2007 ($2.71 in chips) 
Seat 7: ser447787 ($3.06 in chips) 
Seat 8: edoschenko ($1.58 in chips) 
Seat 9: Cesnielumige ($1.76 in chips) 
ser447787: posts small blind $0.01
edoschenko: posts big blind $0.02
*** HOLE CARDS ***
Dealt to Dorex2007 [3s Th]
Cesnielumige: folds 
ppeetteerr175: calls $0.02
Azznak: folds 
PABLOZAL10: folds 
kiling1: folds 
ezviktor: calls $0.02
Dorex2007: folds 
ser447787: folds 
edoschenko: checks 
*** FLOP *** [6c Ac 8c]
edoschenko: checks 
ppeetteerr175: checks 
ezviktor: checks 
*** TURN *** [6c Ac 8c] [3d]
edoschenko: checks 
ppeetteerr175: checks 
ezviktor: checks 
*** RIVER *** [6c Ac 8c 3d] [7h]
edoschenko: checks 
ppeetteerr175: checks 
ezviktor: checks 
*** SHOW DOWN ***
edoschenko: shows [5s Qs] (high card Ace)
ppeetteerr175: shows [3h 5h] (a pair of Threes)
ezviktor: mucks hand 
ppeetteerr175 collected $0.07 from pot
*** SUMMARY ***
Total pot $0.07 | Rake $0 
Board [6c Ac 8c 3d 7h]
Seat 1: ppeetteerr175 showed [3h 5h] and won ($0.07) with a pair of Threes
Seat 2: Azznak folded before Flop (didn't bet)
Seat 3: PABLOZAL10 folded before Flop (didn't bet)
Seat 4: kiling1 folded before Flop (didn't bet)
Seat 5: ezviktor mucked [Kd 4d]
Seat 6: Dorex2007 (button) folded before Flop (didn't bet)
Seat 7: ser447787 (small blind) folded before Flop
Seat 8: edoschenko (big blind) showed [5s Qs] and lost with high card Ace
Seat 9: Cesnielumige folded before Flop (didn't bet)



PokerStars Hand #224826283308:  Hold'em No Limit ($0.01/$0.02 USD) - 2021/03/14 22:52:15 PT [2021/03/15 1:52:15 ET]
Table 'Piccolo IV' 9-max Seat #7 is the button
Seat 1: ppeetteerr175 ($1.87 in chips) 
Seat 2: Azznak ($2 in chips) 
Seat 3: PABLOZAL10 ($1.29 in chips) 
Seat 4: kiling1 ($2.03 in chips) 
Seat 5: ezviktor ($0.80 in chips) 
Seat 6: Dorex2007 ($2.71 in chips) 
Seat 7: ser447787 ($3.05 in chips) 
Seat 8: edoschenko ($1.56 in chips) 
Seat 9: Cesnielumige ($1.76 in chips) 
edoschenko: posts small blind $0.01
Cesnielumige: posts big blind $0.02
*** HOLE CARDS ***
Dealt to Dorex2007 [2d 8c]
ppeetteerr175: folds 
Azznak: folds 
PABLOZAL10: folds 
kiling1: folds 
ezviktor: raises $0.03 to $0.05
Dorex2007: folds 
ser447787: folds 
edoschenko: calls $0.04
Cesnielumige: calls $0.03
*** FLOP *** [Qc Jc 7h]
edoschenko: checks 
Cesnielumige: checks 
ezviktor: bets $0.07
edoschenko: folds 
Cesnielumige: folds 
Uncalled bet ($0.07) returned to ezviktor
ezviktor collected $0.14 from pot
ezviktor: doesn't show hand 
*** SUMMARY ***
Total pot $0.15 | Rake $0.01 
Board [Qc Jc 7h]
Seat 1: ppeetteerr175 folded before Flop (didn't bet)
Seat 2: Azznak folded before Flop (didn't bet)
Seat 3: PABLOZAL10 folded before Flop (didn't bet)
Seat 4: kiling1 folded before Flop (didn't bet)
Seat 5: ezviktor collected ($0.14)
Seat 6: Dorex2007 folded before Flop (didn't bet)
Seat 7: ser447787 (button) folded before Flop (didn't bet)
Seat 8: edoschenko (small blind) folded on the Flop
Seat 9: Cesnielumige (big blind) folded on the Flop



PokerStars Hand #224826289419:  Hold'em No Limit ($0.01/$0.02 USD) - 2021/03/14 22:52:57 PT [2021/03/15 1:52:57 ET]
Table 'Piccolo IV' 9-max Seat #8 is the button
Seat 1: ppeetteerr175 ($1.87 in chips) 
Seat 2: Azznak ($2 in chips) 
Seat 3: PABLOZAL10 ($1.29 in chips) 
Seat 4: kiling1 ($2.03 in chips) 
Seat 5: ezviktor ($0.89 in chips) 
Seat 6: Dorex2007 ($2.71 in chips) 
Seat 7: ser447787 ($3.05 in chips) 
Seat 8: edoschenko ($1.51 in chips) 
Seat 9: Cesnielumige ($1.71 in chips) 
Cesnielumige: posts small blind $0.01
ppeetteerr175: posts big blind $0.02
*** HOLE CARDS ***
Dealt to Dorex2007 [3d 6d]
Azznak: folds 
PABLOZAL10: raises $0.04 to $0.06
kiling1: folds 
ezviktor: folds 
Dorex2007: folds 
ser447787: folds 
edoschenko: folds 
Cesnielumige: calls $0.05
ppeetteerr175: folds 
*** FLOP *** [4h Jd 5d]
Cesnielumige: bets $0.07
PABLOZAL10: calls $0.07
*** TURN *** [4h Jd 5d] [4d]
Cesnielumige: checks 
PABLOZAL10: checks 
*** RIVER *** [4h Jd 5d 4d] [Qh]
Cesnielumige: bets $0.27
PABLOZAL10: calls $0.27
*** SHOW DOWN ***
Cesnielumige: shows [Qd 9d] (a flush, Queen high)
PABLOZAL10: mucks hand 
Cesnielumige collected $0.79 from pot
*** SUMMARY ***
Total pot $0.82 | Rake $0.03 
Board [4h Jd 5d 4d Qh]
Seat 1: ppeetteerr175 (big blind) folded before Flop
Seat 2: Azznak folded before Flop (didn't bet)
Seat 3: PABLOZAL10 mucked [Qc Kc]
Seat 4: kiling1 folded before Flop (didn't bet)
Seat 5: ezviktor folded before Flop (didn't bet)
Seat 6: Dorex2007 folded before Flop (didn't bet)
Seat 7: ser447787 folded before Flop (didn't bet)
Seat 8: edoschenko (button) folded before Flop (didn't bet)
Seat 9: Cesnielumige (small blind) showed [Qd 9d] and won ($0.79) with a flush, Queen high



PokerStars Hand #224826299193:  Hold'em No Limit ($0.01/$0.02 USD) - 2021/03/14 22:54:05 PT [2021/03/15 1:54:05 ET]
Table 'Piccolo IV' 9-max Seat #9 is the button
Seat 1: ppeetteerr175 ($1.85 in chips) 
Seat 2: Azznak ($2 in chips) 
Seat 3: PABLOZAL10 ($0.89 in chips) 
Seat 4: kiling1 ($2.03 in chips) 
Seat 5: ezviktor ($0.89 in chips) 
Seat 6: Dorex2007 ($2.71 in chips) 
Seat 7: ser447787 ($3.05 in chips) 
Seat 8: edoschenko ($1.51 in chips) 
Seat 9: Cesnielumige ($2.10 in chips) 
ppeetteerr175: posts small blind $0.01
Azznak: posts big blind $0.02
*** HOLE CARDS ***
Dealt to Dorex2007 [Kc 2c]
PABLOZAL10: raises $0.05 to $0.07
kiling1: folds 
ezviktor: folds 
Dorex2007: folds 
ser447787: folds 
edoschenko: folds 
Cesnielumige: folds 
ppeetteerr175: folds 
Azznak: folds 
Uncalled bet ($0.05) returned to PABLOZAL10
PABLOZAL10 collected $0.05 from pot
*** SUMMARY ***
Total pot $0.05 | Rake $0 
Seat 1: ppeetteerr175 (small blind) folded before Flop
Seat 2: Azznak (big blind) folded before Flop
Seat 3: PABLOZAL10 collected ($0.05)
Seat 4: kiling1 folded before Flop (didn't bet)
Seat 5: ezviktor folded before Flop (didn't bet)
Seat 6: Dorex2007 folded before Flop (didn't bet)
Seat 7: ser447787 folded before Flop (didn't bet)
Seat 8: edoschenko folded before Flop (didn't bet)
Seat 9: Cesnielumige (button) folded before Flop (didn't bet)



PokerStars Hand #224826302025:  Hold'em No Limit ($0.01/$0.02 USD) - 2021/03/14 22:54:24 PT [2021/03/15 1:54:24 ET]
Table 'Piccolo IV' 9-max Seat #1 is the button
Seat 1: ppeetteerr175 ($1.84 in chips) 
Seat 2: Azznak ($1.98 in chips) 
Seat 3: PABLOZAL10 ($0.92 in chips) 
Seat 4: kiling1 ($2.03 in chips) 
Seat 5: ezviktor ($0.89 in chips) 
Seat 6: Dorex2007 ($2.71 in chips) 
Seat 7: ser447787 ($3.05 in chips) 
Seat 8: edoschenko ($1.51 in chips) 
Seat 9: Cesnielumige ($2.10 in chips) 
Azznak: posts small blind $0.01
PABLOZAL10: posts big blind $0.02
*** HOLE CARDS ***
Dealt to Dorex2007 [2h 6s]
kiling1: folds 
ezviktor: calls $0.02
Dorex2007: folds 
ser447787: folds 
edoschenko: folds 
Cesnielumige: folds 
ppeetteerr175: folds 
Azznak: raises $0.02 to $0.04
PABLOZAL10: calls $0.02
ezviktor: calls $0.02
*** FLOP *** [Qc 5d 9c]
Azznak: checks 
PABLOZAL10: checks 
ezviktor: checks 
*** TURN *** [Qc 5d 9c] [7s]
Azznak: checks 
PABLOZAL10: bets $0.12
ezviktor: calls $0.12
Azznak: folds 
*** RIVER *** [Qc 5d 9c 7s] [Kc]
PABLOZAL10: checks 
ezviktor: bets $0.18
PABLOZAL10: folds 
Uncalled bet ($0.18) returned to ezviktor
ezviktor collected $0.35 from pot
ezviktor: doesn't show hand 
*** SUMMARY ***
Total pot $0.36 | Rake $0.01 
Board [Qc 5d 9c 7s Kc]
Seat 1: ppeetteerr175 (button) folded before Flop (didn't bet)
Seat 2: Azznak (small blind) folded on the Turn
Seat 3: PABLOZAL10 (big blind) folded on the River
Seat 4: kiling1 folded before Flop (didn't bet)
Seat 5: ezviktor collected ($0.35)
Seat 6: Dorex2007 folded before Flop (didn't bet)
Seat 7: ser447787 folded before Flop (didn't bet)
Seat 8: edoschenko folded before Flop (didn't bet)
Seat 9: Cesnielumige folded before Flop (didn't bet)



PokerStars Hand #224826311860:  Hold'em No Limit ($0.01/$0.02 USD) - 2021/03/14 22:55:36 PT [2021/03/15 1:55:36 ET]
Table 'Piccolo IV' 9-max Seat #2 is the button
Seat 1: ppeetteerr175 ($1.84 in chips) 
Seat 2: Azznak ($1.94 in chips) 
Seat 3: PABLOZAL10 ($0.76 in chips) 
Seat 4: kiling1 ($2.03 in chips) 
Seat 5: ezviktor ($1.08 in chips) 
Seat 6: Dorex2007 ($2.71 in chips) 
Seat 7: ser447787 ($3.05 in chips) 
Seat 8: edoschenko ($1.51 in chips) 
Seat 9: Cesnielumige ($2.10 in chips) 
PABLOZAL10: posts small blind $0.01
kiling1: posts big blind $0.02
*** HOLE CARDS ***
Dealt to Dorex2007 [4c 9d]
ezviktor: folds 
Dorex2007: folds 
ser447787: folds 
edoschenko: folds 
Cesnielumige: folds 
ppeetteerr175: folds 
Azznak: folds 
PABLOZAL10: folds 
Uncalled bet ($0.01) returned to kiling1
kiling1 collected $0.02 from pot
kiling1: doesn't show hand 
*** SUMMARY ***
Total pot $0.02 | Rake $0 
Seat 1: ppeetteerr175 folded before Flop (didn't bet)
Seat 2: Azznak (button) folded before Flop (didn't bet)
Seat 3: PABLOZAL10 (small blind) folded before Flop
Seat 4: kiling1 (big blind) collected ($0.02)
Seat 5: ezviktor folded before Flop (didn't bet)
Seat 6: Dorex2007 folded before Flop (didn't bet)
Seat 7: ser447787 folded before Flop (didn't bet)
Seat 8: edoschenko folded before Flop (didn't bet)
Seat 9: Cesnielumige folded before Flop (didn't bet)



PokerStars Hand #224826314749:  Hold'em No Limit ($0.01/$0.02 USD) - 2021/03/14 22:56:00 PT [2021/03/15 1:56:00 ET]
Table 'Piccolo IV' 9-max Seat #3 is the button
Seat 1: ppeetteerr175 ($1.84 in chips) 
Seat 2: Azznak ($1.94 in chips) 
Seat 3: PABLOZAL10 ($0.75 in chips) 
Seat 4: kiling1 ($2.04 in chips) 
Seat 5: ezviktor ($1.08 in chips) 
Seat 6: Dorex2007 ($2.71 in chips) 
Seat 7: ser447787 ($3.05 in chips) 
Seat 8: edoschenko ($1.51 in chips) 
Seat 9: Cesnielumige ($2.10 in chips) 
kiling1: posts small blind $0.01
ezviktor: posts big blind $0.02
*** HOLE CARDS ***
Dealt to Dorex2007 [8d 3h]
Dorex2007: folds 
ser447787: folds 
edoschenko: folds 
Cesnielumige: folds 
ppeetteerr175: folds 
Azznak: folds 
PABLOZAL10: raises $0.02 to $0.04
kiling1: folds 
ezviktor: calls $0.02
*** FLOP *** [Th Jd 9s]
ezviktor: checks 
PABLOZAL10: bets $0.05
ezviktor: calls $0.05
*** TURN *** [Th Jd 9s] [Ts]
ezviktor: checks 
PABLOZAL10: bets $0.22
ezviktor: folds 
Uncalled bet ($0.22) returned to PABLOZAL10
PABLOZAL10 collected $0.18 from pot
PABLOZAL10: doesn't show hand 
*** SUMMARY ***
Total pot $0.19 | Rake $0.01 
Board [Th Jd 9s Ts]
Seat 1: ppeetteerr175 folded before Flop (didn't bet)
Seat 2: Azznak folded before Flop (didn't bet)
Seat 3: PABLOZAL10 (button) collected ($0.18)
Seat 4: kiling1 (small blind) folded before Flop
Seat 5: ezviktor (big blind) folded on the Turn
Seat 6: Dorex2007 folded before Flop (didn't bet)
Seat 7: ser447787 folded before Flop (didn't bet)
Seat 8: edoschenko folded before Flop (didn't bet)
Seat 9: Cesnielumige folded before Flop (didn't bet)



PokerStars Hand #224826324050:  Hold'em No Limit ($0.01/$0.02 USD) - 2021/03/14 22:57:14 PT [2021/03/15 1:57:14 ET]
Table 'Piccolo IV' 9-max Seat #4 is the button
Seat 1: ppeetteerr175 ($1.84 in chips) 
Seat 2: Azznak ($1.94 in chips) 
Seat 3: PABLOZAL10 ($2 in chips) 
Seat 4: kiling1 ($2.03 in chips) 
Seat 5: ezviktor ($0.99 in chips) 
Seat 6: Dorex2007 ($2.71 in chips) 
Seat 7: ser447787 ($3.05 in chips) 
Seat 8: edoschenko ($1.51 in chips) 
Seat 9: Cesnielumige ($2.10 in chips) 
ezviktor: posts small blind $0.01
Dorex2007: posts big blind $0.02
*** HOLE CARDS ***
Dealt to Dorex2007 [Kc As]
ser447787: folds 
edoschenko: folds 
Cesnielumige: folds 
ppeetteerr175: calls $0.02
Azznak: calls $0.02
PABLOZAL10: calls $0.02
kiling1: folds 
ezviktor: raises $0.06 to $0.08
Dorex2007: raises $0.16 to $0.24
ppeetteerr175: folds 
Azznak: folds 
PABLOZAL10: folds 
ezviktor: calls $0.16
*** FLOP *** [5h 6d Jh]
ezviktor: checks 
ser447787 leaves the table
Dorex2007: bets $2.47 and is all-in
ezviktor: calls $0.75 and is all-in
Uncalled bet ($1.72) returned to Dorex2007
*** TURN *** [5h 6d Jh] [Ac]
*** RIVER *** [5h 6d Jh Ac] [8d]
*** SHOW DOWN ***
ezviktor: shows [Ts Td] (a pair of Tens)
Dorex2007: shows [Kc As] (a pair of Aces)
Dorex2007 collected $1.97 from pot
secret1977 joins the table at seat #7 
ezviktor cashed out the hand for $1.48 | Cash Out Fee $0.01
*** SUMMARY ***
Total pot $2.04 | Rake $0.07 
Board [5h 6d Jh Ac 8d]
Seat 1: ppeetteerr175 folded before Flop
Seat 2: Azznak folded before Flop
Seat 3: PABLOZAL10 folded before Flop
Seat 4: kiling1 (button) folded before Flop (didn't bet)
Seat 5: ezviktor (small blind) showed [Ts Td] and lost with a pair of Tens (cashed out).
Seat 6: Dorex2007 (big blind) showed [Kc As] and won ($1.97) with a pair of Aces
Seat 7: ser447787 folded before Flop (didn't bet)
Seat 8: edoschenko folded before Flop (didn't bet)
Seat 9: Cesnielumige folded before Flop (didn't bet)



PokerStars Hand #224826332353:  Hold'em No Limit ($0.01/$0.02 USD) - 2021/03/14 22:58:20 PT [2021/03/15 1:58:20 ET]
Table 'Piccolo IV' 9-max Seat #5 is the button
Seat 1: ppeetteerr175 ($1.82 in chips) 
Seat 2: Azznak ($1.92 in chips) 
Seat 3: PABLOZAL10 ($1.98 in chips) 
Seat 4: kiling1 ($2.03 in chips) 
Seat 5: ezviktor ($1.48 in chips) 
Seat 6: Dorex2007 ($3.69 in chips) 
Seat 7: secret1977 ($2 in chips) 
Seat 8: edoschenko ($1.51 in chips) 
Seat 9: Cesnielumige ($2.10 in chips) 
Dorex2007: posts small blind $0.01
secret1977: posts big blind $0.02
*** HOLE CARDS ***
Dealt to Dorex2007 [4h Ts]
edoschenko: folds 
Cesnielumige: folds 
ppeetteerr175: folds 
Azznak: folds 
PABLOZAL10: raises $0.04 to $0.06
kiling1: folds 
ezviktor: calls $0.06
Dorex2007: folds 
secret1977: folds 
*** FLOP *** [6s Jc Tc]
PABLOZAL10: bets $0.14
ezviktor: folds 
Uncalled bet ($0.14) returned to PABLOZAL10
PABLOZAL10 collected $0.14 from pot
PABLOZAL10: doesn't show hand 
*** SUMMARY ***
Total pot $0.15 | Rake $0.01 
Board [6s Jc Tc]
Seat 1: ppeetteerr175 folded before Flop (didn't bet)
Seat 2: Azznak folded before Flop (didn't bet)
Seat 3: PABLOZAL10 collected ($0.14)
Seat 4: kiling1 folded before Flop (didn't bet)
Seat 5: ezviktor (button) folded on the Flop
Seat 6: Dorex2007 (small blind) folded before Flop
Seat 7: secret1977 (big blind) folded before Flop
Seat 8: edoschenko folded before Flop (didn't bet)
Seat 9: Cesnielumige folded before Flop (didn't bet)



PokerStars Hand #224826337813:  Hold'em No Limit ($0.01/$0.02 USD) - 2021/03/14 22:59:03 PT [2021/03/15 1:59:03 ET]
Table 'Piccolo IV' 9-max Seat #6 is the button
Seat 1: ppeetteerr175 ($1.82 in chips) 
Seat 2: Azznak ($1.92 in chips) 
Seat 3: PABLOZAL10 ($2.06 in chips) 
Seat 4: kiling1 ($2.03 in chips) 
Seat 5: ezviktor ($1.42 in chips) 
Seat 6: Dorex2007 ($3.68 in chips) 
Seat 7: secret1977 ($1.98 in chips) 
Seat 8: edoschenko ($1.51 in chips) 
Seat 9: Cesnielumige ($2.10 in chips) 
secret1977: posts small blind $0.01
edoschenko: posts big blind $0.02
*** HOLE CARDS ***
Dealt to Dorex2007 [9c 3c]
Cesnielumige: folds 
ppeetteerr175: folds 
Azznak: folds 
PABLOZAL10: raises $0.02 to $0.04
kiling1: folds 
ezviktor: raises $0.08 to $0.12
Dorex2007: folds 
secret1977: folds 
edoschenko: folds 
PABLOZAL10: calls $0.08
*** FLOP *** [4h Jh 2d]
PABLOZAL10: checks 
ezviktor: bets $0.13
PABLOZAL10: folds 
Uncalled bet ($0.13) returned to ezviktor
ezviktor collected $0.26 from pot
ezviktor: doesn't show hand 
*** SUMMARY ***
Total pot $0.27 | Rake $0.01 
Board [4h Jh 2d]
Seat 1: ppeetteerr175 folded before Flop (didn't bet)
Seat 2: Azznak folded before Flop (didn't bet)
Seat 3: PABLOZAL10 folded on the Flop
Seat 4: kiling1 folded before Flop (didn't bet)
Seat 5: ezviktor collected ($0.26)
Seat 6: Dorex2007 (button) folded before Flop (didn't bet)
Seat 7: secret1977 (small blind) folded before Flop
Seat 8: edoschenko (big blind) folded before Flop
Seat 9: Cesnielumige folded before Flop (didn't bet)



PokerStars Hand #224826343628:  Hold'em No Limit ($0.01/$0.02 USD) - 2021/03/14 22:59:48 PT [2021/03/15 1:59:48 ET]
Table 'Piccolo IV' 9-max Seat #7 is the button
Seat 1: ppeetteerr175 ($1.82 in chips) 
Seat 2: Azznak ($1.92 in chips) 
Seat 3: PABLOZAL10 ($1.94 in chips) 
Seat 4: kiling1 ($2.03 in chips) 
Seat 5: ezviktor ($1.56 in chips) 
Seat 6: Dorex2007 ($3.68 in chips) 
Seat 7: secret1977 ($1.97 in chips) 
Seat 8: edoschenko ($1.49 in chips) 
Seat 9: Cesnielumige ($2.10 in chips) 
edoschenko: posts small blind $0.01
Cesnielumige: posts big blind $0.02
*** HOLE CARDS ***
Dealt to Dorex2007 [5d Js]
ppeetteerr175: folds 
Azznak: folds 
PABLOZAL10: folds 
kiling1: folds 
ezviktor: folds 
Dorex2007: folds 
secret1977: folds 
edoschenko: raises $0.06 to $0.08
Cesnielumige: folds 
Uncalled bet ($0.06) returned to edoschenko
edoschenko collected $0.04 from pot
edoschenko: doesn't show hand 
*** SUMMARY ***
Total pot $0.04 | Rake $0 
Seat 1: ppeetteerr175 folded before Flop (didn't bet)
Seat 2: Azznak folded before Flop (didn't bet)
Seat 3: PABLOZAL10 folded before Flop (didn't bet)
Seat 4: kiling1 folded before Flop (didn't bet)
Seat 5: ezviktor folded before Flop (didn't bet)
Seat 6: Dorex2007 folded before Flop (didn't bet)
Seat 7: secret1977 (button) folded before Flop (didn't bet)
Seat 8: edoschenko (small blind) collected ($0.04)
Seat 9: Cesnielumige (big blind) folded before Flop



PokerStars Hand #224826346819:  Hold'em No Limit ($0.01/$0.02 USD) - 2021/03/14 23:00:13 PT [2021/03/15 2:00:13 ET]
Table 'Piccolo IV' 9-max Seat #8 is the button
Seat 1: ppeetteerr175 ($1.82 in chips) 
Seat 2: Azznak ($1.92 in chips) 
Seat 3: PABLOZAL10 ($1.94 in chips) 
Seat 4: kiling1 ($2.03 in chips) 
Seat 6: Dorex2007 ($3.68 in chips) 
Seat 7: secret1977 ($1.97 in chips) 
Seat 8: edoschenko ($1.51 in chips) 
Seat 9: Cesnielumige ($2.08 in chips) 
Cesnielumige: posts small blind $0.01
ppeetteerr175: posts big blind $0.02
*** HOLE CARDS ***
Dealt to Dorex2007 [6h 8s]
Azznak: folds 
PABLOZAL10: raises $0.02 to $0.04
kiling1: folds 
Dorex2007: folds 
secret1977: calls $0.04
edoschenko: folds 
Cesnielumige: folds 
ppeetteerr175: calls $0.02
*** FLOP *** [2c 2d Jh]
ppeetteerr175: checks 
PABLOZAL10: bets $0.13
secret1977: folds 
ppeetteerr175: folds 
Uncalled bet ($0.13) returned to PABLOZAL10
PABLOZAL10 collected $0.13 from pot
PABLOZAL10: doesn't show hand 
*** SUMMARY ***
Total pot $0.13 | Rake $0 
Board [2c 2d Jh]
Seat 1: ppeetteerr175 (big blind) folded on the Flop
Seat 2: Azznak folded before Flop (didn't bet)
Seat 3: PABLOZAL10 collected ($0.13)
Seat 4: kiling1 folded before Flop (didn't bet)
Seat 6: Dorex2007 folded before Flop (didn't bet)
Seat 7: secret1977 folded on the Flop
Seat 8: edoschenko (button) folded before Flop (didn't bet)
Seat 9: Cesnielumige (small blind) folded before Flop



PokerStars Hand #224826352767:  Hold'em No Limit ($0.01/$0.02 USD) - 2021/03/14 23:00:55 PT [2021/03/15 2:00:55 ET]
Table 'Piccolo IV' 9-max Seat #9 is the button
Seat 1: ppeetteerr175 ($1.78 in chips) 
Seat 2: Azznak ($1.92 in chips) 
Seat 3: PABLOZAL10 ($2.03 in chips) 
Seat 4: kiling1 ($2.03 in chips) 
Seat 6: Dorex2007 ($3.68 in chips) 
Seat 7: secret1977 ($1.93 in chips) 
Seat 8: edoschenko ($1.51 in chips) 
Seat 9: Cesnielumige ($2.07 in chips) 
ppeetteerr175: posts small blind $0.01
Azznak: posts big blind $0.02
*** HOLE CARDS ***
Dealt to Dorex2007 [4d 8s]
PABLOZAL10: folds 
kiling1: folds 
Dorex2007: folds 
secret1977: folds 
edoschenko: folds 
Cesnielumige: folds 
ppeetteerr175: folds 
Uncalled bet ($0.01) returned to Azznak
Azznak collected $0.02 from pot
Azznak: doesn't show hand 
*** SUMMARY ***
Total pot $0.02 | Rake $0 
Seat 1: ppeetteerr175 (small blind) folded before Flop
Seat 2: Azznak (big blind) collected ($0.02)
Seat 3: PABLOZAL10 folded before Flop (didn't bet)
Seat 4: kiling1 folded before Flop (didn't bet)
Seat 6: Dorex2007 folded before Flop (didn't bet)
Seat 7: secret1977 folded before Flop (didn't bet)
Seat 8: edoschenko folded before Flop (didn't bet)
Seat 9: Cesnielumige (button) folded before Flop (didn't bet)



PokerStars Hand #224826355794:  Hold'em No Limit ($0.01/$0.02 USD) - 2021/03/14 23:01:17 PT [2021/03/15 2:01:17 ET]
Table 'Piccolo IV' 9-max Seat #1 is the button
Seat 1: ppeetteerr175 ($1.77 in chips) 
Seat 2: Azznak ($1.93 in chips) 
Seat 3: PABLOZAL10 ($2.03 in chips) 
Seat 4: kiling1 ($2.03 in chips) 
Seat 6: Dorex2007 ($3.68 in chips) 
Seat 7: secret1977 ($1.93 in chips) 
Seat 8: edoschenko ($1.51 in chips) 
Seat 9: Cesnielumige ($2.07 in chips) 
Azznak: posts small blind $0.01
PABLOZAL10: posts big blind $0.02
*** HOLE CARDS ***
Dealt to Dorex2007 [Jd As]
kiling1: raises $0.05 to $0.07
Dorex2007: folds 
secret1977: folds 
edoschenko: folds 
Cesnielumige: folds 
ppeetteerr175: calls $0.07
Azznak: folds 
PABLOZAL10: folds 
*** FLOP *** [7d Th 4h]
kiling1: bets $0.08
ppeetteerr175: calls $0.08
*** TURN *** [7d Th 4h] [9h]
kiling1: bets $0.10
ppeetteerr175: calls $0.10
*** RIVER *** [7d Th 4h 9h] [3d]
kiling1: bets $0.31
ppeetteerr175: raises $1.21 to $1.52 and is all-in
kiling1: folds 
Uncalled bet ($1.21) returned to ppeetteerr175
ppeetteerr175 collected $1.11 from pot
ppeetteerr175: doesn't show hand 
*** SUMMARY ***
Total pot $1.15 | Rake $0.04 
Board [7d Th 4h 9h 3d]
Seat 1: ppeetteerr175 (button) collected ($1.11)
Seat 2: Azznak (small blind) folded before Flop
Seat 3: PABLOZAL10 (big blind) folded before Flop
Seat 4: kiling1 folded on the River
Seat 6: Dorex2007 folded before Flop (didn't bet)
Seat 7: secret1977 folded before Flop (didn't bet)
Seat 8: edoschenko folded before Flop (didn't bet)
Seat 9: Cesnielumige folded before Flop (didn't bet)



PokerStars Hand #224826370699:  Hold'em No Limit ($0.01/$0.02 USD) - 2021/03/14 23:02:59 PT [2021/03/15 2:02:59 ET]
Table 'Piccolo IV' 9-max Seat #2 is the button
Seat 1: ppeetteerr175 ($2.32 in chips) 
Seat 2: Azznak ($1.92 in chips) 
Seat 3: PABLOZAL10 ($2.01 in chips) 
Seat 4: kiling1 ($1.47 in chips) 
Seat 6: Dorex2007 ($3.68 in chips) 
Seat 7: secret1977 ($1.93 in chips) 
Seat 8: edoschenko ($1.51 in chips) 
Seat 9: Cesnielumige ($2.07 in chips) 
PABLOZAL10: posts small blind $0.01
kiling1: posts big blind $0.02
*** HOLE CARDS ***
Dealt to Dorex2007 [5h 8h]
Dorex2007: folds 
secret1977: calls $0.02
edoschenko: folds 
Cesnielumige: folds 
ppeetteerr175: folds 
Azznak: calls $0.02
PABLOZAL10: calls $0.01
kiling1: checks 
*** FLOP *** [3d 6d 4s]
PABLOZAL10: checks 
kiling1: checks 
secret1977: checks 
Azznak: bets $0.04
PABLOZAL10: folds 
kiling1: raises $0.16 to $0.20
secret1977: folds 
Azznak: folds 
Uncalled bet ($0.16) returned to kiling1
kiling1 collected $0.15 from pot
kiling1: doesn't show hand 
*** SUMMARY ***
Total pot $0.16 | Rake $0.01 
Board [3d 6d 4s]
Seat 1: ppeetteerr175 folded before Flop (didn't bet)
Seat 2: Azznak (button) folded on the Flop
Seat 3: PABLOZAL10 (small blind) folded on the Flop
Seat 4: kiling1 (big blind) collected ($0.15)
Seat 6: Dorex2007 folded before Flop (didn't bet)
Seat 7: secret1977 folded on the Flop
Seat 8: edoschenko folded before Flop (didn't bet)
Seat 9: Cesnielumige folded before Flop (didn't bet)



PokerStars Hand #224826379265:  Hold'em No Limit ($0.01/$0.02 USD) - 2021/03/14 23:03:57 PT [2021/03/15 2:03:57 ET]
Table 'Piccolo IV' 9-max Seat #3 is the button
Seat 1: ppeetteerr175 ($2.32 in chips) 
Seat 2: Azznak ($2 in chips) 
Seat 3: PABLOZAL10 ($1.99 in chips) 
Seat 4: kiling1 ($1.56 in chips) 
Seat 6: Dorex2007 ($3.68 in chips) 
Seat 7: secret1977 ($1.91 in chips) 
Seat 8: edoschenko ($1.51 in chips) 
Seat 9: Cesnielumige ($2.07 in chips) 
kiling1: posts small blind $0.01
Dorex2007: posts big blind $0.02
*** HOLE CARDS ***
Dealt to Dorex2007 [Kd 3c]
secret1977: folds 
edoschenko: folds 
Cesnielumige: folds 
ppeetteerr175: folds 
Azznak: folds 
PABLOZAL10: folds 
kiling1: folds 
Uncalled bet ($0.01) returned to Dorex2007
Dorex2007 collected $0.02 from pot
Dorex2007: doesn't show hand 
*** SUMMARY ***
Total pot $0.02 | Rake $0 
Seat 1: ppeetteerr175 folded before Flop (didn't bet)
Seat 2: Azznak folded before Flop (didn't bet)
Seat 3: PABLOZAL10 (button) folded before Flop (didn't bet)
Seat 4: kiling1 (small blind) folded before Flop
Seat 6: Dorex2007 (big blind) collected ($0.02)
Seat 7: secret1977 folded before Flop (didn't bet)
Seat 8: edoschenko folded before Flop (didn't bet)
Seat 9: Cesnielumige folded before Flop (didn't bet)



PokerStars Hand #224826381556:  Hold'em No Limit ($0.01/$0.02 USD) - 2021/03/14 23:04:13 PT [2021/03/15 2:04:13 ET]
Table 'Piccolo IV' 9-max Seat #4 is the button
Seat 1: ppeetteerr175 ($2.32 in chips) 
Seat 2: Azznak ($2 in chips) 
Seat 3: PABLOZAL10 ($1.99 in chips) 
Seat 4: kiling1 ($1.55 in chips) 
Seat 6: Dorex2007 ($3.69 in chips) 
Seat 7: secret1977 ($1.91 in chips) 
Seat 8: edoschenko ($1.51 in chips) 
Seat 9: Cesnielumige ($2.07 in chips) 
Dorex2007: posts small blind $0.01
secret1977: posts big blind $0.02
*** HOLE CARDS ***
Dealt to Dorex2007 [8s 6c]
edoschenko: folds 
Cesnielumige: folds 
ppeetteerr175: folds 
Azznak: folds 
PABLOZAL10: folds 
kiling1: raises $0.04 to $0.06
Dorex2007: folds 
secret1977: folds 
Uncalled bet ($0.04) returned to kiling1
kiling1 collected $0.05 from pot
kiling1: doesn't show hand 
*** SUMMARY ***
Total pot $0.05 | Rake $0 
Seat 1: ppeetteerr175 folded before Flop (didn't bet)
Seat 2: Azznak folded before Flop (didn't bet)
Seat 3: PABLOZAL10 folded before Flop (didn't bet)
Seat 4: kiling1 (button) collected ($0.05)
Seat 6: Dorex2007 (small blind) folded before Flop
Seat 7: secret1977 (big blind) folded before Flop
Seat 8: edoschenko folded before Flop (didn't bet)
Seat 9: Cesnielumige folded before Flop (didn't bet)



PokerStars Hand #224826385555:  Hold'em No Limit ($0.01/$0.02 USD) - 2021/03/14 23:04:40 PT [2021/03/15 2:04:40 ET]
Table 'Piccolo IV' 9-max Seat #6 is the button
Seat 1: ppeetteerr175 ($2.32 in chips) 
Seat 2: Azznak ($2 in chips) 
Seat 3: PABLOZAL10 ($1.99 in chips) 
Seat 4: kiling1 ($1.58 in chips) 
Seat 6: Dorex2007 ($3.68 in chips) 
Seat 7: secret1977 ($1.89 in chips) 
Seat 8: edoschenko ($1.51 in chips) 
Seat 9: Cesnielumige ($2.07 in chips) 
secret1977: posts small blind $0.01
edoschenko: posts big blind $0.02
ezviktor: sits out 
*** HOLE CARDS ***
Dealt to Dorex2007 [8h 4c]
Cesnielumige: calls $0.02
ppeetteerr175: folds 
Azznak: folds 
PABLOZAL10: folds 
kiling1: folds 
Dorex2007: folds 
secret1977: calls $0.01
edoschenko: checks 
*** FLOP *** [7s 9h 8c]
secret1977: checks 
edoschenko: checks 
Cesnielumige: bets $0.04
secret1977: folds 
edoschenko: folds 
Uncalled bet ($0.04) returned to Cesnielumige
Cesnielumige collected $0.06 from pot
Cesnielumige: doesn't show hand 
*** SUMMARY ***
Total pot $0.06 | Rake $0 
Board [7s 9h 8c]
Seat 1: ppeetteerr175 folded before Flop (didn't bet)
Seat 2: Azznak folded before Flop (didn't bet)
Seat 3: PABLOZAL10 folded before Flop (didn't bet)
Seat 4: kiling1 folded before Flop (didn't bet)
Seat 6: Dorex2007 (button) folded before Flop (didn't bet)
Seat 7: secret1977 (small blind) folded on the Flop
Seat 8: edoschenko (big blind) folded on the Flop
Seat 9: Cesnielumige collected ($0.06)



PokerStars Hand #224826391510:  Hold'em No Limit ($0.01/$0.02 USD) - 2021/03/14 23:05:20 PT [2021/03/15 2:05:20 ET]
Table 'Piccolo IV' 9-max Seat #7 is the button
Seat 1: ppeetteerr175 ($2.32 in chips) 
Seat 2: Azznak ($2 in chips) 
Seat 3: PABLOZAL10 ($1.99 in chips) 
Seat 4: kiling1 ($1.58 in chips) 
Seat 6: Dorex2007 ($3.68 in chips) 
Seat 7: secret1977 ($1.87 in chips) 
Seat 8: edoschenko ($1.49 in chips) 
Seat 9: Cesnielumige ($2.11 in chips) 
edoschenko: posts small blind $0.01
Cesnielumige: posts big blind $0.02
ezviktor: sits out 
*** HOLE CARDS ***
Dealt to Dorex2007 [8c Ks]
ppeetteerr175: folds 
Azznak: folds 
PABLOZAL10: folds 
kiling1: folds 
Dorex2007: folds 
secret1977: folds 
edoschenko: folds 
Uncalled bet ($0.01) returned to Cesnielumige
Cesnielumige collected $0.02 from pot
Cesnielumige: doesn't show hand 
*** SUMMARY ***
Total pot $0.02 | Rake $0 
Seat 1: ppeetteerr175 folded before Flop (didn't bet)
Seat 2: Azznak folded before Flop (didn't bet)
Seat 3: PABLOZAL10 folded before Flop (didn't bet)
Seat 4: kiling1 folded before Flop (didn't bet)
Seat 6: Dorex2007 folded before Flop (didn't bet)
Seat 7: secret1977 (button) folded before Flop (didn't bet)
Seat 8: edoschenko (small blind) folded before Flop
Seat 9: Cesnielumige (big blind) collected ($0.02)



PokerStars Hand #224826393860:  Hold'em No Limit ($0.01/$0.02 USD) - 2021/03/14 23:05:36 PT [2021/03/15 2:05:36 ET]
Table 'Piccolo IV' 9-max Seat #8 is the button
Seat 1: ppeetteerr175 ($2.32 in chips) 
Seat 2: Azznak ($2 in chips) 
Seat 3: PABLOZAL10 ($1.99 in chips) 
Seat 4: kiling1 ($1.58 in chips) 
Seat 6: Dorex2007 ($3.68 in chips) 
Seat 7: secret1977 ($1.87 in chips) 
Seat 8: edoschenko ($1.48 in chips) 
Seat 9: Cesnielumige ($2.12 in chips) 
Cesnielumige: posts small blind $0.01
ppeetteerr175: posts big blind $0.02
ezviktor: sits out 
*** HOLE CARDS ***
Dealt to Dorex2007 [5d 6d]
Azznak: folds 
PABLOZAL10: folds 
kiling1: calls $0.02
Dorex2007: calls $0.02
secret1977: folds 
edoschenko: raises $0.12 to $0.14
Cesnielumige: folds 
ppeetteerr175: folds 
kiling1: folds 
Dorex2007: folds 
Uncalled bet ($0.12) returned to edoschenko
edoschenko collected $0.09 from pot
edoschenko: doesn't show hand 
*** SUMMARY ***
Total pot $0.09 | Rake $0 
Seat 1: ppeetteerr175 (big blind) folded before Flop
Seat 2: Azznak folded before Flop (didn't bet)
Seat 3: PABLOZAL10 folded before Flop (didn't bet)
Seat 4: kiling1 folded before Flop
Seat 6: Dorex2007 folded before Flop
Seat 7: secret1977 folded before Flop (didn't bet)
Seat 8: edoschenko (button) collected ($0.09)
Seat 9: Cesnielumige (small blind) folded before Flop



PokerStars Hand #224826397684:  Hold'em No Limit ($0.01/$0.02 USD) - 2021/03/14 23:06:03 PT [2021/03/15 2:06:03 ET]
Table 'Piccolo IV' 9-max Seat #9 is the button
Seat 1: ppeetteerr175 ($2.30 in chips) 
Seat 2: Azznak ($2 in chips) 
Seat 3: PABLOZAL10 ($1.99 in chips) 
Seat 4: kiling1 ($1.56 in chips) 
Seat 6: Dorex2007 ($3.66 in chips) 
Seat 7: secret1977 ($1.87 in chips) 
Seat 8: edoschenko ($1.55 in chips) 
Seat 9: Cesnielumige ($2.11 in chips) 
ppeetteerr175: posts small blind $0.01
Azznak: posts big blind $0.02
ezviktor: sits out 
*** HOLE CARDS ***
Dealt to Dorex2007 [Ac Kh]
PABLOZAL10: folds 
kiling1: folds 
Dorex2007: raises $0.06 to $0.08
secret1977: folds 
edoschenko: folds 
Cesnielumige: folds 
ppeetteerr175: calls $0.07
Azznak: folds 
*** FLOP *** [Tc 6c 2c]
ppeetteerr175: checks 
Dorex2007: checks 
*** TURN *** [Tc 6c 2c] [As]
ppeetteerr175: bets $0.17
Dorex2007: calls $0.17
*** RIVER *** [Tc 6c 2c As] [Jc]
ppeetteerr175: checks 
Dorex2007: bets $0.25
ppeetteerr175: calls $0.25
*** SHOW DOWN ***
Dorex2007: shows [Ac Kh] (a flush, Ace high)
ppeetteerr175: mucks hand 
Dorex2007 collected $0.98 from pot
*** SUMMARY ***
Total pot $1.02 | Rake $0.04 
Board [Tc 6c 2c As Jc]
Seat 1: ppeetteerr175 (small blind) mucked [Ts Td]
Seat 2: Azznak (big blind) folded before Flop
Seat 3: PABLOZAL10 folded before Flop (didn't bet)
Seat 4: kiling1 folded before Flop (didn't bet)
Seat 6: Dorex2007 showed [Ac Kh] and won ($0.98) with a flush, Ace high
Seat 7: secret1977 folded before Flop (didn't bet)
Seat 8: edoschenko folded before Flop (didn't bet)
Seat 9: Cesnielumige (button) folded before Flop (didn't bet)



PokerStars Hand #224826408578:  Hold'em No Limit ($0.01/$0.02 USD) - 2021/03/14 23:07:07 PT [2021/03/15 2:07:07 ET]
Table 'Piccolo IV' 9-max Seat #1 is the button
Seat 1: ppeetteerr175 ($1.80 in chips) 
Seat 2: Azznak ($1.98 in chips) 
Seat 3: PABLOZAL10 ($1.99 in chips) 
Seat 4: kiling1 ($1.56 in chips) 
Seat 6: Dorex2007 ($4.14 in chips) 
Seat 7: secret1977 ($1.87 in chips) 
Seat 8: edoschenko ($1.55 in chips) 
Seat 9: Cesnielumige ($2.11 in chips) 
Azznak: posts small blind $0.01
PABLOZAL10: posts big blind $0.02
ezviktor: sits out 
*** HOLE CARDS ***
Dealt to Dorex2007 [Jd 6s]
kiling1: folds 
Dorex2007: folds 
secret1977: folds 
edoschenko: folds 
Cesnielumige: raises $0.04 to $0.06
ppeetteerr175: folds 
Azznak: folds 
PABLOZAL10: raises $0.13 to $0.19
Cesnielumige: folds 
Uncalled bet ($0.13) returned to PABLOZAL10
PABLOZAL10 collected $0.13 from pot
PABLOZAL10: doesn't show hand 
*** SUMMARY ***
Total pot $0.13 | Rake $0 
Seat 1: ppeetteerr175 (button) folded before Flop (didn't bet)
Seat 2: Azznak (small blind) folded before Flop
Seat 3: PABLOZAL10 (big blind) collected ($0.13)
Seat 4: kiling1 folded before Flop (didn't bet)
Seat 6: Dorex2007 folded before Flop (didn't bet)
Seat 7: secret1977 folded before Flop (didn't bet)
Seat 8: edoschenko folded before Flop (didn't bet)
Seat 9: Cesnielumige folded before Flop



PokerStars Hand #224826413037:  Hold'em No Limit ($0.01/$0.02 USD) - 2021/03/14 23:07:37 PT [2021/03/15 2:07:37 ET]
Table 'Piccolo IV' 9-max Seat #2 is the button
Seat 1: ppeetteerr175 ($1.80 in chips) 
Seat 2: Azznak ($1.97 in chips) 
Seat 3: PABLOZAL10 ($2.06 in chips) 
Seat 4: kiling1 ($1.56 in chips) 
Seat 6: Dorex2007 ($4.14 in chips) 
Seat 7: secret1977 ($1.87 in chips) 
Seat 8: edoschenko ($1.55 in chips) 
Seat 9: Cesnielumige ($2.05 in chips) 
PABLOZAL10: posts small blind $0.01
kiling1: posts big blind $0.02
ezviktor: sits out 
*** HOLE CARDS ***
Dealt to Dorex2007 [2d 9h]
Dorex2007: folds 
secret1977: folds 
edoschenko: folds 
Cesnielumige: folds 
ppeetteerr175: folds 
Azznak: folds 
PABLOZAL10: folds 
Uncalled bet ($0.01) returned to kiling1
kiling1 collected $0.02 from pot
kiling1: doesn't show hand 
*** SUMMARY ***
Total pot $0.02 | Rake $0 
Seat 1: ppeetteerr175 folded before Flop (didn't bet)
Seat 2: Azznak (button) folded before Flop (didn't bet)
Seat 3: PABLOZAL10 (small blind) folded before Flop
Seat 4: kiling1 (big blind) collected ($0.02)
Seat 6: Dorex2007 folded before Flop (didn't bet)
Seat 7: secret1977 folded before Flop (didn't bet)
Seat 8: edoschenko folded before Flop (didn't bet)
Seat 9: Cesnielumige folded before Flop (didn't bet)



PokerStars Hand #224826415988:  Hold'em No Limit ($0.01/$0.02 USD) - 2021/03/14 23:07:58 PT [2021/03/15 2:07:58 ET]
Table 'Piccolo IV' 9-max Seat #3 is the button
Seat 1: ppeetteerr175 ($1.80 in chips) 
Seat 2: Azznak ($1.97 in chips) 
Seat 3: PABLOZAL10 ($2.05 in chips) 
Seat 4: kiling1 ($1.57 in chips) 
Seat 5: ezviktor ($1.56 in chips) 
Seat 6: Dorex2007 ($4.14 in chips) 
Seat 7: secret1977 ($1.87 in chips) 
Seat 8: edoschenko ($1.55 in chips) 
Seat 9: Cesnielumige ($2.05 in chips) 
kiling1: posts small blind $0.01
ezviktor: posts big blind $0.02
*** HOLE CARDS ***
Dealt to Dorex2007 [9h Th]
Dorex2007: raises $0.04 to $0.06
secret1977: folds 
edoschenko: folds 
Cesnielumige: folds 
ppeetteerr175: calls $0.06
Azznak: folds 
PABLOZAL10: folds 
kiling1: folds 
ezviktor: folds 
*** FLOP *** [4h 2h 3c]
Dorex2007: checks 
ppeetteerr175: bets $0.14
Dorex2007: calls $0.14
*** TURN *** [4h 2h 3c] [Ad]
Dorex2007: checks 
edoschenko leaves the table
ppeetteerr175: bets $0.41
Dorex2007: folds 
Uncalled bet ($0.41) returned to ppeetteerr175
ppeetteerr175 collected $0.41 from pot
ppeetteerr175: doesn't show hand 
*** SUMMARY ***
Total pot $0.43 | Rake $0.02 
Board [4h 2h 3c Ad]
Seat 1: ppeetteerr175 collected ($0.41)
Seat 2: Azznak folded before Flop (didn't bet)
Seat 3: PABLOZAL10 (button) folded before Flop (didn't bet)
Seat 4: kiling1 (small blind) folded before Flop
Seat 5: ezviktor (big blind) folded before Flop
Seat 6: Dorex2007 folded on the Turn
Seat 7: secret1977 folded before Flop (didn't bet)
Seat 8: edoschenko folded before Flop (didn't bet)
Seat 9: Cesnielumige folded before Flop (didn't bet)



PokerStars Hand #224826427071:  Hold'em No Limit ($0.01/$0.02 USD) - 2021/03/14 23:09:12 PT [2021/03/15 2:09:12 ET]
Table 'Piccolo IV' 9-max Seat #4 is the button
Seat 1: ppeetteerr175 ($2.01 in chips) 
Seat 2: Azznak ($1.97 in chips) 
Seat 3: PABLOZAL10 ($2.05 in chips) 
Seat 4: kiling1 ($1.56 in chips) 
Seat 5: ezviktor ($1.54 in chips) 
Seat 6: Dorex2007 ($3.94 in chips) 
Seat 7: secret1977 ($1.87 in chips) 
Seat 9: Cesnielumige ($2.05 in chips) 
ezviktor: posts small blind $0.01
Dorex2007: posts big blind $0.02
*** HOLE CARDS ***
Dealt to Dorex2007 [Jd 9d]
secret1977: calls $0.02
Cesnielumige: folds 
ppeetteerr175: folds 
Azznak: folds 
PABLOZAL10: folds 
kiling1: raises $0.07 to $0.09
ezviktor: folds 
Dorex2007: folds 
secret1977: calls $0.07
*** FLOP *** [Ks 5c 4c]
secret1977: checks 
kiling1: bets $0.10
secret1977: folds 
Uncalled bet ($0.10) returned to kiling1
kiling1 collected $0.20 from pot
kiling1: doesn't show hand 
*** SUMMARY ***
Total pot $0.21 | Rake $0.01 
Board [Ks 5c 4c]
Seat 1: ppeetteerr175 folded before Flop (didn't bet)
Seat 2: Azznak folded before Flop (didn't bet)
Seat 3: PABLOZAL10 folded before Flop (didn't bet)
Seat 4: kiling1 (button) collected ($0.20)
Seat 5: ezviktor (small blind) folded before Flop
Seat 6: Dorex2007 (big blind) folded before Flop
Seat 7: secret1977 folded on the Flop
Seat 9: Cesnielumige folded before Flop (didn't bet)



PokerStars Hand #224826433243:  Hold'em No Limit ($0.01/$0.02 USD) - 2021/03/14 23:09:55 PT [2021/03/15 2:09:55 ET]
Table 'Piccolo IV' 9-max Seat #5 is the button
Seat 1: ppeetteerr175 ($2.01 in chips) 
Seat 2: Azznak ($1.97 in chips) 
Seat 3: PABLOZAL10 ($2.05 in chips) 
Seat 4: kiling1 ($1.67 in chips) 
Seat 5: ezviktor ($1.53 in chips) 
Seat 6: Dorex2007 ($3.92 in chips) 
Seat 7: secret1977 ($1.78 in chips) 
Seat 9: Cesnielumige ($2.05 in chips) 
Dorex2007: posts small blind $0.01
secret1977: posts big blind $0.02
*** HOLE CARDS ***
Dealt to Dorex2007 [Kc Qd]
Cesnielumige: folds 
ppeetteerr175: folds 
Azznak: folds 
Cesnielumige leaves the table
PABLOZAL10: raises $0.05 to $0.07
kiling1: folds 
ezviktor: folds 
Dorex2007: folds 
secret1977: folds 
Uncalled bet ($0.05) returned to PABLOZAL10
PABLOZAL10 collected $0.05 from pot
PABLOZAL10: doesn't show hand 
*** SUMMARY ***
Total pot $0.05 | Rake $0 
Seat 1: ppeetteerr175 folded before Flop (didn't bet)
Seat 2: Azznak folded before Flop (didn't bet)
Seat 3: PABLOZAL10 collected ($0.05)
Seat 4: kiling1 folded before Flop (didn't bet)
Seat 5: ezviktor (button) folded before Flop (didn't bet)
Seat 6: Dorex2007 (small blind) folded before Flop
Seat 7: secret1977 (big blind) folded before Flop
Seat 9: Cesnielumige folded before Flop (didn't bet)



PokerStars Hand #224826436836:  Hold'em No Limit ($0.01/$0.02 USD) - 2021/03/14 23:10:19 PT [2021/03/15 2:10:19 ET]
Table 'Piccolo IV' 9-max Seat #6 is the button
Seat 1: ppeetteerr175 ($2.01 in chips) 
Seat 2: Azznak ($1.97 in chips) 
Seat 3: PABLOZAL10 ($2.08 in chips) 
Seat 4: kiling1 ($1.67 in chips) 
Seat 5: ezviktor ($1.53 in chips) 
Seat 6: Dorex2007 ($3.91 in chips) 
Seat 7: secret1977 ($1.98 in chips) 
secret1977: posts small blind $0.01
ppeetteerr175: posts big blind $0.02
*** HOLE CARDS ***
Dealt to Dorex2007 [7c 4c]
Azznak: folds 
PABLOZAL10: raises $0.05 to $0.07
kiling1: folds 
ezviktor: folds 
Dorex2007: folds 
DEDpartizan joins the table at seat #8 
secret1977: calls $0.06
ppeetteerr175: folds 
*** FLOP *** [Jd Ah 4s]
secret1977: checks 
PABLOZAL10: bets $0.15
secret1977: folds 
Uncalled bet ($0.15) returned to PABLOZAL10
PABLOZAL10 collected $0.15 from pot
PABLOZAL10: doesn't show hand 
*** SUMMARY ***
Total pot $0.16 | Rake $0.01 
Board [Jd Ah 4s]
Seat 1: ppeetteerr175 (big blind) folded before Flop
Seat 2: Azznak folded before Flop (didn't bet)
Seat 3: PABLOZAL10 collected ($0.15)
Seat 4: kiling1 folded before Flop (didn't bet)
Seat 5: ezviktor folded before Flop (didn't bet)
Seat 6: Dorex2007 (button) folded before Flop (didn't bet)
Seat 7: secret1977 (small blind) folded on the Flop



PokerStars Hand #224826441910:  Hold'em No Limit ($0.01/$0.02 USD) - 2021/03/14 23:10:54 PT [2021/03/15 2:10:54 ET]
Table 'Piccolo IV' 9-max Seat #7 is the button
Seat 1: ppeetteerr175 ($1.99 in chips) 
Seat 2: Azznak ($1.97 in chips) 
Seat 3: PABLOZAL10 ($2.16 in chips) 
Seat 4: kiling1 ($1.67 in chips) 
Seat 5: ezviktor ($1.53 in chips) 
Seat 6: Dorex2007 ($3.91 in chips) 
Seat 7: secret1977 ($1.91 in chips) 
ppeetteerr175: posts small blind $0.01
Azznak: posts big blind $0.02
*** HOLE CARDS ***
Dealt to Dorex2007 [Ad 4s]
PABLOZAL10: folds 
kiling1: folds 
ezviktor: folds 
Dorex2007: folds 
secret1977: folds 
ppeetteerr175: folds 
Uncalled bet ($0.01) returned to Azznak
Azznak collected $0.02 from pot
Azznak: doesn't show hand 
*** SUMMARY ***
Total pot $0.02 | Rake $0 
Seat 1: ppeetteerr175 (small blind) folded before Flop
Seat 2: Azznak (big blind) collected ($0.02)
Seat 3: PABLOZAL10 folded before Flop (didn't bet)
Seat 4: kiling1 folded before Flop (didn't bet)
Seat 5: ezviktor folded before Flop (didn't bet)
Seat 6: Dorex2007 folded before Flop (didn't bet)
Seat 7: secret1977 (button) folded before Flop (didn't bet)



PokerStars Hand #224826444018:  Hold'em No Limit ($0.01/$0.02 USD) - 2021/03/14 23:11:08 PT [2021/03/15 2:11:08 ET]
Table 'Piccolo IV' 9-max Seat #1 is the button
Seat 1: ppeetteerr175 ($1.98 in chips) 
Seat 2: Azznak ($1.98 in chips) 
Seat 3: PABLOZAL10 ($2.16 in chips) 
Seat 4: kiling1 ($1.67 in chips) 
Seat 5: ezviktor ($1.53 in chips) 
Seat 6: Dorex2007 ($3.91 in chips) 
Seat 7: secret1977 ($1.91 in chips) 
Azznak: posts small blind $0.01
PABLOZAL10: posts big blind $0.02
DEDpartizan: sits out 
*** HOLE CARDS ***
Dealt to Dorex2007 [Kh 9s]
kiling1: folds 
ezviktor: folds 
Dorex2007: folds 
secret1977: folds 
ppeetteerr175: folds 
Azznak: folds 
Uncalled bet ($0.01) returned to PABLOZAL10
PABLOZAL10 collected $0.02 from pot
PABLOZAL10: doesn't show hand 
*** SUMMARY ***
Total pot $0.02 | Rake $0 
Seat 1: ppeetteerr175 (button) folded before Flop (didn't bet)
Seat 2: Azznak (small blind) folded before Flop
Seat 3: PABLOZAL10 (big blind) collected ($0.02)
Seat 4: kiling1 folded before Flop (didn't bet)
Seat 5: ezviktor folded before Flop (didn't bet)
Seat 6: Dorex2007 folded before Flop (didn't bet)
Seat 7: secret1977 folded before Flop (didn't bet)



PokerStars Hand #224826445803:  Hold'em No Limit ($0.01/$0.02 USD) - 2021/03/14 23:11:21 PT [2021/03/15 2:11:21 ET]
Table 'Piccolo IV' 9-max Seat #2 is the button
Seat 1: ppeetteerr175 ($1.98 in chips) 
Seat 2: Azznak ($1.97 in chips) 
Seat 3: PABLOZAL10 ($2.17 in chips) 
Seat 4: kiling1 ($1.67 in chips) 
Seat 5: ezviktor ($1.53 in chips) 
Seat 6: Dorex2007 ($3.91 in chips) 
Seat 7: secret1977 ($1.91 in chips) 
PABLOZAL10: posts small blind $0.01
kiling1: posts big blind $0.02
DEDpartizan: sits out 
*** HOLE CARDS ***
Dealt to Dorex2007 [7h Qh]
ezviktor: folds 
Dorex2007: folds 
secret1977: folds 
germar89 joins the table at seat #9 
ppeetteerr175: folds 
Azznak: calls $0.02
PABLOZAL10: raises $0.04 to $0.06
kiling1: folds 
Azznak: calls $0.04
*** FLOP *** [6s Jh 7s]
PABLOZAL10: checks 
Azznak: bets $0.07
PABLOZAL10: calls $0.07
*** TURN *** [6s Jh 7s] [5c]
PABLOZAL10: checks 
Azznak: bets $0.27
PABLOZAL10: folds 
Uncalled bet ($0.27) returned to Azznak
Azznak collected $0.27 from pot
Azznak: doesn't show hand 
*** SUMMARY ***
Total pot $0.28 | Rake $0.01 
Board [6s Jh 7s 5c]
Seat 1: ppeetteerr175 folded before Flop (didn't bet)
Seat 2: Azznak (button) collected ($0.27)
Seat 3: PABLOZAL10 (small blind) folded on the Turn
Seat 4: kiling1 (big blind) folded before Flop
Seat 5: ezviktor folded before Flop (didn't bet)
Seat 6: Dorex2007 folded before Flop (didn't bet)
Seat 7: secret1977 folded before Flop (didn't bet)



PokerStars Hand #224826452900:  Hold'em No Limit ($0.01/$0.02 USD) - 2021/03/14 23:12:09 PT [2021/03/15 2:12:09 ET]
Table 'Piccolo IV' 9-max Seat #3 is the button
Seat 1: ppeetteerr175 ($1.98 in chips) 
Seat 2: Azznak ($2.11 in chips) 
Seat 3: PABLOZAL10 ($2.04 in chips) 
Seat 4: kiling1 ($1.65 in chips) 
Seat 5: ezviktor ($1.53 in chips) 
Seat 6: Dorex2007 ($3.91 in chips) 
Seat 7: secret1977 ($1.91 in chips) 
Seat 9: germar89 ($1.29 in chips) 
kiling1: posts small blind $0.01
ezviktor: posts big blind $0.02
DEDpartizan: sits out 
germar89: posts big blind $0.02
*** HOLE CARDS ***
Dealt to Dorex2007 [Jh 6s]
Dorex2007: folds 
secret1977: folds 
germar89: checks 
ppeetteerr175: folds 
Azznak: folds 
PABLOZAL10: raises $0.02 to $0.04
kiling1: calls $0.03
ezviktor: calls $0.02
germar89: calls $0.02
*** FLOP *** [As 3c 6d]
kiling1: checks 
ezviktor: checks 
germar89: checks 
PABLOZAL10: checks 
*** TURN *** [As 3c 6d] [5c]
kiling1: checks 
ezviktor: checks 
germar89: checks 
PABLOZAL10: checks 
*** RIVER *** [As 3c 6d 5c] [5s]
kiling1: checks 
ezviktor: checks 
germar89: bets $0.15
PABLOZAL10: folds 
secret1977 leaves the table
kiling1: folds 
ezviktor: folds 
Uncalled bet ($0.15) returned to germar89
germar89 collected $0.15 from pot
germar89: doesn't show hand 
*** SUMMARY ***
Total pot $0.16 | Rake $0.01 
Board [As 3c 6d 5c 5s]
Seat 1: ppeetteerr175 folded before Flop (didn't bet)
Seat 2: Azznak folded before Flop (didn't bet)
Seat 3: PABLOZAL10 (button) folded on the River
Seat 4: kiling1 (small blind) folded on the River
Seat 5: ezviktor (big blind) folded on the River
Seat 6: Dorex2007 folded before Flop (didn't bet)
Seat 7: secret1977 folded before Flop (didn't bet)
Seat 9: germar89 collected ($0.15)



PokerStars Hand #224826464164:  Hold'em No Limit ($0.01/$0.02 USD) - 2021/03/14 23:13:27 PT [2021/03/15 2:13:27 ET]
Table 'Piccolo IV' 9-max Seat #4 is the button
Seat 1: ppeetteerr175 ($1.98 in chips) 
Seat 3: PABLOZAL10 ($2 in chips) 
Seat 4: kiling1 ($1.61 in chips) 
Seat 5: ezviktor ($1.49 in chips) 
Seat 6: Dorex2007 ($3.91 in chips) 
Seat 9: germar89 ($1.40 in chips) 
ezviktor: posts small blind $0.01
Dorex2007: posts big blind $0.02
DEDpartizan: sits out 
*** HOLE CARDS ***
Dealt to Dorex2007 [5d 8c]
germar89: raises $0.02 to $0.04
187Equalizer joins the table at seat #7 
ppeetteerr175: raises $0.11 to $0.15
PABLOZAL10: folds 
kiling1: folds 
ezviktor: folds 
Dorex2007: folds 
germar89: calls $0.11
*** FLOP *** [Js As Jh]
germar89: checks 
ppeetteerr175: checks 
*** TURN *** [Js As Jh] [9h]
germar89: bets $0.32
ppeetteerr175: folds 
Uncalled bet ($0.32) returned to germar89
germar89 collected $0.32 from pot
germar89: doesn't show hand 
*** SUMMARY ***
Total pot $0.33 | Rake $0.01 
Board [Js As Jh 9h]
Seat 1: ppeetteerr175 folded on the Turn
Seat 3: PABLOZAL10 folded before Flop (didn't bet)
Seat 4: kiling1 (button) folded before Flop (didn't bet)
Seat 5: ezviktor (small blind) folded before Flop
Seat 6: Dorex2007 (big blind) folded before Flop
Seat 9: germar89 collected ($0.32)



PokerStars Hand #224826475071:  Hold'em No Limit ($0.01/$0.02 USD) - 2021/03/14 23:14:41 PT [2021/03/15 2:14:41 ET]
Table 'Piccolo IV' 9-max Seat #5 is the button
Seat 1: ppeetteerr175 ($1.83 in chips) 
Seat 2: Azznak ($2.11 in chips) 
Seat 3: PABLOZAL10 ($2 in chips) 
Seat 4: kiling1 ($1.61 in chips) 
Seat 5: ezviktor ($1.48 in chips) 
Seat 6: Dorex2007 ($3.89 in chips) 
Seat 7: 187Equalizer ($0.80 in chips) 
Seat 9: germar89 ($1.57 in chips) 
Dorex2007: posts small blind $0.01
187Equalizer: posts big blind $0.02
DEDpartizan: sits out 
*** HOLE CARDS ***
Dealt to Dorex2007 [Th Tc]
germar89: folds 
ppeetteerr175: folds 
Azznak: folds 
PABLOZAL10: folds 
kiling1: raises $0.04 to $0.06
ezviktor: folds 
Dorex2007: calls $0.05
187Equalizer: raises $0.34 to $0.40
kiling1: folds 
Dorex2007: folds 
Uncalled bet ($0.34) returned to 187Equalizer
187Equalizer collected $0.18 from pot
187Equalizer: doesn't show hand 
*** SUMMARY ***
Total pot $0.18 | Rake $0 
Seat 1: ppeetteerr175 folded before Flop (didn't bet)
Seat 2: Azznak folded before Flop (didn't bet)
Seat 3: PABLOZAL10 folded before Flop (didn't bet)
Seat 4: kiling1 folded before Flop
Seat 5: ezviktor (button) folded before Flop (didn't bet)
Seat 6: Dorex2007 (small blind) folded before Flop
Seat 7: 187Equalizer (big blind) collected ($0.18)
Seat 9: germar89 folded before Flop (didn't bet)



PokerStars Hand #224826479658:  Hold'em No Limit ($0.01/$0.02 USD) - 2021/03/14 23:15:13 PT [2021/03/15 2:15:13 ET]
Table 'Piccolo IV' 9-max Seat #6 is the button
Seat 1: ppeetteerr175 ($1.83 in chips) 
Seat 2: Azznak ($2.11 in chips) 
Seat 3: PABLOZAL10 ($2 in chips) 
Seat 4: kiling1 ($1.55 in chips) 
Seat 5: ezviktor ($1.48 in chips) 
Seat 6: Dorex2007 ($3.83 in chips) 
Seat 7: 187Equalizer ($0.92 in chips) 
Seat 8: DEDpartizan ($0.80 in chips) 
Seat 9: germar89 ($1.57 in chips) 
187Equalizer: posts small blind $0.01
DEDpartizan: posts big blind $0.02
*** HOLE CARDS ***
Dealt to Dorex2007 [8d 5s]
germar89: calls $0.02
ppeetteerr175: calls $0.02
Azznak: folds 
PABLOZAL10: folds 
kiling1: folds 
ezviktor: folds 
Dorex2007: folds 
187Equalizer: calls $0.01
DEDpartizan: checks 
*** FLOP *** [Th 6d 4d]
187Equalizer: bets $0.04
DEDpartizan: folds 
germar89: folds 
ppeetteerr175: calls $0.04
*** TURN *** [Th 6d 4d] [As]
187Equalizer: checks 
ppeetteerr175: checks 
*** RIVER *** [Th 6d 4d As] [6h]
187Equalizer: checks 
ppeetteerr175: checks 
*** SHOW DOWN ***
187Equalizer: shows [9d 9c] (two pair, Nines and Sixes)
ppeetteerr175: mucks hand 
187Equalizer collected $0.15 from pot
*** SUMMARY ***
Total pot $0.16 | Rake $0.01 
Board [Th 6d 4d As 6h]
Seat 1: ppeetteerr175 mucked [3d Qd]
Seat 2: Azznak folded before Flop (didn't bet)
Seat 3: PABLOZAL10 folded before Flop (didn't bet)
Seat 4: kiling1 folded before Flop (didn't bet)
Seat 5: ezviktor folded before Flop (didn't bet)
Seat 6: Dorex2007 (button) folded before Flop (didn't bet)
Seat 7: 187Equalizer (small blind) showed [9d 9c] and won ($0.15) with two pair, Nines and Sixes
Seat 8: DEDpartizan (big blind) folded on the Flop
Seat 9: germar89 folded on the Flop



PokerStars Hand #224826486240:  Hold'em No Limit ($0.01/$0.02 USD) - 2021/03/14 23:15:59 PT [2021/03/15 2:15:59 ET]
Table 'Piccolo IV' 9-max Seat #7 is the button
Seat 1: ppeetteerr175 ($1.77 in chips) 
Seat 2: Azznak ($2.11 in chips) 
Seat 3: PABLOZAL10 ($2 in chips) 
Seat 4: kiling1 ($1.55 in chips) 
Seat 5: ezviktor ($1.48 in chips) 
Seat 6: Dorex2007 ($3.83 in chips) 
Seat 7: 187Equalizer ($1.01 in chips) 
Seat 8: DEDpartizan ($0.78 in chips) 
Seat 9: germar89 ($1.55 in chips) 
DEDpartizan: posts small blind $0.01
germar89: posts big blind $0.02
*** HOLE CARDS ***
Dealt to Dorex2007 [9d 5d]
ppeetteerr175: folds 
Azznak: folds 
PABLOZAL10: folds 
kiling1: folds 
ezviktor: folds 
Dorex2007: folds 
187Equalizer: folds 
DEDpartizan: raises $0.04 to $0.06
germar89: raises $0.04 to $0.10
DEDpartizan: folds 
Uncalled bet ($0.04) returned to germar89
germar89 collected $0.12 from pot
germar89: doesn't show hand 
*** SUMMARY ***
Total pot $0.12 | Rake $0 
Seat 1: ppeetteerr175 folded before Flop (didn't bet)
Seat 2: Azznak folded before Flop (didn't bet)
Seat 3: PABLOZAL10 folded before Flop (didn't bet)
Seat 4: kiling1 folded before Flop (didn't bet)
Seat 5: ezviktor folded before Flop (didn't bet)
Seat 6: Dorex2007 folded before Flop (didn't bet)
Seat 7: 187Equalizer (button) folded before Flop (didn't bet)
Seat 8: DEDpartizan (small blind) folded before Flop
Seat 9: germar89 (big blind) collected ($0.12)



PokerStars Hand #224826490901:  Hold'em No Limit ($0.01/$0.02 USD) - 2021/03/14 23:16:31 PT [2021/03/15 2:16:31 ET]
Table 'Piccolo IV' 9-max Seat #8 is the button
Seat 1: ppeetteerr175 ($1.77 in chips) 
Seat 2: Azznak ($2.11 in chips) 
Seat 3: PABLOZAL10 ($2 in chips) 
Seat 4: kiling1 ($1.55 in chips) 
Seat 5: ezviktor ($1.48 in chips) 
Seat 6: Dorex2007 ($3.83 in chips) 
Seat 7: 187Equalizer ($1.01 in chips) 
Seat 8: DEDpartizan ($0.72 in chips) 
Seat 9: germar89 ($1.61 in chips) 
germar89: posts small blind $0.01
ppeetteerr175: posts big blind $0.02
*** HOLE CARDS ***
Dealt to Dorex2007 [7h 6h]
Azznak: folds 
PABLOZAL10: folds 
kiling1: raises $0.04 to $0.06
ezviktor: calls $0.06
Dorex2007: folds 
187Equalizer: folds 
DEDpartizan: folds 
germar89: folds 
ppeetteerr175: raises $0.19 to $0.25
kiling1: calls $0.19
ezviktor: calls $0.19
*** FLOP *** [4c 7d Tc]
ppeetteerr175: checks 
kiling1: checks 
ezviktor: checks 
*** TURN *** [4c 7d Tc] [5s]
ppeetteerr175: checks 
kiling1: checks 
ezviktor: bets $0.23
ppeetteerr175: folds 
kiling1: folds 
Uncalled bet ($0.23) returned to ezviktor
ezviktor collected $0.73 from pot
ezviktor: doesn't show hand 
*** SUMMARY ***
Total pot $0.76 | Rake $0.03 
Board [4c 7d Tc 5s]
Seat 1: ppeetteerr175 (big blind) folded on the Turn
Seat 2: Azznak folded before Flop (didn't bet)
Seat 3: PABLOZAL10 folded before Flop (didn't bet)
Seat 4: kiling1 folded on the Turn
Seat 5: ezviktor collected ($0.73)
Seat 6: Dorex2007 folded before Flop (didn't bet)
Seat 7: 187Equalizer folded before Flop (didn't bet)
Seat 8: DEDpartizan (button) folded before Flop (didn't bet)
Seat 9: germar89 (small blind) folded before Flop



PokerStars Hand #224826514306:  Hold'em No Limit ($0.01/$0.02 USD) - 2021/03/14 23:18:23 PT [2021/03/15 2:18:23 ET]
Table 'Piccolo IV' 9-max Seat #9 is the button
Seat 1: ppeetteerr175 ($1.52 in chips) 
Seat 2: Azznak ($2.11 in chips) 
Seat 3: PABLOZAL10 ($2 in chips) 
Seat 4: kiling1 ($1.30 in chips) 
Seat 5: ezviktor ($1.96 in chips) 
Seat 6: Dorex2007 ($3.83 in chips) 
Seat 7: 187Equalizer ($1.01 in chips) 
Seat 8: DEDpartizan ($0.72 in chips) 
Seat 9: germar89 ($1.60 in chips) 
ppeetteerr175: posts small blind $0.01
Azznak: posts big blind $0.02
*** HOLE CARDS ***
Dealt to Dorex2007 [3c Jc]
PABLOZAL10: calls $0.02
kiling1: folds 
ezviktor: folds 
Dorex2007: folds 
187Equalizer: folds 
DEDpartizan: folds 
germar89: raises $0.07 to $0.09
ppeetteerr175: folds 
Azznak: folds 
PABLOZAL10: calls $0.07
*** FLOP *** [4d 2s 9h]
PABLOZAL10: checks 
germar89: bets $0.12
187Equalizer leaves the table
PABLOZAL10: folds 
Uncalled bet ($0.12) returned to germar89
germar89 collected $0.20 from pot
germar89: doesn't show hand 
*** SUMMARY ***
Total pot $0.21 | Rake $0.01 
Board [4d 2s 9h]
Seat 1: ppeetteerr175 (small blind) folded before Flop
Seat 2: Azznak (big blind) folded before Flop
Seat 3: PABLOZAL10 folded on the Flop
Seat 4: kiling1 folded before Flop (didn't bet)
Seat 5: ezviktor folded before Flop (didn't bet)
Seat 6: Dorex2007 folded before Flop (didn't bet)
Seat 7: 187Equalizer folded before Flop (didn't bet)
Seat 8: DEDpartizan folded before Flop (didn't bet)
Seat 9: germar89 (button) collected ($0.20)



PokerStars Hand #224826520415:  Hold'em No Limit ($0.01/$0.02 USD) - 2021/03/14 23:19:04 PT [2021/03/15 2:19:04 ET]
Table 'Piccolo IV' 9-max Seat #1 is the button
Seat 1: ppeetteerr175 ($1.51 in chips) 
Seat 2: Azznak ($2.09 in chips) 
Seat 3: PABLOZAL10 ($1.91 in chips) 
Seat 4: kiling1 ($1.30 in chips) 
Seat 5: ezviktor ($1.96 in chips) 
Seat 6: Dorex2007 ($3.83 in chips) 
Seat 8: DEDpartizan ($0.72 in chips) 
Seat 9: germar89 ($1.71 in chips) 
Azznak: posts small blind $0.01
PABLOZAL10: posts big blind $0.02
*** HOLE CARDS ***
Dealt to Dorex2007 [2h Ks]
kiling1: folds 
ezviktor: folds 
Dorex2007: folds 
DEDpartizan: folds 
germar89: folds 
ppeetteerr175: folds 
Azznak: folds 
Uncalled bet ($0.01) returned to PABLOZAL10
PABLOZAL10 collected $0.02 from pot
PABLOZAL10: doesn't show hand 
*** SUMMARY ***
Total pot $0.02 | Rake $0 
Seat 1: ppeetteerr175 (button) folded before Flop (didn't bet)
Seat 2: Azznak (small blind) folded before Flop
Seat 3: PABLOZAL10 (big blind) collected ($0.02)
Seat 4: kiling1 folded before Flop (didn't bet)
Seat 5: ezviktor folded before Flop (didn't bet)
Seat 6: Dorex2007 folded before Flop (didn't bet)
Seat 8: DEDpartizan folded before Flop (didn't bet)
Seat 9: germar89 folded before Flop (didn't bet)



PokerStars Hand #224826523341:  Hold'em No Limit ($0.01/$0.02 USD) - 2021/03/14 23:19:24 PT [2021/03/15 2:19:24 ET]
Table 'Piccolo IV' 9-max Seat #2 is the button
Seat 1: ppeetteerr175 ($1.51 in chips) 
Seat 2: Azznak ($2.08 in chips) 
Seat 3: PABLOZAL10 ($1.92 in chips) 
Seat 4: kiling1 ($1.30 in chips) 
Seat 5: ezviktor ($1.96 in chips) 
Seat 6: Dorex2007 ($3.83 in chips) 
Seat 8: DEDpartizan ($0.72 in chips) 
Seat 9: germar89 ($1.71 in chips) 
PABLOZAL10: posts small blind $0.01
kiling1: posts big blind $0.02
*** HOLE CARDS ***
Dealt to Dorex2007 [9d Td]
ezviktor: calls $0.02
Dorex2007: calls $0.02
DEDpartizan: calls $0.02
germar89: folds 
ppeetteerr175: raises $0.04 to $0.06
Azznak: folds 
PABLOZAL10: calls $0.05
MartKei joins the table at seat #7 
kiling1: folds 
ezviktor: calls $0.04
Dorex2007: calls $0.04
DEDpartizan: calls $0.04
*** FLOP *** [2h 4h 3h]
PABLOZAL10: checks 
ezviktor: checks 
Dorex2007: checks 
DEDpartizan: checks 
ppeetteerr175: checks 
*** TURN *** [2h 4h 3h] [2s]
PABLOZAL10: checks 
ezviktor: checks 
Dorex2007: checks 
DEDpartizan: checks 
ppeetteerr175: checks 
*** RIVER *** [2h 4h 3h 2s] [6c]
PABLOZAL10: checks 
ezviktor: bets $0.16
Dorex2007: folds 
DEDpartizan: folds 
ppeetteerr175: folds 
PABLOZAL10: folds 
Uncalled bet ($0.16) returned to ezviktor
ezviktor collected $0.31 from pot
ezviktor: doesn't show hand 
*** SUMMARY ***
Total pot $0.32 | Rake $0.01 
Board [2h 4h 3h 2s 6c]
Seat 1: ppeetteerr175 folded on the River
Seat 2: Azznak (button) folded before Flop (didn't bet)
Seat 3: PABLOZAL10 (small blind) folded on the River
Seat 4: kiling1 (big blind) folded before Flop
Seat 5: ezviktor collected ($0.31)
Seat 6: Dorex2007 folded on the River
Seat 8: DEDpartizan folded on the River
Seat 9: germar89 folded before Flop (didn't bet)



PokerStars Hand #224826537833:  Hold'em No Limit ($0.01/$0.02 USD) - 2021/03/14 23:21:02 PT [2021/03/15 2:21:02 ET]
Table 'Piccolo IV' 9-max Seat #3 is the button
Seat 1: ppeetteerr175 ($1.45 in chips) 
Seat 2: Azznak ($2.08 in chips) 
Seat 3: PABLOZAL10 ($1.86 in chips) 
Seat 4: kiling1 ($1.28 in chips) 
Seat 5: ezviktor ($2.21 in chips) 
Seat 6: Dorex2007 ($3.77 in chips) 
Seat 8: DEDpartizan ($0.66 in chips) 
Seat 9: germar89 ($1.71 in chips) 
kiling1: posts small blind $0.01
ezviktor: posts big blind $0.02
MartKei: sits out 
*** HOLE CARDS ***
Dealt to Dorex2007 [6s Kd]
Dorex2007: folds 
DEDpartizan: folds 
germar89: raises $0.02 to $0.04
ppeetteerr175: folds 
Azznak: folds 
PABLOZAL10: folds 
kiling1: folds 
ezviktor: calls $0.02
*** FLOP *** [3h 7h 4s]
ezviktor: checks 
germar89: checks 
*** TURN *** [3h 7h 4s] [8s]
ezviktor: checks 
germar89: checks 
*** RIVER *** [3h 7h 4s 8s] [Qs]
ezviktor: checks 
germar89: bets $0.09
ezviktor: folds 
Uncalled bet ($0.09) returned to germar89
germar89 collected $0.09 from pot
germar89: doesn't show hand 
*** SUMMARY ***
Total pot $0.09 | Rake $0 
Board [3h 7h 4s 8s Qs]
Seat 1: ppeetteerr175 folded before Flop (didn't bet)
Seat 2: Azznak folded before Flop (didn't bet)
Seat 3: PABLOZAL10 (button) folded before Flop (didn't bet)
Seat 4: kiling1 (small blind) folded before Flop
Seat 5: ezviktor (big blind) folded on the River
Seat 6: Dorex2007 folded before Flop (didn't bet)
Seat 8: DEDpartizan folded before Flop (didn't bet)
Seat 9: germar89 collected ($0.09)



PokerStars Hand #224826548077:  Hold'em No Limit ($0.01/$0.02 USD) - 2021/03/14 23:22:01 PT [2021/03/15 2:22:01 ET]
Table 'Piccolo IV' 9-max Seat #4 is the button
Seat 1: ppeetteerr175 ($1.45 in chips) 
Seat 2: Azznak ($2.08 in chips) 
Seat 3: PABLOZAL10 ($1.86 in chips) 
Seat 4: kiling1 ($1.27 in chips) 
Seat 5: ezviktor ($2.17 in chips) 
Seat 6: Dorex2007 ($3.77 in chips) 
Seat 8: DEDpartizan ($0.66 in chips) 
Seat 9: germar89 ($1.76 in chips) 
ezviktor: posts small blind $0.01
Dorex2007: posts big blind $0.02
MartKei: sits out 
*** HOLE CARDS ***
Dealt to Dorex2007 [Tc 6d]
DEDpartizan: folds 
germar89: folds 
ppeetteerr175: folds 
Azznak: calls $0.02
PABLOZAL10: calls $0.02
kiling1 has timed out
kiling1: folds 
ezviktor: folds 
Dorex2007: checks 
*** FLOP *** [Ah Jc As]
Dorex2007: checks 
Azznak: checks 
PABLOZAL10: checks 
*** TURN *** [Ah Jc As] [4s]
ezviktor leaves the table
Dorex2007: bets $0.07
Azznak: folds 
PABLOZAL10: folds 
Uncalled bet ($0.07) returned to Dorex2007
Dorex2007 collected $0.07 from pot
Dorex2007: doesn't show hand 
*** SUMMARY ***
Total pot $0.07 | Rake $0 
Board [Ah Jc As 4s]
Seat 1: ppeetteerr175 folded before Flop (didn't bet)
Seat 2: Azznak folded on the Turn
Seat 3: PABLOZAL10 folded on the Turn
Seat 4: kiling1 (button) folded before Flop (didn't bet)
Seat 5: ezviktor (small blind) folded before Flop
Seat 6: Dorex2007 (big blind) collected ($0.07)
Seat 8: DEDpartizan folded before Flop (didn't bet)
Seat 9: germar89 folded before Flop (didn't bet)



PokerStars Hand #224826558875:  Hold'em No Limit ($0.01/$0.02 USD) - 2021/03/14 23:23:13 PT [2021/03/15 2:23:13 ET]
Table 'Piccolo IV' 9-max Seat #6 is the button
Seat 1: ppeetteerr175 ($1.45 in chips) 
Seat 2: Azznak ($2.06 in chips) 
Seat 3: PABLOZAL10 ($1.84 in chips) 
Seat 4: kiling1 ($1.27 in chips) 
Seat 6: Dorex2007 ($3.82 in chips) 
Seat 8: DEDpartizan ($0.66 in chips) 
Seat 9: germar89 ($1.76 in chips) 
DEDpartizan: posts small blind $0.01
germar89: posts big blind $0.02
*** HOLE CARDS ***
Dealt to Dorex2007 [Td Jd]
ppeetteerr175: folds 
Azznak: folds 
PABLOZAL10: folds 
kiling1: raises $0.04 to $0.06
Dorex2007: calls $0.06
DEDpartizan: folds 
germar89: folds 
*** FLOP *** [Kd Qc 6d]
germar89 leaves the table
kiling1: checks 
Dorex2007: bets $0.14
kiling1: folds 
Uncalled bet ($0.14) returned to Dorex2007
Dorex2007 collected $0.14 from pot
Dorex2007: doesn't show hand 
*** SUMMARY ***
Total pot $0.15 | Rake $0.01 
Board [Kd Qc 6d]
Seat 1: ppeetteerr175 folded before Flop (didn't bet)
Seat 2: Azznak folded before Flop (didn't bet)
Seat 3: PABLOZAL10 folded before Flop (didn't bet)
Seat 4: kiling1 folded on the Flop
Seat 6: Dorex2007 (button) collected ($0.14)
Seat 8: DEDpartizan (small blind) folded before Flop
Seat 9: germar89 (big blind) folded before Flop



PokerStars Hand #224826566518:  Hold'em No Limit ($0.01/$0.02 USD) - 2021/03/14 23:24:05 PT [2021/03/15 2:24:05 ET]
Table 'Piccolo IV' 9-max Seat #8 is the button
Seat 1: ppeetteerr175 ($1.45 in chips) 
Seat 2: Azznak ($2.06 in chips) 
Seat 3: PABLOZAL10 ($1.84 in chips) 
Seat 4: kiling1 ($1.21 in chips) 
Seat 6: Dorex2007 ($3.90 in chips) 
Seat 8: DEDpartizan ($0.65 in chips) 
ppeetteerr175: posts small blind $0.01
Azznak: posts big blind $0.02
MartKei: sits out 
*** HOLE CARDS ***
Dealt to Dorex2007 [6s Ah]
PABLOZAL10: folds 
kiling1: folds 
Dorex2007: folds 
DEDpartizan: folds 
ppeetteerr175: calls $0.01
Rafael70018 joins the table at seat #9 
Azznak: checks 
*** FLOP *** [Jc Js Jh]
ppeetteerr175: checks 
Azznak: checks 
*** TURN *** [Jc Js Jh] [2s]
radod421 joins the table at seat #5 
ppeetteerr175: checks 
Azznak: checks 
*** RIVER *** [Jc Js Jh 2s] [5s]
ppeetteerr175: checks 
Azznak: checks 
*** SHOW DOWN ***
ppeetteerr175: shows [Kd Qc] (three of a kind, Jacks)
Azznak: mucks hand 
ppeetteerr175 collected $0.04 from pot
*** SUMMARY ***
Total pot $0.04 | Rake $0 
Board [Jc Js Jh 2s 5s]
Seat 1: ppeetteerr175 (small blind) showed [Kd Qc] and won ($0.04) with three of a kind, Jacks
Seat 2: Azznak (big blind) mucked [8s Th]
Seat 3: PABLOZAL10 folded before Flop (didn't bet)
Seat 4: kiling1 folded before Flop (didn't bet)
Seat 6: Dorex2007 folded before Flop (didn't bet)
Seat 8: DEDpartizan (button) folded before Flop (didn't bet)



PokerStars Hand #224826572322:  Hold'em No Limit ($0.01/$0.02 USD) - 2021/03/14 23:24:44 PT [2021/03/15 2:24:44 ET]
Table 'Piccolo IV' 9-max Seat #1 is the button
Seat 1: ppeetteerr175 ($1.47 in chips) 
Seat 2: Azznak ($2.04 in chips) 
Seat 3: PABLOZAL10 ($1.84 in chips) 
Seat 4: kiling1 ($1.21 in chips) 
Seat 5: radod421 ($1 in chips) 
Seat 6: Dorex2007 ($3.90 in chips) 
Seat 8: DEDpartizan ($0.65 in chips) 
Azznak: posts small blind $0.01
PABLOZAL10: posts big blind $0.02
radod421: posts big blind $0.02
MartKei: sits out 
Rafael70018: sits out 
*** HOLE CARDS ***
Dealt to Dorex2007 [3d Jc]
kiling1: folds 
radod421: checks 
Dorex2007: folds 
DEDpartizan: folds 
ppeetteerr175: folds 
Azznak: folds 
PABLOZAL10: checks 
*** FLOP *** [5h 4c 3h]
PABLOZAL10: checks 
radod421: checks 
*** TURN *** [5h 4c 3h] [7d]
PABLOZAL10: checks 
radod421: bets $0.02
PABLOZAL10: folds 
Uncalled bet ($0.02) returned to radod421
radod421 collected $0.05 from pot
*** SUMMARY ***
Total pot $0.05 | Rake $0 
Board [5h 4c 3h 7d]
Seat 1: ppeetteerr175 (button) folded before Flop (didn't bet)
Seat 2: Azznak (small blind) folded before Flop
Seat 3: PABLOZAL10 (big blind) folded on the Turn
Seat 4: kiling1 folded before Flop (didn't bet)
Seat 5: radod421 collected ($0.05)
Seat 6: Dorex2007 folded before Flop (didn't bet)
Seat 8: DEDpartizan folded before Flop (didn't bet)



PokerStars Hand #224826578223:  Hold'em No Limit ($0.01/$0.02 USD) - 2021/03/14 23:25:23 PT [2021/03/15 2:25:23 ET]
Table 'Piccolo IV' 9-max Seat #2 is the button
Seat 1: ppeetteerr175 ($1.47 in chips) 
Seat 2: Azznak ($2.03 in chips) 
Seat 3: PABLOZAL10 ($1.82 in chips) 
Seat 4: kiling1 ($1.21 in chips) 
Seat 5: radod421 ($1.03 in chips) 
Seat 6: Dorex2007 ($3.90 in chips) 
Seat 8: DEDpartizan ($0.65 in chips) 
PABLOZAL10: posts small blind $0.01
kiling1: posts big blind $0.02
MartKei: sits out 
Rafael70018: sits out 
*** HOLE CARDS ***
Dealt to Dorex2007 [7h Ts]
radod421: folds 
Dorex2007: folds 
DEDpartizan: calls $0.02
ppeetteerr175: folds 
Azznak: calls $0.02
PABLOZAL10: calls $0.01
kiling1: checks 
*** FLOP *** [7s Ah 2h]
PABLOZAL10: checks 
kiling1: checks 
DEDpartizan: checks 
Azznak: checks 
*** TURN *** [7s Ah 2h] [Jh]
PABLOZAL10: checks 
kiling1: checks 
DEDpartizan: checks 
Azznak: checks 
*** RIVER *** [7s Ah 2h Jh] [6c]
PABLOZAL10: checks 
kiling1: checks 
DEDpartizan: checks 
Azznak: checks 
*** SHOW DOWN ***
PABLOZAL10: shows [4h 9s] (high card Ace)
kiling1: shows [2d Qd] (a pair of Deuces)
DEDpartizan: shows [4c 4d] (a pair of Fours)
Azznak: mucks hand 
DEDpartizan collected $0.08 from pot
*** SUMMARY ***
Total pot $0.08 | Rake $0 
Board [7s Ah 2h Jh 6c]
Seat 1: ppeetteerr175 folded before Flop (didn't bet)
Seat 2: Azznak (button) mucked [Td Qh]
Seat 3: PABLOZAL10 (small blind) showed [4h 9s] and lost with high card Ace
Seat 4: kiling1 (big blind) showed [2d Qd] and lost with a pair of Deuces
Seat 5: radod421 folded before Flop (didn't bet)
Seat 6: Dorex2007 folded before Flop (didn't bet)
Seat 8: DEDpartizan showed [4c 4d] and won ($0.08) with a pair of Fours



PokerStars Hand #224826590164:  Hold'em No Limit ($0.01/$0.02 USD) - 2021/03/14 23:26:43 PT [2021/03/15 2:26:43 ET]
Table 'Piccolo IV' 9-max Seat #3 is the button
Seat 1: ppeetteerr175 ($1.47 in chips) 
Seat 2: Azznak ($2.01 in chips) 
Seat 3: PABLOZAL10 ($1.80 in chips) 
Seat 4: kiling1 ($1.19 in chips) 
Seat 5: radod421 ($1.03 in chips) 
Seat 6: Dorex2007 ($3.90 in chips) 
Seat 8: DEDpartizan ($0.71 in chips) 
kiling1: posts small blind $0.01
radod421: posts big blind $0.02
MartKei: sits out 
Rafael70018: sits out 
*** HOLE CARDS ***
Dealt to Dorex2007 [9d 7d]
Dorex2007: folds 
DEDpartizan: folds 
ppeetteerr175: raises $0.02 to $0.04
Azznak: folds 
PABLOZAL10: raises $0.06 to $0.10
kiling1: folds 
radod421: folds 
ppeetteerr175: calls $0.06
*** FLOP *** [2d 8c 5h]
ppeetteerr175: checks 
PABLOZAL10: checks 
*** TURN *** [2d 8c 5h] [9c]
ppeetteerr175: checks 
PABLOZAL10: bets $0.22
ppeetteerr175: folds 
Uncalled bet ($0.22) returned to PABLOZAL10
PABLOZAL10 collected $0.22 from pot
PABLOZAL10: doesn't show hand 
*** SUMMARY ***
Total pot $0.23 | Rake $0.01 
Board [2d 8c 5h 9c]
Seat 1: ppeetteerr175 folded on the Turn
Seat 2: Azznak folded before Flop (didn't bet)
Seat 3: PABLOZAL10 (button) collected ($0.22)
Seat 4: kiling1 (small blind) folded before Flop
Seat 5: radod421 (big blind) folded before Flop
Seat 6: Dorex2007 folded before Flop (didn't bet)
Seat 8: DEDpartizan folded before Flop (didn't bet)



PokerStars Hand #224826596748:  Hold'em No Limit ($0.01/$0.02 USD) - 2021/03/14 23:27:27 PT [2021/03/15 2:27:27 ET]
Table 'Piccolo IV' 9-max Seat #4 is the button
Seat 1: ppeetteerr175 ($1.37 in chips) 
Seat 2: Azznak ($2.01 in chips) 
Seat 3: PABLOZAL10 ($1.92 in chips) 
Seat 4: kiling1 ($1.18 in chips) 
Seat 5: radod421 ($1.01 in chips) 
Seat 6: Dorex2007 ($3.90 in chips) 
Seat 8: DEDpartizan ($0.71 in chips) 
radod421: posts small blind $0.01
Dorex2007: posts big blind $0.02
MartKei: sits out 
Rafael70018: sits out 
*** HOLE CARDS ***
Dealt to Dorex2007 [Td Kc]
DEDpartizan: folds 
ppeetteerr175: folds 
Azznak: folds 
PABLOZAL10: calls $0.02
kiling1 has timed out
kiling1: folds 
radod421: calls $0.01
Dorex2007: checks 
*** FLOP *** [9d Jc 5c]
radod421: checks 
Dorex2007: checks 
PABLOZAL10: bets $0.06
radod421: folds 
Dorex2007: calls $0.06
*** TURN *** [9d Jc 5c] [Kh]
Dorex2007: bets $0.11
PABLOZAL10: calls $0.11
*** RIVER *** [9d Jc 5c Kh] [Ad]
Dorex2007: bets $0.14
PABLOZAL10: folds 
Uncalled bet ($0.14) returned to Dorex2007
Dorex2007 collected $0.39 from pot
Dorex2007: doesn't show hand 
*** SUMMARY ***
Total pot $0.40 | Rake $0.01 
Board [9d Jc 5c Kh Ad]
Seat 1: ppeetteerr175 folded before Flop (didn't bet)
Seat 2: Azznak folded before Flop (didn't bet)
Seat 3: PABLOZAL10 folded on the River
Seat 4: kiling1 (button) folded before Flop (didn't bet)
Seat 5: radod421 (small blind) folded on the Flop
Seat 6: Dorex2007 (big blind) collected ($0.39)
Seat 8: DEDpartizan folded before Flop (didn't bet)



PokerStars Hand #224826605514:  Hold'em No Limit ($0.01/$0.02 USD) - 2021/03/14 23:28:26 PT [2021/03/15 2:28:26 ET]
Table 'Piccolo IV' 9-max Seat #5 is the button
Seat 1: ppeetteerr175 ($1.37 in chips) 
Seat 2: Azznak ($2.01 in chips) 
Seat 3: PABLOZAL10 ($1.73 in chips) 
Seat 5: radod421 ($0.99 in chips) 
Seat 6: Dorex2007 ($4.10 in chips) 
Seat 7: MartKei ($0.80 in chips) 
Seat 8: DEDpartizan ($0.71 in chips) 
Seat 9: Rafael70018 ($0.86 in chips) 
Dorex2007: posts small blind $0.01
MartKei: posts big blind $0.02
Rafael70018: posts big blind $0.02
*** HOLE CARDS ***
Dealt to Dorex2007 [8d 7h]
DEDpartizan: folds 
Rafael70018: checks 
ppeetteerr175: folds 
Azznak: folds 
PABLOZAL10: folds 
radod421: folds 
Dorex2007: calls $0.01
MartKei: raises $0.08 to $0.10
Rafael70018: folds 
Dorex2007: folds 
Uncalled bet ($0.08) returned to MartKei
MartKei collected $0.06 from pot
MartKei: doesn't show hand 
*** SUMMARY ***
Total pot $0.06 | Rake $0 
Seat 1: ppeetteerr175 folded before Flop (didn't bet)
Seat 2: Azznak folded before Flop (didn't bet)
Seat 3: PABLOZAL10 folded before Flop (didn't bet)
Seat 5: radod421 (button) folded before Flop (didn't bet)
Seat 6: Dorex2007 (small blind) folded before Flop
Seat 7: MartKei (big blind) collected ($0.06)
Seat 8: DEDpartizan folded before Flop (didn't bet)
Seat 9: Rafael70018 folded before Flop (didn't bet)



PokerStars Hand #224826610994:  Hold'em No Limit ($0.01/$0.02 USD) - 2021/03/14 23:29:03 PT [2021/03/15 2:29:03 ET]
Table 'Piccolo IV' 9-max Seat #6 is the button
Seat 1: ppeetteerr175 ($1.37 in chips) 
Seat 2: Azznak ($2.01 in chips) 
Seat 3: PABLOZAL10 ($1.73 in chips) 
Seat 4: kiling1 ($1.18 in chips) 
Seat 5: radod421 ($0.99 in chips) 
Seat 6: Dorex2007 ($4.08 in chips) 
Seat 7: MartKei ($0.84 in chips) 
Seat 8: DEDpartizan ($0.71 in chips) 
Seat 9: Rafael70018 ($0.84 in chips) 
MartKei: posts small blind $0.01
DEDpartizan: posts big blind $0.02
*** HOLE CARDS ***
Dealt to Dorex2007 [Td Ks]
Rafael70018: folds 
ppeetteerr175: raises $0.04 to $0.06
Azznak: folds 
PABLOZAL10: folds 
kiling1: folds 
radod421: folds 
Dorex2007: calls $0.06
MartKei: folds 
DEDpartizan: folds 
*** FLOP *** [2c 7s 6d]
ppeetteerr175: bets $0.07
Dorex2007: folds 
Uncalled bet ($0.07) returned to ppeetteerr175
ppeetteerr175 collected $0.14 from pot
ppeetteerr175: doesn't show hand 
*** SUMMARY ***
Total pot $0.15 | Rake $0.01 
Board [2c 7s 6d]
Seat 1: ppeetteerr175 collected ($0.14)
Seat 2: Azznak folded before Flop (didn't bet)
Seat 3: PABLOZAL10 folded before Flop (didn't bet)
Seat 4: kiling1 folded before Flop (didn't bet)
Seat 5: radod421 folded before Flop (didn't bet)
Seat 6: Dorex2007 (button) folded on the Flop
Seat 7: MartKei (small blind) folded before Flop
Seat 8: DEDpartizan (big blind) folded before Flop
Seat 9: Rafael70018 folded before Flop (didn't bet)



PokerStars Hand #224826616174:  Hold'em No Limit ($0.01/$0.02 USD) - 2021/03/14 23:29:38 PT [2021/03/15 2:29:38 ET]
Table 'Piccolo IV' 9-max Seat #7 is the button
Seat 1: ppeetteerr175 ($1.45 in chips) 
Seat 2: Azznak ($2.01 in chips) 
Seat 3: PABLOZAL10 ($1.73 in chips) 
Seat 4: kiling1 ($1.18 in chips) 
Seat 5: radod421 ($0.99 in chips) 
Seat 6: Dorex2007 ($4.02 in chips) 
Seat 7: MartKei ($0.83 in chips) 
Seat 8: DEDpartizan ($0.69 in chips) 
Seat 9: Rafael70018 ($0.84 in chips) 
DEDpartizan: posts small blind $0.01
Rafael70018: posts big blind $0.02
*** HOLE CARDS ***
Dealt to Dorex2007 [7h 2h]
ppeetteerr175: folds 
Azznak: folds 
PABLOZAL10: folds 
kiling1: folds 
radod421: calls $0.02
Dorex2007: folds 
MartKei: folds 
DEDpartizan: folds 
Rafael70018: checks 
*** FLOP *** [4c Qd 5s]
Rafael70018: checks 
radod421: bets $0.02
Rafael70018: calls $0.02
*** TURN *** [4c Qd 5s] [3c]
Rafael70018: checks 
radod421: bets $0.02
Rafael70018: calls $0.02
*** RIVER *** [4c Qd 5s 3c] [Qs]
Rafael70018: bets $0.78 and is all-in
radod421: folds 
Uncalled bet ($0.78) returned to Rafael70018
Rafael70018 collected $0.13 from pot
Rafael70018: doesn't show hand 
*** SUMMARY ***
Total pot $0.13 | Rake $0 
Board [4c Qd 5s 3c Qs]
Seat 1: ppeetteerr175 folded before Flop (didn't bet)
Seat 2: Azznak folded before Flop (didn't bet)
Seat 3: PABLOZAL10 folded before Flop (didn't bet)
Seat 4: kiling1 folded before Flop (didn't bet)
Seat 5: radod421 folded on the River
Seat 6: Dorex2007 folded before Flop (didn't bet)
Seat 7: MartKei (button) folded before Flop (didn't bet)
Seat 8: DEDpartizan (small blind) folded before Flop
Seat 9: Rafael70018 (big blind) collected ($0.13)



PokerStars Hand #224826623324:  Hold'em No Limit ($0.01/$0.02 USD) - 2021/03/14 23:30:25 PT [2021/03/15 2:30:25 ET]
Table 'Piccolo IV' 9-max Seat #8 is the button
Seat 1: ppeetteerr175 ($1.45 in chips) 
Seat 2: Azznak ($2.01 in chips) 
Seat 3: PABLOZAL10 ($1.73 in chips) 
Seat 4: kiling1 ($1.18 in chips) 
Seat 5: radod421 ($0.93 in chips) 
Seat 6: Dorex2007 ($4.02 in chips) 
Seat 7: MartKei ($0.83 in chips) 
Seat 8: DEDpartizan ($0.68 in chips) 
Seat 9: Rafael70018 ($0.91 in chips) 
Rafael70018: posts small blind $0.01
ppeetteerr175: posts big blind $0.02
*** HOLE CARDS ***
Dealt to Dorex2007 [2h Qc]
Azznak: folds 
PABLOZAL10: folds 
kiling1: folds 
radod421: calls $0.02
Dorex2007: folds 
MartKei: folds 
DEDpartizan: folds 
Rafael70018: calls $0.01
ppeetteerr175: checks 
*** FLOP *** [Kd 7d 4s]
Rafael70018: checks 
ppeetteerr175: checks 
radod421: bets $0.02
Rafael70018: folds 
ppeetteerr175: calls $0.02
*** TURN *** [Kd 7d 4s] [9d]
ppeetteerr175: checks 
radod421: bets $0.02
ppeetteerr175: folds 
Uncalled bet ($0.02) returned to radod421
radod421 collected $0.10 from pot
*** SUMMARY ***
Total pot $0.10 | Rake $0 
Board [Kd 7d 4s 9d]
Seat 1: ppeetteerr175 (big blind) folded on the Turn
Seat 2: Azznak folded before Flop (didn't bet)
Seat 3: PABLOZAL10 folded before Flop (didn't bet)
Seat 4: kiling1 folded before Flop (didn't bet)
Seat 5: radod421 collected ($0.10)
Seat 6: Dorex2007 folded before Flop (didn't bet)
Seat 7: MartKei folded before Flop (didn't bet)
Seat 8: DEDpartizan (button) folded before Flop (didn't bet)
Seat 9: Rafael70018 (small blind) folded on the Flop



PokerStars Hand #224826630384:  Hold'em No Limit ($0.01/$0.02 USD) - 2021/03/14 23:31:13 PT [2021/03/15 2:31:13 ET]
Table 'Piccolo IV' 9-max Seat #9 is the button
Seat 1: ppeetteerr175 ($1.41 in chips) 
Seat 2: Azznak ($2.01 in chips) 
Seat 3: PABLOZAL10 ($1.73 in chips) 
Seat 4: kiling1 ($1.18 in chips) 
Seat 5: radod421 ($0.99 in chips) 
Seat 6: Dorex2007 ($4.02 in chips) 
Seat 7: MartKei ($0.83 in chips) 
Seat 8: DEDpartizan ($0.68 in chips) 
Seat 9: Rafael70018 ($0.89 in chips) 
ppeetteerr175: posts small blind $0.01
Azznak: posts big blind $0.02
*** HOLE CARDS ***
Dealt to Dorex2007 [4s 7h]
PABLOZAL10: folds 
kiling1 has timed out
kiling1: folds 
radod421: calls $0.02
Dorex2007: folds 
MartKei: folds 
DEDpartizan: folds 
Rafael70018: raises $0.06 to $0.08
ppeetteerr175: calls $0.07
Azznak: folds 
radod421: folds 
*** FLOP *** [Th 3d Ks]
ppeetteerr175: bets $0.19
Rafael70018: calls $0.19
*** TURN *** [Th 3d Ks] [Ts]
ppeetteerr175: bets $0.32
Rafael70018: calls $0.32
*** RIVER *** [Th 3d Ks Ts] [Kh]
Azznak leaves the table
ppeetteerr175: bets $0.20
Rafael70018: raises $0.10 to $0.30 and is all-in
ppeetteerr175: calls $0.10
*** SHOW DOWN ***
Rafael70018: shows [Jc Jd] (two pair, Kings and Jacks)
ppeetteerr175: shows [Kd Ah] (a full house, Kings full of Tens)
ppeetteerr175 collected $1.76 from pot
*** SUMMARY ***
Total pot $1.82 | Rake $0.06 
Board [Th 3d Ks Ts Kh]
Seat 1: ppeetteerr175 (small blind) showed [Kd Ah] and won ($1.76) with a full house, Kings full of Tens
Seat 2: Azznak (big blind) folded before Flop
Seat 3: PABLOZAL10 folded before Flop (didn't bet)
Seat 4: kiling1 folded before Flop (didn't bet)
Seat 5: radod421 folded before Flop
Seat 6: Dorex2007 folded before Flop (didn't bet)
Seat 7: MartKei folded before Flop (didn't bet)
Seat 8: DEDpartizan folded before Flop (didn't bet)
Seat 9: Rafael70018 (button) showed [Jc Jd] and lost with two pair, Kings and Jacks



PokerStars Hand #224826642597:  Hold'em No Limit ($0.01/$0.02 USD) - 2021/03/14 23:32:34 PT [2021/03/15 2:32:34 ET]
Table 'Piccolo IV' 9-max Seat #1 is the button
Seat 1: ppeetteerr175 ($2.28 in chips) 
Seat 3: PABLOZAL10 ($1.73 in chips) 
Seat 5: radod421 ($0.97 in chips) 
Seat 6: Dorex2007 ($4.02 in chips) 
Seat 7: MartKei ($0.83 in chips) 
Seat 8: DEDpartizan ($0.68 in chips) 
PABLOZAL10: posts small blind $0.01
radod421: posts big blind $0.02
*** HOLE CARDS ***
Dealt to Dorex2007 [3d 6c]
Dorex2007: folds 
MartKei: folds 
DEDpartizan: folds 
ppeetteerr175: raises $0.02 to $0.04
PABLOZAL10: folds 
radod421: folds 
Uncalled bet ($0.02) returned to ppeetteerr175
ppeetteerr175 collected $0.05 from pot
ppeetteerr175: doesn't show hand 
*** SUMMARY ***
Total pot $0.05 | Rake $0 
Seat 1: ppeetteerr175 (button) collected ($0.05)
Seat 3: PABLOZAL10 (small blind) folded before Flop
Seat 5: radod421 (big blind) folded before Flop
Seat 6: Dorex2007 folded before Flop (didn't bet)
Seat 7: MartKei folded before Flop (didn't bet)
Seat 8: DEDpartizan folded before Flop (didn't bet)



PokerStars Hand #224826645754:  Hold'em No Limit ($0.01/$0.02 USD) - 2021/03/14 23:32:55 PT [2021/03/15 2:32:55 ET]
Table 'Piccolo IV' 9-max Seat #3 is the button
Seat 1: ppeetteerr175 ($2.31 in chips) 
Seat 3: PABLOZAL10 ($1.72 in chips) 
Seat 5: radod421 ($0.95 in chips) 
Seat 6: Dorex2007 ($4.02 in chips) 
Seat 7: MartKei ($0.83 in chips) 
Seat 8: DEDpartizan ($0.68 in chips) 
Seat 9: Rafael70018 ($0.98 in chips) 
radod421: posts small blind $0.01
Dorex2007: posts big blind $0.02
*** HOLE CARDS ***
Dealt to Dorex2007 [5c Ac]
MartKei: folds 
DEDpartizan: calls $0.02
Rafael70018: folds 
ppeetteerr175: folds 
PABLOZAL10: calls $0.02
radod421: folds 
Dorex2007: checks 
*** FLOP *** [6c 4s Kh]
Dorex2007: checks 
DEDpartizan: checks 
PABLOZAL10: checks 
*** TURN *** [6c 4s Kh] [5d]
Dorex2007: bets $0.07
DEDpartizan: folds 
PABLOZAL10: calls $0.07
*** RIVER *** [6c 4s Kh 5d] [9s]
Dorex2007: checks 
PABLOZAL10: checks 
*** SHOW DOWN ***
Dorex2007: shows [5c Ac] (a pair of Fives)
PABLOZAL10: mucks hand 
Dorex2007 collected $0.20 from pot
*** SUMMARY ***
Total pot $0.21 | Rake $0.01 
Board [6c 4s Kh 5d 9s]
Seat 1: ppeetteerr175 folded before Flop (didn't bet)
Seat 3: PABLOZAL10 (button) mucked [Jc 5s]
Seat 5: radod421 (small blind) folded before Flop
Seat 6: Dorex2007 (big blind) showed [5c Ac] and won ($0.20) with a pair of Fives
Seat 7: MartKei folded before Flop (didn't bet)
Seat 8: DEDpartizan folded on the Turn
Seat 9: Rafael70018 folded before Flop (didn't bet)



PokerStars Hand #224826651531:  Hold'em No Limit ($0.01/$0.02 USD) - 2021/03/14 23:33:33 PT [2021/03/15 2:33:33 ET]
Table 'Piccolo IV' 9-max Seat #5 is the button
Seat 1: ppeetteerr175 ($2.31 in chips) 
Seat 3: PABLOZAL10 ($1.63 in chips) 
Seat 5: radod421 ($0.94 in chips) 
Seat 6: Dorex2007 ($4.13 in chips) 
Seat 7: MartKei ($0.83 in chips) 
Seat 8: DEDpartizan ($0.66 in chips) 
Seat 9: Rafael70018 ($0.98 in chips) 
Dorex2007: posts small blind $0.01
MartKei: posts big blind $0.02
*** HOLE CARDS ***
Dealt to Dorex2007 [9d 5h]
DEDpartizan: raises $0.04 to $0.06
Rafael70018: calls $0.06
ppeetteerr175: folds 
PABLOZAL10: folds 
radod421: folds 
Dorex2007: folds 
MartKei: folds 
*** FLOP *** [Kc 2s 2d]
DEDpartizan: bets $0.07
Rafael70018: folds 
Uncalled bet ($0.07) returned to DEDpartizan
DEDpartizan collected $0.14 from pot
pi4oporec joins the table at seat #2 
*** SUMMARY ***
Total pot $0.15 | Rake $0.01 
Board [Kc 2s 2d]
Seat 1: ppeetteerr175 folded before Flop (didn't bet)
Seat 3: PABLOZAL10 folded before Flop (didn't bet)
Seat 5: radod421 (button) folded before Flop (didn't bet)
Seat 6: Dorex2007 (small blind) folded before Flop
Seat 7: MartKei (big blind) folded before Flop
Seat 8: DEDpartizan collected ($0.14)
Seat 9: Rafael70018 folded on the Flop



PokerStars Hand #224826657043:  Hold'em No Limit ($0.01/$0.02 USD) - 2021/03/14 23:34:10 PT [2021/03/15 2:34:10 ET]
Table 'Piccolo IV' 9-max Seat #6 is the button
Seat 1: ppeetteerr175 ($2.31 in chips) 
Seat 3: PABLOZAL10 ($1.63 in chips) 
Seat 5: radod421 ($0.94 in chips) 
Seat 6: Dorex2007 ($4.12 in chips) 
Seat 7: MartKei ($0.81 in chips) 
Seat 8: DEDpartizan ($0.74 in chips) 
Seat 9: Rafael70018 ($0.92 in chips) 
MartKei: posts small blind $0.01
DEDpartizan: posts big blind $0.02
pi4oporec: sits out 
*** HOLE CARDS ***
Dealt to Dorex2007 [7c Kc]
Rafael70018: folds 
ppeetteerr175: folds 
PABLOZAL10: folds 
radod421: folds 
Dorex2007: raises $0.04 to $0.06
MartKei: folds 
DEDpartizan: folds 
Uncalled bet ($0.04) returned to Dorex2007
Dorex2007 collected $0.05 from pot
Dorex2007: doesn't show hand 
*** SUMMARY ***
Total pot $0.05 | Rake $0 
Seat 1: ppeetteerr175 folded before Flop (didn't bet)
Seat 3: PABLOZAL10 folded before Flop (didn't bet)
Seat 5: radod421 folded before Flop (didn't bet)
Seat 6: Dorex2007 (button) collected ($0.05)
Seat 7: MartKei (small blind) folded before Flop
Seat 8: DEDpartizan (big blind) folded before Flop
Seat 9: Rafael70018 folded before Flop (didn't bet)



PokerStars Hand #224826660065:  Hold'em No Limit ($0.01/$0.02 USD) - 2021/03/14 23:34:30 PT [2021/03/15 2:34:30 ET]
Table 'Piccolo IV' 9-max Seat #7 is the button
Seat 1: ppeetteerr175 ($2.31 in chips) 
Seat 2: pi4oporec ($0.82 in chips) 
Seat 3: PABLOZAL10 ($1.63 in chips) 
Seat 5: radod421 ($0.94 in chips) 
Seat 6: Dorex2007 ($4.15 in chips) 
Seat 7: MartKei ($0.80 in chips) 
Seat 8: DEDpartizan ($0.72 in chips) 
Seat 9: Rafael70018 ($0.92 in chips) 
DEDpartizan: posts small blind $0.01
Rafael70018: posts big blind $0.02
pi4oporec: posts big blind $0.02
*** HOLE CARDS ***
Dealt to Dorex2007 [Kh 2d]
ppeetteerr175: calls $0.02
pi4oporec has timed out
pi4oporec: checks 
PABLOZAL10: raises $0.16 to $0.18
radod421: folds 
Dorex2007: folds 
MartKei: folds 
DEDpartizan: folds 
Rafael70018: folds 
ppeetteerr175: folds 
pi4oporec has timed out
pi4oporec: folds 
Uncalled bet ($0.16) returned to PABLOZAL10
PABLOZAL10 collected $0.09 from pot
PABLOZAL10: doesn't show hand 
*** SUMMARY ***
Total pot $0.09 | Rake $0 
Seat 1: ppeetteerr175 folded before Flop
Seat 2: pi4oporec folded before Flop (didn't bet)
Seat 3: PABLOZAL10 collected ($0.09)
Seat 5: radod421 folded before Flop (didn't bet)
Seat 6: Dorex2007 folded before Flop (didn't bet)
Seat 7: MartKei (button) folded before Flop (didn't bet)
Seat 8: DEDpartizan (small blind) folded before Flop
Seat 9: Rafael70018 (big blind) folded before Flop



PokerStars Hand #224826670199:  Hold'em No Limit ($0.01/$0.02 USD) - 2021/03/14 23:35:37 PT [2021/03/15 2:35:37 ET]
Table 'Piccolo IV' 9-max Seat #8 is the button
Seat 1: ppeetteerr175 ($2.29 in chips) 
Seat 2: pi4oporec ($0.80 in chips) 
Seat 3: PABLOZAL10 ($1.70 in chips) 
Seat 5: radod421 ($0.94 in chips) 
Seat 6: Dorex2007 ($4.15 in chips) 
Seat 7: MartKei ($0.80 in chips) 
Seat 8: DEDpartizan ($0.71 in chips) 
Seat 9: Rafael70018 ($0.90 in chips) 
Rafael70018: posts small blind $0.01
ppeetteerr175: posts big blind $0.02
*** HOLE CARDS ***
Dealt to Dorex2007 [Ac 6c]
pi4oporec has timed out
pi4oporec: folds 
PABLOZAL10: folds 
radod421: calls $0.02
Dorex2007: calls $0.02
MartKei: folds 
DEDpartizan: folds 
Rafael70018: calls $0.01
ppeetteerr175: checks 
*** FLOP *** [6h 3c 2s]
Rafael70018: checks 
ppeetteerr175: checks 
radod421: checks 
Dorex2007: bets $0.08
Rafael70018: folds 
ppeetteerr175: folds 
radod421: folds 
Uncalled bet ($0.08) returned to Dorex2007
Dorex2007 collected $0.08 from pot
Dorex2007: doesn't show hand 
*** SUMMARY ***
Total pot $0.08 | Rake $0 
Board [6h 3c 2s]
Seat 1: ppeetteerr175 (big blind) folded on the Flop
Seat 2: pi4oporec folded before Flop (didn't bet)
Seat 3: PABLOZAL10 folded before Flop (didn't bet)
Seat 5: radod421 folded on the Flop
Seat 6: Dorex2007 collected ($0.08)
Seat 7: MartKei folded before Flop (didn't bet)
Seat 8: DEDpartizan (button) folded before Flop (didn't bet)
Seat 9: Rafael70018 (small blind) folded on the Flop



PokerStars Hand #224826680438:  Hold'em No Limit ($0.01/$0.02 USD) - 2021/03/14 23:36:23 PT [2021/03/15 2:36:23 ET]
Table 'Piccolo IV' 9-max Seat #9 is the button
Seat 1: ppeetteerr175 ($2.27 in chips) 
Seat 3: PABLOZAL10 ($1.70 in chips) 
Seat 5: radod421 ($0.92 in chips) 
Seat 6: Dorex2007 ($4.21 in chips) 
Seat 7: MartKei ($0.80 in chips) 
Seat 8: DEDpartizan ($0.71 in chips) 
Seat 9: Rafael70018 ($0.88 in chips) 
ppeetteerr175: posts small blind $0.01
PABLOZAL10: posts big blind $0.02
*** HOLE CARDS ***
Dealt to Dorex2007 [Qs Jd]
radod421: folds 
Dorex2007: folds 
MartKei: raises $0.03 to $0.05
DEDpartizan: folds 
Rafael70018: folds 
ppeetteerr175: folds 
PABLOZAL10: calls $0.03
*** FLOP *** [Ad 6d 2c]
PABLOZAL10: checks 
MartKei: bets $0.04
PABLOZAL10: folds 
Uncalled bet ($0.04) returned to MartKei
MartKei collected $0.11 from pot
MartKei: doesn't show hand 
*** SUMMARY ***
Total pot $0.11 | Rake $0 
Board [Ad 6d 2c]
Seat 1: ppeetteerr175 (small blind) folded before Flop
Seat 3: PABLOZAL10 (big blind) folded on the Flop
Seat 5: radod421 folded before Flop (didn't bet)
Seat 6: Dorex2007 folded before Flop (didn't bet)
Seat 7: MartKei collected ($0.11)
Seat 8: DEDpartizan folded before Flop (didn't bet)
Seat 9: Rafael70018 (button) folded before Flop (didn't bet)



PokerStars Hand #224826684093:  Hold'em No Limit ($0.01/$0.02 USD) - 2021/03/14 23:36:47 PT [2021/03/15 2:36:47 ET]
Table 'Piccolo IV' 9-max Seat #1 is the button
Seat 1: ppeetteerr175 ($2.26 in chips) 
Seat 3: PABLOZAL10 ($1.65 in chips) 
Seat 5: radod421 ($0.92 in chips) 
Seat 6: Dorex2007 ($4.21 in chips) 
Seat 7: MartKei ($0.86 in chips) 
Seat 8: DEDpartizan ($0.71 in chips) 
Seat 9: Rafael70018 ($0.88 in chips) 
PABLOZAL10: posts small blind $0.01
radod421: posts big blind $0.02
*** HOLE CARDS ***
Dealt to Dorex2007 [5s 2d]
Dorex2007: folds 
MartKei: folds 
DEDpartizan: calls $0.02
Rafael70018: folds 
ppeetteerr175: calls $0.02
PABLOZAL10: folds 
radod421: checks 
*** FLOP *** [8d Kh As]
radod421: checks 
DEDpartizan: checks 
ppeetteerr175: bets $0.04
radod421: folds 
DEDpartizan: calls $0.04
*** TURN *** [8d Kh As] [6h]
DEDpartizan: checks 
ppeetteerr175: checks 
*** RIVER *** [8d Kh As 6h] [Th]
DEDpartizan: checks 
ppeetteerr175: checks 
*** SHOW DOWN ***
DEDpartizan: shows [Qs 8s] (a pair of Eights)
ppeetteerr175: shows [Jc Kd] (a pair of Kings)
ppeetteerr175 collected $0.14 from pot
*** SUMMARY ***
Total pot $0.15 | Rake $0.01 
Board [8d Kh As 6h Th]
Seat 1: ppeetteerr175 (button) showed [Jc Kd] and won ($0.14) with a pair of Kings
Seat 3: PABLOZAL10 (small blind) folded before Flop
Seat 5: radod421 (big blind) folded on the Flop
Seat 6: Dorex2007 folded before Flop (didn't bet)
Seat 7: MartKei folded before Flop (didn't bet)
Seat 8: DEDpartizan showed [Qs 8s] and lost with a pair of Eights
Seat 9: Rafael70018 folded before Flop (didn't bet)



PokerStars Hand #224826691351:  Hold'em No Limit ($0.01/$0.02 USD) - 2021/03/14 23:37:35 PT [2021/03/15 2:37:35 ET]
Table 'Piccolo IV' 9-max Seat #3 is the button
Seat 1: ppeetteerr175 ($2.34 in chips) 
Seat 3: PABLOZAL10 ($1.64 in chips) 
Seat 5: radod421 ($0.90 in chips) 
Seat 6: Dorex2007 ($4.21 in chips) 
Seat 7: MartKei ($0.86 in chips) 
Seat 8: DEDpartizan ($0.65 in chips) 
Seat 9: Rafael70018 ($0.88 in chips) 
radod421: posts small blind $0.01
Dorex2007: posts big blind $0.02
pi4oporec: sits out 
*** HOLE CARDS ***
Dealt to Dorex2007 [Qd Ad]
MartKei: folds 
DEDpartizan: folds 
Rafael70018: folds 
ppeetteerr175: folds 
PABLOZAL10: folds 
radod421: folds 
Uncalled bet ($0.01) returned to Dorex2007
Dorex2007 collected $0.02 from pot
Dorex2007: doesn't show hand 
*** SUMMARY ***
Total pot $0.02 | Rake $0 
Seat 1: ppeetteerr175 folded before Flop (didn't bet)
Seat 3: PABLOZAL10 (button) folded before Flop (didn't bet)
Seat 5: radod421 (small blind) folded before Flop
Seat 6: Dorex2007 (big blind) collected ($0.02)
Seat 7: MartKei folded before Flop (didn't bet)
Seat 8: DEDpartizan folded before Flop (didn't bet)
Seat 9: Rafael70018 folded before Flop (didn't bet)



PokerStars Hand #224826693167:  Hold'em No Limit ($0.01/$0.02 USD) - 2021/03/14 23:37:47 PT [2021/03/15 2:37:47 ET]
Table 'Piccolo IV' 9-max Seat #5 is the button
Seat 1: ppeetteerr175 ($2.34 in chips) 
Seat 3: PABLOZAL10 ($1.64 in chips) 
Seat 5: radod421 ($0.89 in chips) 
Seat 6: Dorex2007 ($4.22 in chips) 
Seat 8: DEDpartizan ($0.65 in chips) 
Seat 9: Rafael70018 ($0.88 in chips) 
Dorex2007: posts small blind $0.01
MartKei: is sitting out 
DEDpartizan: posts big blind $0.02
pi4oporec: sits out 
kiling1: sits out 
*** HOLE CARDS ***
Dealt to Dorex2007 [9s 4h]
Rafael70018: folds 
ppeetteerr175: folds 
MartKei leaves the table
PABLOZAL10: calls $0.02
radod421: calls $0.02
Dorex2007: folds 
DEDpartizan: checks 
*** FLOP *** [Qd 5h Kc]
koupin joins the table at seat #7 
DEDpartizan has timed out
DEDpartizan: checks 
PABLOZAL10: checks 
radod421: checks 
*** TURN *** [Qd 5h Kc] [4s]
DEDpartizan: bets $0.02
PABLOZAL10: folds 
radod421: folds 
Uncalled bet ($0.02) returned to DEDpartizan
DEDpartizan collected $0.07 from pot
*** SUMMARY ***
Total pot $0.07 | Rake $0 
Board [Qd 5h Kc 4s]
Seat 1: ppeetteerr175 folded before Flop (didn't bet)
Seat 3: PABLOZAL10 folded on the Turn
Seat 5: radod421 (button) folded on the Turn
Seat 6: Dorex2007 (small blind) folded before Flop
Seat 8: DEDpartizan (big blind) collected ($0.07)
Seat 9: Rafael70018 folded before Flop (didn't bet)



PokerStars Hand #224826703912:  Hold'em No Limit ($0.01/$0.02 USD) - 2021/03/14 23:38:57 PT [2021/03/15 2:38:57 ET]
Table 'Piccolo IV' 9-max Seat #6 is the button
Seat 1: ppeetteerr175 ($2.34 in chips) 
Seat 2: pi4oporec ($0.80 in chips) 
Seat 3: PABLOZAL10 ($1.62 in chips) 
Seat 5: radod421 ($0.87 in chips) 
Seat 6: Dorex2007 ($4.21 in chips) 
Seat 8: DEDpartizan ($0.70 in chips) 
Seat 9: Rafael70018 ($0.88 in chips) 
DEDpartizan: posts small blind $0.01
Rafael70018: posts big blind $0.02
pi4oporec: posts small & big blinds $0.03
kiling1: sits out 
*** HOLE CARDS ***
Dealt to Dorex2007 [Kc Ac]
ppeetteerr175: folds 
pi4oporec: checks 
PABLOZAL10: folds 
radod421: folds 
Dorex2007: raises $0.06 to $0.08
DEDpartizan: calls $0.07
Rafael70018: calls $0.06
pi4oporec: folds 
*** FLOP *** [7s 8s Kd]
DEDpartizan: checks 
Rafael70018: checks 
Dorex2007: bets $0.26
DEDpartizan: folds 
Rafael70018: folds 
Uncalled bet ($0.26) returned to Dorex2007
Dorex2007 collected $0.26 from pot
Dorex2007: doesn't show hand 
*** SUMMARY ***
Total pot $0.27 | Rake $0.01 
Board [7s 8s Kd]
Seat 1: ppeetteerr175 folded before Flop (didn't bet)
Seat 2: pi4oporec folded before Flop (didn't bet)
Seat 3: PABLOZAL10 folded before Flop (didn't bet)
Seat 5: radod421 folded before Flop (didn't bet)
Seat 6: Dorex2007 (button) collected ($0.26)
Seat 8: DEDpartizan (small blind) folded on the Flop
Seat 9: Rafael70018 (big blind) folded on the Flop



PokerStars Hand #224826711262:  Hold'em No Limit ($0.01/$0.02 USD) - 2021/03/14 23:39:46 PT [2021/03/15 2:39:46 ET]
Table 'Piccolo IV' 9-max Seat #8 is the button
Seat 1: ppeetteerr175 ($2.34 in chips) 
Seat 2: pi4oporec ($0.77 in chips) 
Seat 3: PABLOZAL10 ($1.62 in chips) 
Seat 5: radod421 ($0.87 in chips) 
Seat 6: Dorex2007 ($4.39 in chips) 
Seat 8: DEDpartizan ($0.62 in chips) 
Seat 9: Rafael70018 ($0.80 in chips) 
Rafael70018: posts small blind $0.01
ppeetteerr175: posts big blind $0.02
kiling1: sits out 
koupin: sits out 
*** HOLE CARDS ***
Dealt to Dorex2007 [5h 2h]
pi4oporec: folds 
PABLOZAL10: folds 
radod421: calls $0.02
Dorex2007: folds 
DEDpartizan: folds 
Rafael70018: calls $0.01
ppeetteerr175: checks 
*** FLOP *** [8s 8d 7h]
Rafael70018: checks 
ppeetteerr175: checks 
radod421: checks 
*** TURN *** [8s 8d 7h] [Ks]
Rafael70018: checks 
ppeetteerr175: checks 
radod421: bets $0.02
Rafael70018: folds 
ppeetteerr175: folds 
Uncalled bet ($0.02) returned to radod421
radod421 collected $0.06 from pot
*** SUMMARY ***
Total pot $0.06 | Rake $0 
Board [8s 8d 7h Ks]
Seat 1: ppeetteerr175 (big blind) folded on the Turn
Seat 2: pi4oporec folded before Flop (didn't bet)
Seat 3: PABLOZAL10 folded before Flop (didn't bet)
Seat 5: radod421 collected ($0.06)
Seat 6: Dorex2007 folded before Flop (didn't bet)
Seat 8: DEDpartizan (button) folded before Flop (didn't bet)
Seat 9: Rafael70018 (small blind) folded on the Turn



PokerStars Hand #224826717038:  Hold'em No Limit ($0.01/$0.02 USD) - 2021/03/14 23:40:23 PT [2021/03/15 2:40:23 ET]
Table 'Piccolo IV' 9-max Seat #9 is the button
Seat 1: ppeetteerr175 ($2.32 in chips) 
Seat 2: pi4oporec ($0.77 in chips) 
Seat 3: PABLOZAL10 ($1.62 in chips) 
Seat 5: radod421 ($0.91 in chips) 
Seat 6: Dorex2007 ($4.39 in chips) 
Seat 7: koupin ($2 in chips) 
Seat 8: DEDpartizan ($0.62 in chips) 
Seat 9: Rafael70018 ($0.78 in chips) 
ppeetteerr175: posts small blind $0.01
pi4oporec: posts big blind $0.02
kiling1: sits out 
koupin: posts big blind $0.02
*** HOLE CARDS ***
Dealt to Dorex2007 [9c Kc]
PABLOZAL10: calls $0.02
radod421: folds 
Dorex2007: raises $0.04 to $0.06
koupin: folds 
DEDpartizan: folds 
Rafael70018: folds 
ppeetteerr175: folds 
pi4oporec: calls $0.04
PABLOZAL10: calls $0.04
*** FLOP *** [Ad Qd 4c]
pi4oporec: bets $0.06
PABLOZAL10: folds 
Dorex2007: folds 
Uncalled bet ($0.06) returned to pi4oporec
pi4oporec collected $0.20 from pot
pi4oporec: doesn't show hand 
*** SUMMARY ***
Total pot $0.21 | Rake $0.01 
Board [Ad Qd 4c]
Seat 1: ppeetteerr175 (small blind) folded before Flop
Seat 2: pi4oporec (big blind) collected ($0.20)
Seat 3: PABLOZAL10 folded on the Flop
Seat 5: radod421 folded before Flop (didn't bet)
Seat 6: Dorex2007 folded on the Flop
Seat 7: koupin folded before Flop (didn't bet)
Seat 8: DEDpartizan folded before Flop (didn't bet)
Seat 9: Rafael70018 (button) folded before Flop (didn't bet)



PokerStars Hand #224826721655:  Hold'em No Limit ($0.01/$0.02 USD) - 2021/03/14 23:40:54 PT [2021/03/15 2:40:54 ET]
Table 'Piccolo IV' 9-max Seat #1 is the button
Seat 1: ppeetteerr175 ($2.31 in chips) 
Seat 2: pi4oporec ($0.91 in chips) 
Seat 3: PABLOZAL10 ($1.56 in chips) 
Seat 5: radod421 ($0.91 in chips) 
Seat 6: Dorex2007 ($4.33 in chips) 
Seat 8: DEDpartizan ($0.62 in chips) 
Seat 9: Rafael70018 ($0.78 in chips) 
pi4oporec: posts small blind $0.01
PABLOZAL10: posts big blind $0.02
kiling1: sits out 
*** HOLE CARDS ***
Dealt to Dorex2007 [7s 6c]
radod421: calls $0.02
Dorex2007: folds 
DEDpartizan: folds 
Rafael70018: folds 
ppeetteerr175: calls $0.02
pi4oporec: calls $0.01
PABLOZAL10: checks 
*** FLOP *** [7h 3h 5s]
pi4oporec: bets $0.02
PABLOZAL10: calls $0.02
radod421: raises $0.02 to $0.04
ppeetteerr175: folds 
pi4oporec: calls $0.02
PABLOZAL10: calls $0.02
*** TURN *** [7h 3h 5s] [Jd]
pi4oporec: checks 
PABLOZAL10: checks 
radod421: bets $0.12
pi4oporec: folds 
PABLOZAL10: folds 
Uncalled bet ($0.12) returned to radod421
radod421 collected $0.19 from pot
*** SUMMARY ***
Total pot $0.20 | Rake $0.01 
Board [7h 3h 5s Jd]
Seat 1: ppeetteerr175 (button) folded on the Flop
Seat 2: pi4oporec (small blind) folded on the Turn
Seat 3: PABLOZAL10 (big blind) folded on the Turn
Seat 5: radod421 collected ($0.19)
Seat 6: Dorex2007 folded before Flop (didn't bet)
Seat 8: DEDpartizan folded before Flop (didn't bet)
Seat 9: Rafael70018 folded before Flop (didn't bet)



PokerStars Hand #224826731882:  Hold'em No Limit ($0.01/$0.02 USD) - 2021/03/14 23:42:01 PT [2021/03/15 2:42:01 ET]
Table 'Piccolo IV' 9-max Seat #2 is the button
Seat 1: ppeetteerr175 ($2.29 in chips) 
Seat 2: pi4oporec ($0.85 in chips) 
Seat 3: PABLOZAL10 ($1.50 in chips) 
Seat 4: kiling1 ($1.18 in chips) 
Seat 5: radod421 ($1.04 in chips) 
Seat 6: Dorex2007 ($4.33 in chips) 
Seat 8: DEDpartizan ($0.62 in chips) 
Seat 9: Rafael70018 ($0.78 in chips) 
PABLOZAL10: posts small blind $0.01
kiling1: posts big blind $0.02
*** HOLE CARDS ***
Dealt to Dorex2007 [6c 4h]
radod421: calls $0.02
Dorex2007: folds 
DEDpartizan: folds 
Rafael70018: calls $0.02
ppeetteerr175: calls $0.02
pi4oporec: calls $0.02
PABLOZAL10: folds 
kiling1: checks 
*** FLOP *** [5d 8d 6d]
kiling1: checks 
radod421: checks 
Rafael70018: checks 
ppeetteerr175: checks 
pi4oporec: checks 
*** TURN *** [5d 8d 6d] [Td]
kiling1: checks 
radod421: checks 
Rafael70018: bets $0.02
ppeetteerr175: folds 
pi4oporec: calls $0.02
kiling1: folds 
radod421: folds 
*** RIVER *** [5d 8d 6d Td] [3s]
Rafael70018: bets $0.74 and is all-in
pi4oporec: folds 
Uncalled bet ($0.74) returned to Rafael70018
Rafael70018 collected $0.14 from pot
Rafael70018: doesn't show hand 
*** SUMMARY ***
Total pot $0.15 | Rake $0.01 
Board [5d 8d 6d Td 3s]
Seat 1: ppeetteerr175 folded on the Turn
Seat 2: pi4oporec (button) folded on the River
Seat 3: PABLOZAL10 (small blind) folded before Flop
Seat 4: kiling1 (big blind) folded on the Turn
Seat 5: radod421 folded on the Turn
Seat 6: Dorex2007 folded before Flop (didn't bet)
Seat 8: DEDpartizan folded before Flop (didn't bet)
Seat 9: Rafael70018 collected ($0.14)



PokerStars Hand #224826741749:  Hold'em No Limit ($0.01/$0.02 USD) - 2021/03/14 23:43:06 PT [2021/03/15 2:43:06 ET]
Table 'Piccolo IV' 9-max Seat #3 is the button
Seat 1: ppeetteerr175 ($2.27 in chips) 
Seat 2: pi4oporec ($0.81 in chips) 
Seat 3: PABLOZAL10 ($1.49 in chips) 
Seat 4: kiling1 ($1.16 in chips) 
Seat 5: radod421 ($1.02 in chips) 
Seat 6: Dorex2007 ($4.33 in chips) 
Seat 8: DEDpartizan ($0.62 in chips) 
Seat 9: Rafael70018 ($0.88 in chips) 
kiling1: posts small blind $0.01
radod421: posts big blind $0.02
*** HOLE CARDS ***
Dealt to Dorex2007 [4c 6s]
Dorex2007: folds 
DEDpartizan: calls $0.02
Rafael70018: folds 
ppeetteerr175: raises $0.04 to $0.06
pi4oporec: folds 
PABLOZAL10: folds 
kiling1: folds 
radod421: calls $0.04
DEDpartizan: calls $0.04
*** FLOP *** [3c 3d 7s]
radod421: checks 
DEDpartizan: checks 
ppeetteerr175: checks 
*** TURN *** [3c 3d 7s] [4h]
radod421: checks 
DEDpartizan: checks 
ppeetteerr175: checks 
*** RIVER *** [3c 3d 7s 4h] [5s]
radod421: checks 
DEDpartizan: checks 
ppeetteerr175: bets $0.09
radod421: folds 
DEDpartizan: folds 
Uncalled bet ($0.09) returned to ppeetteerr175
ppeetteerr175 collected $0.18 from pot
ppeetteerr175: doesn't show hand 
*** SUMMARY ***
Total pot $0.19 | Rake $0.01 
Board [3c 3d 7s 4h 5s]
Seat 1: ppeetteerr175 collected ($0.18)
Seat 2: pi4oporec folded before Flop (didn't bet)
Seat 3: PABLOZAL10 (button) folded before Flop (didn't bet)
Seat 4: kiling1 (small blind) folded before Flop
Seat 5: radod421 (big blind) folded on the River
Seat 6: Dorex2007 folded before Flop (didn't bet)
Seat 8: DEDpartizan folded on the River
Seat 9: Rafael70018 folded before Flop (didn't bet)



PokerStars Hand #224826751228:  Hold'em No Limit ($0.01/$0.02 USD) - 2021/03/14 23:44:08 PT [2021/03/15 2:44:08 ET]
Table 'Piccolo IV' 9-max Seat #4 is the button
Seat 1: ppeetteerr175 ($2.39 in chips) 
Seat 2: pi4oporec ($0.81 in chips) 
Seat 3: PABLOZAL10 ($1.49 in chips) 
Seat 4: kiling1 ($1.15 in chips) 
Seat 5: radod421 ($0.96 in chips) 
Seat 6: Dorex2007 ($4.33 in chips) 
Seat 8: DEDpartizan ($0.56 in chips) 
Seat 9: Rafael70018 ($0.88 in chips) 
radod421: posts small blind $0.01
Dorex2007: posts big blind $0.02
*** HOLE CARDS ***
Dealt to Dorex2007 [4c 9s]
DEDpartizan: folds 
Rafael70018: calls $0.02
ppeetteerr175: folds 
pi4oporec: folds 
PABLOZAL10: calls $0.02
kiling1: folds 
radod421: calls $0.01
Dorex2007: checks 
*** FLOP *** [Jh 6h 8s]
radod421: bets $0.02
Dorex2007: folds 
Rafael70018: calls $0.02
PABLOZAL10: calls $0.02
*** TURN *** [Jh 6h 8s] [Qh]
radod421: bets $0.02
Rafael70018: calls $0.02
PABLOZAL10: calls $0.02
*** RIVER *** [Jh 6h 8s Qh] [2d]
radod421: checks 
Rafael70018: bets $0.82 and is all-in
PABLOZAL10: folds 
radod421: folds 
Uncalled bet ($0.82) returned to Rafael70018
Rafael70018 collected $0.19 from pot
Rafael70018: doesn't show hand 
*** SUMMARY ***
Total pot $0.20 | Rake $0.01 
Board [Jh 6h 8s Qh 2d]
Seat 1: ppeetteerr175 folded before Flop (didn't bet)
Seat 2: pi4oporec folded before Flop (didn't bet)
Seat 3: PABLOZAL10 folded on the River
Seat 4: kiling1 (button) folded before Flop (didn't bet)
Seat 5: radod421 (small blind) folded on the River
Seat 6: Dorex2007 (big blind) folded on the Flop
Seat 8: DEDpartizan folded before Flop (didn't bet)
Seat 9: Rafael70018 collected ($0.19)



PokerStars Hand #224826761668:  Hold'em No Limit ($0.01/$0.02 USD) - 2021/03/14 23:45:18 PT [2021/03/15 2:45:18 ET]
Table 'Piccolo IV' 9-max Seat #5 is the button
Seat 1: ppeetteerr175 ($2.39 in chips) 
Seat 2: pi4oporec ($0.81 in chips) 
Seat 3: PABLOZAL10 ($1.43 in chips) 
Seat 4: kiling1 ($1.15 in chips) 
Seat 5: radod421 ($0.90 in chips) 
Seat 6: Dorex2007 ($4.31 in chips) 
Seat 7: koupin ($1.98 in chips) 
Seat 8: DEDpartizan ($0.56 in chips) 
Dorex2007: posts small blind $0.01
koupin: posts big blind $0.02
*** HOLE CARDS ***
Dealt to Dorex2007 [Qd 5s]
DEDpartizan: folds 
ppeetteerr175: raises $0.04 to $0.06
pi4oporec: folds 
PABLOZAL10: folds 
kiling1: folds 
radod421: folds 
Dorex2007: folds 
koupin: calls $0.04
*** FLOP *** [Ts Qc 2h]
koupin: checks 
ppeetteerr175: checks 
*** TURN *** [Ts Qc 2h] [Th]
koupin: bets $0.04
ppeetteerr175: calls $0.04
*** RIVER *** [Ts Qc 2h Th] [Ac]
koupin: checks 
ppeetteerr175: bets $0.10
koupin: folds 
Uncalled bet ($0.10) returned to ppeetteerr175
ppeetteerr175 collected $0.20 from pot
ppeetteerr175: doesn't show hand 
*** SUMMARY ***
Total pot $0.21 | Rake $0.01 
Board [Ts Qc 2h Th Ac]
Seat 1: ppeetteerr175 collected ($0.20)
Seat 2: pi4oporec folded before Flop (didn't bet)
Seat 3: PABLOZAL10 folded before Flop (didn't bet)
Seat 4: kiling1 folded before Flop (didn't bet)
Seat 5: radod421 (button) folded before Flop (didn't bet)
Seat 6: Dorex2007 (small blind) folded before Flop
Seat 7: koupin (big blind) folded on the River
Seat 8: DEDpartizan folded before Flop (didn't bet)



PokerStars Hand #224826769829:  Hold'em No Limit ($0.01/$0.02 USD) - 2021/03/14 23:46:11 PT [2021/03/15 2:46:11 ET]
Table 'Piccolo IV' 9-max Seat #6 is the button
Seat 1: ppeetteerr175 ($2.49 in chips) 
Seat 2: pi4oporec ($0.81 in chips) 
Seat 3: PABLOZAL10 ($1.43 in chips) 
Seat 4: kiling1 ($1.15 in chips) 
Seat 5: radod421 ($0.90 in chips) 
Seat 6: Dorex2007 ($4.30 in chips) 
Seat 7: koupin ($1.88 in chips) 
Seat 8: DEDpartizan ($0.56 in chips) 
Seat 9: Rafael70018 ($1.01 in chips) 
koupin: posts small blind $0.01
DEDpartizan: posts big blind $0.02
*** HOLE CARDS ***
Dealt to Dorex2007 [Ad 2h]
Rafael70018: calls $0.02
ppeetteerr175: calls $0.02
pi4oporec: folds 
PABLOZAL10: folds 
kiling1 has timed out
kiling1: folds 
radod421: calls $0.02
Dorex2007 has timed out
Dorex2007: folds 
koupin: calls $0.01
DEDpartizan: checks 
*** FLOP *** [Ts 2d Kc]
koupin: bets $0.03
DEDpartizan: calls $0.03
Rafael70018: folds 
ppeetteerr175: calls $0.03
radod421: folds 
*** TURN *** [Ts 2d Kc] [8h]
koupin: bets $0.05
DEDpartizan: folds 
ppeetteerr175: folds 
Uncalled bet ($0.05) returned to koupin
koupin collected $0.18 from pot
koupin: doesn't show hand 
*** SUMMARY ***
Total pot $0.19 | Rake $0.01 
Board [Ts 2d Kc 8h]
Seat 1: ppeetteerr175 folded on the Turn
Seat 2: pi4oporec folded before Flop (didn't bet)
Seat 3: PABLOZAL10 folded before Flop (didn't bet)
Seat 4: kiling1 folded before Flop (didn't bet)
Seat 5: radod421 folded on the Flop
Seat 6: Dorex2007 (button) folded before Flop (didn't bet)
Seat 7: koupin (small blind) collected ($0.18)
Seat 8: DEDpartizan (big blind) folded on the Turn
Seat 9: Rafael70018 folded on the Flop



PokerStars Hand #224826799287:  Hold'em No Limit ($0.01/$0.02 USD) - 2021/03/14 23:49:27 PT [2021/03/15 2:49:27 ET]
Table 'Piccolo IV' 9-max Seat #9 is the button
Seat 1: ppeetteerr175 ($2.66 in chips) 
Seat 2: sai199orz ($2 in chips) 
Seat 3: PABLOZAL10 ($1.25 in chips) 
Seat 5: radod421 ($0.88 in chips) 
Seat 6: Dorex2007 ($4.30 in chips) 
Seat 7: koupin ($2.01 in chips) 
Seat 9: Rafael70018 ($0.95 in chips) 
ppeetteerr175: posts small blind $0.01
sai199orz: posts big blind $0.02
*** HOLE CARDS ***
Dealt to Dorex2007 [Td 8h]
RazvanBabanu joins the table at seat #4 
PABLOZAL10: folds 
radod421: folds 
Dorex2007: folds 
koupin: folds 
Rafael70018: folds 
ppeetteerr175: calls $0.01
sai199orz: raises $0.06 to $0.08
ppeetteerr175: folds 
Uncalled bet ($0.06) returned to sai199orz
sai199orz collected $0.04 from pot
sai199orz: doesn't show hand 
*** SUMMARY ***
Total pot $0.04 | Rake $0 
Seat 1: ppeetteerr175 (small blind) folded before Flop
Seat 2: sai199orz (big blind) collected ($0.04)
Seat 3: PABLOZAL10 folded before Flop (didn't bet)
Seat 5: radod421 folded before Flop (didn't bet)
Seat 6: Dorex2007 folded before Flop (didn't bet)
Seat 7: koupin folded before Flop (didn't bet)
Seat 9: Rafael70018 (button) folded before Flop (didn't bet)



PokerStars Hand #224826804608:  Hold'em No Limit ($0.01/$0.02 USD) - 2021/03/14 23:50:02 PT [2021/03/15 2:50:02 ET]
Table 'Piccolo IV' 9-max Seat #1 is the button
Seat 1: ppeetteerr175 ($2.64 in chips) 
Seat 2: sai199orz ($2.02 in chips) 
Seat 3: PABLOZAL10 ($1.25 in chips) 
Seat 5: radod421 ($0.88 in chips) 
Seat 6: Dorex2007 ($4.30 in chips) 
Seat 7: koupin ($2.01 in chips) 
Seat 9: Rafael70018 ($0.95 in chips) 
sai199orz: posts small blind $0.01
PABLOZAL10: posts big blind $0.02
RazvanBabanu: sits out 
*** HOLE CARDS ***
Dealt to Dorex2007 [Qc 3s]
radod421: folds 
Dorex2007: folds 
koupin: folds 
Rafael70018: calls $0.02
ppeetteerr175: folds 
sai199orz: folds 
PABLOZAL10: checks 
*** FLOP *** [Kc 7d Kd]
PABLOZAL10: checks 
Rafael70018: checks 
*** TURN *** [Kc 7d Kd] [Ad]
PABLOZAL10: checks 
Rafael70018: checks 
*** RIVER *** [Kc 7d Kd Ad] [Kh]
PABLOZAL10: checks 
Rafael70018: checks 
*** SHOW DOWN ***
PABLOZAL10: shows [6s 5h] (three of a kind, Kings)
Rafael70018: shows [Td Js] (three of a kind, Kings - Ace+Jack kicker)
Rafael70018 collected $0.05 from pot
*** SUMMARY ***
Total pot $0.05 | Rake $0 
Board [Kc 7d Kd Ad Kh]
Seat 1: ppeetteerr175 (button) folded before Flop (didn't bet)
Seat 2: sai199orz (small blind) folded before Flop
Seat 3: PABLOZAL10 (big blind) showed [6s 5h] and lost with three of a kind, Kings
Seat 5: radod421 folded before Flop (didn't bet)
Seat 6: Dorex2007 folded before Flop (didn't bet)
Seat 7: koupin folded before Flop (didn't bet)
Seat 9: Rafael70018 showed [Td Js] and won ($0.05) with three of a kind, Kings



PokerStars Hand #224826809267:  Hold'em No Limit ($0.01/$0.02 USD) - 2021/03/14 23:50:33 PT [2021/03/15 2:50:33 ET]
Table 'Piccolo IV' 9-max Seat #2 is the button
Seat 1: ppeetteerr175 ($2.64 in chips) 
Seat 2: sai199orz ($2.01 in chips) 
Seat 3: PABLOZAL10 ($1.23 in chips) 
Seat 4: RazvanBabanu ($2 in chips) 
Seat 5: radod421 ($0.88 in chips) 
Seat 6: Dorex2007 ($4.30 in chips) 
Seat 7: koupin ($2.01 in chips) 
Seat 9: Rafael70018 ($0.98 in chips) 
PABLOZAL10: posts small blind $0.01
RazvanBabanu: posts big blind $0.02
*** HOLE CARDS ***
Dealt to Dorex2007 [Ah 5d]
radod421: calls $0.02
Dorex2007: folds 
koupin: folds 
Rafael70018: calls $0.02
ppeetteerr175: folds 
sai199orz: folds 
PABLOZAL10: raises $0.08 to $0.10
RazvanBabanu: folds 
radod421: folds 
Rafael70018: calls $0.08
*** FLOP *** [4d Kd 8c]
PABLOZAL10: bets $0.12
Rafael70018: raises $0.12 to $0.24
PABLOZAL10: folds 
Uncalled bet ($0.12) returned to Rafael70018
Rafael70018 collected $0.46 from pot
Rafael70018: doesn't show hand 
*** SUMMARY ***
Total pot $0.48 | Rake $0.02 
Board [4d Kd 8c]
Seat 1: ppeetteerr175 folded before Flop (didn't bet)
Seat 2: sai199orz (button) folded before Flop (didn't bet)
Seat 3: PABLOZAL10 (small blind) folded on the Flop
Seat 4: RazvanBabanu (big blind) folded before Flop
Seat 5: radod421 folded before Flop
Seat 6: Dorex2007 folded before Flop (didn't bet)
Seat 7: koupin folded before Flop (didn't bet)
Seat 9: Rafael70018 collected ($0.46)



PokerStars Hand #224826814949:  Hold'em No Limit ($0.01/$0.02 USD) - 2021/03/14 23:51:10 PT [2021/03/15 2:51:10 ET]
Table 'Piccolo IV' 9-max Seat #3 is the button
Seat 1: ppeetteerr175 ($2.64 in chips) 
Seat 2: sai199orz ($2.01 in chips) 
Seat 3: PABLOZAL10 ($1.01 in chips) 
Seat 4: RazvanBabanu ($1.98 in chips) 
Seat 5: radod421 ($0.86 in chips) 
Seat 6: Dorex2007 ($4.30 in chips) 
Seat 7: koupin ($2.01 in chips) 
Seat 8: DEDpartizan ($0.50 in chips) 
Seat 9: Rafael70018 ($1.22 in chips) 
RazvanBabanu: posts small blind $0.01
radod421: posts big blind $0.02
*** HOLE CARDS ***
Dealt to Dorex2007 [Ac Qs]
Dorex2007: raises $0.04 to $0.06
koupin: folds 
DEDpartizan: folds 
Rafael70018: folds 
ppeetteerr175: folds 
sai199orz: folds 
PABLOZAL10: folds 
RazvanBabanu: folds 
radod421: folds 
Uncalled bet ($0.04) returned to Dorex2007
Dorex2007 collected $0.05 from pot
Dorex2007: doesn't show hand 
*** SUMMARY ***
Total pot $0.05 | Rake $0 
Seat 1: ppeetteerr175 folded before Flop (didn't bet)
Seat 2: sai199orz folded before Flop (didn't bet)
Seat 3: PABLOZAL10 (button) folded before Flop (didn't bet)
Seat 4: RazvanBabanu (small blind) folded before Flop
Seat 5: radod421 (big blind) folded before Flop
Seat 6: Dorex2007 collected ($0.05)
Seat 7: koupin folded before Flop (didn't bet)
Seat 8: DEDpartizan folded before Flop (didn't bet)
Seat 9: Rafael70018 folded before Flop (didn't bet)



PokerStars Hand #224826817908:  Hold'em No Limit ($0.01/$0.02 USD) - 2021/03/14 23:51:30 PT [2021/03/15 2:51:30 ET]
Table 'Piccolo IV' 9-max Seat #4 is the button
Seat 1: ppeetteerr175 ($2.64 in chips) 
Seat 2: sai199orz ($2.01 in chips) 
Seat 3: PABLOZAL10 ($1.01 in chips) 
Seat 4: RazvanBabanu ($1.97 in chips) 
Seat 5: radod421 ($0.84 in chips) 
Seat 6: Dorex2007 ($4.33 in chips) 
Seat 7: koupin ($2.01 in chips) 
Seat 8: DEDpartizan ($0.50 in chips) 
Seat 9: Rafael70018 ($1.22 in chips) 
radod421: posts small blind $0.01
Dorex2007: posts big blind $0.02
*** HOLE CARDS ***
Dealt to Dorex2007 [Kd 6h]
koupin: folds 
DEDpartizan: folds 
Rafael70018: folds 
Rafael70018 leaves the table
ppeetteerr175: folds 
sai199orz: folds 
PABLOZAL10: folds 
RazvanBabanu: folds 
radod421: calls $0.01
Dorex2007: checks 
*** FLOP *** [Td 8h 5d]
radod421: bets $0.02
Dorex2007: folds 
Uncalled bet ($0.02) returned to radod421
radod421 collected $0.04 from pot
*** SUMMARY ***
Total pot $0.04 | Rake $0 
Board [Td 8h 5d]
Seat 1: ppeetteerr175 folded before Flop (didn't bet)
Seat 2: sai199orz folded before Flop (didn't bet)
Seat 3: PABLOZAL10 folded before Flop (didn't bet)
Seat 4: RazvanBabanu (button) folded before Flop (didn't bet)
Seat 5: radod421 (small blind) collected ($0.04)
Seat 6: Dorex2007 (big blind) folded on the Flop
Seat 7: koupin folded before Flop (didn't bet)
Seat 8: DEDpartizan folded before Flop (didn't bet)
Seat 9: Rafael70018 folded before Flop (didn't bet)



PokerStars Hand #224826823563:  Hold'em No Limit ($0.01/$0.02 USD) - 2021/03/14 23:52:07 PT [2021/03/15 2:52:07 ET]
Table 'Piccolo IV' 9-max Seat #5 is the button
Seat 1: ppeetteerr175 ($2.64 in chips) 
Seat 2: sai199orz ($2.01 in chips) 
Seat 3: PABLOZAL10 ($1.01 in chips) 
Seat 4: RazvanBabanu ($1.97 in chips) 
Seat 5: radod421 ($0.86 in chips) 
Seat 6: Dorex2007 ($4.31 in chips) 
Seat 7: koupin ($2.01 in chips) 
Seat 8: DEDpartizan ($0.50 in chips) 
Dorex2007: posts small blind $0.01
koupin: posts big blind $0.02
*** HOLE CARDS ***
Dealt to Dorex2007 [9c 7h]
DEDpartizan: raises $0.04 to $0.06
ppeetteerr175: calls $0.06
sai199orz: folds 
PABLOZAL10: calls $0.06
RazvanBabanu: folds 
radod421: folds 
Dorex2007: folds 
koupin: folds 
*** FLOP *** [5c 7d 4d]
DEDpartizan: checks 
ppeetteerr175: checks 
PABLOZAL10: bets $0.95 and is all-in
DEDpartizan: folds 
ppeetteerr175: folds 
Uncalled bet ($0.95) returned to PABLOZAL10
PABLOZAL10 collected $0.20 from pot
PABLOZAL10: doesn't show hand 
*** SUMMARY ***
Total pot $0.21 | Rake $0.01 
Board [5c 7d 4d]
Seat 1: ppeetteerr175 folded on the Flop
Seat 2: sai199orz folded before Flop (didn't bet)
Seat 3: PABLOZAL10 collected ($0.20)
Seat 4: RazvanBabanu folded before Flop (didn't bet)
Seat 5: radod421 (button) folded before Flop (didn't bet)
Seat 6: Dorex2007 (small blind) folded before Flop
Seat 7: koupin (big blind) folded before Flop
Seat 8: DEDpartizan folded on the Flop



PokerStars Hand #224826831509:  Hold'em No Limit ($0.01/$0.02 USD) - 2021/03/14 23:53:00 PT [2021/03/15 2:53:00 ET]
Table 'Piccolo IV' 9-max Seat #6 is the button
Seat 1: ppeetteerr175 ($2.58 in chips) 
Seat 2: sai199orz ($2.01 in chips) 
Seat 3: PABLOZAL10 ($1.15 in chips) 
Seat 4: RazvanBabanu ($1.97 in chips) 
Seat 5: radod421 ($0.86 in chips) 
Seat 6: Dorex2007 ($4.30 in chips) 
Seat 7: koupin ($1.99 in chips) 
Seat 8: DEDpartizan ($0.44 in chips) 
koupin: posts small blind $0.01
DEDpartizan: posts big blind $0.02
*** HOLE CARDS ***
Dealt to Dorex2007 [2h Kd]
ppeetteerr175: folds 
sai199orz: folds 
PABLOZAL10: raises $0.02 to $0.04
RazvanBabanu: folds 
radod421: folds 
Dorex2007: folds 
koupin: folds 
DEDpartizan: folds 
Uncalled bet ($0.02) returned to PABLOZAL10
PABLOZAL10 collected $0.05 from pot
PABLOZAL10: doesn't show hand 
*** SUMMARY ***
Total pot $0.05 | Rake $0 
Seat 1: ppeetteerr175 folded before Flop (didn't bet)
Seat 2: sai199orz folded before Flop (didn't bet)
Seat 3: PABLOZAL10 collected ($0.05)
Seat 4: RazvanBabanu folded before Flop (didn't bet)
Seat 5: radod421 folded before Flop (didn't bet)
Seat 6: Dorex2007 (button) folded before Flop (didn't bet)
Seat 7: koupin (small blind) folded before Flop
Seat 8: DEDpartizan (big blind) folded before Flop



PokerStars Hand #224826834533:  Hold'em No Limit ($0.01/$0.02 USD) - 2021/03/14 23:53:20 PT [2021/03/15 2:53:20 ET]
Table 'Piccolo IV' 9-max Seat #7 is the button
Seat 1: ppeetteerr175 ($2.58 in chips) 
Seat 2: sai199orz ($2.01 in chips) 
Seat 3: PABLOZAL10 ($1.18 in chips) 
Seat 4: RazvanBabanu ($1.97 in chips) 
Seat 5: radod421 ($0.86 in chips) 
Seat 6: Dorex2007 ($4.30 in chips) 
Seat 7: koupin ($1.98 in chips) 
Seat 8: DEDpartizan ($0.42 in chips) 
DEDpartizan: posts small blind $0.01
ppeetteerr175: posts big blind $0.02
*** HOLE CARDS ***
Dealt to Dorex2007 [3s 4d]
sai199orz: folds 
PABLOZAL10: folds 
RazvanBabanu: folds 
radod421: folds 
Dorex2007: folds 
koupin: folds 
DEDpartizan: calls $0.01
ppeetteerr175: checks 
*** FLOP *** [Tc 9d 8h]
DEDpartizan: checks 
ppeetteerr175: bets $0.02
DEDpartizan: folds 
Uncalled bet ($0.02) returned to ppeetteerr175
ppeetteerr175 collected $0.04 from pot
ppeetteerr175: doesn't show hand 
*** SUMMARY ***
Total pot $0.04 | Rake $0 
Board [Tc 9d 8h]
Seat 1: ppeetteerr175 (big blind) collected ($0.04)
Seat 2: sai199orz folded before Flop (didn't bet)
Seat 3: PABLOZAL10 folded before Flop (didn't bet)
Seat 4: RazvanBabanu folded before Flop (didn't bet)
Seat 5: radod421 folded before Flop (didn't bet)
Seat 6: Dorex2007 folded before Flop (didn't bet)
Seat 7: koupin (button) folded before Flop (didn't bet)
Seat 8: DEDpartizan (small blind) folded on the Flop



PokerStars Hand #224826838677:  Hold'em No Limit ($0.01/$0.02 USD) - 2021/03/14 23:53:48 PT [2021/03/15 2:53:48 ET]
Table 'Piccolo IV' 9-max Seat #8 is the button
Seat 1: ppeetteerr175 ($2.60 in chips) 
Seat 2: sai199orz ($2.01 in chips) 
Seat 3: PABLOZAL10 ($1.18 in chips) 
Seat 4: RazvanBabanu ($1.97 in chips) 
Seat 5: radod421 ($0.86 in chips) 
Seat 6: Dorex2007 ($4.30 in chips) 
Seat 7: koupin ($1.98 in chips) 
Seat 8: DEDpartizan ($0.40 in chips) 
ppeetteerr175: posts small blind $0.01
sai199orz: posts big blind $0.02
*** HOLE CARDS ***
Dealt to Dorex2007 [5s Kh]
PABLOZAL10: folds 
RazvanBabanu: calls $0.02
radod421: folds 
Dorex2007: folds 
koupin: folds 
DEDpartizan: folds 
ppeetteerr175: calls $0.01
sai199orz: raises $0.06 to $0.08
RazvanBabanu: calls $0.06
ppeetteerr175: folds 
*** FLOP *** [6c 2c 6d]
sai199orz: bets $0.06
RazvanBabanu: calls $0.06
*** TURN *** [6c 2c 6d] [4c]
sai199orz: checks 
RazvanBabanu: bets $0.15
sai199orz: folds 
Uncalled bet ($0.15) returned to RazvanBabanu
RazvanBabanu collected $0.29 from pot
RazvanBabanu: doesn't show hand 
*** SUMMARY ***
Total pot $0.30 | Rake $0.01 
Board [6c 2c 6d 4c]
Seat 1: ppeetteerr175 (small blind) folded before Flop
Seat 2: sai199orz (big blind) folded on the Turn
Seat 3: PABLOZAL10 folded before Flop (didn't bet)
Seat 4: RazvanBabanu collected ($0.29)
Seat 5: radod421 folded before Flop (didn't bet)
Seat 6: Dorex2007 folded before Flop (didn't bet)
Seat 7: koupin folded before Flop (didn't bet)
Seat 8: DEDpartizan (button) folded before Flop (didn't bet)



