PokerStars Hand #238018564147:  Hold'em No Limit ($0.02/$0.05 USD) - 2022/08/15 21:00:39 PT [2022/08/16 0:00:39 ET]
Table 'Alkurah III' 9-max Seat #1 is the button
Seat 1: Dorex2007 ($8.88 in chips) 
Seat 2: BluffOnTable ($5 in chips) 
Seat 4: Sticky514 ($7.41 in chips) 
Seat 5: onlyfoolsguy ($4.04 in chips) 
Seat 6: Ginnungagap7 ($3.88 in chips) 
Seat 8: InDiosArg95' ($5.35 in chips) 
Seat 9: Maria'sDad77 ($4 in chips) 
BluffOnTable: posts small blind $0.02
Sticky514: posts big blind $0.05
zoepaul: sits out 
*** HOLE CARDS ***
Dealt to Dorex2007 [4d 2h]
onlyfoolsguy: folds 
Ginnungagap7: folds 
InDiosArg95': folds 
Maria'sDad77: folds 
Dorex2007: folds 
BluffOnTable: folds 
Uncalled bet ($0.03) returned to Sticky514
Sticky514 collected $0.04 from pot
Sticky514: doesn't show hand 
*** SUMMARY ***
Total pot $0.04 | Rake $0 
Seat 1: Dorex2007 (button) folded before Flop (didn't bet)
Seat 2: BluffOnTable (small blind) folded before Flop
Seat 4: Sticky514 (big blind) collected ($0.04)
Seat 5: onlyfoolsguy folded before Flop (didn't bet)
Seat 6: Ginnungagap7 folded before Flop (didn't bet)
Seat 8: InDiosArg95' folded before Flop (didn't bet)
Seat 9: Maria'sDad77 folded before Flop (didn't bet)



PokerStars Hand #238018566376:  Hold'em No Limit ($0.02/$0.05 USD) - 2022/08/15 21:00:58 PT [2022/08/16 0:00:58 ET]
Table 'Alkurah III' 9-max Seat #2 is the button
Seat 1: Dorex2007 ($8.88 in chips) 
Seat 2: BluffOnTable ($5 in chips) 
Seat 4: Sticky514 ($7.43 in chips) 
Seat 5: onlyfoolsguy ($4.04 in chips) 
Seat 6: Ginnungagap7 ($3.88 in chips) 
Seat 8: InDiosArg95' ($5.35 in chips) 
Seat 9: Maria'sDad77 ($4 in chips) 
Sticky514: posts small blind $0.02
onlyfoolsguy: posts big blind $0.05
zoepaul: sits out 
*** HOLE CARDS ***
Dealt to Dorex2007 [Jd 2d]
Ginnungagap7: folds 
InDiosArg95': folds 
Maria'sDad77: folds 
Dorex2007: folds 
BluffOnTable: folds 
Sticky514: folds 
Uncalled bet ($0.03) returned to onlyfoolsguy
onlyfoolsguy collected $0.04 from pot
onlyfoolsguy: doesn't show hand 
*** SUMMARY ***
Total pot $0.04 | Rake $0 
Seat 1: Dorex2007 folded before Flop (didn't bet)
Seat 2: BluffOnTable (button) folded before Flop (didn't bet)
Seat 4: Sticky514 (small blind) folded before Flop
Seat 5: onlyfoolsguy (big blind) collected ($0.04)
Seat 6: Ginnungagap7 folded before Flop (didn't bet)
Seat 8: InDiosArg95' folded before Flop (didn't bet)
Seat 9: Maria'sDad77 folded before Flop (didn't bet)



PokerStars Hand #238018569140:  Hold'em No Limit ($0.02/$0.05 USD) - 2022/08/15 21:01:21 PT [2022/08/16 0:01:21 ET]
Table 'Alkurah III' 9-max Seat #4 is the button
Seat 1: Dorex2007 ($8.88 in chips) 
Seat 2: BluffOnTable ($5 in chips) 
Seat 4: Sticky514 ($7.41 in chips) 
Seat 5: onlyfoolsguy ($4.06 in chips) 
Seat 6: Ginnungagap7 ($3.88 in chips) 
Seat 8: InDiosArg95' ($5.35 in chips) 
Seat 9: Maria'sDad77 ($4 in chips) 
onlyfoolsguy: posts small blind $0.02
Ginnungagap7: posts big blind $0.05
zoepaul: sits out 
*** HOLE CARDS ***
Dealt to Dorex2007 [Jh 8c]
InDiosArg95': folds 
Maria'sDad77: folds 
Dorex2007: folds 
Lagosha joins the table at seat #3 
BluffOnTable has timed out
BluffOnTable: folds 
Sticky514 has timed out
Sticky514: folds 
onlyfoolsguy: raises $0.10 to $0.15
Ginnungagap7: folds 
Uncalled bet ($0.10) returned to onlyfoolsguy
onlyfoolsguy collected $0.10 from pot
onlyfoolsguy: doesn't show hand 
*** SUMMARY ***
Total pot $0.10 | Rake $0 
Seat 1: Dorex2007 folded before Flop (didn't bet)
Seat 2: BluffOnTable folded before Flop (didn't bet)
Seat 4: Sticky514 (button) folded before Flop (didn't bet)
Seat 5: onlyfoolsguy (small blind) collected ($0.10)
Seat 6: Ginnungagap7 (big blind) folded before Flop
Seat 8: InDiosArg95' folded before Flop (didn't bet)
Seat 9: Maria'sDad77 folded before Flop (didn't bet)



PokerStars Hand #238018574549:  Hold'em No Limit ($0.02/$0.05 USD) - 2022/08/15 21:02:05 PT [2022/08/16 0:02:05 ET]
Table 'Alkurah III' 9-max Seat #5 is the button
Seat 1: Dorex2007 ($8.88 in chips) 
Seat 2: BluffOnTable ($5 in chips) 
Seat 3: Lagosha ($5 in chips) 
Seat 4: Sticky514 ($7.41 in chips) 
Seat 5: onlyfoolsguy ($4.11 in chips) 
Seat 6: Ginnungagap7 ($3.83 in chips) 
Seat 7: zoepaul ($5 in chips) 
Seat 8: InDiosArg95' ($5.35 in chips) 
Seat 9: Maria'sDad77 ($4 in chips) 
Ginnungagap7: posts small blind $0.02
zoepaul: posts big blind $0.05
Lagosha: posts big blind $0.05
*** HOLE CARDS ***
Dealt to Dorex2007 [2c 4h]
InDiosArg95': folds 
Maria'sDad77: folds 
Dorex2007: folds 
BluffOnTable: raises $0.10 to $0.15
Lagosha: calls $0.10
Sticky514: raises $0.15 to $0.30
onlyfoolsguy: folds 
Ginnungagap7: folds 
zoepaul: folds 
BluffOnTable: calls $0.15
Lagosha: folds 
*** FLOP *** [Th 8c 3s]
BluffOnTable: checks 
Sticky514: bets $0.39
BluffOnTable: calls $0.39
*** TURN *** [Th 8c 3s] [6d]
BluffOnTable: checks 
Sticky514: bets $0.50
BluffOnTable: folds 
Uncalled bet ($0.50) returned to Sticky514
Sticky514 collected $1.53 from pot
Sticky514: doesn't show hand 
*** SUMMARY ***
Total pot $1.60 | Rake $0.07 
Board [Th 8c 3s 6d]
Seat 1: Dorex2007 folded before Flop (didn't bet)
Seat 2: BluffOnTable folded on the Turn
Seat 3: Lagosha folded before Flop
Seat 4: Sticky514 collected ($1.53)
Seat 5: onlyfoolsguy (button) folded before Flop (didn't bet)
Seat 6: Ginnungagap7 (small blind) folded before Flop
Seat 7: zoepaul (big blind) folded before Flop
Seat 8: InDiosArg95' folded before Flop (didn't bet)
Seat 9: Maria'sDad77 folded before Flop (didn't bet)



PokerStars Hand #238018582551:  Hold'em No Limit ($0.02/$0.05 USD) - 2022/08/15 21:03:10 PT [2022/08/16 0:03:10 ET]
Table 'Alkurah III' 9-max Seat #6 is the button
Seat 1: Dorex2007 ($8.88 in chips) 
Seat 2: BluffOnTable ($5 in chips) 
Seat 3: Lagosha ($5 in chips) 
Seat 4: Sticky514 ($8.25 in chips) 
Seat 5: onlyfoolsguy ($4.11 in chips) 
Seat 6: Ginnungagap7 ($3.81 in chips) 
Seat 7: zoepaul ($4.95 in chips) 
Seat 8: InDiosArg95' ($5.35 in chips) 
Seat 9: Maria'sDad77 ($4 in chips) 
zoepaul: posts small blind $0.02
InDiosArg95': posts big blind $0.05
*** HOLE CARDS ***
Dealt to Dorex2007 [6c 5c]
Maria'sDad77: folds 
Dorex2007: folds 
BluffOnTable: folds 
Lagosha: folds 
Sticky514: folds 
onlyfoolsguy: folds 
Ginnungagap7: folds 
zoepaul: folds 
Uncalled bet ($0.03) returned to InDiosArg95'
InDiosArg95' collected $0.04 from pot
*** SUMMARY ***
Total pot $0.04 | Rake $0 
Seat 1: Dorex2007 folded before Flop (didn't bet)
Seat 2: BluffOnTable folded before Flop (didn't bet)
Seat 3: Lagosha folded before Flop (didn't bet)
Seat 4: Sticky514 folded before Flop (didn't bet)
Seat 5: onlyfoolsguy folded before Flop (didn't bet)
Seat 6: Ginnungagap7 (button) folded before Flop (didn't bet)
Seat 7: zoepaul (small blind) folded before Flop
Seat 8: InDiosArg95' (big blind) collected ($0.04)
Seat 9: Maria'sDad77 folded before Flop (didn't bet)



PokerStars Hand #238018586249:  Hold'em No Limit ($0.02/$0.05 USD) - 2022/08/15 21:03:40 PT [2022/08/16 0:03:40 ET]
Table 'Alkurah III' 9-max Seat #7 is the button
Seat 1: Dorex2007 ($8.88 in chips) 
Seat 2: BluffOnTable ($5 in chips) 
Seat 3: Lagosha ($5 in chips) 
Seat 4: Sticky514 ($8.25 in chips) 
Seat 5: onlyfoolsguy ($4.11 in chips) 
Seat 6: Ginnungagap7 ($3.81 in chips) 
Seat 7: zoepaul ($4.93 in chips) 
Seat 8: InDiosArg95' ($5.37 in chips) 
Seat 9: Maria'sDad77 ($4 in chips) 
InDiosArg95': posts small blind $0.02
Maria'sDad77: posts big blind $0.05
*** HOLE CARDS ***
Dealt to Dorex2007 [Ts Td]
Dorex2007: calls $0.05
BluffOnTable: folds 
Lagosha: folds 
Sticky514: folds 
onlyfoolsguy: raises $0.22 to $0.27
Ginnungagap7: folds 
zoepaul: folds 
InDiosArg95': folds 
Maria'sDad77: folds 
Dorex2007: folds 
Uncalled bet ($0.22) returned to onlyfoolsguy
onlyfoolsguy collected $0.17 from pot
onlyfoolsguy: doesn't show hand 
*** SUMMARY ***
Total pot $0.17 | Rake $0 
Seat 1: Dorex2007 folded before Flop
Seat 2: BluffOnTable folded before Flop (didn't bet)
Seat 3: Lagosha folded before Flop (didn't bet)
Seat 4: Sticky514 folded before Flop (didn't bet)
Seat 5: onlyfoolsguy collected ($0.17)
Seat 6: Ginnungagap7 folded before Flop (didn't bet)
Seat 7: zoepaul (button) folded before Flop (didn't bet)
Seat 8: InDiosArg95' (small blind) folded before Flop
Seat 9: Maria'sDad77 (big blind) folded before Flop



PokerStars Hand #238018590772:  Hold'em No Limit ($0.02/$0.05 USD) - 2022/08/15 21:04:16 PT [2022/08/16 0:04:16 ET]
Table 'Alkurah III' 9-max Seat #8 is the button
Seat 1: Dorex2007 ($8.83 in chips) 
Seat 2: BluffOnTable ($5 in chips) 
Seat 3: Lagosha ($5 in chips) 
Seat 4: Sticky514 ($8.25 in chips) 
Seat 5: onlyfoolsguy ($4.23 in chips) 
Seat 6: Ginnungagap7 ($3.81 in chips) 
Seat 7: zoepaul ($4.93 in chips) 
Seat 8: InDiosArg95' ($5.35 in chips) 
Seat 9: Maria'sDad77 ($4 in chips) 
Maria'sDad77: posts small blind $0.02
Dorex2007: posts big blind $0.05
*** HOLE CARDS ***
Dealt to Dorex2007 [7d 5c]
BluffOnTable has timed out
BluffOnTable: folds 
Lagosha: folds 
Sticky514: calls $0.05
onlyfoolsguy: folds 
Ginnungagap7: folds 
zoepaul: raises $0.10 to $0.15
InDiosArg95': folds 
Maria'sDad77: folds 
Dorex2007: folds 
Sticky514: calls $0.10
*** FLOP *** [4s Jd 2h]
Sticky514: checks 
zoepaul: bets $0.17
Sticky514: folds 
Uncalled bet ($0.17) returned to zoepaul
zoepaul collected $0.35 from pot
*** SUMMARY ***
Total pot $0.37 | Rake $0.02 
Board [4s Jd 2h]
Seat 1: Dorex2007 (big blind) folded before Flop
Seat 2: BluffOnTable folded before Flop (didn't bet)
Seat 3: Lagosha folded before Flop (didn't bet)
Seat 4: Sticky514 folded on the Flop
Seat 5: onlyfoolsguy folded before Flop (didn't bet)
Seat 6: Ginnungagap7 folded before Flop (didn't bet)
Seat 7: zoepaul collected ($0.35)
Seat 8: InDiosArg95' (button) folded before Flop (didn't bet)
Seat 9: Maria'sDad77 (small blind) folded before Flop



PokerStars Hand #238018600709:  Hold'em No Limit ($0.02/$0.05 USD) - 2022/08/15 21:05:37 PT [2022/08/16 0:05:37 ET]
Table 'Alkurah III' 9-max Seat #9 is the button
Seat 1: Dorex2007 ($8.78 in chips) 
Seat 2: BluffOnTable ($5 in chips) 
Seat 3: Lagosha ($5 in chips) 
Seat 4: Sticky514 ($8.10 in chips) 
Seat 5: onlyfoolsguy ($4.23 in chips) 
Seat 6: Ginnungagap7 ($3.81 in chips) 
Seat 7: zoepaul ($5.13 in chips) 
Seat 9: Maria'sDad77 ($4 in chips) 
Dorex2007: posts small blind $0.02
BluffOnTable: posts big blind $0.05
*** HOLE CARDS ***
Dealt to Dorex2007 [4d Th]
Lagosha: folds 
Sticky514: calls $0.05
onlyfoolsguy: folds 
Ginnungagap7: folds 
zoepaul: raises $0.17 to $0.22
Maria'sDad77: folds 
Dorex2007: folds 
BluffOnTable: folds 
Sticky514: calls $0.17
*** FLOP *** [9h 8h Td]
Sticky514: checks 
zoepaul: checks 
*** TURN *** [9h 8h Td] [Kd]
Sticky514: bets $0.24
zoepaul: calls $0.24
*** RIVER *** [9h 8h Td Kd] [Jc]
Sticky514: bets $0.47
zoepaul: raises $4.20 to $4.67 and is all-in
Sticky514: calls $4.20
*** SHOW DOWN ***
zoepaul: shows [Ac Qs] (a straight, Ten to Ace)
Sticky514: shows [Ts Qh] (a straight, Nine to King)
zoepaul collected $9.90 from pot
*** SUMMARY ***
Total pot $10.33 | Rake $0.43 
Board [9h 8h Td Kd Jc]
Seat 1: Dorex2007 (small blind) folded before Flop
Seat 2: BluffOnTable (big blind) folded before Flop
Seat 3: Lagosha folded before Flop (didn't bet)
Seat 4: Sticky514 showed [Ts Qh] and lost with a straight, Nine to King
Seat 5: onlyfoolsguy folded before Flop (didn't bet)
Seat 6: Ginnungagap7 folded before Flop (didn't bet)
Seat 7: zoepaul showed [Ac Qs] and won ($9.90) with a straight, Ten to Ace
Seat 9: Maria'sDad77 (button) folded before Flop (didn't bet)



PokerStars Hand #238018610774:  Hold'em No Limit ($0.02/$0.05 USD) - 2022/08/15 21:06:59 PT [2022/08/16 0:06:59 ET]
Table 'Alkurah III' 9-max Seat #1 is the button
Seat 1: Dorex2007 ($8.76 in chips) 
Seat 2: BluffOnTable ($5 in chips) 
Seat 4: Sticky514 ($2.97 in chips) 
Seat 5: onlyfoolsguy ($4.23 in chips) 
Seat 6: Ginnungagap7 ($3.81 in chips) 
Seat 7: zoepaul ($9.90 in chips) 
Seat 8: InDiosArg95' ($5.35 in chips) 
Seat 9: Maria'sDad77 ($4 in chips) 
BluffOnTable: posts small blind $0.02
Lagosha: is sitting out 
Sticky514: posts big blind $0.05
*** HOLE CARDS ***
Dealt to Dorex2007 [2h 7s]
onlyfoolsguy: folds 
Ginnungagap7: folds 
zoepaul: raises $0.10 to $0.15
InDiosArg95': folds 
Maria'sDad77: folds 
Dorex2007: folds 
BluffOnTable: folds 
Sticky514: folds 
Uncalled bet ($0.10) returned to zoepaul
zoepaul collected $0.12 from pot
*** SUMMARY ***
Total pot $0.12 | Rake $0 
Seat 1: Dorex2007 (button) folded before Flop (didn't bet)
Seat 2: BluffOnTable (small blind) folded before Flop
Seat 4: Sticky514 (big blind) folded before Flop
Seat 5: onlyfoolsguy folded before Flop (didn't bet)
Seat 6: Ginnungagap7 folded before Flop (didn't bet)
Seat 7: zoepaul collected ($0.12)
Seat 8: InDiosArg95' folded before Flop (didn't bet)
Seat 9: Maria'sDad77 folded before Flop (didn't bet)



PokerStars Hand #238018614355:  Hold'em No Limit ($0.02/$0.05 USD) - 2022/08/15 21:07:28 PT [2022/08/16 0:07:28 ET]
Table 'Alkurah III' 9-max Seat #2 is the button
Seat 1: Dorex2007 ($8.76 in chips) 
Seat 2: BluffOnTable ($5 in chips) 
Seat 4: Sticky514 ($2.92 in chips) 
Seat 5: onlyfoolsguy ($4.23 in chips) 
Seat 6: Ginnungagap7 ($3.81 in chips) 
Seat 7: zoepaul ($9.97 in chips) 
Seat 8: InDiosArg95' ($5.35 in chips) 
Seat 9: Maria'sDad77 ($4 in chips) 
Sticky514: posts small blind $0.02
onlyfoolsguy: posts big blind $0.05
*** HOLE CARDS ***
Dealt to Dorex2007 [Jd 7s]
Ginnungagap7: folds 
Lagosha leaves the table
Ginnungagap7 leaves the table
zoepaul: folds 
InDiosArg95': folds 
Maria'sDad77: folds 
 $DCarv13$ joins the table at seat #3 
Dorex2007: folds 
BluffOnTable: folds 
rgrfredy joins the table at seat #6 
Sticky514: folds 
Uncalled bet ($0.03) returned to onlyfoolsguy
onlyfoolsguy collected $0.04 from pot
onlyfoolsguy: doesn't show hand 
*** SUMMARY ***
Total pot $0.04 | Rake $0 
Seat 1: Dorex2007 folded before Flop (didn't bet)
Seat 2: BluffOnTable (button) folded before Flop (didn't bet)
Seat 4: Sticky514 (small blind) folded before Flop
Seat 5: onlyfoolsguy (big blind) collected ($0.04)
Seat 6: Ginnungagap7 folded before Flop (didn't bet)
Seat 7: zoepaul folded before Flop (didn't bet)
Seat 8: InDiosArg95' folded before Flop (didn't bet)
Seat 9: Maria'sDad77 folded before Flop (didn't bet)



PokerStars Hand #238018617368:  Hold'em No Limit ($0.02/$0.05 USD) - 2022/08/15 21:07:53 PT [2022/08/16 0:07:53 ET]
Table 'Alkurah III' 9-max Seat #4 is the button
Seat 1: Dorex2007 ($8.76 in chips) 
Seat 2: BluffOnTable ($5 in chips) 
Seat 3:  $DCarv13$ ($4 in chips) 
Seat 4: Sticky514 ($2.90 in chips) 
Seat 5: onlyfoolsguy ($4.25 in chips) 
Seat 6: rgrfredy ($3.45 in chips) 
Seat 7: zoepaul ($9.97 in chips) 
Seat 8: InDiosArg95' ($5.35 in chips) 
Seat 9: Maria'sDad77 ($4 in chips) 
onlyfoolsguy: posts small blind $0.02
rgrfredy: posts big blind $0.05
 $DCarv13$: posts big blind $0.05
*** HOLE CARDS ***
Dealt to Dorex2007 [8h 7d]
zoepaul: raises $0.05 to $0.10
InDiosArg95': folds 
Maria'sDad77: folds 
Dorex2007: folds 
BluffOnTable: folds 
 $DCarv13$: calls $0.05
Sticky514: folds 
onlyfoolsguy: folds 
rgrfredy: calls $0.05
*** FLOP *** [3h Ad 9h]
rgrfredy: checks 
zoepaul: bets $0.31
 $DCarv13$: folds 
rgrfredy: folds 
Uncalled bet ($0.31) returned to zoepaul
zoepaul collected $0.31 from pot
*** SUMMARY ***
Total pot $0.32 | Rake $0.01 
Board [3h Ad 9h]
Seat 1: Dorex2007 folded before Flop (didn't bet)
Seat 2: BluffOnTable folded before Flop (didn't bet)
Seat 3:  $DCarv13$ folded on the Flop
Seat 4: Sticky514 (button) folded before Flop (didn't bet)
Seat 5: onlyfoolsguy (small blind) folded before Flop
Seat 6: rgrfredy (big blind) folded on the Flop
Seat 7: zoepaul collected ($0.31)
Seat 8: InDiosArg95' folded before Flop (didn't bet)
Seat 9: Maria'sDad77 folded before Flop (didn't bet)



PokerStars Hand #238018622605:  Hold'em No Limit ($0.02/$0.05 USD) - 2022/08/15 21:08:36 PT [2022/08/16 0:08:36 ET]
Table 'Alkurah III' 9-max Seat #5 is the button
Seat 1: Dorex2007 ($8.76 in chips) 
Seat 2: BluffOnTable ($5 in chips) 
Seat 3:  $DCarv13$ ($4.25 in chips) 
Seat 4: Sticky514 ($2.90 in chips) 
Seat 5: onlyfoolsguy ($4.23 in chips) 
Seat 6: rgrfredy ($3.35 in chips) 
Seat 7: zoepaul ($10.18 in chips) 
Seat 8: InDiosArg95' ($5.35 in chips) 
Seat 9: Maria'sDad77 ($4 in chips) 
rgrfredy: posts small blind $0.02
zoepaul: posts big blind $0.05
*** HOLE CARDS ***
Dealt to Dorex2007 [2h As]
InDiosArg95': folds 
Maria'sDad77: folds 
Dorex2007: folds 
BluffOnTable: folds 
 $DCarv13$: folds 
Sticky514: calls $0.05
onlyfoolsguy: folds 
rgrfredy: calls $0.03
zoepaul: checks 
*** FLOP *** [Js 6d 2s]
rgrfredy: bets $0.05
zoepaul: folds 
Sticky514: folds 
Uncalled bet ($0.05) returned to rgrfredy
rgrfredy collected $0.14 from pot
*** SUMMARY ***
Total pot $0.15 | Rake $0.01 
Board [Js 6d 2s]
Seat 1: Dorex2007 folded before Flop (didn't bet)
Seat 2: BluffOnTable folded before Flop (didn't bet)
Seat 3:  $DCarv13$ folded before Flop (didn't bet)
Seat 4: Sticky514 folded on the Flop
Seat 5: onlyfoolsguy (button) folded before Flop (didn't bet)
Seat 6: rgrfredy (small blind) collected ($0.14)
Seat 7: zoepaul (big blind) folded on the Flop
Seat 8: InDiosArg95' folded before Flop (didn't bet)
Seat 9: Maria'sDad77 folded before Flop (didn't bet)



PokerStars Hand #238018628804:  Hold'em No Limit ($0.02/$0.05 USD) - 2022/08/15 21:09:28 PT [2022/08/16 0:09:28 ET]
Table 'Alkurah III' 9-max Seat #6 is the button
Seat 1: Dorex2007 ($8.76 in chips) 
Seat 2: BluffOnTable ($5 in chips) 
Seat 3:  $DCarv13$ ($4.25 in chips) 
Seat 4: Sticky514 ($2.85 in chips) 
Seat 5: onlyfoolsguy ($4.23 in chips) 
Seat 6: rgrfredy ($3.44 in chips) 
Seat 7: zoepaul ($10.13 in chips) 
Seat 8: InDiosArg95' ($5.35 in chips) 
Seat 9: Maria'sDad77 ($4 in chips) 
zoepaul: posts small blind $0.02
InDiosArg95': posts big blind $0.05
*** HOLE CARDS ***
Dealt to Dorex2007 [3s 6h]
Maria'sDad77: folds 
Dorex2007: folds 
BluffOnTable: folds 
 $DCarv13$: folds 
Sticky514: raises $0.12 to $0.17
onlyfoolsguy: folds 
rgrfredy: calls $0.17
zoepaul: folds 
InDiosArg95': folds 
*** FLOP *** [8s Tc 4d]
Sticky514: bets $0.19
rgrfredy: folds 
Uncalled bet ($0.19) returned to Sticky514
Sticky514 collected $0.39 from pot
Sticky514: doesn't show hand 
*** SUMMARY ***
Total pot $0.41 | Rake $0.02 
Board [8s Tc 4d]
Seat 1: Dorex2007 folded before Flop (didn't bet)
Seat 2: BluffOnTable folded before Flop (didn't bet)
Seat 3:  $DCarv13$ folded before Flop (didn't bet)
Seat 4: Sticky514 collected ($0.39)
Seat 5: onlyfoolsguy folded before Flop (didn't bet)
Seat 6: rgrfredy (button) folded on the Flop
Seat 7: zoepaul (small blind) folded before Flop
Seat 8: InDiosArg95' (big blind) folded before Flop
Seat 9: Maria'sDad77 folded before Flop (didn't bet)



PokerStars Hand #238018637004:  Hold'em No Limit ($0.02/$0.05 USD) - 2022/08/15 21:10:36 PT [2022/08/16 0:10:36 ET]
Table 'Alkurah III' 9-max Seat #7 is the button
Seat 1: Dorex2007 ($8.76 in chips) 
Seat 2: BluffOnTable ($5 in chips) 
Seat 3:  $DCarv13$ ($4.25 in chips) 
Seat 4: Sticky514 ($3.07 in chips) 
Seat 5: onlyfoolsguy ($4.23 in chips) 
Seat 6: rgrfredy ($3.27 in chips) 
Seat 7: zoepaul ($10.11 in chips) 
Seat 8: InDiosArg95' ($5.30 in chips) 
Seat 9: Maria'sDad77 ($4 in chips) 
InDiosArg95': posts small blind $0.02
Maria'sDad77: posts big blind $0.05
*** HOLE CARDS ***
Dealt to Dorex2007 [7s 9h]
Dorex2007: folds 
BluffOnTable: folds 
 $DCarv13$: folds 
Sticky514: folds 
onlyfoolsguy: raises $0.10 to $0.15
rgrfredy: calls $0.15
zoepaul: folds 
InDiosArg95': calls $0.13
Maria'sDad77: folds 
*** FLOP *** [7c Jd 4h]
InDiosArg95': checks 
onlyfoolsguy: checks 
rgrfredy: bets $0.16
InDiosArg95': calls $0.16
onlyfoolsguy: calls $0.16
*** TURN *** [7c Jd 4h] [8c]
InDiosArg95': checks 
onlyfoolsguy: checks 
rgrfredy: checks 
*** RIVER *** [7c Jd 4h 8c] [Kh]
InDiosArg95': checks 
onlyfoolsguy: checks 
rgrfredy: checks 
*** SHOW DOWN ***
InDiosArg95': shows [5d 5h] (a pair of Fives)
onlyfoolsguy: shows [Kd Qd] (a pair of Kings)
rgrfredy: mucks hand 
onlyfoolsguy collected $0.94 from pot
*** SUMMARY ***
Total pot $0.98 | Rake $0.04 
Board [7c Jd 4h 8c Kh]
Seat 1: Dorex2007 folded before Flop (didn't bet)
Seat 2: BluffOnTable folded before Flop (didn't bet)
Seat 3:  $DCarv13$ folded before Flop (didn't bet)
Seat 4: Sticky514 folded before Flop (didn't bet)
Seat 5: onlyfoolsguy showed [Kd Qd] and won ($0.94) with a pair of Kings
Seat 6: rgrfredy mucked [Ad 5s]
Seat 7: zoepaul (button) folded before Flop (didn't bet)
Seat 8: InDiosArg95' (small blind) showed [5d 5h] and lost with a pair of Fives
Seat 9: Maria'sDad77 (big blind) folded before Flop



PokerStars Hand #238018646046:  Hold'em No Limit ($0.02/$0.05 USD) - 2022/08/15 21:11:50 PT [2022/08/16 0:11:50 ET]
Table 'Alkurah III' 9-max Seat #8 is the button
Seat 1: Dorex2007 ($8.76 in chips) 
Seat 2: BluffOnTable ($5 in chips) 
Seat 3:  $DCarv13$ ($4.25 in chips) 
Seat 4: Sticky514 ($3.07 in chips) 
Seat 5: onlyfoolsguy ($4.86 in chips) 
Seat 6: rgrfredy ($2.96 in chips) 
Seat 7: zoepaul ($10.11 in chips) 
Seat 8: InDiosArg95' ($4.99 in chips) 
Seat 9: Maria'sDad77 ($4 in chips) 
Maria'sDad77: posts small blind $0.02
Dorex2007: posts big blind $0.05
*** HOLE CARDS ***
Dealt to Dorex2007 [7h 8d]
BluffOnTable: folds 
 $DCarv13$: raises $0.07 to $0.12
Sticky514: calls $0.12
onlyfoolsguy: calls $0.12
rgrfredy: folds 
zoepaul: calls $0.12
InDiosArg95': folds 
Maria'sDad77: folds 
Dorex2007: folds 
*** FLOP *** [4h 4d Ks]
 $DCarv13$: checks 
Sticky514: checks 
onlyfoolsguy: checks 
zoepaul: checks 
*** TURN *** [4h 4d Ks] [7c]
 $DCarv13$: checks 
Sticky514: checks 
onlyfoolsguy: checks 
zoepaul: checks 
*** RIVER *** [4h 4d Ks 7c] [8c]
 $DCarv13$: checks 
Sticky514: checks 
onlyfoolsguy: checks 
zoepaul: checks 
*** SHOW DOWN ***
 $DCarv13$: shows [Jh Qc] (a pair of Fours)
Sticky514: shows [Ac 3d] (a pair of Fours - Ace kicker)
onlyfoolsguy: shows [6d 7d] (two pair, Sevens and Fours)
zoepaul: shows [As 8h] (two pair, Eights and Fours)
zoepaul collected $0.53 from pot
*** SUMMARY ***
Total pot $0.55 | Rake $0.02 
Board [4h 4d Ks 7c 8c]
Seat 1: Dorex2007 (big blind) folded before Flop
Seat 2: BluffOnTable folded before Flop (didn't bet)
Seat 3:  $DCarv13$ showed [Jh Qc] and lost with a pair of Fours
Seat 4: Sticky514 showed [Ac 3d] and lost with a pair of Fours
Seat 5: onlyfoolsguy showed [6d 7d] and lost with two pair, Sevens and Fours
Seat 6: rgrfredy folded before Flop (didn't bet)
Seat 7: zoepaul showed [As 8h] and won ($0.53) with two pair, Eights and Fours
Seat 8: InDiosArg95' (button) folded before Flop (didn't bet)
Seat 9: Maria'sDad77 (small blind) folded before Flop



PokerStars Hand #238018655365:  Hold'em No Limit ($0.02/$0.05 USD) - 2022/08/15 21:13:06 PT [2022/08/16 0:13:06 ET]
Table 'Alkurah III' 9-max Seat #9 is the button
Seat 1: Dorex2007 ($8.71 in chips) 
Seat 2: BluffOnTable ($5 in chips) 
Seat 3:  $DCarv13$ ($4.13 in chips) 
Seat 4: Sticky514 ($2.95 in chips) 
Seat 5: onlyfoolsguy ($4.74 in chips) 
Seat 6: rgrfredy ($2.96 in chips) 
Seat 7: zoepaul ($10.52 in chips) 
Seat 8: InDiosArg95' ($4.99 in chips) 
Seat 9: Maria'sDad77 ($4 in chips) 
Dorex2007: posts small blind $0.02
BluffOnTable: posts big blind $0.05
*** HOLE CARDS ***
Dealt to Dorex2007 [As Td]
 $DCarv13$: folds 
Sticky514: calls $0.05
onlyfoolsguy: folds 
rgrfredy: folds 
zoepaul: raises $0.07 to $0.12
InDiosArg95': folds 
Maria'sDad77: folds 
Dorex2007: folds 
BluffOnTable: folds 
Sticky514: calls $0.07
*** FLOP *** [Ah 8h 7h]
Sticky514: checks 
zoepaul: bets $0.15
Sticky514: calls $0.15
*** TURN *** [Ah 8h 7h] [Jd]
Sticky514: checks 
zoepaul: checks 
*** RIVER *** [Ah 8h 7h Jd] [9h]
Sticky514: bets $0.34
zoepaul: folds 
Uncalled bet ($0.34) returned to Sticky514
Sticky514 collected $0.58 from pot
Sticky514: doesn't show hand 
*** SUMMARY ***
Total pot $0.61 | Rake $0.03 
Board [Ah 8h 7h Jd 9h]
Seat 1: Dorex2007 (small blind) folded before Flop
Seat 2: BluffOnTable (big blind) folded before Flop
Seat 3:  $DCarv13$ folded before Flop (didn't bet)
Seat 4: Sticky514 collected ($0.58)
Seat 5: onlyfoolsguy folded before Flop (didn't bet)
Seat 6: rgrfredy folded before Flop (didn't bet)
Seat 7: zoepaul folded on the River
Seat 8: InDiosArg95' folded before Flop (didn't bet)
Seat 9: Maria'sDad77 (button) folded before Flop (didn't bet)



PokerStars Hand #238018664905:  Hold'em No Limit ($0.02/$0.05 USD) - 2022/08/15 21:14:20 PT [2022/08/16 0:14:20 ET]
Table 'Alkurah III' 9-max Seat #1 is the button
Seat 1: Dorex2007 ($8.69 in chips) 
Seat 2: BluffOnTable ($5 in chips) 
Seat 3:  $DCarv13$ ($4.13 in chips) 
Seat 4: Sticky514 ($3.26 in chips) 
Seat 6: rgrfredy ($2.96 in chips) 
Seat 7: zoepaul ($10.25 in chips) 
Seat 8: InDiosArg95' ($4.99 in chips) 
Seat 9: Maria'sDad77 ($4 in chips) 
BluffOnTable: posts small blind $0.02
 $DCarv13$: posts big blind $0.05
*** HOLE CARDS ***
Dealt to Dorex2007 [9c Ad]
Sticky514: raises $0.05 to $0.10
rgrfredy: calls $0.10
zoepaul: folds 
InDiosArg95': folds 
Maria'sDad77: folds 
Dorex2007: folds 
BluffOnTable: folds 
 $DCarv13$: calls $0.05
*** FLOP *** [4c 4h Jh]
 $DCarv13$: checks 
Sticky514: bets $0.15
rgrfredy: raises $0.15 to $0.30
 $DCarv13$: folds 
Sticky514: calls $0.15
*** TURN *** [4c 4h Jh] [4d]
Sticky514: bets $0.15
rgrfredy: calls $0.15
*** RIVER *** [4c 4h Jh 4d] [Jc]
Sticky514: bets $0.58
rgrfredy: calls $0.58
*** SHOW DOWN ***
Sticky514: shows [7h Ah] (a full house, Fours full of Jacks)
rgrfredy: shows [3h As] (a full house, Fours full of Jacks)
Sticky514 collected $1.14 from pot
rgrfredy collected $1.14 from pot
*** SUMMARY ***
Total pot $2.38 | Rake $0.10 
Board [4c 4h Jh 4d Jc]
Seat 1: Dorex2007 (button) folded before Flop (didn't bet)
Seat 2: BluffOnTable (small blind) folded before Flop
Seat 3:  $DCarv13$ (big blind) folded on the Flop
Seat 4: Sticky514 showed [7h Ah] and won ($1.14) with a full house, Fours full of Jacks
Seat 6: rgrfredy showed [3h As] and won ($1.14) with a full house, Fours full of Jacks
Seat 7: zoepaul folded before Flop (didn't bet)
Seat 8: InDiosArg95' folded before Flop (didn't bet)
Seat 9: Maria'sDad77 folded before Flop (didn't bet)



PokerStars Hand #238018673220:  Hold'em No Limit ($0.02/$0.05 USD) - 2022/08/15 21:15:25 PT [2022/08/16 0:15:25 ET]
Table 'Alkurah III' 9-max Seat #2 is the button
Seat 1: Dorex2007 ($8.69 in chips) 
Seat 2: BluffOnTable ($5 in chips) 
Seat 3:  $DCarv13$ ($4.03 in chips) 
Seat 4: Sticky514 ($3.27 in chips) 
Seat 6: rgrfredy ($2.97 in chips) 
Seat 7: zoepaul ($10.25 in chips) 
Seat 8: InDiosArg95' ($4.99 in chips) 
Seat 9: Maria'sDad77 ($4 in chips) 
 $DCarv13$: posts small blind $0.02
Sticky514: posts big blind $0.05
*** HOLE CARDS ***
Dealt to Dorex2007 [8s 5s]
rgrfredy: folds 
zoepaul: folds 
InDiosArg95': folds 
Maria'sDad77: folds 
Dorex2007: folds 
BluffOnTable: folds 
 $DCarv13$: folds 
Uncalled bet ($0.03) returned to Sticky514
Sticky514 collected $0.04 from pot
Sticky514: doesn't show hand 
*** SUMMARY ***
Total pot $0.04 | Rake $0 
Seat 1: Dorex2007 folded before Flop (didn't bet)
Seat 2: BluffOnTable (button) folded before Flop (didn't bet)
Seat 3:  $DCarv13$ (small blind) folded before Flop
Seat 4: Sticky514 (big blind) collected ($0.04)
Seat 6: rgrfredy folded before Flop (didn't bet)
Seat 7: zoepaul folded before Flop (didn't bet)
Seat 8: InDiosArg95' folded before Flop (didn't bet)
Seat 9: Maria'sDad77 folded before Flop (didn't bet)



PokerStars Hand #238018675531:  Hold'em No Limit ($0.02/$0.05 USD) - 2022/08/15 21:15:45 PT [2022/08/16 0:15:45 ET]
Table 'Alkurah III' 9-max Seat #3 is the button
Seat 1: Dorex2007 ($8.69 in chips) 
Seat 2: BluffOnTable ($5 in chips) 
Seat 3:  $DCarv13$ ($4.01 in chips) 
Seat 4: Sticky514 ($3.29 in chips) 
Seat 6: rgrfredy ($2.97 in chips) 
Seat 7: zoepaul ($10.25 in chips) 
Seat 8: InDiosArg95' ($4.99 in chips) 
Seat 9: Maria'sDad77 ($4 in chips) 
Sticky514: posts small blind $0.02
rgrfredy: posts big blind $0.05
*** HOLE CARDS ***
Dealt to Dorex2007 [Th 5s]
zoepaul: folds 
InDiosArg95': folds 
Maria'sDad77: folds 
Dorex2007: folds 
BluffOnTable: folds 
 $DCarv13$: folds 
Sticky514: folds 
Uncalled bet ($0.03) returned to rgrfredy
rgrfredy collected $0.04 from pot
*** SUMMARY ***
Total pot $0.04 | Rake $0 
Seat 1: Dorex2007 folded before Flop (didn't bet)
Seat 2: BluffOnTable folded before Flop (didn't bet)
Seat 3:  $DCarv13$ (button) folded before Flop (didn't bet)
Seat 4: Sticky514 (small blind) folded before Flop
Seat 6: rgrfredy (big blind) collected ($0.04)
Seat 7: zoepaul folded before Flop (didn't bet)
Seat 8: InDiosArg95' folded before Flop (didn't bet)
Seat 9: Maria'sDad77 folded before Flop (didn't bet)



PokerStars Hand #238018678207:  Hold'em No Limit ($0.02/$0.05 USD) - 2022/08/15 21:16:07 PT [2022/08/16 0:16:07 ET]
Table 'Alkurah III' 9-max Seat #4 is the button
Seat 1: Dorex2007 ($8.69 in chips) 
Seat 2: BluffOnTable ($5 in chips) 
Seat 3:  $DCarv13$ ($4.01 in chips) 
Seat 4: Sticky514 ($3.27 in chips) 
Seat 6: rgrfredy ($2.99 in chips) 
Seat 7: zoepaul ($10.25 in chips) 
Seat 8: InDiosArg95' ($4.99 in chips) 
Seat 9: Maria'sDad77 ($4 in chips) 
rgrfredy: posts small blind $0.02
zoepaul: posts big blind $0.05
*** HOLE CARDS ***
Dealt to Dorex2007 [As Ad]
InDiosArg95': folds 
Maria'sDad77: folds 
Dorex2007: raises $0.05 to $0.10
BluffOnTable: folds 
 $DCarv13$: folds 
Sticky514: calls $0.10
rgrfredy: raises $0.35 to $0.45
zoepaul: folds 
Dorex2007: raises $8.24 to $8.69 and is all-in
Sticky514: folds 
rgrfredy: calls $2.54 and is all-in
Uncalled bet ($5.70) returned to Dorex2007
*** FLOP *** [Qh 2s Qs]
*** TURN *** [Qh 2s Qs] [7c]
*** RIVER *** [Qh 2s Qs 7c] [6d]
*** SHOW DOWN ***
rgrfredy: shows [Jc Jh] (two pair, Queens and Jacks)
Dorex2007: shows [As Ad] (two pair, Aces and Queens)
Dorex2007 cashed out the hand for $4.68 | Cash Out Fee $0.05
rgrfredy cashed out the hand for $1.14 | Cash Out Fee $0.01
*** SUMMARY ***
Total pot $6.13 | Rake $0.25 
Board [Qh 2s Qs 7c 6d]
Seat 1: Dorex2007 showed [As Ad] and won ($5.88) with two pair, Aces and Queens (pot not awarded as player cashed out)
Seat 2: BluffOnTable folded before Flop (didn't bet)
Seat 3:  $DCarv13$ folded before Flop (didn't bet)
Seat 4: Sticky514 (button) folded before Flop
Seat 6: rgrfredy (small blind) showed [Jc Jh] and lost with two pair, Queens and Jacks (cashed out).
Seat 7: zoepaul (big blind) folded before Flop
Seat 8: InDiosArg95' folded before Flop (didn't bet)
Seat 9: Maria'sDad77 folded before Flop (didn't bet)



PokerStars Hand #238018688389:  Hold'em No Limit ($0.02/$0.05 USD) - 2022/08/15 21:17:24 PT [2022/08/16 0:17:24 ET]
Table 'Alkurah III' 9-max Seat #6 is the button
Seat 1: Dorex2007 ($10.38 in chips) 
Seat 2: BluffOnTable ($5 in chips) 
Seat 3:  $DCarv13$ ($4.01 in chips) 
Seat 4: Sticky514 ($3.17 in chips) 
Seat 6: rgrfredy ($1.14 in chips) 
Seat 7: zoepaul ($10.20 in chips) 
Seat 8: InDiosArg95' ($4.99 in chips) 
Seat 9: Maria'sDad77 ($4 in chips) 
zoepaul: posts small blind $0.02
InDiosArg95': posts big blind $0.05
*** HOLE CARDS ***
Dealt to Dorex2007 [4h 5c]
Maria'sDad77: folds 
Dorex2007: folds 
BluffOnTable: folds 
 $DCarv13$: folds 
Sticky514: raises $0.10 to $0.15
rgrfredy: calls $0.15
zoepaul: folds 
InDiosArg95': calls $0.10
*** FLOP *** [Ac 3d Jh]
InDiosArg95': checks 
Sticky514: bets $0.22
rgrfredy: folds 
InDiosArg95': calls $0.22
*** TURN *** [Ac 3d Jh] [6c]
InDiosArg95': checks 
Sticky514: bets $0.33
InDiosArg95': calls $0.33
*** RIVER *** [Ac 3d Jh 6c] [Jc]
InDiosArg95': checks 
Sticky514: bets $0.90
InDiosArg95': folds 
Uncalled bet ($0.90) returned to Sticky514
Sticky514 collected $1.50 from pot
Sticky514: doesn't show hand 
*** SUMMARY ***
Total pot $1.57 | Rake $0.07 
Board [Ac 3d Jh 6c Jc]
Seat 1: Dorex2007 folded before Flop (didn't bet)
Seat 2: BluffOnTable folded before Flop (didn't bet)
Seat 3:  $DCarv13$ folded before Flop (didn't bet)
Seat 4: Sticky514 collected ($1.50)
Seat 6: rgrfredy (button) folded on the Flop
Seat 7: zoepaul (small blind) folded before Flop
Seat 8: InDiosArg95' (big blind) folded on the River
Seat 9: Maria'sDad77 folded before Flop (didn't bet)



PokerStars Hand #238018699829:  Hold'em No Limit ($0.02/$0.05 USD) - 2022/08/15 21:18:59 PT [2022/08/16 0:18:59 ET]
Table 'Alkurah III' 9-max Seat #7 is the button
Seat 1: Dorex2007 ($10.38 in chips) 
Seat 2: BluffOnTable ($5 in chips) 
Seat 3:  $DCarv13$ ($4.01 in chips) 
Seat 4: Sticky514 ($3.97 in chips) 
Seat 5: onlyfoolsguy ($4.74 in chips) 
Seat 6: rgrfredy ($0.99 in chips) 
Seat 7: zoepaul ($10.18 in chips) 
Seat 8: InDiosArg95' ($5 in chips) 
Seat 9: Maria'sDad77 ($4 in chips) 
InDiosArg95': posts small blind $0.02
Maria'sDad77: posts big blind $0.05
onlyfoolsguy: posts small & big blinds $0.07
*** HOLE CARDS ***
Dealt to Dorex2007 [9h Jh]
Dorex2007: folds 
BluffOnTable: folds 
 $DCarv13$: folds 
Sticky514: calls $0.05
onlyfoolsguy: raises $0.22 to $0.27
rgrfredy: folds 
zoepaul: folds 
InDiosArg95': folds 
Maria'sDad77: folds 
Sticky514: folds 
Uncalled bet ($0.22) returned to onlyfoolsguy
onlyfoolsguy collected $0.19 from pot
onlyfoolsguy: doesn't show hand 
*** SUMMARY ***
Total pot $0.19 | Rake $0 
Seat 1: Dorex2007 folded before Flop (didn't bet)
Seat 2: BluffOnTable folded before Flop (didn't bet)
Seat 3:  $DCarv13$ folded before Flop (didn't bet)
Seat 4: Sticky514 folded before Flop
Seat 5: onlyfoolsguy collected ($0.19)
Seat 6: rgrfredy folded before Flop (didn't bet)
Seat 7: zoepaul (button) folded before Flop (didn't bet)
Seat 8: InDiosArg95' (small blind) folded before Flop
Seat 9: Maria'sDad77 (big blind) folded before Flop



PokerStars Hand #238018712162:  Hold'em No Limit ($0.02/$0.05 USD) - 2022/08/15 21:19:41 PT [2022/08/16 0:19:41 ET]
Table 'Alkurah III' 9-max Seat #8 is the button
Seat 1: Dorex2007 ($10.38 in chips) 
Seat 2: BluffOnTable ($5 in chips) 
Seat 3:  $DCarv13$ ($4.01 in chips) 
Seat 4: Sticky514 ($3.92 in chips) 
Seat 5: onlyfoolsguy ($4.86 in chips) 
Seat 6: rgrfredy ($0.99 in chips) 
Seat 7: zoepaul ($10.18 in chips) 
Seat 8: InDiosArg95' ($4.98 in chips) 
Seat 9: Maria'sDad77 ($4 in chips) 
Maria'sDad77: posts small blind $0.02
Dorex2007: posts big blind $0.05
*** HOLE CARDS ***
Dealt to Dorex2007 [Jh Kh]
BluffOnTable: folds 
 $DCarv13$: folds 
Sticky514: folds 
onlyfoolsguy: raises $0.10 to $0.15
rgrfredy: folds 
zoepaul: calls $0.15
InDiosArg95': raises $0.55 to $0.70
Maria'sDad77: folds 
Dorex2007: folds 
onlyfoolsguy: folds 
zoepaul: folds 
Uncalled bet ($0.55) returned to InDiosArg95'
InDiosArg95' collected $0.52 from pot
*** SUMMARY ***
Total pot $0.52 | Rake $0 
Seat 1: Dorex2007 (big blind) folded before Flop
Seat 2: BluffOnTable folded before Flop (didn't bet)
Seat 3:  $DCarv13$ folded before Flop (didn't bet)
Seat 4: Sticky514 folded before Flop (didn't bet)
Seat 5: onlyfoolsguy folded before Flop
Seat 6: rgrfredy folded before Flop (didn't bet)
Seat 7: zoepaul folded before Flop
Seat 8: InDiosArg95' (button) collected ($0.52)
Seat 9: Maria'sDad77 (small blind) folded before Flop



PokerStars Hand #238018718611:  Hold'em No Limit ($0.02/$0.05 USD) - 2022/08/15 21:20:35 PT [2022/08/16 0:20:35 ET]
Table 'Alkurah III' 9-max Seat #9 is the button
Seat 1: Dorex2007 ($10.33 in chips) 
Seat 2: BluffOnTable ($5 in chips) 
Seat 3:  $DCarv13$ ($4.01 in chips) 
Seat 4: Sticky514 ($3.92 in chips) 
Seat 5: onlyfoolsguy ($4.71 in chips) 
Seat 6: rgrfredy ($0.99 in chips) 
Seat 7: zoepaul ($10.03 in chips) 
Seat 8: InDiosArg95' ($5.35 in chips) 
Seat 9: Maria'sDad77 ($4 in chips) 
Dorex2007: posts small blind $0.02
BluffOnTable: posts big blind $0.05
*** HOLE CARDS ***
Dealt to Dorex2007 [4h 5d]
 $DCarv13$: folds 
Sticky514: folds 
onlyfoolsguy: folds 
rgrfredy: folds 
zoepaul: raises $0.07 to $0.12
InDiosArg95': calls $0.12
Maria'sDad77: calls $0.12
Dorex2007: folds 
BluffOnTable: calls $0.07
*** FLOP *** [8h Ts 2s]
BluffOnTable: checks 
zoepaul: bets $0.24
InDiosArg95': folds 
Maria'sDad77: calls $0.24
BluffOnTable: folds 
*** TURN *** [8h Ts 2s] [6d]
zoepaul: bets $0.50
Maria'sDad77: calls $0.50
*** RIVER *** [8h Ts 2s 6d] [Js]
zoepaul: checks 
Maria'sDad77: bets $0.45
zoepaul: calls $0.45
*** SHOW DOWN ***
Maria'sDad77: shows [9s Ks] (a flush, King high)
zoepaul: mucks hand 
Maria'sDad77 collected $2.76 from pot
*** SUMMARY ***
Total pot $2.88 | Rake $0.12 
Board [8h Ts 2s 6d Js]
Seat 1: Dorex2007 (small blind) folded before Flop
Seat 2: BluffOnTable (big blind) folded on the Flop
Seat 3:  $DCarv13$ folded before Flop (didn't bet)
Seat 4: Sticky514 folded before Flop (didn't bet)
Seat 5: onlyfoolsguy folded before Flop (didn't bet)
Seat 6: rgrfredy folded before Flop (didn't bet)
Seat 7: zoepaul mucked [Jd Tc]
Seat 8: InDiosArg95' folded on the Flop
Seat 9: Maria'sDad77 (button) showed [9s Ks] and won ($2.76) with a flush, King high



PokerStars Hand #238018730593:  Hold'em No Limit ($0.02/$0.05 USD) - 2022/08/15 21:22:17 PT [2022/08/16 0:22:17 ET]
Table 'Alkurah III' 9-max Seat #1 is the button
Seat 1: Dorex2007 ($10.31 in chips) 
Seat 2: BluffOnTable ($5 in chips) 
Seat 3:  $DCarv13$ ($4.01 in chips) 
Seat 4: Sticky514 ($3.92 in chips) 
Seat 5: onlyfoolsguy ($4.71 in chips) 
Seat 6: rgrfredy ($0.99 in chips) 
Seat 7: zoepaul ($8.72 in chips) 
Seat 8: InDiosArg95' ($5.23 in chips) 
Seat 9: Maria'sDad77 ($5.45 in chips) 
BluffOnTable: posts small blind $0.02
 $DCarv13$: posts big blind $0.05
*** HOLE CARDS ***
Dealt to Dorex2007 [6c Qc]
Sticky514: raises $0.10 to $0.15
onlyfoolsguy: calls $0.15
rgrfredy: folds 
zoepaul: folds 
InDiosArg95': folds 
Maria'sDad77: folds 
Dorex2007: folds 
BluffOnTable: folds 
 $DCarv13$: folds 
*** FLOP *** [Qh Js 4d]
Sticky514: bets $0.15
onlyfoolsguy: calls $0.15
*** TURN *** [Qh Js 4d] [Jd]
Sticky514: checks 
onlyfoolsguy: checks 
*** RIVER *** [Qh Js 4d Jd] [5d]
Sticky514: bets $0.32
onlyfoolsguy: calls $0.32
*** SHOW DOWN ***
Sticky514: shows [Tc Kd] (a pair of Jacks)
onlyfoolsguy: shows [Qs As] (two pair, Queens and Jacks)
onlyfoolsguy collected $1.26 from pot
*** SUMMARY ***
Total pot $1.31 | Rake $0.05 
Board [Qh Js 4d Jd 5d]
Seat 1: Dorex2007 (button) folded before Flop (didn't bet)
Seat 2: BluffOnTable (small blind) folded before Flop
Seat 3:  $DCarv13$ (big blind) folded before Flop
Seat 4: Sticky514 showed [Tc Kd] and lost with a pair of Jacks
Seat 5: onlyfoolsguy showed [Qs As] and won ($1.26) with two pair, Queens and Jacks
Seat 6: rgrfredy folded before Flop (didn't bet)
Seat 7: zoepaul folded before Flop (didn't bet)
Seat 8: InDiosArg95' folded before Flop (didn't bet)
Seat 9: Maria'sDad77 folded before Flop (didn't bet)



PokerStars Hand #238018738550:  Hold'em No Limit ($0.02/$0.05 USD) - 2022/08/15 21:23:23 PT [2022/08/16 0:23:23 ET]
Table 'Alkurah III' 9-max Seat #2 is the button
Seat 1: Dorex2007 ($10.31 in chips) 
Seat 2: BluffOnTable ($5 in chips) 
Seat 3:  $DCarv13$ ($3.96 in chips) 
Seat 4: Sticky514 ($3.30 in chips) 
Seat 5: onlyfoolsguy ($5.35 in chips) 
Seat 6: rgrfredy ($0.99 in chips) 
Seat 7: zoepaul ($8.72 in chips) 
Seat 8: InDiosArg95' ($5.23 in chips) 
Seat 9: Maria'sDad77 ($5.45 in chips) 
 $DCarv13$: posts small blind $0.02
Sticky514: posts big blind $0.05
*** HOLE CARDS ***
Dealt to Dorex2007 [2c 3h]
onlyfoolsguy: folds 
rgrfredy: raises $0.10 to $0.15
zoepaul: folds 
InDiosArg95': folds 
Maria'sDad77: folds 
Dorex2007: folds 
BluffOnTable: folds 
 $DCarv13$: calls $0.13
Sticky514: calls $0.10
*** FLOP *** [4c Kh 5s]
 $DCarv13$: checks 
Sticky514: checks 
rgrfredy: checks 
*** TURN *** [4c Kh 5s] [Ts]
 $DCarv13$: checks 
Sticky514: bets $0.21
rgrfredy: folds 
 $DCarv13$: folds 
Uncalled bet ($0.21) returned to Sticky514
Sticky514 collected $0.43 from pot
Sticky514: doesn't show hand 
*** SUMMARY ***
Total pot $0.45 | Rake $0.02 
Board [4c Kh 5s Ts]
Seat 1: Dorex2007 folded before Flop (didn't bet)
Seat 2: BluffOnTable (button) folded before Flop (didn't bet)
Seat 3:  $DCarv13$ (small blind) folded on the Turn
Seat 4: Sticky514 (big blind) collected ($0.43)
Seat 5: onlyfoolsguy folded before Flop (didn't bet)
Seat 6: rgrfredy folded on the Turn
Seat 7: zoepaul folded before Flop (didn't bet)
Seat 8: InDiosArg95' folded before Flop (didn't bet)
Seat 9: Maria'sDad77 folded before Flop (didn't bet)



PokerStars Hand #238018745710:  Hold'em No Limit ($0.02/$0.05 USD) - 2022/08/15 21:24:23 PT [2022/08/16 0:24:23 ET]
Table 'Alkurah III' 9-max Seat #3 is the button
Seat 1: Dorex2007 ($10.31 in chips) 
Seat 2: BluffOnTable ($5 in chips) 
Seat 3:  $DCarv13$ ($3.81 in chips) 
Seat 4: Sticky514 ($3.58 in chips) 
Seat 5: onlyfoolsguy ($5.35 in chips) 
Seat 6: rgrfredy ($0.84 in chips) 
Seat 7: zoepaul ($8.72 in chips) 
Seat 8: InDiosArg95' ($5.23 in chips) 
Seat 9: Maria'sDad77 ($5.45 in chips) 
Sticky514: posts small blind $0.02
onlyfoolsguy: posts big blind $0.05
*** HOLE CARDS ***
Dealt to Dorex2007 [Tc 5s]
rgrfredy: folds 
zoepaul: raises $0.10 to $0.15
InDiosArg95': folds 
Maria'sDad77: folds 
Dorex2007: folds 
BluffOnTable: folds 
 $DCarv13$: folds 
Sticky514: calls $0.13
onlyfoolsguy: folds 
*** FLOP *** [7h 8c 4s]
Sticky514: checks 
zoepaul: bets $0.34
Sticky514: folds 
Uncalled bet ($0.34) returned to zoepaul
zoepaul collected $0.34 from pot
*** SUMMARY ***
Total pot $0.35 | Rake $0.01 
Board [7h 8c 4s]
Seat 1: Dorex2007 folded before Flop (didn't bet)
Seat 2: BluffOnTable folded before Flop (didn't bet)
Seat 3:  $DCarv13$ (button) folded before Flop (didn't bet)
Seat 4: Sticky514 (small blind) folded on the Flop
Seat 5: onlyfoolsguy (big blind) folded before Flop
Seat 6: rgrfredy folded before Flop (didn't bet)
Seat 7: zoepaul collected ($0.34)
Seat 8: InDiosArg95' folded before Flop (didn't bet)
Seat 9: Maria'sDad77 folded before Flop (didn't bet)



PokerStars Hand #238018752521:  Hold'em No Limit ($0.02/$0.05 USD) - 2022/08/15 21:25:20 PT [2022/08/16 0:25:20 ET]
Table 'Alkurah III' 9-max Seat #4 is the button
Seat 1: Dorex2007 ($10.31 in chips) 
Seat 2: BluffOnTable ($5 in chips) 
Seat 3:  $DCarv13$ ($3.81 in chips) 
Seat 4: Sticky514 ($3.43 in chips) 
Seat 5: onlyfoolsguy ($5.30 in chips) 
Seat 6: rgrfredy ($0.84 in chips) 
Seat 7: zoepaul ($8.91 in chips) 
Seat 8: InDiosArg95' ($5.23 in chips) 
Seat 9: Maria'sDad77 ($5.45 in chips) 
onlyfoolsguy: posts small blind $0.02
rgrfredy: posts big blind $0.05
*** HOLE CARDS ***
Dealt to Dorex2007 [6c 3d]
zoepaul: raises $0.05 to $0.10
InDiosArg95': folds 
Maria'sDad77: folds 
Dorex2007: folds 
BluffOnTable: folds 
 $DCarv13$: folds 
Sticky514: folds 
onlyfoolsguy: folds 
rgrfredy: calls $0.05
*** FLOP *** [8h Qc Qh]
rgrfredy: checks 
zoepaul: bets $0.21
rgrfredy: folds 
Uncalled bet ($0.21) returned to zoepaul
zoepaul collected $0.21 from pot
*** SUMMARY ***
Total pot $0.22 | Rake $0.01 
Board [8h Qc Qh]
Seat 1: Dorex2007 folded before Flop (didn't bet)
Seat 2: BluffOnTable folded before Flop (didn't bet)
Seat 3:  $DCarv13$ folded before Flop (didn't bet)
Seat 4: Sticky514 (button) folded before Flop (didn't bet)
Seat 5: onlyfoolsguy (small blind) folded before Flop
Seat 6: rgrfredy (big blind) folded on the Flop
Seat 7: zoepaul collected ($0.21)
Seat 8: InDiosArg95' folded before Flop (didn't bet)
Seat 9: Maria'sDad77 folded before Flop (didn't bet)



PokerStars Hand #238018757798:  Hold'em No Limit ($0.02/$0.05 USD) - 2022/08/15 21:26:05 PT [2022/08/16 0:26:05 ET]
Table 'Alkurah III' 9-max Seat #5 is the button
Seat 1: Dorex2007 ($10.31 in chips) 
Seat 2: BluffOnTable ($5 in chips) 
Seat 3:  $DCarv13$ ($3.81 in chips) 
Seat 4: Sticky514 ($3.43 in chips) 
Seat 5: onlyfoolsguy ($5.28 in chips) 
Seat 6: rgrfredy ($0.74 in chips) 
Seat 7: zoepaul ($9.02 in chips) 
Seat 8: InDiosArg95' ($5.23 in chips) 
Seat 9: Maria'sDad77 ($5.45 in chips) 
rgrfredy: posts small blind $0.02
zoepaul: posts big blind $0.05
*** HOLE CARDS ***
Dealt to Dorex2007 [6c Qd]
InDiosArg95': folds 
Maria'sDad77: folds 
Dorex2007: folds 
BluffOnTable: folds 
 $DCarv13$: folds 
Sticky514: calls $0.05
onlyfoolsguy: folds 
rgrfredy: calls $0.03
zoepaul: checks 
*** FLOP *** [7c 3c 4h]
rgrfredy: checks 
zoepaul: checks 
Sticky514: checks 
*** TURN *** [7c 3c 4h] [Kd]
rgrfredy: bets $0.14
zoepaul: folds 
Sticky514: calls $0.14
*** RIVER *** [7c 3c 4h Kd] [Jh]
rgrfredy: bets $0.55 and is all-in
Sticky514: folds 
Uncalled bet ($0.55) returned to rgrfredy
rgrfredy collected $0.41 from pot
*** SUMMARY ***
Total pot $0.43 | Rake $0.02 
Board [7c 3c 4h Kd Jh]
Seat 1: Dorex2007 folded before Flop (didn't bet)
Seat 2: BluffOnTable folded before Flop (didn't bet)
Seat 3:  $DCarv13$ folded before Flop (didn't bet)
Seat 4: Sticky514 folded on the River
Seat 5: onlyfoolsguy (button) folded before Flop (didn't bet)
Seat 6: rgrfredy (small blind) collected ($0.41)
Seat 7: zoepaul (big blind) folded on the Turn
Seat 8: InDiosArg95' folded before Flop (didn't bet)
Seat 9: Maria'sDad77 folded before Flop (didn't bet)



PokerStars Hand #238018767683:  Hold'em No Limit ($0.02/$0.05 USD) - 2022/08/15 21:27:27 PT [2022/08/16 0:27:27 ET]
Table 'Alkurah III' 9-max Seat #6 is the button
Seat 1: Dorex2007 ($10.31 in chips) 
Seat 2: BluffOnTable ($5 in chips) 
Seat 3:  $DCarv13$ ($3.81 in chips) 
Seat 4: Sticky514 ($3.24 in chips) 
Seat 5: onlyfoolsguy ($5.28 in chips) 
Seat 6: rgrfredy ($0.96 in chips) 
Seat 7: zoepaul ($8.97 in chips) 
Seat 8: InDiosArg95' ($5.23 in chips) 
Seat 9: Maria'sDad77 ($5.45 in chips) 
zoepaul: posts small blind $0.02
InDiosArg95': posts big blind $0.05
*** HOLE CARDS ***
Dealt to Dorex2007 [6s 5c]
Maria'sDad77: folds 
Dorex2007: folds 
BluffOnTable: folds 
 $DCarv13$: folds 
Sticky514: raises $0.12 to $0.17
onlyfoolsguy: folds 
rgrfredy: folds 
zoepaul: folds 
InDiosArg95': folds 
Uncalled bet ($0.12) returned to Sticky514
Sticky514 collected $0.12 from pot
Sticky514: doesn't show hand 
*** SUMMARY ***
Total pot $0.12 | Rake $0 
Seat 1: Dorex2007 folded before Flop (didn't bet)
Seat 2: BluffOnTable folded before Flop (didn't bet)
Seat 3:  $DCarv13$ folded before Flop (didn't bet)
Seat 4: Sticky514 collected ($0.12)
Seat 5: onlyfoolsguy folded before Flop (didn't bet)
Seat 6: rgrfredy (button) folded before Flop (didn't bet)
Seat 7: zoepaul (small blind) folded before Flop
Seat 8: InDiosArg95' (big blind) folded before Flop
Seat 9: Maria'sDad77 folded before Flop (didn't bet)



PokerStars Hand #238018771930:  Hold'em No Limit ($0.02/$0.05 USD) - 2022/08/15 21:28:03 PT [2022/08/16 0:28:03 ET]
Table 'Alkurah III' 9-max Seat #7 is the button
Seat 1: Dorex2007 ($10.31 in chips) 
Seat 2: BluffOnTable ($5 in chips) 
Seat 3:  $DCarv13$ ($3.81 in chips) 
Seat 4: Sticky514 ($3.31 in chips) 
Seat 5: onlyfoolsguy ($5.28 in chips) 
Seat 6: rgrfredy ($0.96 in chips) 
Seat 7: zoepaul ($8.95 in chips) 
Seat 8: InDiosArg95' ($5.18 in chips) 
Seat 9: Maria'sDad77 ($5.45 in chips) 
InDiosArg95': posts small blind $0.02
Maria'sDad77: posts big blind $0.05
*** HOLE CARDS ***
Dealt to Dorex2007 [6h 8c]
Dorex2007: folds 
BluffOnTable: folds 
 $DCarv13$: folds 
Sticky514: raises $0.05 to $0.10
onlyfoolsguy: raises $0.38 to $0.48
rgrfredy: folds 
zoepaul: folds 
InDiosArg95': folds 
Maria'sDad77: folds 
Sticky514: folds 
Uncalled bet ($0.38) returned to onlyfoolsguy
onlyfoolsguy collected $0.27 from pot
onlyfoolsguy: doesn't show hand 
*** SUMMARY ***
Total pot $0.27 | Rake $0 
Seat 1: Dorex2007 folded before Flop (didn't bet)
Seat 2: BluffOnTable folded before Flop (didn't bet)
Seat 3:  $DCarv13$ folded before Flop (didn't bet)
Seat 4: Sticky514 folded before Flop
Seat 5: onlyfoolsguy collected ($0.27)
Seat 6: rgrfredy folded before Flop (didn't bet)
Seat 7: zoepaul (button) folded before Flop (didn't bet)
Seat 8: InDiosArg95' (small blind) folded before Flop
Seat 9: Maria'sDad77 (big blind) folded before Flop



PokerStars Hand #238018775571:  Hold'em No Limit ($0.02/$0.05 USD) - 2022/08/15 21:28:33 PT [2022/08/16 0:28:33 ET]
Table 'Alkurah III' 9-max Seat #8 is the button
Seat 1: Dorex2007 ($10.31 in chips) 
Seat 2: BluffOnTable ($5 in chips) 
Seat 3:  $DCarv13$ ($3.81 in chips) 
Seat 4: Sticky514 ($3.21 in chips) 
Seat 5: onlyfoolsguy ($5.45 in chips) 
Seat 6: rgrfredy ($0.96 in chips) 
Seat 7: zoepaul ($8.95 in chips) 
Seat 8: InDiosArg95' ($5.16 in chips) 
Seat 9: Maria'sDad77 ($5.40 in chips) 
Maria'sDad77: posts small blind $0.02
Dorex2007: posts big blind $0.05
*** HOLE CARDS ***
Dealt to Dorex2007 [2d Jd]
BluffOnTable: folds 
 $DCarv13$: folds 
Sticky514: calls $0.05
onlyfoolsguy: folds 
rgrfredy: raises $0.10 to $0.15
zoepaul: folds 
InDiosArg95': folds 
Maria'sDad77: folds 
Dorex2007: calls $0.10
Sticky514: calls $0.10
*** FLOP *** [6d 2c 3h]
Dorex2007: bets $0.45
Sticky514: folds 
rgrfredy: raises $0.36 to $0.81 and is all-in
Dorex2007: calls $0.36
*** TURN *** [6d 2c 3h] [Kh]
*** RIVER *** [6d 2c 3h Kh] [7c]
*** SHOW DOWN ***
Dorex2007: shows [2d Jd] (a pair of Deuces)
rgrfredy: shows [Kc Js] (a pair of Kings)
rgrfredy collected $2 from pot
Dorex2007 cashed out the hand for $1.70 | Cash Out Fee $0.02
*** SUMMARY ***
Total pot $2.09 | Rake $0.09 
Board [6d 2c 3h Kh 7c]
Seat 1: Dorex2007 (big blind) showed [2d Jd] and lost with a pair of Deuces (cashed out).
Seat 2: BluffOnTable folded before Flop (didn't bet)
Seat 3:  $DCarv13$ folded before Flop (didn't bet)
Seat 4: Sticky514 folded on the Flop
Seat 5: onlyfoolsguy folded before Flop (didn't bet)
Seat 6: rgrfredy showed [Kc Js] and won ($2) with a pair of Kings
Seat 7: zoepaul folded before Flop (didn't bet)
Seat 8: InDiosArg95' (button) folded before Flop (didn't bet)
Seat 9: Maria'sDad77 (small blind) folded before Flop



PokerStars Hand #238018793641:  Hold'em No Limit ($0.02/$0.05 USD) - 2022/08/15 21:29:46 PT [2022/08/16 0:29:46 ET]
Table 'Alkurah III' 9-max Seat #9 is the button
Seat 1: Dorex2007 ($11.05 in chips) 
Seat 2: BluffOnTable ($5 in chips) 
Seat 3:  $DCarv13$ ($3.81 in chips) 
Seat 4: Sticky514 ($3.06 in chips) 
Seat 5: onlyfoolsguy ($5.45 in chips) 
Seat 6: rgrfredy ($2 in chips) 
Seat 7: zoepaul ($8.95 in chips) 
Seat 8: InDiosArg95' ($5.16 in chips) 
Seat 9: Maria'sDad77 ($5.38 in chips) 
Dorex2007: posts small blind $0.02
BluffOnTable: posts big blind $0.05
*** HOLE CARDS ***
Dealt to Dorex2007 [Td 7h]
 $DCarv13$: folds 
Sticky514: raises $0.12 to $0.17
onlyfoolsguy: folds 
rgrfredy: raises $0.41 to $0.58
zoepaul: folds 
InDiosArg95': folds 
Maria'sDad77: folds 
Dorex2007: folds 
BluffOnTable: folds 
Sticky514: calls $0.41
*** FLOP *** [Tc Ts 2h]
Sticky514: bets $2.48 and is all-in
rgrfredy: calls $1.42 and is all-in
Uncalled bet ($1.06) returned to Sticky514
*** TURN *** [Tc Ts 2h] [4s]
*** RIVER *** [Tc Ts 2h 4s] [9d]
*** SHOW DOWN ***
Sticky514: shows [5d 5s] (two pair, Tens and Fives)
rgrfredy: shows [4d 4c] (a full house, Fours full of Tens)
rgrfredy collected $3.90 from pot
*** SUMMARY ***
Total pot $4.07 | Rake $0.17 
Board [Tc Ts 2h 4s 9d]
Seat 1: Dorex2007 (small blind) folded before Flop
Seat 2: BluffOnTable (big blind) folded before Flop
Seat 3:  $DCarv13$ folded before Flop (didn't bet)
Seat 4: Sticky514 showed [5d 5s] and lost with two pair, Tens and Fives
Seat 5: onlyfoolsguy folded before Flop (didn't bet)
Seat 6: rgrfredy showed [4d 4c] and won ($3.90) with a full house, Fours full of Tens
Seat 7: zoepaul folded before Flop (didn't bet)
Seat 8: InDiosArg95' folded before Flop (didn't bet)
Seat 9: Maria'sDad77 (button) folded before Flop (didn't bet)



PokerStars Hand #238018803246:  Hold'em No Limit ($0.02/$0.05 USD) - 2022/08/15 21:31:08 PT [2022/08/16 0:31:08 ET]
Table 'Alkurah III' 9-max Seat #1 is the button
Seat 1: Dorex2007 ($11.03 in chips) 
Seat 2: BluffOnTable ($5 in chips) 
Seat 3:  $DCarv13$ ($3.81 in chips) 
Seat 4: Sticky514 ($1.06 in chips) 
Seat 5: onlyfoolsguy ($5.45 in chips) 
Seat 6: rgrfredy ($3.90 in chips) 
Seat 7: zoepaul ($8.95 in chips) 
Seat 8: InDiosArg95' ($5.16 in chips) 
Seat 9: Maria'sDad77 ($5.38 in chips) 
BluffOnTable: posts small blind $0.02
 $DCarv13$: posts big blind $0.05
*** HOLE CARDS ***
Dealt to Dorex2007 [Qs 7h]
Sticky514: folds 
onlyfoolsguy: folds 
rgrfredy: folds 
zoepaul: raises $0.10 to $0.15
rgrfredy leaves the table
InDiosArg95': folds 
Maria'sDad77: folds 
Dorex2007: folds 
BluffOnTable: folds 
 $DCarv13$: folds 
Uncalled bet ($0.10) returned to zoepaul
zoepaul collected $0.12 from pot
*** SUMMARY ***
Total pot $0.12 | Rake $0 
Seat 1: Dorex2007 (button) folded before Flop (didn't bet)
Seat 2: BluffOnTable (small blind) folded before Flop
Seat 3:  $DCarv13$ (big blind) folded before Flop
Seat 4: Sticky514 folded before Flop (didn't bet)
Seat 5: onlyfoolsguy folded before Flop (didn't bet)
Seat 6: rgrfredy folded before Flop (didn't bet)
Seat 7: zoepaul collected ($0.12)
Seat 8: InDiosArg95' folded before Flop (didn't bet)
Seat 9: Maria'sDad77 folded before Flop (didn't bet)



PokerStars Hand #238018805901:  Hold'em No Limit ($0.02/$0.05 USD) - 2022/08/15 21:31:32 PT [2022/08/16 0:31:32 ET]
Table 'Alkurah III' 9-max Seat #2 is the button
Seat 1: Dorex2007 ($11.03 in chips) 
Seat 2: BluffOnTable ($5 in chips) 
Seat 3:  $DCarv13$ ($3.76 in chips) 
Seat 5: onlyfoolsguy ($5.45 in chips) 
Seat 7: zoepaul ($9.02 in chips) 
Seat 8: InDiosArg95' ($5.16 in chips) 
Seat 9: Maria'sDad77 ($5.38 in chips) 
 $DCarv13$: posts small blind $0.02
Sticky514: is sitting out 
onlyfoolsguy: posts big blind $0.05
*** HOLE CARDS ***
Dealt to Dorex2007 [3s Ts]
zoepaul: calls $0.05
InDiosArg95': folds 
Maria'sDad77: folds 
Sticky514 leaves the table
Dorex2007: folds 
BluffOnTable: folds 
 $DCarv13$: folds 
onlyfoolsguy: checks 
*** FLOP *** [2d Kh Js]
onlyfoolsguy: checks 
zoepaul: bets $0.05
onlyfoolsguy: folds 
Uncalled bet ($0.05) returned to zoepaul
zoepaul collected $0.12 from pot
*** SUMMARY ***
Total pot $0.12 | Rake $0 
Board [2d Kh Js]
Seat 1: Dorex2007 folded before Flop (didn't bet)
Seat 2: BluffOnTable (button) folded before Flop (didn't bet)
Seat 3:  $DCarv13$ (small blind) folded before Flop
Seat 5: onlyfoolsguy (big blind) folded on the Flop
Seat 7: zoepaul collected ($0.12)
Seat 8: InDiosArg95' folded before Flop (didn't bet)
Seat 9: Maria'sDad77 folded before Flop (didn't bet)



PokerStars Hand #238018811806:  Hold'em No Limit ($0.02/$0.05 USD) - 2022/08/15 21:32:22 PT [2022/08/16 0:32:22 ET]
Table 'Alkurah III' 9-max Seat #3 is the button
Seat 1: Dorex2007 ($11.03 in chips) 
Seat 2: BluffOnTable ($5 in chips) 
Seat 3:  $DCarv13$ ($3.74 in chips) 
Seat 5: onlyfoolsguy ($5.40 in chips) 
Seat 7: zoepaul ($9.09 in chips) 
Seat 8: InDiosArg95' ($5.16 in chips) 
Seat 9: Maria'sDad77 ($5.38 in chips) 
onlyfoolsguy: posts small blind $0.02
zoepaul: posts big blind $0.05
*** HOLE CARDS ***
Dealt to Dorex2007 [5d 5s]
InDiosArg95': folds 
Maria'sDad77: folds 
Dorex2007: raises $0.15 to $0.20
fantome75 joins the table at seat #4 
moitzigu joins the table at seat #6 
BluffOnTable: folds 
 $DCarv13$: folds 
onlyfoolsguy: calls $0.18
zoepaul: folds 
*** FLOP *** [Th 4h 5c]
onlyfoolsguy: checks 
Dorex2007: bets $0.43
onlyfoolsguy: folds 
Uncalled bet ($0.43) returned to Dorex2007
Dorex2007 collected $0.43 from pot
Dorex2007: doesn't show hand 
*** SUMMARY ***
Total pot $0.45 | Rake $0.02 
Board [Th 4h 5c]
Seat 1: Dorex2007 collected ($0.43)
Seat 2: BluffOnTable folded before Flop (didn't bet)
Seat 3:  $DCarv13$ (button) folded before Flop (didn't bet)
Seat 5: onlyfoolsguy (small blind) folded on the Flop
Seat 7: zoepaul (big blind) folded before Flop
Seat 8: InDiosArg95' folded before Flop (didn't bet)
Seat 9: Maria'sDad77 folded before Flop (didn't bet)



PokerStars Hand #238018825402:  Hold'em No Limit ($0.02/$0.05 USD) - 2022/08/15 21:33:16 PT [2022/08/16 0:33:16 ET]
Table 'Alkurah III' 9-max Seat #7 is the button
Seat 1: Dorex2007 ($11.26 in chips) 
Seat 2: BluffOnTable ($5 in chips) 
Seat 3:  $DCarv13$ ($3.74 in chips) 
Seat 4: fantome75 ($4 in chips) 
Seat 7: zoepaul ($9.04 in chips) 
Seat 8: InDiosArg95' ($5.16 in chips) 
Seat 9: Maria'sDad77 ($5.38 in chips) 
InDiosArg95': posts small blind $0.02
Maria'sDad77: posts big blind $0.05
fantome75: posts big blind $0.05
moitzigu: sits out 
*** HOLE CARDS ***
Dealt to Dorex2007 [Kc Td]
Dorex2007: folds 
BluffOnTable: folds 
 $DCarv13$: folds 
fantome75: checks 
zoepaul: folds 
InDiosArg95': folds 
Maria'sDad77: checks 
*** FLOP *** [4d Jc 6s]
Maria'sDad77: checks 
fantome75: checks 
*** TURN *** [4d Jc 6s] [4h]
Maria'sDad77: checks 
fantome75: checks 
*** RIVER *** [4d Jc 6s 4h] [6d]
Maria'sDad77: checks 
fantome75: checks 
*** SHOW DOWN ***
Maria'sDad77: shows [Qs 8h] (two pair, Sixes and Fours)
fantome75: shows [5s As] (two pair, Sixes and Fours - Ace kicker)
fantome75 collected $0.12 from pot
*** SUMMARY ***
Total pot $0.12 | Rake $0 
Board [4d Jc 6s 4h 6d]
Seat 1: Dorex2007 folded before Flop (didn't bet)
Seat 2: BluffOnTable folded before Flop (didn't bet)
Seat 3:  $DCarv13$ folded before Flop (didn't bet)
Seat 4: fantome75 showed [5s As] and won ($0.12) with two pair, Sixes and Fours
Seat 7: zoepaul (button) folded before Flop (didn't bet)
Seat 8: InDiosArg95' (small blind) folded before Flop
Seat 9: Maria'sDad77 (big blind) showed [Qs 8h] and lost with two pair, Sixes and Fours



PokerStars Hand #238018831152:  Hold'em No Limit ($0.02/$0.05 USD) - 2022/08/15 21:34:06 PT [2022/08/16 0:34:06 ET]
Table 'Alkurah III' 9-max Seat #8 is the button
Seat 1: Dorex2007 ($11.26 in chips) 
Seat 2: BluffOnTable ($5 in chips) 
Seat 3:  $DCarv13$ ($3.74 in chips) 
Seat 4: fantome75 ($4.07 in chips) 
Seat 7: zoepaul ($9.04 in chips) 
Seat 8: InDiosArg95' ($5.14 in chips) 
Seat 9: Maria'sDad77 ($5.33 in chips) 
Maria'sDad77: posts small blind $0.02
Dorex2007: posts big blind $0.05
moitzigu: sits out 
*** HOLE CARDS ***
Dealt to Dorex2007 [5h 9d]
BluffOnTable: folds 
 $DCarv13$: folds 
fantome75: calls $0.05
zoepaul: raises $0.10 to $0.15
InDiosArg95': folds 
Maria'sDad77: calls $0.13
Dorex2007: folds 
fantome75: calls $0.10
*** FLOP *** [9c 3h 7h]
Maria'sDad77: checks 
fantome75: checks 
zoepaul: bets $0.30
Maria'sDad77: folds 
fantome75: calls $0.30
*** TURN *** [9c 3h 7h] [Tc]
fantome75: checks 
zoepaul: bets $0.75
fantome75: folds 
Uncalled bet ($0.75) returned to zoepaul
zoepaul collected $1.05 from pot
*** SUMMARY ***
Total pot $1.10 | Rake $0.05 
Board [9c 3h 7h Tc]
Seat 1: Dorex2007 (big blind) folded before Flop
Seat 2: BluffOnTable folded before Flop (didn't bet)
Seat 3:  $DCarv13$ folded before Flop (didn't bet)
Seat 4: fantome75 folded on the Turn
Seat 7: zoepaul collected ($1.05)
Seat 8: InDiosArg95' (button) folded before Flop (didn't bet)
Seat 9: Maria'sDad77 (small blind) folded on the Flop



PokerStars Hand #238018840249:  Hold'em No Limit ($0.02/$0.05 USD) - 2022/08/15 21:35:25 PT [2022/08/16 0:35:25 ET]
Table 'Alkurah III' 9-max Seat #9 is the button
Seat 1: Dorex2007 ($11.21 in chips) 
Seat 2: BluffOnTable ($5 in chips) 
Seat 3:  $DCarv13$ ($3.74 in chips) 
Seat 4: fantome75 ($3.62 in chips) 
Seat 7: zoepaul ($9.64 in chips) 
Seat 8: InDiosArg95' ($5.14 in chips) 
Seat 9: Maria'sDad77 ($5.18 in chips) 
Dorex2007: posts small blind $0.02
BluffOnTable: posts big blind $0.05
moitzigu: sits out 
*** HOLE CARDS ***
Dealt to Dorex2007 [2d 2h]
 $DCarv13$: folds 
fantome75: calls $0.05
zoepaul: folds 
InDiosArg95': folds 
Maria'sDad77: folds 
Dorex2007: calls $0.03
BluffOnTable: checks 
*** FLOP *** [8d 8s 9c]
Dorex2007: checks 
BluffOnTable: checks 
fantome75: checks 
*** TURN *** [8d 8s 9c] [4h]
Dorex2007: checks 
BluffOnTable: checks 
 $DCarv13$ leaves the table
fantome75: checks 
*** RIVER *** [8d 8s 9c 4h] [Ts]
Dorex2007: checks 
BluffOnTable: checks 
fantome75: checks 
*** SHOW DOWN ***
Dorex2007: shows [2d 2h] (two pair, Eights and Deuces)
BluffOnTable: shows [7h Th] (two pair, Tens and Eights)
fantome75: mucks hand 
BluffOnTable collected $0.14 from pot
*** SUMMARY ***
Total pot $0.15 | Rake $0.01 
Board [8d 8s 9c 4h Ts]
Seat 1: Dorex2007 (small blind) showed [2d 2h] and lost with two pair, Eights and Deuces
Seat 2: BluffOnTable (big blind) showed [7h Th] and won ($0.14) with two pair, Tens and Eights
Seat 3:  $DCarv13$ folded before Flop (didn't bet)
Seat 4: fantome75 mucked [6s Ad]
Seat 7: zoepaul folded before Flop (didn't bet)
Seat 8: InDiosArg95' folded before Flop (didn't bet)
Seat 9: Maria'sDad77 (button) folded before Flop (didn't bet)



PokerStars Hand #238018845457:  Hold'em No Limit ($0.02/$0.05 USD) - 2022/08/15 21:36:10 PT [2022/08/16 0:36:10 ET]
Table 'Alkurah III' 9-max Seat #1 is the button
Seat 1: Dorex2007 ($11.16 in chips) 
Seat 2: BluffOnTable ($5.09 in chips) 
Seat 4: fantome75 ($3.57 in chips) 
Seat 6: moitzigu ($5 in chips) 
Seat 7: zoepaul ($9.64 in chips) 
Seat 8: InDiosArg95' ($5.14 in chips) 
Seat 9: Maria'sDad77 ($5.18 in chips) 
BluffOnTable: posts small blind $0.02
fantome75: posts big blind $0.05
moitzigu: posts big blind $0.05
*** HOLE CARDS ***
Dealt to Dorex2007 [3c Td]
moitzigu: checks 
zoepaul has timed out
zoepaul: folds 
Nicolas Trin joins the table at seat #3 
InDiosArg95': folds 
Maria'sDad77: folds 
Dorex2007: folds 
BluffOnTable: folds 
fantome75: checks 
*** FLOP *** [5s Ah Kh]
fantome75: checks 
moitzigu: bets $0.05
fantome75: folds 
Uncalled bet ($0.05) returned to moitzigu
moitzigu collected $0.12 from pot
moitzigu: doesn't show hand 
*** SUMMARY ***
Total pot $0.12 | Rake $0 
Board [5s Ah Kh]
Seat 1: Dorex2007 (button) folded before Flop (didn't bet)
Seat 2: BluffOnTable (small blind) folded before Flop
Seat 4: fantome75 (big blind) folded on the Flop
Seat 6: moitzigu collected ($0.12)
Seat 7: zoepaul folded before Flop (didn't bet)
Seat 8: InDiosArg95' folded before Flop (didn't bet)
Seat 9: Maria'sDad77 folded before Flop (didn't bet)



PokerStars Hand #238018850610:  Hold'em No Limit ($0.02/$0.05 USD) - 2022/08/15 21:36:55 PT [2022/08/16 0:36:55 ET]
Table 'Alkurah III' 9-max Seat #2 is the button
Seat 1: Dorex2007 ($11.16 in chips) 
Seat 2: BluffOnTable ($5.07 in chips) 
Seat 4: fantome75 ($3.52 in chips) 
Seat 6: moitzigu ($5.07 in chips) 
Seat 7: zoepaul ($9.64 in chips) 
Seat 8: InDiosArg95' ($5.14 in chips) 
Seat 9: Maria'sDad77 ($5.18 in chips) 
fantome75: posts small blind $0.02
moitzigu: posts big blind $0.05
*** HOLE CARDS ***
Dealt to Dorex2007 [Ah 7c]
zoepaul: folds 
InDiosArg95': folds 
Maria'sDad77: folds 
Dorex2007: folds 
BluffOnTable: folds 
fantome75: calls $0.03
moitzigu: checks 
*** FLOP *** [2c 9d 8d]
fantome75: checks 
moitzigu: bets $0.05
fantome75: calls $0.05
*** TURN *** [2c 9d 8d] [Js]
fantome75: checks 
moitzigu: bets $0.10
fantome75: calls $0.10
*** RIVER *** [2c 9d 8d Js] [3s]
fantome75: checks 
moitzigu: bets $0.20
fantome75: folds 
Uncalled bet ($0.20) returned to moitzigu
moitzigu collected $0.38 from pot
moitzigu: doesn't show hand 
*** SUMMARY ***
Total pot $0.40 | Rake $0.02 
Board [2c 9d 8d Js 3s]
Seat 1: Dorex2007 folded before Flop (didn't bet)
Seat 2: BluffOnTable (button) folded before Flop (didn't bet)
Seat 4: fantome75 (small blind) folded on the River
Seat 6: moitzigu (big blind) collected ($0.38)
Seat 7: zoepaul folded before Flop (didn't bet)
Seat 8: InDiosArg95' folded before Flop (didn't bet)
Seat 9: Maria'sDad77 folded before Flop (didn't bet)



PokerStars Hand #238018857781:  Hold'em No Limit ($0.02/$0.05 USD) - 2022/08/15 21:37:57 PT [2022/08/16 0:37:57 ET]
Table 'Alkurah III' 9-max Seat #4 is the button
Seat 1: Dorex2007 ($11.16 in chips) 
Seat 2: BluffOnTable ($5.07 in chips) 
Seat 4: fantome75 ($3.32 in chips) 
Seat 6: moitzigu ($5.25 in chips) 
Seat 7: zoepaul ($9.64 in chips) 
Seat 8: InDiosArg95' ($5.14 in chips) 
Seat 9: Maria'sDad77 ($5.18 in chips) 
moitzigu: posts small blind $0.02
zoepaul: posts big blind $0.05
Nicolas Trin: sits out 
*** HOLE CARDS ***
Dealt to Dorex2007 [6d 9h]
InDiosArg95': folds 
Maria'sDad77: folds 
Dorex2007: folds 
BluffOnTable: folds 
fantome75: calls $0.05
moitzigu: calls $0.03
zoepaul: checks 
*** FLOP *** [6s Qs 3d]
moitzigu: checks 
zoepaul: bets $0.14
fantome75: folds 
moitzigu: folds 
Uncalled bet ($0.14) returned to zoepaul
zoepaul collected $0.14 from pot
*** SUMMARY ***
Total pot $0.15 | Rake $0.01 
Board [6s Qs 3d]
Seat 1: Dorex2007 folded before Flop (didn't bet)
Seat 2: BluffOnTable folded before Flop (didn't bet)
Seat 4: fantome75 (button) folded on the Flop
Seat 6: moitzigu (small blind) folded on the Flop
Seat 7: zoepaul (big blind) collected ($0.14)
Seat 8: InDiosArg95' folded before Flop (didn't bet)
Seat 9: Maria'sDad77 folded before Flop (didn't bet)



PokerStars Hand #238018863243:  Hold'em No Limit ($0.02/$0.05 USD) - 2022/08/15 21:38:44 PT [2022/08/16 0:38:44 ET]
Table 'Alkurah III' 9-max Seat #6 is the button
Seat 1: Dorex2007 ($11.16 in chips) 
Seat 2: BluffOnTable ($5.07 in chips) 
Seat 4: fantome75 ($3.27 in chips) 
Seat 6: moitzigu ($5.20 in chips) 
Seat 7: zoepaul ($9.73 in chips) 
Seat 8: InDiosArg95' ($5.14 in chips) 
Seat 9: Maria'sDad77 ($5.18 in chips) 
zoepaul: posts small blind $0.02
InDiosArg95': posts big blind $0.05
Nicolas Trin: sits out 
*** HOLE CARDS ***
Dealt to Dorex2007 [Qh 6c]
Maria'sDad77: folds 
Dorex2007: folds 
BluffOnTable: folds 
fantome75: raises $0.10 to $0.15
moitzigu: folds 
zoepaul: folds 
InDiosArg95': calls $0.10
*** FLOP *** [Jc 7d Kh]
InDiosArg95': checks 
fantome75: bets $0.15
InDiosArg95': folds 
Uncalled bet ($0.15) returned to fantome75
fantome75 collected $0.31 from pot
fantome75: doesn't show hand 
*** SUMMARY ***
Total pot $0.32 | Rake $0.01 
Board [Jc 7d Kh]
Seat 1: Dorex2007 folded before Flop (didn't bet)
Seat 2: BluffOnTable folded before Flop (didn't bet)
Seat 4: fantome75 collected ($0.31)
Seat 6: moitzigu (button) folded before Flop (didn't bet)
Seat 7: zoepaul (small blind) folded before Flop
Seat 8: InDiosArg95' (big blind) folded on the Flop
Seat 9: Maria'sDad77 folded before Flop (didn't bet)



PokerStars Hand #238018868563:  Hold'em No Limit ($0.02/$0.05 USD) - 2022/08/15 21:39:30 PT [2022/08/16 0:39:30 ET]
Table 'Alkurah III' 9-max Seat #7 is the button
Seat 1: Dorex2007 ($11.16 in chips) 
Seat 2: BluffOnTable ($5.07 in chips) 
Seat 4: fantome75 ($3.43 in chips) 
Seat 6: moitzigu ($5.20 in chips) 
Seat 7: zoepaul ($9.71 in chips) 
Seat 8: InDiosArg95' ($4.99 in chips) 
Seat 9: Maria'sDad77 ($5.18 in chips) 
InDiosArg95': posts small blind $0.02
Maria'sDad77: posts big blind $0.05
Nicolas Trin: sits out 
*** HOLE CARDS ***
Dealt to Dorex2007 [Jc Jd]
Dorex2007: raises $0.20 to $0.25
BluffOnTable: calls $0.25
fantome75: folds 
moitzigu: folds 
zoepaul: calls $0.25
InDiosArg95': folds 
Maria'sDad77: folds 
*** FLOP *** [Th 3s 7d]
Dorex2007: bets $10.91 and is all-in
BluffOnTable: folds 
zoepaul: folds 
Uncalled bet ($10.91) returned to Dorex2007
Dorex2007 collected $0.79 from pot
Dorex2007: doesn't show hand 
*** SUMMARY ***
Total pot $0.82 | Rake $0.03 
Board [Th 3s 7d]
Seat 1: Dorex2007 collected ($0.79)
Seat 2: BluffOnTable folded on the Flop
Seat 4: fantome75 folded before Flop (didn't bet)
Seat 6: moitzigu folded before Flop (didn't bet)
Seat 7: zoepaul (button) folded on the Flop
Seat 8: InDiosArg95' (small blind) folded before Flop
Seat 9: Maria'sDad77 (big blind) folded before Flop



PokerStars Hand #238018874795:  Hold'em No Limit ($0.02/$0.05 USD) - 2022/08/15 21:40:24 PT [2022/08/16 0:40:24 ET]
Table 'Alkurah III' 9-max Seat #8 is the button
Seat 1: Dorex2007 ($11.70 in chips) 
Seat 2: BluffOnTable ($5 in chips) 
Seat 4: fantome75 ($3.43 in chips) 
Seat 6: moitzigu ($5.20 in chips) 
Seat 7: zoepaul ($9.46 in chips) 
Seat 8: InDiosArg95' ($4.97 in chips) 
Seat 9: Maria'sDad77 ($5.13 in chips) 
Maria'sDad77: posts small blind $0.02
Dorex2007: posts big blind $0.05
Nicolas Trin: sits out 
*** HOLE CARDS ***
Dealt to Dorex2007 [7c Tc]
BluffOnTable: folds 
fantome75: folds 
moitzigu: folds 
zoepaul: folds 
InDiosArg95': folds 
Maria'sDad77: folds 
Uncalled bet ($0.03) returned to Dorex2007
Dorex2007 collected $0.04 from pot
Dorex2007: doesn't show hand 
*** SUMMARY ***
Total pot $0.04 | Rake $0 
Seat 1: Dorex2007 (big blind) collected ($0.04)
Seat 2: BluffOnTable folded before Flop (didn't bet)
Seat 4: fantome75 folded before Flop (didn't bet)
Seat 6: moitzigu folded before Flop (didn't bet)
Seat 7: zoepaul folded before Flop (didn't bet)
Seat 8: InDiosArg95' (button) folded before Flop (didn't bet)
Seat 9: Maria'sDad77 (small blind) folded before Flop



PokerStars Hand #238018876370:  Hold'em No Limit ($0.02/$0.05 USD) - 2022/08/15 21:40:38 PT [2022/08/16 0:40:38 ET]
Table 'Alkurah III' 9-max Seat #9 is the button
Seat 1: Dorex2007 ($11.72 in chips) 
Seat 2: BluffOnTable ($5 in chips) 
Seat 4: fantome75 ($3.43 in chips) 
Seat 6: moitzigu ($5.20 in chips) 
Seat 7: zoepaul ($9.46 in chips) 
Seat 8: InDiosArg95' ($4.97 in chips) 
Seat 9: Maria'sDad77 ($5.11 in chips) 
Dorex2007: posts small blind $0.02
BluffOnTable: posts big blind $0.05
Nicolas Trin: sits out 
*** HOLE CARDS ***
Dealt to Dorex2007 [Ah 2d]
fantome75: folds 
moitzigu: folds 
zoepaul: raises $0.10 to $0.15
InDiosArg95': folds 
Maria'sDad77: folds 
Dorex2007: folds 
BluffOnTable: folds 
Uncalled bet ($0.10) returned to zoepaul
zoepaul collected $0.12 from pot
*** SUMMARY ***
Total pot $0.12 | Rake $0 
Seat 1: Dorex2007 (small blind) folded before Flop
Seat 2: BluffOnTable (big blind) folded before Flop
Seat 4: fantome75 folded before Flop (didn't bet)
Seat 6: moitzigu folded before Flop (didn't bet)
Seat 7: zoepaul collected ($0.12)
Seat 8: InDiosArg95' folded before Flop (didn't bet)
Seat 9: Maria'sDad77 (button) folded before Flop (didn't bet)



PokerStars Hand #238018879076:  Hold'em No Limit ($0.02/$0.05 USD) - 2022/08/15 21:41:01 PT [2022/08/16 0:41:01 ET]
Table 'Alkurah III' 9-max Seat #1 is the button
Seat 1: Dorex2007 ($11.70 in chips) 
Seat 2: BluffOnTable ($5 in chips) 
Seat 3: Nicolas Trin ($5 in chips) 
Seat 4: fantome75 ($3.43 in chips) 
Seat 6: moitzigu ($5.20 in chips) 
Seat 7: zoepaul ($9.53 in chips) 
Seat 8: InDiosArg95' ($4.97 in chips) 
Seat 9: Maria'sDad77 ($5.11 in chips) 
BluffOnTable: posts small blind $0.02
Nicolas Trin: posts big blind $0.05
*** HOLE CARDS ***
Dealt to Dorex2007 [Ac 7d]
fantome75: folds 
moitzigu: folds 
zoepaul has timed out
zoepaul: folds 
InDiosArg95': folds 
Maria'sDad77: folds 
Dorex2007: folds 
BluffOnTable: folds 
Uncalled bet ($0.03) returned to Nicolas Trin
Nicolas Trin collected $0.04 from pot
*** SUMMARY ***
Total pot $0.04 | Rake $0 
Seat 1: Dorex2007 (button) folded before Flop (didn't bet)
Seat 2: BluffOnTable (small blind) folded before Flop
Seat 3: Nicolas Trin (big blind) collected ($0.04)
Seat 4: fantome75 folded before Flop (didn't bet)
Seat 6: moitzigu folded before Flop (didn't bet)
Seat 7: zoepaul folded before Flop (didn't bet)
Seat 8: InDiosArg95' folded before Flop (didn't bet)
Seat 9: Maria'sDad77 folded before Flop (didn't bet)



PokerStars Hand #238018882894:  Hold'em No Limit ($0.02/$0.05 USD) - 2022/08/15 21:41:35 PT [2022/08/16 0:41:35 ET]
Table 'Alkurah III' 9-max Seat #2 is the button
Seat 1: Dorex2007 ($11.70 in chips) 
Seat 2: BluffOnTable ($5 in chips) 
Seat 3: Nicolas Trin ($5.02 in chips) 
Seat 4: fantome75 ($3.43 in chips) 
Seat 6: moitzigu ($5.20 in chips) 
Seat 7: zoepaul ($9.53 in chips) 
Seat 8: InDiosArg95' ($4.97 in chips) 
Seat 9: Maria'sDad77 ($5.11 in chips) 
Nicolas Trin: posts small blind $0.02
fantome75: posts big blind $0.05
*** HOLE CARDS ***
Dealt to Dorex2007 [Ts 6s]
moitzigu: folds 
zoepaul: folds 
InDiosArg95': folds 
Maria'sDad77: raises $0.05 to $0.10
Dorex2007: folds 
BluffOnTable: folds 
Nicolas Trin: folds 
fantome75: calls $0.05
*** FLOP *** [9s 6d 8s]
fantome75: checks 
Maria'sDad77: checks 
*** TURN *** [9s 6d 8s] [Th]
fantome75: checks 
Maria'sDad77: checks 
*** RIVER *** [9s 6d 8s Th] [Qd]
fantome75: checks 
Maria'sDad77: checks 
*** SHOW DOWN ***
fantome75: shows [4c 5d] (high card Queen)
Maria'sDad77: shows [Ks Qs] (a pair of Queens)
Maria'sDad77 collected $0.21 from pot
*** SUMMARY ***
Total pot $0.22 | Rake $0.01 
Board [9s 6d 8s Th Qd]
Seat 1: Dorex2007 folded before Flop (didn't bet)
Seat 2: BluffOnTable (button) folded before Flop (didn't bet)
Seat 3: Nicolas Trin (small blind) folded before Flop
Seat 4: fantome75 (big blind) showed [4c 5d] and lost with high card Queen
Seat 6: moitzigu folded before Flop (didn't bet)
Seat 7: zoepaul folded before Flop (didn't bet)
Seat 8: InDiosArg95' folded before Flop (didn't bet)
Seat 9: Maria'sDad77 showed [Ks Qs] and won ($0.21) with a pair of Queens



PokerStars Hand #238018891445:  Hold'em No Limit ($0.02/$0.05 USD) - 2022/08/15 21:42:51 PT [2022/08/16 0:42:51 ET]
Table 'Alkurah III' 9-max Seat #3 is the button
Seat 1: Dorex2007 ($11.70 in chips) 
Seat 2: BluffOnTable ($5 in chips) 
Seat 3: Nicolas Trin ($5 in chips) 
Seat 4: fantome75 ($3.33 in chips) 
Seat 6: moitzigu ($5.20 in chips) 
Seat 7: zoepaul ($9.53 in chips) 
Seat 8: InDiosArg95' ($4.97 in chips) 
Seat 9: Maria'sDad77 ($5.22 in chips) 
fantome75: posts small blind $0.02
moitzigu: posts big blind $0.05
*** HOLE CARDS ***
Dealt to Dorex2007 [3h Ac]
zoepaul: raises $0.07 to $0.12
InDiosArg95': folds 
Maria'sDad77: folds 
Dorex2007: folds 
BluffOnTable: raises $0.33 to $0.45
Nicolas Trin: folds 
fantome75: calls $0.43
onlyfoolsguy is disconnected 
moitzigu: folds 
zoepaul: calls $0.33
*** FLOP *** [Ts 6d 9s]
fantome75: checks 
zoepaul: checks 
BluffOnTable: checks 
*** TURN *** [Ts 6d 9s] [As]
fantome75: checks 
zoepaul: checks 
BluffOnTable: checks 
*** RIVER *** [Ts 6d 9s As] [5s]
fantome75: checks 
zoepaul: checks 
BluffOnTable: checks 
*** SHOW DOWN ***
fantome75: shows [Jd Kd] (high card Ace)
zoepaul: shows [Qd Td] (a pair of Tens)
BluffOnTable: shows [Ad Kh] (a pair of Aces)
BluffOnTable collected $1.34 from pot
*** SUMMARY ***
Total pot $1.40 | Rake $0.06 
Board [Ts 6d 9s As 5s]
Seat 1: Dorex2007 folded before Flop (didn't bet)
Seat 2: BluffOnTable showed [Ad Kh] and won ($1.34) with a pair of Aces
Seat 3: Nicolas Trin (button) folded before Flop (didn't bet)
Seat 4: fantome75 (small blind) showed [Jd Kd] and lost with high card Ace
Seat 6: moitzigu (big blind) folded before Flop
Seat 7: zoepaul showed [Qd Td] and lost with a pair of Tens
Seat 8: InDiosArg95' folded before Flop (didn't bet)
Seat 9: Maria'sDad77 folded before Flop (didn't bet)



PokerStars Hand #238018901038:  Hold'em No Limit ($0.02/$0.05 USD) - 2022/08/15 21:44:13 PT [2022/08/16 0:44:13 ET]
Table 'Alkurah III' 9-max Seat #4 is the button
Seat 1: Dorex2007 ($11.70 in chips) 
Seat 2: BluffOnTable ($5.89 in chips) 
Seat 3: Nicolas Trin ($5 in chips) 
Seat 4: fantome75 ($2.88 in chips) 
Seat 6: moitzigu ($5.15 in chips) 
Seat 7: zoepaul ($9.08 in chips) 
Seat 8: InDiosArg95' ($4.97 in chips) 
Seat 9: Maria'sDad77 ($5.22 in chips) 
moitzigu: posts small blind $0.02
zoepaul: posts big blind $0.05
*** HOLE CARDS ***
Dealt to Dorex2007 [5c Qs]
InDiosArg95': raises $0.07 to $0.12
Maria'sDad77: folds 
Dorex2007: folds 
BluffOnTable: folds 
Nicolas Trin: calls $0.12
fantome75: folds 
moitzigu: folds 
zoepaul: folds 
*** FLOP *** [5s 4d Kh]
InDiosArg95': bets $0.10
Nicolas Trin: folds 
Uncalled bet ($0.10) returned to InDiosArg95'
InDiosArg95' collected $0.30 from pot
*** SUMMARY ***
Total pot $0.31 | Rake $0.01 
Board [5s 4d Kh]
Seat 1: Dorex2007 folded before Flop (didn't bet)
Seat 2: BluffOnTable folded before Flop (didn't bet)
Seat 3: Nicolas Trin folded on the Flop
Seat 4: fantome75 (button) folded before Flop (didn't bet)
Seat 6: moitzigu (small blind) folded before Flop
Seat 7: zoepaul (big blind) folded before Flop
Seat 8: InDiosArg95' collected ($0.30)
Seat 9: Maria'sDad77 folded before Flop (didn't bet)



PokerStars Hand #238018905640:  Hold'em No Limit ($0.02/$0.05 USD) - 2022/08/15 21:44:53 PT [2022/08/16 0:44:53 ET]
Table 'Alkurah III' 9-max Seat #6 is the button
Seat 1: Dorex2007 ($11.70 in chips) 
Seat 2: BluffOnTable ($5.89 in chips) 
Seat 3: Nicolas Trin ($4.88 in chips) 
Seat 4: fantome75 ($2.88 in chips) 
Seat 6: moitzigu ($5.13 in chips) 
Seat 7: zoepaul ($9.03 in chips) 
Seat 8: InDiosArg95' ($5.15 in chips) 
Seat 9: Maria'sDad77 ($5.22 in chips) 
zoepaul: posts small blind $0.02
InDiosArg95': posts big blind $0.05
*** HOLE CARDS ***
Dealt to Dorex2007 [Qc Kh]
Maria'sDad77: folds 
Dorex2007: raises $0.15 to $0.20
BluffOnTable: folds 
Nicolas Trin: folds 
fantome75: folds 
moitzigu: folds 
zoepaul: folds 
InDiosArg95': folds 
Uncalled bet ($0.15) returned to Dorex2007
Dorex2007 collected $0.12 from pot
Dorex2007: doesn't show hand 
*** SUMMARY ***
Total pot $0.12 | Rake $0 
Seat 1: Dorex2007 collected ($0.12)
Seat 2: BluffOnTable folded before Flop (didn't bet)
Seat 3: Nicolas Trin folded before Flop (didn't bet)
Seat 4: fantome75 folded before Flop (didn't bet)
Seat 6: moitzigu (button) folded before Flop (didn't bet)
Seat 7: zoepaul (small blind) folded before Flop
Seat 8: InDiosArg95' (big blind) folded before Flop
Seat 9: Maria'sDad77 folded before Flop (didn't bet)



PokerStars Hand #238018909199:  Hold'em No Limit ($0.02/$0.05 USD) - 2022/08/15 21:45:24 PT [2022/08/16 0:45:24 ET]
Table 'Alkurah III' 9-max Seat #7 is the button
Seat 1: Dorex2007 ($11.77 in chips) 
Seat 2: BluffOnTable ($5.89 in chips) 
Seat 3: Nicolas Trin ($4.88 in chips) 
Seat 4: fantome75 ($2.88 in chips) 
Seat 6: moitzigu ($5.13 in chips) 
Seat 7: zoepaul ($9.01 in chips) 
Seat 8: InDiosArg95' ($5.10 in chips) 
Seat 9: Maria'sDad77 ($5.22 in chips) 
InDiosArg95': posts small blind $0.02
Maria'sDad77: posts big blind $0.05
*** HOLE CARDS ***
Dealt to Dorex2007 [9d As]
Dorex2007: folds 
BluffOnTable: folds 
Nicolas Trin: folds 
fantome75: folds 
moitzigu: folds 
zoepaul: raises $0.15 to $0.20
InDiosArg95': folds 
Maria'sDad77: calls $0.15
*** FLOP *** [3c Ad Jh]
Maria'sDad77: checks 
zoepaul: bets $0.20
Maria'sDad77: calls $0.20
*** TURN *** [3c Ad Jh] [8h]
Maria'sDad77: checks 
zoepaul: checks 
*** RIVER *** [3c Ad Jh 8h] [Kh]
Maria'sDad77: checks 
zoepaul: checks 
*** SHOW DOWN ***
Maria'sDad77: shows [Ah Qs] (a pair of Aces)
zoepaul: mucks hand 
Maria'sDad77 collected $0.79 from pot
*** SUMMARY ***
Total pot $0.82 | Rake $0.03 
Board [3c Ad Jh 8h Kh]
Seat 1: Dorex2007 folded before Flop (didn't bet)
Seat 2: BluffOnTable folded before Flop (didn't bet)
Seat 3: Nicolas Trin folded before Flop (didn't bet)
Seat 4: fantome75 folded before Flop (didn't bet)
Seat 6: moitzigu folded before Flop (didn't bet)
Seat 7: zoepaul (button) mucked [Qd Qh]
Seat 8: InDiosArg95' (small blind) folded before Flop
Seat 9: Maria'sDad77 (big blind) showed [Ah Qs] and won ($0.79) with a pair of Aces



PokerStars Hand #238018917731:  Hold'em No Limit ($0.02/$0.05 USD) - 2022/08/15 21:46:39 PT [2022/08/16 0:46:39 ET]
Table 'Alkurah III' 9-max Seat #8 is the button
Seat 1: Dorex2007 ($11.77 in chips) 
Seat 2: BluffOnTable ($5.89 in chips) 
Seat 3: Nicolas Trin ($4.88 in chips) 
Seat 4: fantome75 ($2.88 in chips) 
Seat 6: moitzigu ($5.13 in chips) 
Seat 7: zoepaul ($8.61 in chips) 
Seat 8: InDiosArg95' ($5.08 in chips) 
Seat 9: Maria'sDad77 ($5.61 in chips) 
Maria'sDad77: posts small blind $0.02
Dorex2007: posts big blind $0.05
*** HOLE CARDS ***
Dealt to Dorex2007 [2c 6c]
BluffOnTable: folds 
Nicolas Trin: calls $0.05
fantome75: folds 
moitzigu: folds 
zoepaul: raises $0.20 to $0.25
InDiosArg95': folds 
Maria'sDad77: folds 
Dorex2007: folds 
Nicolas Trin: calls $0.20
*** FLOP *** [8c Qd Ac]
Nicolas Trin: checks 
zoepaul: bets $0.30
Nicolas Trin: calls $0.30
*** TURN *** [8c Qd Ac] [As]
Nicolas Trin: checks 
zoepaul: bets $1.12
Nicolas Trin: calls $1.12
*** RIVER *** [8c Qd Ac As] [7h]
Nicolas Trin: checks 
zoepaul: bets $3.27
Nicolas Trin: calls $3.21 and is all-in
Uncalled bet ($0.06) returned to zoepaul
*** SHOW DOWN ***
zoepaul: shows [Qc Qh] (a full house, Queens full of Aces)
Nicolas Trin: shows [Qs 7s] (two pair, Aces and Queens)
zoepaul collected $9.42 from pot
*** SUMMARY ***
Total pot $9.83 | Rake $0.41 
Board [8c Qd Ac As 7h]
Seat 1: Dorex2007 (big blind) folded before Flop
Seat 2: BluffOnTable folded before Flop (didn't bet)
Seat 3: Nicolas Trin showed [Qs 7s] and lost with two pair, Aces and Queens
Seat 4: fantome75 folded before Flop (didn't bet)
Seat 6: moitzigu folded before Flop (didn't bet)
Seat 7: zoepaul showed [Qc Qh] and won ($9.42) with a full house, Queens full of Aces
Seat 8: InDiosArg95' (button) folded before Flop (didn't bet)
Seat 9: Maria'sDad77 (small blind) folded before Flop



PokerStars Hand #238018923146:  Hold'em No Limit ($0.02/$0.05 USD) - 2022/08/15 21:47:26 PT [2022/08/16 0:47:26 ET]
Table 'Alkurah III' 9-max Seat #9 is the button
Seat 1: Dorex2007 ($11.72 in chips) 
Seat 2: BluffOnTable ($5.89 in chips) 
Seat 4: fantome75 ($2.88 in chips) 
Seat 6: moitzigu ($5.13 in chips) 
Seat 7: zoepaul ($13.15 in chips) 
Seat 8: InDiosArg95' ($5.08 in chips) 
Seat 9: Maria'sDad77 ($5.59 in chips) 
Dorex2007: posts small blind $0.02
BluffOnTable: posts big blind $0.05
*** HOLE CARDS ***
Dealt to Dorex2007 [Ad 3c]
fantome75: folds 
moitzigu: raises $0.10 to $0.15
zoepaul: calls $0.15
InDiosArg95': calls $0.15
Maria'sDad77: folds 
Dorex2007: folds 
BluffOnTable: calls $0.10
*** FLOP *** [Jd 4s 4d]
BluffOnTable: checks 
moitzigu: bets $0.25
zoepaul: folds 
InDiosArg95': calls $0.25
BluffOnTable: folds 
*** TURN *** [Jd 4s 4d] [2h]
moitzigu: bets $0.35
InDiosArg95': calls $0.35
*** RIVER *** [Jd 4s 4d 2h] [7d]
moitzigu: bets $0.60
InDiosArg95': raises $1.20 to $1.80
moitzigu: folds 
Uncalled bet ($1.20) returned to InDiosArg95'
InDiosArg95' collected $2.89 from pot
*** SUMMARY ***
Total pot $3.02 | Rake $0.13 
Board [Jd 4s 4d 2h 7d]
Seat 1: Dorex2007 (small blind) folded before Flop
Seat 2: BluffOnTable (big blind) folded on the Flop
Seat 4: fantome75 folded before Flop (didn't bet)
Seat 6: moitzigu folded on the River
Seat 7: zoepaul folded on the Flop
Seat 8: InDiosArg95' collected ($2.89)
Seat 9: Maria'sDad77 (button) folded before Flop (didn't bet)



PokerStars Hand #238018940210:  Hold'em No Limit ($0.02/$0.05 USD) - 2022/08/15 21:49:03 PT [2022/08/16 0:49:03 ET]
Table 'Alkurah III' 9-max Seat #1 is the button
Seat 1: Dorex2007 ($11.70 in chips) 
Seat 2: BluffOnTable ($5.74 in chips) 
Seat 3: Nicolas Trin ($5 in chips) 
Seat 4: fantome75 ($2.88 in chips) 
Seat 6: moitzigu ($5 in chips) 
Seat 7: zoepaul ($13 in chips) 
Seat 8: InDiosArg95' ($6.62 in chips) 
Seat 9: Maria'sDad77 ($5.59 in chips) 
BluffOnTable: posts small blind $0.02
Nicolas Trin: posts big blind $0.05
*** HOLE CARDS ***
Dealt to Dorex2007 [8h 2h]
fantome75: folds 
moitzigu: folds 
zoepaul: folds 
InDiosArg95': folds 
Maria'sDad77: folds 
Dorex2007: folds 
BluffOnTable: folds 
Uncalled bet ($0.03) returned to Nicolas Trin
Nicolas Trin collected $0.04 from pot
*** SUMMARY ***
Total pot $0.04 | Rake $0 
Seat 1: Dorex2007 (button) folded before Flop (didn't bet)
Seat 2: BluffOnTable (small blind) folded before Flop
Seat 3: Nicolas Trin (big blind) collected ($0.04)
Seat 4: fantome75 folded before Flop (didn't bet)
Seat 6: moitzigu folded before Flop (didn't bet)
Seat 7: zoepaul folded before Flop (didn't bet)
Seat 8: InDiosArg95' folded before Flop (didn't bet)
Seat 9: Maria'sDad77 folded before Flop (didn't bet)



PokerStars Hand #238018943368:  Hold'em No Limit ($0.02/$0.05 USD) - 2022/08/15 21:49:31 PT [2022/08/16 0:49:31 ET]
Table 'Alkurah III' 9-max Seat #2 is the button
Seat 1: Dorex2007 ($11.70 in chips) 
Seat 2: BluffOnTable ($5.72 in chips) 
Seat 3: Nicolas Trin ($5.02 in chips) 
Seat 4: fantome75 ($2.88 in chips) 
Seat 6: moitzigu ($5 in chips) 
Seat 7: zoepaul ($13 in chips) 
Seat 8: InDiosArg95' ($6.62 in chips) 
Seat 9: Maria'sDad77 ($5.59 in chips) 
Nicolas Trin: posts small blind $0.02
fantome75: posts big blind $0.05
*** HOLE CARDS ***
Dealt to Dorex2007 [Kd 6s]
moitzigu: raises $0.10 to $0.15
zoepaul: calls $0.15
InDiosArg95': calls $0.15
Maria'sDad77: folds 
Dorex2007: folds 
BluffOnTable: folds 
Nicolas Trin: folds 
fantome75: calls $0.10
*** FLOP *** [8h 8c 6d]
fantome75: checks 
moitzigu: checks 
zoepaul: checks 
InDiosArg95': checks 
*** TURN *** [8h 8c 6d] [2s]
fantome75: checks 
moitzigu: checks 
zoepaul: bets $0.59
InDiosArg95': folds 
fantome75: folds 
moitzigu: folds 
Uncalled bet ($0.59) returned to zoepaul
zoepaul collected $0.59 from pot
*** SUMMARY ***
Total pot $0.62 | Rake $0.03 
Board [8h 8c 6d 2s]
Seat 1: Dorex2007 folded before Flop (didn't bet)
Seat 2: BluffOnTable (button) folded before Flop (didn't bet)
Seat 3: Nicolas Trin (small blind) folded before Flop
Seat 4: fantome75 (big blind) folded on the Turn
Seat 6: moitzigu folded on the Turn
Seat 7: zoepaul collected ($0.59)
Seat 8: InDiosArg95' folded on the Turn
Seat 9: Maria'sDad77 folded before Flop (didn't bet)



PokerStars Hand #238018951579:  Hold'em No Limit ($0.02/$0.05 USD) - 2022/08/15 21:50:44 PT [2022/08/16 0:50:44 ET]
Table 'Alkurah III' 9-max Seat #3 is the button
Seat 1: Dorex2007 ($11.70 in chips) 
Seat 2: BluffOnTable ($5.72 in chips) 
Seat 3: Nicolas Trin ($5 in chips) 
Seat 4: fantome75 ($2.73 in chips) 
Seat 6: moitzigu ($5 in chips) 
Seat 7: zoepaul ($13.44 in chips) 
Seat 8: InDiosArg95' ($6.47 in chips) 
Seat 9: Maria'sDad77 ($5.59 in chips) 
fantome75: posts small blind $0.02
moitzigu: posts big blind $0.05
*** HOLE CARDS ***
Dealt to Dorex2007 [Kc 8c]
zoepaul: folds 
InDiosArg95': folds 
Maria'sDad77: folds 
Dorex2007: folds 
BluffOnTable: folds 
Nicolas Trin: folds 
fantome75: calls $0.03
moitzigu: checks 
*** FLOP *** [Td 3d Ks]
fantome75: checks 
moitzigu: bets $0.05
fantome75: calls $0.05
*** TURN *** [Td 3d Ks] [8s]
fantome75: checks 
moitzigu: bets $0.10
fantome75: calls $0.10
*** RIVER *** [Td 3d Ks 8s] [3h]
fantome75: checks 
moitzigu: bets $0.15
fantome75: calls $0.15
*** SHOW DOWN ***
moitzigu: shows [9d Js] (a pair of Threes)
fantome75: shows [7c Ts] (two pair, Tens and Threes)
fantome75 collected $0.67 from pot
*** SUMMARY ***
Total pot $0.70 | Rake $0.03 
Board [Td 3d Ks 8s 3h]
Seat 1: Dorex2007 folded before Flop (didn't bet)
Seat 2: BluffOnTable folded before Flop (didn't bet)
Seat 3: Nicolas Trin (button) folded before Flop (didn't bet)
Seat 4: fantome75 (small blind) showed [7c Ts] and won ($0.67) with two pair, Tens and Threes
Seat 6: moitzigu (big blind) showed [9d Js] and lost with a pair of Threes
Seat 7: zoepaul folded before Flop (didn't bet)
Seat 8: InDiosArg95' folded before Flop (didn't bet)
Seat 9: Maria'sDad77 folded before Flop (didn't bet)



PokerStars Hand #238018959203:  Hold'em No Limit ($0.02/$0.05 USD) - 2022/08/15 21:51:52 PT [2022/08/16 0:51:52 ET]
Table 'Alkurah III' 9-max Seat #4 is the button
Seat 1: Dorex2007 ($11.70 in chips) 
Seat 2: BluffOnTable ($5.72 in chips) 
Seat 3: Nicolas Trin ($5 in chips) 
Seat 4: fantome75 ($3.05 in chips) 
Seat 6: moitzigu ($5 in chips) 
Seat 7: zoepaul ($13.44 in chips) 
Seat 8: InDiosArg95' ($6.47 in chips) 
Seat 9: Maria'sDad77 ($5.59 in chips) 
moitzigu: posts small blind $0.02
zoepaul: posts big blind $0.05
*** HOLE CARDS ***
Dealt to Dorex2007 [Kc 2h]
InDiosArg95': folds 
Maria'sDad77: folds 
Dorex2007: folds 
BluffOnTable: raises $0.10 to $0.15
Nicolas Trin: folds 
fantome75: calls $0.15
moitzigu: folds 
zoepaul: calls $0.10
*** FLOP *** [Jc Qd As]
zoepaul: checks 
BluffOnTable: checks 
fantome75: bets $0.20
zoepaul: calls $0.20
BluffOnTable: folds 
*** TURN *** [Jc Qd As] [8c]
zoepaul: checks 
fantome75: bets $0.20
zoepaul: calls $0.20
*** RIVER *** [Jc Qd As 8c] [6s]
zoepaul: checks 
fantome75: bets $0.25
zoepaul: folds 
Uncalled bet ($0.25) returned to fantome75
fantome75 collected $1.22 from pot
fantome75: doesn't show hand 
*** SUMMARY ***
Total pot $1.27 | Rake $0.05 
Board [Jc Qd As 8c 6s]
Seat 1: Dorex2007 folded before Flop (didn't bet)
Seat 2: BluffOnTable folded on the Flop
Seat 3: Nicolas Trin folded before Flop (didn't bet)
Seat 4: fantome75 (button) collected ($1.22)
Seat 6: moitzigu (small blind) folded before Flop
Seat 7: zoepaul (big blind) folded on the River
Seat 8: InDiosArg95' folded before Flop (didn't bet)
Seat 9: Maria'sDad77 folded before Flop (didn't bet)



PokerStars Hand #238018968030:  Hold'em No Limit ($0.02/$0.05 USD) - 2022/08/15 21:53:11 PT [2022/08/16 0:53:11 ET]
Table 'Alkurah III' 9-max Seat #6 is the button
Seat 1: Dorex2007 ($11.70 in chips) 
Seat 2: BluffOnTable ($5.57 in chips) 
Seat 3: Nicolas Trin ($5 in chips) 
Seat 4: fantome75 ($3.72 in chips) 
Seat 6: moitzigu ($5 in chips) 
Seat 7: zoepaul ($12.89 in chips) 
Seat 8: InDiosArg95' ($6.47 in chips) 
Seat 9: Maria'sDad77 ($5.59 in chips) 
zoepaul: posts small blind $0.02
InDiosArg95': posts big blind $0.05
*** HOLE CARDS ***
Dealt to Dorex2007 [Qs 6c]
Maria'sDad77: folds 
Dorex2007: folds 
onlyfoolsguy leaves the table
DannamoH joins the table at seat #5 
BluffOnTable has timed out
BluffOnTable: folds 
Nicolas Trin: calls $0.05
fantome75: calls $0.05
moitzigu: folds 
zoepaul: calls $0.03
InDiosArg95': checks 
*** FLOP *** [8s 5d 5h]
zoepaul: checks 
InDiosArg95': checks 
Nicolas Trin: checks 
fantome75: checks 
*** TURN *** [8s 5d 5h] [5c]
zoepaul: checks 
InDiosArg95': checks 
Nicolas Trin: checks 
fantome75: checks 
*** RIVER *** [8s 5d 5h 5c] [7d]
zoepaul: checks 
InDiosArg95': checks 
Nicolas Trin: checks 
fantome75: checks 
*** SHOW DOWN ***
zoepaul: shows [9c Qh] (three of a kind, Fives)
InDiosArg95': shows [2c 7h] (a full house, Fives full of Sevens)
Nicolas Trin: mucks hand 
fantome75: mucks hand 
InDiosArg95' collected $0.19 from pot
*** SUMMARY ***
Total pot $0.20 | Rake $0.01 
Board [8s 5d 5h 5c 7d]
Seat 1: Dorex2007 folded before Flop (didn't bet)
Seat 2: BluffOnTable folded before Flop (didn't bet)
Seat 3: Nicolas Trin mucked [Th 9d]
Seat 4: fantome75 mucked [2h 2d]
Seat 6: moitzigu (button) folded before Flop (didn't bet)
Seat 7: zoepaul (small blind) showed [9c Qh] and lost with three of a kind, Fives
Seat 8: InDiosArg95' (big blind) showed [2c 7h] and won ($0.19) with a full house, Fives full of Sevens
Seat 9: Maria'sDad77 folded before Flop (didn't bet)



PokerStars Hand #238018978950:  Hold'em No Limit ($0.02/$0.05 USD) - 2022/08/15 21:54:51 PT [2022/08/16 0:54:51 ET]
Table 'Alkurah III' 9-max Seat #7 is the button
Seat 1: Dorex2007 ($11.70 in chips) 
Seat 2: BluffOnTable ($5.57 in chips) 
Seat 3: Nicolas Trin ($4.95 in chips) 
Seat 4: fantome75 ($3.67 in chips) 
Seat 5: DannamoH ($5 in chips) 
Seat 6: moitzigu ($5 in chips) 
Seat 7: zoepaul ($12.84 in chips) 
Seat 8: InDiosArg95' ($6.61 in chips) 
Seat 9: Maria'sDad77 ($5.59 in chips) 
InDiosArg95': posts small blind $0.02
Maria'sDad77: posts big blind $0.05
DannamoH: posts big blind $0.05
*** HOLE CARDS ***
Dealt to Dorex2007 [Td 3s]
Dorex2007: folds 
BluffOnTable: folds 
Nicolas Trin: folds 
fantome75: folds 
DannamoH: checks 
moitzigu: raises $0.15 to $0.20
zoepaul: calls $0.20
InDiosArg95': folds 
Maria'sDad77: folds 
DannamoH: folds 
*** FLOP *** [6h 9h Jh]
moitzigu: checks 
zoepaul: checks 
*** TURN *** [6h 9h Jh] [2h]
moitzigu: bets $0.20
zoepaul: folds 
Uncalled bet ($0.20) returned to moitzigu
moitzigu collected $0.50 from pot
moitzigu: doesn't show hand 
*** SUMMARY ***
Total pot $0.52 | Rake $0.02 
Board [6h 9h Jh 2h]
Seat 1: Dorex2007 folded before Flop (didn't bet)
Seat 2: BluffOnTable folded before Flop (didn't bet)
Seat 3: Nicolas Trin folded before Flop (didn't bet)
Seat 4: fantome75 folded before Flop (didn't bet)
Seat 5: DannamoH folded before Flop (didn't bet)
Seat 6: moitzigu collected ($0.50)
Seat 7: zoepaul (button) folded on the Turn
Seat 8: InDiosArg95' (small blind) folded before Flop
Seat 9: Maria'sDad77 (big blind) folded before Flop



PokerStars Hand #238018984353:  Hold'em No Limit ($0.02/$0.05 USD) - 2022/08/15 21:55:44 PT [2022/08/16 0:55:44 ET]
Table 'Alkurah III' 9-max Seat #8 is the button
Seat 1: Dorex2007 ($11.70 in chips) 
Seat 2: BluffOnTable ($5.57 in chips) 
Seat 3: Nicolas Trin ($4.95 in chips) 
Seat 4: fantome75 ($3.67 in chips) 
Seat 5: DannamoH ($4.95 in chips) 
Seat 6: moitzigu ($5.30 in chips) 
Seat 7: zoepaul ($12.64 in chips) 
Seat 8: InDiosArg95' ($6.59 in chips) 
Seat 9: Maria'sDad77 ($5.54 in chips) 
Maria'sDad77: posts small blind $0.02
Dorex2007: posts big blind $0.05
*** HOLE CARDS ***
Dealt to Dorex2007 [2s 9d]
BluffOnTable: folds 
Nicolas Trin: folds 
fantome75: folds 
DannamoH: raises $0.05 to $0.10
moitzigu: folds 
zoepaul: folds 
InDiosArg95': folds 
Maria'sDad77: folds 
Dorex2007: folds 
Uncalled bet ($0.05) returned to DannamoH
DannamoH collected $0.12 from pot
DannamoH: doesn't show hand 
*** SUMMARY ***
Total pot $0.12 | Rake $0 
Seat 1: Dorex2007 (big blind) folded before Flop
Seat 2: BluffOnTable folded before Flop (didn't bet)
Seat 3: Nicolas Trin folded before Flop (didn't bet)
Seat 4: fantome75 folded before Flop (didn't bet)
Seat 5: DannamoH collected ($0.12)
Seat 6: moitzigu folded before Flop (didn't bet)
Seat 7: zoepaul folded before Flop (didn't bet)
Seat 8: InDiosArg95' (button) folded before Flop (didn't bet)
Seat 9: Maria'sDad77 (small blind) folded before Flop



PokerStars Hand #238018986376:  Hold'em No Limit ($0.02/$0.05 USD) - 2022/08/15 21:56:05 PT [2022/08/16 0:56:05 ET]
Table 'Alkurah III' 9-max Seat #9 is the button
Seat 1: Dorex2007 ($11.65 in chips) 
Seat 2: BluffOnTable ($5.57 in chips) 
Seat 3: Nicolas Trin ($4.95 in chips) 
Seat 4: fantome75 ($3.67 in chips) 
Seat 5: DannamoH ($5.02 in chips) 
Seat 6: moitzigu ($5.30 in chips) 
Seat 7: zoepaul ($12.64 in chips) 
Seat 8: InDiosArg95' ($6.59 in chips) 
Seat 9: Maria'sDad77 ($5.52 in chips) 
Dorex2007: posts small blind $0.02
BluffOnTable: posts big blind $0.05
*** HOLE CARDS ***
Dealt to Dorex2007 [Kh 9d]
Nicolas Trin: calls $0.05
fantome75: folds 
DannamoH: raises $0.05 to $0.10
moitzigu: folds 
zoepaul: folds 
InDiosArg95': folds 
Maria'sDad77: calls $0.10
Dorex2007: folds 
BluffOnTable: raises $0.37 to $0.47
Nicolas Trin: calls $0.42
DannamoH: folds 
Maria'sDad77: folds 
*** FLOP *** [3h Ks 8h]
BluffOnTable: bets $1.11
Nicolas Trin: folds 
Uncalled bet ($1.11) returned to BluffOnTable
BluffOnTable collected $1.11 from pot
BluffOnTable: doesn't show hand 
*** SUMMARY ***
Total pot $1.16 | Rake $0.05 
Board [3h Ks 8h]
Seat 1: Dorex2007 (small blind) folded before Flop
Seat 2: BluffOnTable (big blind) collected ($1.11)
Seat 3: Nicolas Trin folded on the Flop
Seat 4: fantome75 folded before Flop (didn't bet)
Seat 5: DannamoH folded before Flop
Seat 6: moitzigu folded before Flop (didn't bet)
Seat 7: zoepaul folded before Flop (didn't bet)
Seat 8: InDiosArg95' folded before Flop (didn't bet)
Seat 9: Maria'sDad77 (button) folded before Flop



PokerStars Hand #238018991799:  Hold'em No Limit ($0.02/$0.05 USD) - 2022/08/15 21:57:00 PT [2022/08/16 0:57:00 ET]
Table 'Alkurah III' 9-max Seat #1 is the button
Seat 1: Dorex2007 ($11.63 in chips) 
Seat 2: BluffOnTable ($6.21 in chips) 
Seat 3: Nicolas Trin ($4.48 in chips) 
Seat 4: fantome75 ($3.67 in chips) 
Seat 5: DannamoH ($4.92 in chips) 
Seat 6: moitzigu ($5.30 in chips) 
Seat 7: zoepaul ($12.64 in chips) 
Seat 8: InDiosArg95' ($6.59 in chips) 
Seat 9: Maria'sDad77 ($5.42 in chips) 
BluffOnTable: posts small blind $0.02
Nicolas Trin: posts big blind $0.05
*** HOLE CARDS ***
Dealt to Dorex2007 [4h Qc]
fantome75: folds 
DannamoH: folds 
moitzigu: folds 
fantome75 leaves the table
zoepaul: folds 
InDiosArg95': folds 
Maria'sDad77: folds 
Dorex2007: folds 
BluffOnTable: folds 
Uncalled bet ($0.03) returned to Nicolas Trin
Nicolas Trin collected $0.04 from pot
*** SUMMARY ***
Total pot $0.04 | Rake $0 
Seat 1: Dorex2007 (button) folded before Flop (didn't bet)
Seat 2: BluffOnTable (small blind) folded before Flop
Seat 3: Nicolas Trin (big blind) collected ($0.04)
Seat 4: fantome75 folded before Flop (didn't bet)
Seat 5: DannamoH folded before Flop (didn't bet)
Seat 6: moitzigu folded before Flop (didn't bet)
Seat 7: zoepaul folded before Flop (didn't bet)
Seat 8: InDiosArg95' folded before Flop (didn't bet)
Seat 9: Maria'sDad77 folded before Flop (didn't bet)



PokerStars Hand #238018996286:  Hold'em No Limit ($0.02/$0.05 USD) - 2022/08/15 21:57:46 PT [2022/08/16 0:57:46 ET]
Table 'Alkurah III' 9-max Seat #2 is the button
Seat 1: Dorex2007 ($11.63 in chips) 
Seat 2: BluffOnTable ($6.19 in chips) 
Seat 3: Nicolas Trin ($4.50 in chips) 
Seat 5: DannamoH ($4.92 in chips) 
Seat 6: moitzigu ($5.30 in chips) 
Seat 7: zoepaul ($12.64 in chips) 
Seat 8: InDiosArg95' ($6.59 in chips) 
Seat 9: Maria'sDad77 ($5.42 in chips) 
Nicolas Trin: posts small blind $0.02
DannamoH: posts big blind $0.05
*** HOLE CARDS ***
Dealt to Dorex2007 [3h 8c]
moitzigu: folds 
zoepaul has timed out
zoepaul: folds 
InDiosArg95': folds 
Maria'sDad77: folds 
Dorex2007: folds 
BluffOnTable: folds 
Nicolas Trin: calls $0.03
DannamoH: checks 
*** FLOP *** [5d 2c 6h]
Nicolas Trin: bets $0.05
DannamoH: folds 
Uncalled bet ($0.05) returned to Nicolas Trin
Nicolas Trin collected $0.10 from pot
Nicolas Trin: doesn't show hand 
*** SUMMARY ***
Total pot $0.10 | Rake $0 
Board [5d 2c 6h]
Seat 1: Dorex2007 folded before Flop (didn't bet)
Seat 2: BluffOnTable (button) folded before Flop (didn't bet)
Seat 3: Nicolas Trin (small blind) collected ($0.10)
Seat 5: DannamoH (big blind) folded on the Flop
Seat 6: moitzigu folded before Flop (didn't bet)
Seat 7: zoepaul folded before Flop (didn't bet)
Seat 8: InDiosArg95' folded before Flop (didn't bet)
Seat 9: Maria'sDad77 folded before Flop (didn't bet)



PokerStars Hand #238019000172:  Hold'em No Limit ($0.02/$0.05 USD) - 2022/08/15 21:58:27 PT [2022/08/16 0:58:27 ET]
Table 'Alkurah III' 9-max Seat #3 is the button
Seat 1: Dorex2007 ($11.63 in chips) 
Seat 2: BluffOnTable ($6.19 in chips) 
Seat 3: Nicolas Trin ($4.55 in chips) 
Seat 5: DannamoH ($4.87 in chips) 
Seat 7: zoepaul ($12.64 in chips) 
Seat 8: InDiosArg95' ($6.59 in chips) 
Seat 9: Maria'sDad77 ($5.42 in chips) 
DannamoH: posts small blind $0.02
moitzigu: is sitting out 
zoepaul: posts big blind $0.05
*** HOLE CARDS ***
Dealt to Dorex2007 [Ks 4h]
InDiosArg95': folds 
Maria'sDad77: folds 
moitzigu leaves the table
Dorex2007: folds 
BluffOnTable: folds 
Nicolas Trin: calls $0.05
DannamoH: folds 
zoepaul: checks 
*** FLOP *** [Kd 6d 3c]
zoepaul: checks 
Nicolas Trin: checks 
*** TURN *** [Kd 6d 3c] [3s]
zoepaul: checks 
Nicolas Trin: checks 
*** RIVER *** [Kd 6d 3c 3s] [Jh]
zoepaul: checks 
Nicolas Trin: checks 
*** SHOW DOWN ***
zoepaul: shows [7s 2d] (a pair of Threes)
Nicolas Trin: shows [5s Tc] (a pair of Threes - King+Jack+Ten kicker)
Nicolas Trin collected $0.12 from pot
*** SUMMARY ***
Total pot $0.12 | Rake $0 
Board [Kd 6d 3c 3s Jh]
Seat 1: Dorex2007 folded before Flop (didn't bet)
Seat 2: BluffOnTable folded before Flop (didn't bet)
Seat 3: Nicolas Trin (button) showed [5s Tc] and won ($0.12) with a pair of Threes
Seat 5: DannamoH (small blind) folded before Flop
Seat 7: zoepaul (big blind) showed [7s 2d] and lost with a pair of Threes
Seat 8: InDiosArg95' folded before Flop (didn't bet)
Seat 9: Maria'sDad77 folded before Flop (didn't bet)



PokerStars Hand #238019004210:  Hold'em No Limit ($0.02/$0.05 USD) - 2022/08/15 21:59:10 PT [2022/08/16 0:59:10 ET]
Table 'Alkurah III' 9-max Seat #5 is the button
Seat 1: Dorex2007 ($11.63 in chips) 
Seat 2: BluffOnTable ($6.19 in chips) 
Seat 3: Nicolas Trin ($4.62 in chips) 
Seat 5: DannamoH ($4.85 in chips) 
Seat 7: zoepaul ($12.59 in chips) 
Seat 8: InDiosArg95' ($6.59 in chips) 
Seat 9: Maria'sDad77 ($5.42 in chips) 
zoepaul: posts small blind $0.02
InDiosArg95': posts big blind $0.05
*** HOLE CARDS ***
Dealt to Dorex2007 [3h Td]
Maria'sDad77: folds 
Dorex2007: folds 
BluffOnTable: folds 
Nicolas Trin: calls $0.05
DannamoH: folds 
zoepaul: calls $0.03
InDiosArg95': checks 
*** FLOP *** [Tc 7c 8s]
zoepaul: checks 
InDiosArg95': checks 
Nicolas Trin: checks 
*** TURN *** [Tc 7c 8s] [6d]
zoepaul: checks 
InDiosArg95': bets $0.15
Nicolas Trin: calls $0.15
zoepaul: folds 
*** RIVER *** [Tc 7c 8s 6d] [Jh]
InDiosArg95': bets $0.34
Nicolas Trin: calls $0.34
*** SHOW DOWN ***
InDiosArg95': shows [9c Kh] (a straight, Seven to Jack)
Nicolas Trin: shows [As 9s] (a straight, Seven to Jack)
InDiosArg95' collected $0.54 from pot
Nicolas Trin collected $0.54 from pot
*** SUMMARY ***
Total pot $1.13 | Rake $0.05 
Board [Tc 7c 8s 6d Jh]
Seat 1: Dorex2007 folded before Flop (didn't bet)
Seat 2: BluffOnTable folded before Flop (didn't bet)
Seat 3: Nicolas Trin showed [As 9s] and won ($0.54) with a straight, Seven to Jack
Seat 5: DannamoH (button) folded before Flop (didn't bet)
Seat 7: zoepaul (small blind) folded on the Turn
Seat 8: InDiosArg95' (big blind) showed [9c Kh] and won ($0.54) with a straight, Seven to Jack
Seat 9: Maria'sDad77 folded before Flop (didn't bet)



PokerStars Hand #238019009918:  Hold'em No Limit ($0.02/$0.05 USD) - 2022/08/15 22:00:09 PT [2022/08/16 1:00:09 ET]
Table 'Alkurah III' 9-max Seat #7 is the button
Seat 1: Dorex2007 ($11.63 in chips) 
Seat 2: BluffOnTable ($6.19 in chips) 
Seat 3: Nicolas Trin ($4.62 in chips) 
Seat 5: DannamoH ($4.85 in chips) 
Seat 7: zoepaul ($12.54 in chips) 
Seat 8: InDiosArg95' ($6.59 in chips) 
Seat 9: Maria'sDad77 ($5.42 in chips) 
InDiosArg95': posts small blind $0.02
Maria'sDad77: posts big blind $0.05
*** HOLE CARDS ***
Dealt to Dorex2007 [Tc Ac]
Dorex2007: calls $0.05
BluffOnTable: folds 
Nicolas Trin: calls $0.05
DannamoH: folds 
zoepaul: raises $0.05 to $0.10
InDiosArg95': folds 
Maria'sDad77: folds 
Dorex2007: calls $0.05
Nicolas Trin: calls $0.05
*** FLOP *** [Ah 8h 8d]
Dorex2007: checks 
Nicolas Trin: checks 
zoepaul: checks 
*** TURN *** [Ah 8h 8d] [Js]
Dorex2007: bets $0.23
Nicolas Trin: folds 
zoepaul: folds 
Uncalled bet ($0.23) returned to Dorex2007
Dorex2007 collected $0.35 from pot
Dorex2007: doesn't show hand 
paragraf joins the table at seat #4 
*** SUMMARY ***
Total pot $0.37 | Rake $0.02 
Board [Ah 8h 8d Js]
Seat 1: Dorex2007 collected ($0.35)
Seat 2: BluffOnTable folded before Flop (didn't bet)
Seat 3: Nicolas Trin folded on the Turn
Seat 5: DannamoH folded before Flop (didn't bet)
Seat 7: zoepaul (button) folded on the Turn
Seat 8: InDiosArg95' (small blind) folded before Flop
Seat 9: Maria'sDad77 (big blind) folded before Flop



PokerStars Hand #238019015104:  Hold'em No Limit ($0.02/$0.05 USD) - 2022/08/15 22:01:01 PT [2022/08/16 1:01:01 ET]
Table 'Alkurah III' 9-max Seat #8 is the button
Seat 1: Dorex2007 ($11.88 in chips) 
Seat 2: BluffOnTable ($6.19 in chips) 
Seat 3: Nicolas Trin ($4.52 in chips) 
Seat 5: DannamoH ($4.85 in chips) 
Seat 7: zoepaul ($12.44 in chips) 
Seat 8: InDiosArg95' ($6.57 in chips) 
Seat 9: Maria'sDad77 ($5.37 in chips) 
Maria'sDad77: posts small blind $0.02
Dorex2007: posts big blind $0.05
paragraf: sits out 
*** HOLE CARDS ***
Dealt to Dorex2007 [Qh 3h]
BluffOnTable has timed out
BluffOnTable: folds 
Nicolas Trin: calls $0.05
DannamoH: folds 
zoepaul: folds 
InDiosArg95': folds 
Maria'sDad77: folds 
Dorex2007: checks 
*** FLOP *** [9d 5h 7d]
Dorex2007: checks 
Nicolas Trin: bets $0.15
BluffOnTable leaves the table
Dorex2007: folds 
Uncalled bet ($0.15) returned to Nicolas Trin
Nicolas Trin collected $0.12 from pot
Nicolas Trin: doesn't show hand 
*** SUMMARY ***
Total pot $0.12 | Rake $0 
Board [9d 5h 7d]
Seat 1: Dorex2007 (big blind) folded on the Flop
Seat 2: BluffOnTable folded before Flop (didn't bet)
Seat 3: Nicolas Trin collected ($0.12)
Seat 5: DannamoH folded before Flop (didn't bet)
Seat 7: zoepaul folded before Flop (didn't bet)
Seat 8: InDiosArg95' (button) folded before Flop (didn't bet)
Seat 9: Maria'sDad77 (small blind) folded before Flop



PokerStars Hand #238019019793:  Hold'em No Limit ($0.02/$0.05 USD) - 2022/08/15 22:01:45 PT [2022/08/16 1:01:45 ET]
Table 'Alkurah III' 9-max Seat #9 is the button
Seat 1: Dorex2007 ($11.83 in chips) 
Seat 3: Nicolas Trin ($4.59 in chips) 
Seat 4: paragraf ($3 in chips) 
Seat 5: DannamoH ($4.85 in chips) 
Seat 7: zoepaul ($12.44 in chips) 
Seat 8: InDiosArg95' ($6.57 in chips) 
Seat 9: Maria'sDad77 ($5.35 in chips) 
Dorex2007: posts small blind $0.02
Nicolas Trin: posts big blind $0.05
paragraf: posts big blind $0.05
*** HOLE CARDS ***
Dealt to Dorex2007 [5s 5d]
paragraf: checks 
DannamoH: folds 
zoepaul: calls $0.05
InDiosArg95': folds 
Maria'sDad77: calls $0.05
Dorex2007: calls $0.03
Nicolas Trin: raises $0.15 to $0.20
paragraf: folds 
zoepaul: calls $0.15
eziest_e joins the table at seat #2 
Maria'sDad77: calls $0.15
Dorex2007: calls $0.15
*** FLOP *** [6s 4s Kd]
Dorex2007: checks 
Nicolas Trin: bets $0.25
zoepaul: calls $0.25
rezabraba333 joins the table at seat #6 
Maria'sDad77: folds 
Dorex2007: folds 
*** TURN *** [6s 4s Kd] [8h]
Nicolas Trin: bets $0.45
zoepaul: folds 
Uncalled bet ($0.45) returned to Nicolas Trin
Nicolas Trin collected $1.29 from pot
*** SUMMARY ***
Total pot $1.35 | Rake $0.06 
Board [6s 4s Kd 8h]
Seat 1: Dorex2007 (small blind) folded on the Flop
Seat 3: Nicolas Trin (big blind) collected ($1.29)
Seat 4: paragraf folded before Flop (didn't bet)
Seat 5: DannamoH folded before Flop (didn't bet)
Seat 7: zoepaul folded on the Turn
Seat 8: InDiosArg95' folded before Flop (didn't bet)
Seat 9: Maria'sDad77 (button) folded on the Flop



PokerStars Hand #238019030369:  Hold'em No Limit ($0.02/$0.05 USD) - 2022/08/15 22:03:26 PT [2022/08/16 1:03:26 ET]
Table 'Alkurah III' 9-max Seat #1 is the button
Seat 1: Dorex2007 ($11.63 in chips) 
Seat 3: Nicolas Trin ($5.43 in chips) 
Seat 4: paragraf ($2.95 in chips) 
Seat 5: DannamoH ($4.85 in chips) 
Seat 7: zoepaul ($11.99 in chips) 
Seat 8: InDiosArg95' ($6.57 in chips) 
Seat 9: Maria'sDad77 ($5.15 in chips) 
Nicolas Trin: posts small blind $0.02
paragraf: posts big blind $0.05
rezabraba333: sits out 
*** HOLE CARDS ***
Dealt to Dorex2007 [Qs Kh]
DannamoH: raises $0.05 to $0.10
zoepaul: folds 
InDiosArg95': folds 
Maria'sDad77: folds 
Dorex2007: calls $0.10
Nicolas Trin: folds 
paragraf: calls $0.05
*** FLOP *** [2h Js 7h]
paragraf: bets $0.10
DannamoH: calls $0.10
Dorex2007: calls $0.10
*** TURN *** [2h Js 7h] [9c]
paragraf: bets $0.15
DannamoH: calls $0.15
Dorex2007: folds 
*** RIVER *** [2h Js 7h 9c] [6c]
paragraf: bets $0.25
DannamoH: folds 
Uncalled bet ($0.25) returned to paragraf
paragraf collected $0.87 from pot
paragraf: doesn't show hand 
*** SUMMARY ***
Total pot $0.92 | Rake $0.05 
Board [2h Js 7h 9c 6c]
Seat 1: Dorex2007 (button) folded on the Turn
Seat 3: Nicolas Trin (small blind) folded before Flop
Seat 4: paragraf (big blind) collected ($0.87)
Seat 5: DannamoH folded on the River
Seat 7: zoepaul folded before Flop (didn't bet)
Seat 8: InDiosArg95' folded before Flop (didn't bet)
Seat 9: Maria'sDad77 folded before Flop (didn't bet)



PokerStars Hand #238019038256:  Hold'em No Limit ($0.02/$0.05 USD) - 2022/08/15 22:04:40 PT [2022/08/16 1:04:40 ET]
Table 'Alkurah III' 9-max Seat #3 is the button
Seat 1: Dorex2007 ($11.43 in chips) 
Seat 2: eziest_e ($2 in chips) 
Seat 3: Nicolas Trin ($5.41 in chips) 
Seat 4: paragraf ($3.47 in chips) 
Seat 5: DannamoH ($4.50 in chips) 
Seat 7: zoepaul ($11.99 in chips) 
Seat 8: InDiosArg95' ($6.57 in chips) 
Seat 9: Maria'sDad77 ($5.15 in chips) 
paragraf: posts small blind $0.02
DannamoH: posts big blind $0.05
rezabraba333: sits out 
eziest_e: posts big blind $0.05
*** HOLE CARDS ***
Dealt to Dorex2007 [4h 5d]
zoepaul: folds 
InDiosArg95': raises $0.07 to $0.12
Maria'sDad77: folds 
Dorex2007: folds 
eziest_e: folds 
Nicolas Trin: folds 
paragraf: folds 
DannamoH: folds 
Uncalled bet ($0.07) returned to InDiosArg95'
InDiosArg95' collected $0.17 from pot
*** SUMMARY ***
Total pot $0.17 | Rake $0 
Seat 1: Dorex2007 folded before Flop (didn't bet)
Seat 2: eziest_e folded before Flop (didn't bet)
Seat 3: Nicolas Trin (button) folded before Flop (didn't bet)
Seat 4: paragraf (small blind) folded before Flop
Seat 5: DannamoH (big blind) folded before Flop
Seat 7: zoepaul folded before Flop (didn't bet)
Seat 8: InDiosArg95' collected ($0.17)
Seat 9: Maria'sDad77 folded before Flop (didn't bet)



PokerStars Hand #238019040875:  Hold'em No Limit ($0.02/$0.05 USD) - 2022/08/15 22:05:04 PT [2022/08/16 1:05:04 ET]
Table 'Alkurah III' 9-max Seat #4 is the button
Seat 1: Dorex2007 ($11.43 in chips) 
Seat 2: eziest_e ($1.95 in chips) 
Seat 3: Nicolas Trin ($5.41 in chips) 
Seat 4: paragraf ($3.45 in chips) 
Seat 5: DannamoH ($4.45 in chips) 
Seat 6: rezabraba333 ($2 in chips) 
Seat 7: zoepaul ($11.99 in chips) 
Seat 8: InDiosArg95' ($6.69 in chips) 
Seat 9: Maria'sDad77 ($5.15 in chips) 
DannamoH: posts small blind $0.02
rezabraba333: posts big blind $0.05
*** HOLE CARDS ***
Dealt to Dorex2007 [8s 3s]
zoepaul: raises $0.05 to $0.10
InDiosArg95': folds 
Maria'sDad77: calls $0.10
Dorex2007: folds 
eziest_e: calls $0.10
Nicolas Trin: calls $0.10
paragraf: folds 
DannamoH: calls $0.08
rezabraba333: folds 
*** FLOP *** [Ac 3d Ks]
DannamoH: checks 
zoepaul: checks 
Maria'sDad77: bets $0.26
eziest_e: folds 
Nicolas Trin: folds 
DannamoH: folds 
zoepaul: calls $0.26
*** TURN *** [Ac 3d Ks] [Kh]
zoepaul: checks 
Maria'sDad77: checks 
*** RIVER *** [Ac 3d Ks Kh] [8c]
zoepaul: checks 
Maria'sDad77: bets $0.30
zoepaul: calls $0.30
*** SHOW DOWN ***
Maria'sDad77: shows [8h Ah] (two pair, Aces and Kings)
zoepaul: shows [6c As] (two pair, Aces and Kings)
zoepaul collected $0.80 from pot
Maria'sDad77 collected $0.80 from pot
*** SUMMARY ***
Total pot $1.67 | Rake $0.07 
Board [Ac 3d Ks Kh 8c]
Seat 1: Dorex2007 folded before Flop (didn't bet)
Seat 2: eziest_e folded on the Flop
Seat 3: Nicolas Trin folded on the Flop
Seat 4: paragraf (button) folded before Flop (didn't bet)
Seat 5: DannamoH (small blind) folded on the Flop
Seat 6: rezabraba333 (big blind) folded before Flop
Seat 7: zoepaul showed [6c As] and won ($0.80) with two pair, Aces and Kings
Seat 8: InDiosArg95' folded before Flop (didn't bet)
Seat 9: Maria'sDad77 showed [8h Ah] and won ($0.80) with two pair, Aces and Kings



PokerStars Hand #238019050973:  Hold'em No Limit ($0.02/$0.05 USD) - 2022/08/15 22:06:38 PT [2022/08/16 1:06:38 ET]
Table 'Alkurah III' 9-max Seat #5 is the button
Seat 1: Dorex2007 ($11.43 in chips) 
Seat 2: eziest_e ($1.85 in chips) 
Seat 3: Nicolas Trin ($5.31 in chips) 
Seat 4: paragraf ($3.45 in chips) 
Seat 5: DannamoH ($4.35 in chips) 
Seat 6: rezabraba333 ($1.95 in chips) 
Seat 7: zoepaul ($12.13 in chips) 
Seat 8: InDiosArg95' ($6.69 in chips) 
Seat 9: Maria'sDad77 ($5.29 in chips) 
rezabraba333: posts small blind $0.02
zoepaul: posts big blind $0.05
*** HOLE CARDS ***
Dealt to Dorex2007 [Kc Ts]
InDiosArg95': folds 
Maria'sDad77: folds 
Dorex2007: folds 
eziest_e: calls $0.05
Nicolas Trin: folds 
paragraf: calls $0.05
DannamoH: folds 
rezabraba333: folds 
zoepaul: raises $0.25 to $0.30
InDiosArg95' leaves the table
eziest_e: calls $0.25
paragraf: folds 
*** FLOP *** [6c 8d 4d]
zoepaul: bets $0.32
eziest_e: calls $0.32
*** TURN *** [6c 8d 4d] [6h]
Max7899 joins the table at seat #8 
zoepaul: checks 
eziest_e: bets $1.23 and is all-in
zoepaul: calls $1.23
*** RIVER *** [6c 8d 4d 6h] [Kh]
*** SHOW DOWN ***
zoepaul: shows [Kd Ah] (two pair, Kings and Sixes)
eziest_e: shows [Ac Jh] (a pair of Sixes)
zoepaul collected $3.61 from pot
*** SUMMARY ***
Total pot $3.77 | Rake $0.16 
Board [6c 8d 4d 6h Kh]
Seat 1: Dorex2007 folded before Flop (didn't bet)
Seat 2: eziest_e showed [Ac Jh] and lost with a pair of Sixes
Seat 3: Nicolas Trin folded before Flop (didn't bet)
Seat 4: paragraf folded before Flop
Seat 5: DannamoH (button) folded before Flop (didn't bet)
Seat 6: rezabraba333 (small blind) folded before Flop
Seat 7: zoepaul (big blind) showed [Kd Ah] and won ($3.61) with two pair, Kings and Sixes
Seat 8: InDiosArg95' folded before Flop (didn't bet)
Seat 9: Maria'sDad77 folded before Flop (didn't bet)



PokerStars Hand #238019063566:  Hold'em No Limit ($0.02/$0.05 USD) - 2022/08/15 22:08:37 PT [2022/08/16 1:08:37 ET]
Table 'Alkurah III' 9-max Seat #6 is the button
Seat 1: Dorex2007 ($11.43 in chips) 
Seat 3: Nicolas Trin ($5.31 in chips) 
Seat 4: paragraf ($3.40 in chips) 
Seat 5: DannamoH ($4.35 in chips) 
Seat 6: rezabraba333 ($1.93 in chips) 
Seat 7: zoepaul ($13.89 in chips) 
Seat 8: Max7899 ($3 in chips) 
Seat 9: Maria'sDad77 ($5.29 in chips) 
zoepaul: posts small blind $0.02
Max7899: posts big blind $0.05
*** HOLE CARDS ***
Dealt to Dorex2007 [Th 7s]
eziest_e leaves the table
Maria'sDad77: folds 
Dorex2007: folds 
Nicolas Trin: calls $0.05
paragraf: folds 
DannamoH: raises $0.05 to $0.10
rezabraba333: calls $0.10
zoepaul: raises $0.05 to $0.15
Max7899: calls $0.10
Nicolas Trin: calls $0.10
DannamoH: calls $0.05
rezabraba333: calls $0.05
*** FLOP *** [8d Ts Tc]
zoepaul: checks 
Max7899: checks 
Nicolas Trin: checks 
DannamoH: checks 
rezabraba333: checks 
*** TURN *** [8d Ts Tc] [2h]
paragraf leaves the table
zoepaul: checks 
Max7899: bets $0.36
Nicolas Trin: folds 
DannamoH: folds 
rezabraba333: folds 
zoepaul: folds 
Uncalled bet ($0.36) returned to Max7899
Max7899 collected $0.72 from pot
*** SUMMARY ***
Total pot $0.75 | Rake $0.03 
Board [8d Ts Tc 2h]
Seat 1: Dorex2007 folded before Flop (didn't bet)
Seat 3: Nicolas Trin folded on the Turn
Seat 4: paragraf folded before Flop (didn't bet)
Seat 5: DannamoH folded on the Turn
Seat 6: rezabraba333 (button) folded on the Turn
Seat 7: zoepaul (small blind) folded on the Turn
Seat 8: Max7899 (big blind) collected ($0.72)
Seat 9: Maria'sDad77 folded before Flop (didn't bet)



PokerStars Hand #238019072726:  Hold'em No Limit ($0.02/$0.05 USD) - 2022/08/15 22:10:04 PT [2022/08/16 1:10:04 ET]
Table 'Alkurah III' 9-max Seat #7 is the button
Seat 1: Dorex2007 ($11.43 in chips) 
Seat 3: Nicolas Trin ($5.16 in chips) 
Seat 5: DannamoH ($4.20 in chips) 
Seat 6: rezabraba333 ($1.78 in chips) 
Seat 7: zoepaul ($13.74 in chips) 
Seat 8: Max7899 ($3.57 in chips) 
Seat 9: Maria'sDad77 ($5.29 in chips) 
Max7899: posts small blind $0.02
Maria'sDad77: posts big blind $0.05
*** HOLE CARDS ***
Dealt to Dorex2007 [2d 5d]
Dorex2007: folds 
Nicolas Trin: calls $0.05
DannamoH: folds 
rezabraba333: folds 
zoepaul: folds 
Max7899: calls $0.03
Maria'sDad77: checks 
*** FLOP *** [4s 8c Js]
Max7899: checks 
Maria'sDad77: checks 
Nicolas Trin: bets $0.10
Max7899: calls $0.10
Maria'sDad77: folds 
*** TURN *** [4s 8c Js] [Jd]
Phily14 joins the table at seat #2 
DannamoH leaves the table
Max7899: bets $0.17
Nicolas Trin: calls $0.17
*** RIVER *** [4s 8c Js Jd] [Kc]
Max7899: bets $0.66
Nicolas Trin: raises $4.18 to $4.84 and is all-in
Max7899: calls $2.59 and is all-in
Uncalled bet ($1.59) returned to Nicolas Trin
*** SHOW DOWN ***
Nicolas Trin: shows [Jc 8d] (a full house, Jacks full of Eights)
Max7899: shows [Kh 7s] (two pair, Kings and Jacks)
Nicolas Trin collected $6.89 from pot
*** SUMMARY ***
Total pot $7.19 | Rake $0.30 
Board [4s 8c Js Jd Kc]
Seat 1: Dorex2007 folded before Flop (didn't bet)
Seat 3: Nicolas Trin showed [Jc 8d] and won ($6.89) with a full house, Jacks full of Eights
Seat 5: DannamoH folded before Flop (didn't bet)
Seat 6: rezabraba333 folded before Flop (didn't bet)
Seat 7: zoepaul (button) folded before Flop (didn't bet)
Seat 8: Max7899 (small blind) showed [Kh 7s] and lost with two pair, Kings and Jacks
Seat 9: Maria'sDad77 (big blind) folded on the Flop



PokerStars Hand #238019082022:  Hold'em No Limit ($0.02/$0.05 USD) - 2022/08/15 22:11:33 PT [2022/08/16 1:11:33 ET]
Table 'Alkurah III' 9-max Seat #9 is the button
Seat 1: Dorex2007 ($11.43 in chips) 
Seat 2: Phily14 ($5 in chips) 
Seat 3: Nicolas Trin ($8.48 in chips) 
Seat 6: rezabraba333 ($1.78 in chips) 
Seat 7: zoepaul ($13.74 in chips) 
Seat 9: Maria'sDad77 ($5.24 in chips) 
Dorex2007: posts small blind $0.02
Phily14: posts big blind $0.05
*** HOLE CARDS ***
Dealt to Dorex2007 [4d 7c]
Nicolas Trin: raises $0.05 to $0.10
rezabraba333: folds 
zoepaul: calls $0.10
Maria'sDad77: raises $0.15 to $0.25
Dorex2007: folds 
Phily14: folds 
Max7899 leaves the table
Nicolas Trin: calls $0.15
zoepaul: calls $0.15
*** FLOP *** [6c 3h 4h]
Nicolas Trin: checks 
zoepaul: checks 
Maria'sDad77: bets $0.54
Nicolas Trin: calls $0.54
zoepaul: folds 
*** TURN *** [6c 3h 4h] [2h]
Nicolas Trin: checks 
Maria'sDad77: bets $1.01
Nicolas Trin: calls $1.01
*** RIVER *** [6c 3h 4h 2h] [Jd]
Nicolas Trin: checks 
Maria'sDad77: bets $2.03
Nicolas Trin: raises $2.03 to $4.06
Maria'sDad77: calls $1.41 and is all-in
Uncalled bet ($0.62) returned to Nicolas Trin
*** SHOW DOWN ***
Nicolas Trin: shows [Kc Kd] (a pair of Kings)
Maria'sDad77: shows [Ah As] (a pair of Aces)
Maria'sDad77 collected $10.35 from pot
*** SUMMARY ***
Total pot $10.80 | Rake $0.45 
Board [6c 3h 4h 2h Jd]
Seat 1: Dorex2007 (small blind) folded before Flop
Seat 2: Phily14 (big blind) folded before Flop
Seat 3: Nicolas Trin showed [Kc Kd] and lost with a pair of Kings
Seat 6: rezabraba333 folded before Flop (didn't bet)
Seat 7: zoepaul folded on the Flop
Seat 9: Maria'sDad77 (button) showed [Ah As] and won ($10.35) with a pair of Aces



PokerStars Hand #238019093158:  Hold'em No Limit ($0.02/$0.05 USD) - 2022/08/15 22:13:20 PT [2022/08/16 1:13:20 ET]
Table 'Alkurah III' 9-max Seat #1 is the button
Seat 1: Dorex2007 ($11.41 in chips) 
Seat 2: Phily14 ($4.95 in chips) 
Seat 3: Nicolas Trin ($3.24 in chips) 
Seat 6: rezabraba333 ($1.78 in chips) 
Seat 7: zoepaul ($13.49 in chips) 
Seat 9: Maria'sDad77 ($10.35 in chips) 
Phily14: posts small blind $0.02
Nicolas Trin: posts big blind $0.05
*** HOLE CARDS ***
Dealt to Dorex2007 [9h 3s]
rezabraba333: folds 
zoepaul: folds 
Ginnungagap7 joins the table at seat #4 
Maria'sDad77: folds 
Dorex2007: folds 
Phily14: calls $0.03
Nicolas Trin: checks 
*** FLOP *** [Kd Th Qc]
Phily14: checks 
Nicolas Trin: bets $0.05
Phily14: calls $0.05
*** TURN *** [Kd Th Qc] [8s]
Phily14: checks 
Nicolas Trin: bets $0.05
Phily14: folds 
Uncalled bet ($0.05) returned to Nicolas Trin
Nicolas Trin collected $0.19 from pot
*** SUMMARY ***
Total pot $0.20 | Rake $0.01 
Board [Kd Th Qc 8s]
Seat 1: Dorex2007 (button) folded before Flop (didn't bet)
Seat 2: Phily14 (small blind) folded on the Turn
Seat 3: Nicolas Trin (big blind) collected ($0.19)
Seat 6: rezabraba333 folded before Flop (didn't bet)
Seat 7: zoepaul folded before Flop (didn't bet)
Seat 9: Maria'sDad77 folded before Flop (didn't bet)



PokerStars Hand #238019096209:  Hold'em No Limit ($0.02/$0.05 USD) - 2022/08/15 22:13:49 PT [2022/08/16 1:13:49 ET]
Table 'Alkurah III' 9-max Seat #2 is the button
Seat 1: Dorex2007 ($11.41 in chips) 
Seat 2: Phily14 ($4.85 in chips) 
Seat 3: Nicolas Trin ($3.33 in chips) 
Seat 4: Ginnungagap7 ($3.81 in chips) 
Seat 6: rezabraba333 ($1.78 in chips) 
Seat 7: zoepaul ($13.49 in chips) 
Seat 9: Maria'sDad77 ($10.35 in chips) 
Nicolas Trin: posts small blind $0.02
Ginnungagap7: posts big blind $0.05
*** HOLE CARDS ***
Dealt to Dorex2007 [Qs Ks]
rezabraba333: folds 
zoepaul: raises $0.10 to $0.15
1z4guirr3 joins the table at seat #8 
Maria'sDad77: folds 
Dorex2007: calls $0.15
Phily14: folds 
Nicolas Trin: folds 
Ginnungagap7: folds 
*** FLOP *** [6d 8d Kd]
DesignerAta joins the table at seat #5 
zoepaul: checks 
Dorex2007: bets $0.35
zoepaul: folds 
Uncalled bet ($0.35) returned to Dorex2007
Dorex2007 collected $0.35 from pot
Dorex2007: doesn't show hand 
*** SUMMARY ***
Total pot $0.37 | Rake $0.02 
Board [6d 8d Kd]
Seat 1: Dorex2007 collected ($0.35)
Seat 2: Phily14 (button) folded before Flop (didn't bet)
Seat 3: Nicolas Trin (small blind) folded before Flop
Seat 4: Ginnungagap7 (big blind) folded before Flop
Seat 6: rezabraba333 folded before Flop (didn't bet)
Seat 7: zoepaul folded on the Flop
Seat 9: Maria'sDad77 folded before Flop (didn't bet)



PokerStars Hand #238019103504:  Hold'em No Limit ($0.02/$0.05 USD) - 2022/08/15 22:15:00 PT [2022/08/16 1:15:00 ET]
Table 'Alkurah III' 9-max Seat #3 is the button
Seat 1: Dorex2007 ($11.61 in chips) 
Seat 2: Phily14 ($4.85 in chips) 
Seat 3: Nicolas Trin ($3.31 in chips) 
Seat 4: Ginnungagap7 ($3.76 in chips) 
Seat 5: DesignerAta ($2.21 in chips) 
Seat 6: rezabraba333 ($1.78 in chips) 
Seat 7: zoepaul ($13.34 in chips) 
Seat 8: 1z4guirr3 ($5 in chips) 
Seat 9: Maria'sDad77 ($10.35 in chips) 
Ginnungagap7: posts small blind $0.02
DesignerAta: posts big blind $0.05
1z4guirr3: posts big blind $0.05
*** HOLE CARDS ***
Dealt to Dorex2007 [Jc Td]
rezabraba333: folds 
zoepaul: calls $0.05
1z4guirr3: checks 
Maria'sDad77: folds 
Dorex2007: folds 
Phily14: folds 
Nicolas Trin: raises $0.10 to $0.15
Ginnungagap7: folds 
DesignerAta: folds 
zoepaul: calls $0.10
1z4guirr3: calls $0.10
*** FLOP *** [Qs 5s 6d]
zoepaul: checks 
1z4guirr3: bets $0.50
Nicolas Trin: raises $0.50 to $1
zoepaul: folds 
1z4guirr3: calls $0.50
*** TURN *** [Qs 5s 6d] [Jd]
1z4guirr3: checks 
Nicolas Trin: bets $1.30
1z4guirr3: calls $1.30
*** RIVER *** [Qs 5s 6d Jd] [8c]
1z4guirr3: checks 
Nicolas Trin: bets $0.86 and is all-in
1z4guirr3: calls $0.86
*** SHOW DOWN ***
Nicolas Trin: shows [6h 6c] (three of a kind, Sixes)
1z4guirr3: shows [Ad Kc] (high card Ace)
Nicolas Trin collected $6.56 from pot
*** SUMMARY ***
Total pot $6.84 | Rake $0.28 
Board [Qs 5s 6d Jd 8c]
Seat 1: Dorex2007 folded before Flop (didn't bet)
Seat 2: Phily14 folded before Flop (didn't bet)
Seat 3: Nicolas Trin (button) showed [6h 6c] and won ($6.56) with three of a kind, Sixes
Seat 4: Ginnungagap7 (small blind) folded before Flop
Seat 5: DesignerAta (big blind) folded before Flop
Seat 6: rezabraba333 folded before Flop (didn't bet)
Seat 7: zoepaul folded on the Flop
Seat 8: 1z4guirr3 showed [Ad Kc] and lost with high card Ace
Seat 9: Maria'sDad77 folded before Flop (didn't bet)



PokerStars Hand #238019111374:  Hold'em No Limit ($0.02/$0.05 USD) - 2022/08/15 22:16:16 PT [2022/08/16 1:16:16 ET]
Table 'Alkurah III' 9-max Seat #4 is the button
Seat 1: Dorex2007 ($11.61 in chips) 
Seat 2: Phily14 ($4.85 in chips) 
Seat 3: Nicolas Trin ($6.56 in chips) 
Seat 4: Ginnungagap7 ($3.74 in chips) 
Seat 5: DesignerAta ($2.16 in chips) 
Seat 6: rezabraba333 ($1.78 in chips) 
Seat 7: zoepaul ($13.19 in chips) 
Seat 8: 1z4guirr3 ($1.69 in chips) 
Seat 9: Maria'sDad77 ($10.35 in chips) 
DesignerAta: posts small blind $0.02
rezabraba333: posts big blind $0.05
*** HOLE CARDS ***
Dealt to Dorex2007 [6h Jc]
zoepaul: calls $0.05
1z4guirr3: folds 
Maria'sDad77: raises $0.10 to $0.15
Dorex2007: folds 
Phily14: folds 
Nicolas Trin: folds 
Ginnungagap7: folds 
DesignerAta: folds 
rezabraba333: folds 
zoepaul: calls $0.10
*** FLOP *** [2c Ts 9h]
zoepaul: checks 
Maria'sDad77: checks 
*** TURN *** [2c Ts 9h] [5c]
zoepaul: bets $0.35
Maria'sDad77: folds 
Uncalled bet ($0.35) returned to zoepaul
zoepaul collected $0.35 from pot
*** SUMMARY ***
Total pot $0.37 | Rake $0.02 
Board [2c Ts 9h 5c]
Seat 1: Dorex2007 folded before Flop (didn't bet)
Seat 2: Phily14 folded before Flop (didn't bet)
Seat 3: Nicolas Trin folded before Flop (didn't bet)
Seat 4: Ginnungagap7 (button) folded before Flop (didn't bet)
Seat 5: DesignerAta (small blind) folded before Flop
Seat 6: rezabraba333 (big blind) folded before Flop
Seat 7: zoepaul collected ($0.35)
Seat 8: 1z4guirr3 folded before Flop (didn't bet)
Seat 9: Maria'sDad77 folded on the Turn



PokerStars Hand #238019121748:  Hold'em No Limit ($0.02/$0.05 USD) - 2022/08/15 22:17:15 PT [2022/08/16 1:17:15 ET]
Table 'Alkurah III' 9-max Seat #5 is the button
Seat 1: Dorex2007 ($11.61 in chips) 
Seat 2: Phily14 ($4.85 in chips) 
Seat 3: Nicolas Trin ($6.56 in chips) 
Seat 4: Ginnungagap7 ($3.74 in chips) 
Seat 5: DesignerAta ($2.14 in chips) 
Seat 6: rezabraba333 ($1.73 in chips) 
Seat 7: zoepaul ($13.39 in chips) 
Seat 8: 1z4guirr3 ($1.69 in chips) 
Seat 9: Maria'sDad77 ($10.20 in chips) 
rezabraba333: posts small blind $0.02
zoepaul: posts big blind $0.05
*** HOLE CARDS ***
Dealt to Dorex2007 [Qc Ah]
1z4guirr3: folds 
Maria'sDad77: folds 
Dorex2007: raises $0.10 to $0.15
Phily14: folds 
Nicolas Trin: calls $0.15
Ginnungagap7: folds 
DesignerAta: calls $0.15
rezabraba333: folds 
zoepaul: calls $0.10
*** FLOP *** [7s 2c Qh]
zoepaul: checks 
Dorex2007: bets $1
Nicolas Trin: calls $1
DesignerAta: folds 
zoepaul: folds 
*** TURN *** [7s 2c Qh] [3d]
Dorex2007: bets $10.46 and is all-in
Nicolas Trin: calls $5.41 and is all-in
Uncalled bet ($5.05) returned to Dorex2007
*** RIVER *** [7s 2c Qh 3d] [6d]
*** SHOW DOWN ***
Dorex2007: shows [Qc Ah] (a pair of Queens)
Nicolas Trin: shows [Kh Kc] (a pair of Kings)
Nicolas Trin collected $12.88 from pot
Dorex2007 cashed out the hand for $1.46 | Cash Out Fee $0.01
*** SUMMARY ***
Total pot $13.44 | Rake $0.56 
Board [7s 2c Qh 3d 6d]
Seat 1: Dorex2007 showed [Qc Ah] and lost with a pair of Queens (cashed out).
Seat 2: Phily14 folded before Flop (didn't bet)
Seat 3: Nicolas Trin showed [Kh Kc] and won ($12.88) with a pair of Kings
Seat 4: Ginnungagap7 folded before Flop (didn't bet)
Seat 5: DesignerAta (button) folded on the Flop
Seat 6: rezabraba333 (small blind) folded before Flop
Seat 7: zoepaul (big blind) folded on the Flop
Seat 8: 1z4guirr3 folded before Flop (didn't bet)
Seat 9: Maria'sDad77 folded before Flop (didn't bet)



PokerStars Hand #238019128611:  Hold'em No Limit ($0.02/$0.05 USD) - 2022/08/15 22:18:20 PT [2022/08/16 1:18:20 ET]
Table 'Alkurah III' 9-max Seat #6 is the button
Seat 1: Dorex2007 ($6.51 in chips) 
Seat 2: Phily14 ($4.85 in chips) 
Seat 3: Nicolas Trin ($12.88 in chips) 
Seat 4: Ginnungagap7 ($3.74 in chips) 
Seat 5: DesignerAta ($1.99 in chips) 
Seat 6: rezabraba333 ($1.71 in chips) 
Seat 7: zoepaul ($13.24 in chips) 
Seat 8: 1z4guirr3 ($1.69 in chips) 
Seat 9: Maria'sDad77 ($10.20 in chips) 
zoepaul: posts small blind $0.02
1z4guirr3: posts big blind $0.05
*** HOLE CARDS ***
Dealt to Dorex2007 [Jh 3h]
Maria'sDad77: folds 
Dorex2007: folds 
Phily14: folds 
Nicolas Trin: calls $0.05
Ginnungagap7: folds 
DesignerAta: folds 
rezabraba333: folds 
zoepaul: calls $0.03
1z4guirr3: checks 
*** FLOP *** [9d 9c 2s]
zoepaul: checks 
1z4guirr3: checks 
Nicolas Trin: checks 
*** TURN *** [9d 9c 2s] [6c]
zoepaul: bets $0.35
1z4guirr3: folds 
Nicolas Trin: folds 
Uncalled bet ($0.35) returned to zoepaul
zoepaul collected $0.14 from pot
*** SUMMARY ***
Total pot $0.15 | Rake $0.01 
Board [9d 9c 2s 6c]
Seat 1: Dorex2007 folded before Flop (didn't bet)
Seat 2: Phily14 folded before Flop (didn't bet)
Seat 3: Nicolas Trin folded on the Turn
Seat 4: Ginnungagap7 folded before Flop (didn't bet)
Seat 5: DesignerAta folded before Flop (didn't bet)
Seat 6: rezabraba333 (button) folded before Flop (didn't bet)
Seat 7: zoepaul (small blind) collected ($0.14)
Seat 8: 1z4guirr3 (big blind) folded on the Turn
Seat 9: Maria'sDad77 folded before Flop (didn't bet)



PokerStars Hand #238019133815:  Hold'em No Limit ($0.02/$0.05 USD) - 2022/08/15 22:19:10 PT [2022/08/16 1:19:10 ET]
Table 'Alkurah III' 9-max Seat #7 is the button
Seat 1: Dorex2007 ($6.51 in chips) 
Seat 2: Phily14 ($4.85 in chips) 
Seat 3: Nicolas Trin ($12.83 in chips) 
Seat 4: Ginnungagap7 ($3.74 in chips) 
Seat 5: DesignerAta ($1.99 in chips) 
Seat 6: rezabraba333 ($1.71 in chips) 
Seat 7: zoepaul ($13.33 in chips) 
Seat 8: 1z4guirr3 ($1.64 in chips) 
Seat 9: Maria'sDad77 ($10.20 in chips) 
1z4guirr3: posts small blind $0.02
Maria'sDad77: posts big blind $0.05
*** HOLE CARDS ***
Dealt to Dorex2007 [7c 6c]
Dorex2007: folds 
Phily14: calls $0.05
Nicolas Trin: calls $0.05
Ginnungagap7: folds 
DesignerAta: calls $0.05
rezabraba333: folds 
zoepaul: folds 
1z4guirr3: calls $0.03
Maria'sDad77: raises $0.10 to $0.15
Phily14: calls $0.10
Nicolas Trin: calls $0.10
DesignerAta: calls $0.10
1z4guirr3: calls $0.10
*** FLOP *** [Kc 2c As]
1z4guirr3: checks 
Maria'sDad77: bets $0.46
Phily14: folds 
Nicolas Trin: calls $0.46
DesignerAta: folds 
1z4guirr3: calls $0.46
*** TURN *** [Kc 2c As] [Jc]
1z4guirr3: checks 
Maria'sDad77: checks 
Nicolas Trin: checks 
*** RIVER *** [Kc 2c As Jc] [Kh]
1z4guirr3: bets $1.03 and is all-in
Maria'sDad77: folds 
Nicolas Trin: calls $1.03
*** SHOW DOWN ***
1z4guirr3: shows [4d 3c] (a pair of Kings)
Nicolas Trin: shows [9d Kd] (three of a kind, Kings)
Nicolas Trin collected $4.02 from pot
*** SUMMARY ***
Total pot $4.19 | Rake $0.17 
Board [Kc 2c As Jc Kh]
Seat 1: Dorex2007 folded before Flop (didn't bet)
Seat 2: Phily14 folded on the Flop
Seat 3: Nicolas Trin showed [9d Kd] and won ($4.02) with three of a kind, Kings
Seat 4: Ginnungagap7 folded before Flop (didn't bet)
Seat 5: DesignerAta folded on the Flop
Seat 6: rezabraba333 folded before Flop (didn't bet)
Seat 7: zoepaul (button) folded before Flop (didn't bet)
Seat 8: 1z4guirr3 (small blind) showed [4d 3c] and lost with a pair of Kings
Seat 9: Maria'sDad77 (big blind) folded on the River



PokerStars Hand #238019142390:  Hold'em No Limit ($0.02/$0.05 USD) - 2022/08/15 22:20:31 PT [2022/08/16 1:20:31 ET]
Table 'Alkurah III' 9-max Seat #9 is the button
Seat 1: Dorex2007 ($6.51 in chips) 
Seat 2: Phily14 ($4.70 in chips) 
Seat 3: Nicolas Trin ($15.21 in chips) 
Seat 4: Ginnungagap7 ($3.74 in chips) 
Seat 5: DesignerAta ($1.84 in chips) 
Seat 6: rezabraba333 ($1.71 in chips) 
Seat 7: zoepaul ($13.33 in chips) 
Seat 9: Maria'sDad77 ($9.59 in chips) 
Dorex2007: posts small blind $0.02
Phily14: posts big blind $0.05
*** HOLE CARDS ***
Dealt to Dorex2007 [3h Kc]
Nicolas Trin: folds 
Ginnungagap7: folds 
DesignerAta: folds 
rezabraba333: folds 
zoepaul: raises $0.10 to $0.15
Maria'sDad77: folds 
Dorex2007: folds 
Phily14: calls $0.10
*** FLOP *** [9s 6d Jc]
Phily14: bets $0.15
zoepaul: raises $0.61 to $0.76
Phily14: calls $0.61
*** TURN *** [9s 6d Jc] [5h]
Phily14: checks 
zoepaul: checks 
*** RIVER *** [9s 6d Jc 5h] [2d]
Phily14: checks 
zoepaul: bets $0.88
Phily14: folds 
Uncalled bet ($0.88) returned to zoepaul
zoepaul collected $1.76 from pot
*** SUMMARY ***
Total pot $1.84 | Rake $0.08 
Board [9s 6d Jc 5h 2d]
Seat 1: Dorex2007 (small blind) folded before Flop
Seat 2: Phily14 (big blind) folded on the River
Seat 3: Nicolas Trin folded before Flop (didn't bet)
Seat 4: Ginnungagap7 folded before Flop (didn't bet)
Seat 5: DesignerAta folded before Flop (didn't bet)
Seat 6: rezabraba333 folded before Flop (didn't bet)
Seat 7: zoepaul collected ($1.76)
Seat 9: Maria'sDad77 (button) folded before Flop (didn't bet)



PokerStars Hand #238019148887:  Hold'em No Limit ($0.02/$0.05 USD) - 2022/08/15 22:21:31 PT [2022/08/16 1:21:31 ET]
Table 'Alkurah III' 9-max Seat #1 is the button
Seat 1: Dorex2007 ($6.49 in chips) 
Seat 2: Phily14 ($3.79 in chips) 
Seat 3: Nicolas Trin ($15.21 in chips) 
Seat 4: Ginnungagap7 ($3.74 in chips) 
Seat 5: DesignerAta ($1.84 in chips) 
Seat 6: rezabraba333 ($1.71 in chips) 
Seat 7: zoepaul ($14.18 in chips) 
Seat 8: 1z4guirr3 ($2.43 in chips) 
Seat 9: Maria'sDad77 ($9.59 in chips) 
Phily14: posts small blind $0.02
Nicolas Trin: posts big blind $0.05
*** HOLE CARDS ***
Dealt to Dorex2007 [4s 6h]
Ginnungagap7: folds 
DesignerAta: folds 
rezabraba333: calls $0.05
zoepaul: calls $0.05
1z4guirr3: calls $0.05
Maria'sDad77: folds 
Dorex2007: folds 
Phily14: calls $0.03
Nicolas Trin: checks 
*** FLOP *** [Ah 4d Js]
Phily14: checks 
Nicolas Trin: checks 
rezabraba333: checks 
zoepaul: checks 
1z4guirr3: checks 
*** TURN *** [Ah 4d Js] [4h]
Phily14: checks 
Nicolas Trin: checks 
rezabraba333: checks 
zoepaul: checks 
1z4guirr3: checks 
*** RIVER *** [Ah 4d Js 4h] [2h]
Phily14: checks 
Nicolas Trin: checks 
rezabraba333: checks 
zoepaul: bets $0.30
1z4guirr3: folds 
Phily14: folds 
Nicolas Trin: folds 
rezabraba333: calls $0.30
*** SHOW DOWN ***
zoepaul: shows [2c 2d] (a full house, Deuces full of Fours)
rezabraba333: mucks hand 
zoepaul collected $0.81 from pot
*** SUMMARY ***
Total pot $0.85 | Rake $0.04 
Board [Ah 4d Js 4h 2h]
Seat 1: Dorex2007 (button) folded before Flop (didn't bet)
Seat 2: Phily14 (small blind) folded on the River
Seat 3: Nicolas Trin (big blind) folded on the River
Seat 4: Ginnungagap7 folded before Flop (didn't bet)
Seat 5: DesignerAta folded before Flop (didn't bet)
Seat 6: rezabraba333 mucked [Ks Qh]
Seat 7: zoepaul showed [2c 2d] and won ($0.81) with a full house, Deuces full of Fours
Seat 8: 1z4guirr3 folded on the River
Seat 9: Maria'sDad77 folded before Flop (didn't bet)



PokerStars Hand #238019157889:  Hold'em No Limit ($0.02/$0.05 USD) - 2022/08/15 22:22:57 PT [2022/08/16 1:22:57 ET]
Table 'Alkurah III' 9-max Seat #2 is the button
Seat 1: Dorex2007 ($6.49 in chips) 
Seat 2: Phily14 ($3.74 in chips) 
Seat 3: Nicolas Trin ($15.16 in chips) 
Seat 4: Ginnungagap7 ($3.74 in chips) 
Seat 5: DesignerAta ($1.84 in chips) 
Seat 6: rezabraba333 ($1.36 in chips) 
Seat 7: zoepaul ($14.64 in chips) 
Seat 8: 1z4guirr3 ($2.38 in chips) 
Seat 9: Maria'sDad77 ($9.59 in chips) 
Nicolas Trin: posts small blind $0.02
Ginnungagap7: posts big blind $0.05
*** HOLE CARDS ***
Dealt to Dorex2007 [3c 7s]
DesignerAta: calls $0.05
rezabraba333: folds 
zoepaul: raises $0.05 to $0.10
1z4guirr3: calls $0.10
Maria'sDad77: calls $0.10
Dorex2007: folds 
Phily14: folds 
Nicolas Trin: folds 
Ginnungagap7: folds 
DesignerAta: calls $0.05
*** FLOP *** [2h 8h Th]
DesignerAta: checks 
zoepaul: checks 
1z4guirr3: bets $0.45
Maria'sDad77: calls $0.45
DesignerAta: raises $1.29 to $1.74 and is all-in
zoepaul: folds 
1z4guirr3: raises $0.54 to $2.28 and is all-in
Maria'sDad77: folds 
Uncalled bet ($0.54) returned to 1z4guirr3
*** TURN *** [2h 8h Th] [9s]
*** RIVER *** [2h 8h Th 9s] [4s]
*** SHOW DOWN ***
DesignerAta: shows [Qh Qs] (a pair of Queens)
1z4guirr3: shows [5h 5d] (a pair of Fives)
DesignerAta cashed out the hand for $3.90 | Cash Out Fee $0.04
*** SUMMARY ***
Total pot $4.40 | Rake $0.18 
Board [2h 8h Th 9s 4s]
Seat 1: Dorex2007 folded before Flop (didn't bet)
Seat 2: Phily14 (button) folded before Flop (didn't bet)
Seat 3: Nicolas Trin (small blind) folded before Flop
Seat 4: Ginnungagap7 (big blind) folded before Flop
Seat 5: DesignerAta showed [Qh Qs] and won ($4.22) with a pair of Queens (pot not awarded as player cashed out)
Seat 6: rezabraba333 folded before Flop (didn't bet)
Seat 7: zoepaul folded on the Flop
Seat 8: 1z4guirr3 showed [5h 5d] and lost with a pair of Fives
Seat 9: Maria'sDad77 folded on the Flop



PokerStars Hand #238019164478:  Hold'em No Limit ($0.02/$0.05 USD) - 2022/08/15 22:24:00 PT [2022/08/16 1:24:00 ET]
Table 'Alkurah III' 9-max Seat #3 is the button
Seat 1: Dorex2007 ($6.49 in chips) 
Seat 2: Phily14 ($3.74 in chips) 
Seat 3: Nicolas Trin ($15.14 in chips) 
Seat 4: Ginnungagap7 ($3.69 in chips) 
Seat 5: DesignerAta ($3.90 in chips) 
Seat 6: rezabraba333 ($1.36 in chips) 
Seat 7: zoepaul ($14.54 in chips) 
Seat 8: 1z4guirr3 ($0.54 in chips) 
Seat 9: Maria'sDad77 ($9.04 in chips) 
Ginnungagap7: posts small blind $0.02
DesignerAta: posts big blind $0.05
*** HOLE CARDS ***
Dealt to Dorex2007 [Kh Th]
rezabraba333: folds 
zoepaul: folds 
1z4guirr3: raises $0.49 to $0.54 and is all-in
Maria'sDad77: folds 
Dorex2007: folds 
Phily14: folds 
Nicolas Trin: calls $0.54
Ginnungagap7: folds 
DesignerAta: folds 
*** FLOP *** [Qc 6c 6s]
*** TURN *** [Qc 6c 6s] [3d]
*** RIVER *** [Qc 6c 6s 3d] [8c]
*** SHOW DOWN ***
1z4guirr3: shows [Js Qh] (two pair, Queens and Sixes)
Nicolas Trin: shows [7d 7s] (two pair, Sevens and Sixes)
1z4guirr3 collected $1.10 from pot
*** SUMMARY ***
Total pot $1.15 | Rake $0.05 
Board [Qc 6c 6s 3d 8c]
Seat 1: Dorex2007 folded before Flop (didn't bet)
Seat 2: Phily14 folded before Flop (didn't bet)
Seat 3: Nicolas Trin (button) showed [7d 7s] and lost with two pair, Sevens and Sixes
Seat 4: Ginnungagap7 (small blind) folded before Flop
Seat 5: DesignerAta (big blind) folded before Flop
Seat 6: rezabraba333 folded before Flop (didn't bet)
Seat 7: zoepaul folded before Flop (didn't bet)
Seat 8: 1z4guirr3 showed [Js Qh] and won ($1.10) with two pair, Queens and Sixes
Seat 9: Maria'sDad77 folded before Flop (didn't bet)



PokerStars Hand #238019168874:  Hold'em No Limit ($0.02/$0.05 USD) - 2022/08/15 22:24:43 PT [2022/08/16 1:24:43 ET]
Table 'Alkurah III' 9-max Seat #4 is the button
Seat 1: Dorex2007 ($6.49 in chips) 
Seat 2: Phily14 ($3.74 in chips) 
Seat 3: Nicolas Trin ($14.60 in chips) 
Seat 4: Ginnungagap7 ($3.67 in chips) 
Seat 5: DesignerAta ($3.85 in chips) 
Seat 6: rezabraba333 ($1.36 in chips) 
Seat 7: zoepaul ($14.54 in chips) 
Seat 8: 1z4guirr3 ($1.10 in chips) 
Seat 9: Maria'sDad77 ($9.04 in chips) 
DesignerAta: posts small blind $0.02
rezabraba333: posts big blind $0.05
*** HOLE CARDS ***
Dealt to Dorex2007 [Js 3s]
zoepaul: folds 
1z4guirr3: folds 
Maria'sDad77: raises $0.05 to $0.10
Dorex2007: folds 
Phily14: calls $0.10
Nicolas Trin: folds 
Ginnungagap7: folds 
DesignerAta: calls $0.08
rezabraba333: folds 
*** FLOP *** [5s 2h 8h]
DesignerAta: checks 
Maria'sDad77: checks 
Phily14: bets $0.35
DesignerAta: calls $0.35
Maria'sDad77: folds 
*** TURN *** [5s 2h 8h] [3h]
DesignerAta: checks 
Phily14: bets $0.30
DesignerAta: raises $0.30 to $0.60
Phily14: calls $0.30
*** RIVER *** [5s 2h 8h 3h] [4d]
DesignerAta: bets $1.08
Phily14: folds 
Uncalled bet ($1.08) returned to DesignerAta
DesignerAta collected $2.16 from pot
*** SUMMARY ***
Total pot $2.25 | Rake $0.09 
Board [5s 2h 8h 3h 4d]
Seat 1: Dorex2007 folded before Flop (didn't bet)
Seat 2: Phily14 folded on the River
Seat 3: Nicolas Trin folded before Flop (didn't bet)
Seat 4: Ginnungagap7 (button) folded before Flop (didn't bet)
Seat 5: DesignerAta (small blind) collected ($2.16)
Seat 6: rezabraba333 (big blind) folded before Flop
Seat 7: zoepaul folded before Flop (didn't bet)
Seat 8: 1z4guirr3 folded before Flop (didn't bet)
Seat 9: Maria'sDad77 folded on the Flop



PokerStars Hand #238019176583:  Hold'em No Limit ($0.02/$0.05 USD) - 2022/08/15 22:25:57 PT [2022/08/16 1:25:57 ET]
Table 'Alkurah III' 9-max Seat #5 is the button
Seat 1: Dorex2007 ($6.49 in chips) 
Seat 2: Phily14 ($2.69 in chips) 
Seat 3: Nicolas Trin ($14.60 in chips) 
Seat 4: Ginnungagap7 ($3.67 in chips) 
Seat 5: DesignerAta ($4.96 in chips) 
Seat 6: rezabraba333 ($1.31 in chips) 
Seat 8: 1z4guirr3 ($1.10 in chips) 
Seat 9: Maria'sDad77 ($8.94 in chips) 
rezabraba333: posts small blind $0.02
1z4guirr3: posts big blind $0.05
*** HOLE CARDS ***
Dealt to Dorex2007 [2h As]
Maria'sDad77: folds 
Dorex2007: folds 
Phily14: folds 
Nicolas Trin has timed out
Nicolas Trin: folds 
Ginnungagap7: folds 
DesignerAta: folds 
rezabraba333: calls $0.03
1z4guirr3: checks 
*** FLOP *** [Jc 5h 8s]
rezabraba333: checks 
1z4guirr3: bets $0.10
rezabraba333: calls $0.10
*** TURN *** [Jc 5h 8s] [9s]
rezabraba333: checks 
1z4guirr3: bets $0.29
rezabraba333: folds 
Uncalled bet ($0.29) returned to 1z4guirr3
1z4guirr3 collected $0.29 from pot
*** SUMMARY ***
Total pot $0.30 | Rake $0.01 
Board [Jc 5h 8s 9s]
Seat 1: Dorex2007 folded before Flop (didn't bet)
Seat 2: Phily14 folded before Flop (didn't bet)
Seat 3: Nicolas Trin folded before Flop (didn't bet)
Seat 4: Ginnungagap7 folded before Flop (didn't bet)
Seat 5: DesignerAta (button) folded before Flop (didn't bet)
Seat 6: rezabraba333 (small blind) folded on the Turn
Seat 8: 1z4guirr3 (big blind) collected ($0.29)
Seat 9: Maria'sDad77 folded before Flop (didn't bet)



PokerStars Hand #238019181659:  Hold'em No Limit ($0.02/$0.05 USD) - 2022/08/15 22:26:47 PT [2022/08/16 1:26:47 ET]
Table 'Alkurah III' 9-max Seat #6 is the button
Seat 1: Dorex2007 ($6.49 in chips) 
Seat 2: Phily14 ($2.69 in chips) 
Seat 3: Nicolas Trin ($14.60 in chips) 
Seat 4: Ginnungagap7 ($3.67 in chips) 
Seat 5: DesignerAta ($4.96 in chips) 
Seat 6: rezabraba333 ($1.16 in chips) 
Seat 8: 1z4guirr3 ($1.24 in chips) 
Seat 9: Maria'sDad77 ($8.94 in chips) 
1z4guirr3: posts small blind $0.02
Maria'sDad77: posts big blind $0.05
*** HOLE CARDS ***
Dealt to Dorex2007 [2d 7c]
Dorex2007: folds 
Phily14: folds 
Nicolas Trin: calls $0.05
Ginnungagap7: raises $0.17 to $0.22
DesignerAta: folds 
rezabraba333: folds 
1z4guirr3: raises $1.02 to $1.24 and is all-in
Maria'sDad77: folds 
Nicolas Trin: folds 
Ginnungagap7: calls $1.02
*** FLOP *** [Jc 4d Ad]
*** TURN *** [Jc 4d Ad] [9d]
*** RIVER *** [Jc 4d Ad 9d] [Td]
*** SHOW DOWN ***
1z4guirr3: shows [Ac 3h] (a pair of Aces)
Ginnungagap7: shows [Kh As] (a pair of Aces - King kicker)
Ginnungagap7 collected $2.47 from pot
*** SUMMARY ***
Total pot $2.58 | Rake $0.11 
Board [Jc 4d Ad 9d Td]
Seat 1: Dorex2007 folded before Flop (didn't bet)
Seat 2: Phily14 folded before Flop (didn't bet)
Seat 3: Nicolas Trin folded before Flop
Seat 4: Ginnungagap7 showed [Kh As] and won ($2.47) with a pair of Aces
Seat 5: DesignerAta folded before Flop (didn't bet)
Seat 6: rezabraba333 (button) folded before Flop (didn't bet)
Seat 8: 1z4guirr3 (small blind) showed [Ac 3h] and lost with a pair of Aces
Seat 9: Maria'sDad77 (big blind) folded before Flop



PokerStars Hand #238019185622:  Hold'em No Limit ($0.02/$0.05 USD) - 2022/08/15 22:27:24 PT [2022/08/16 1:27:24 ET]
Table 'Alkurah III' 9-max Seat #9 is the button
Seat 1: Dorex2007 ($6.49 in chips) 
Seat 2: Phily14 ($2.69 in chips) 
Seat 3: Nicolas Trin ($14.55 in chips) 
Seat 4: Ginnungagap7 ($4.90 in chips) 
Seat 5: DesignerAta ($4.96 in chips) 
Seat 6: rezabraba333 ($1.16 in chips) 
Seat 9: Maria'sDad77 ($8.89 in chips) 
Dorex2007: posts small blind $0.02
Phily14: posts big blind $0.05
*** HOLE CARDS ***
Dealt to Dorex2007 [6d Jd]
Nicolas Trin: calls $0.05
Ginnungagap7: folds 
DesignerAta: calls $0.05
rezabraba333: folds 
1z4guirr3 leaves the table
Maria'sDad77: raises $0.10 to $0.15
Dorex2007: folds 
Phily14: calls $0.10
Nicolas Trin: calls $0.10
DesignerAta: calls $0.10
*** FLOP *** [4c 6h 5c]
Phily14: checks 
Nicolas Trin: checks 
DesignerAta: bets $0.29
Maria'sDad77: calls $0.29
Phily14: folds 
M@xium70 joins the table at seat #8 
Nicolas Trin: calls $0.29
*** TURN *** [4c 6h 5c] [7c]
Nicolas Trin: checks 
DesignerAta: bets $0.71
Maria'sDad77: calls $0.71
Nicolas Trin: folds 
*** RIVER *** [4c 6h 5c 7c] [8s]
DesignerAta: bets $0.50
Maria'sDad77: calls $0.50
*** SHOW DOWN ***
DesignerAta: shows [Kd Tc] (a straight, Four to Eight)
Maria'sDad77: shows [4d 4s] (a straight, Four to Eight)
DesignerAta collected $1.88 from pot
Maria'sDad77 collected $1.87 from pot
*** SUMMARY ***
Total pot $3.91 | Rake $0.16 
Board [4c 6h 5c 7c 8s]
Seat 1: Dorex2007 (small blind) folded before Flop
Seat 2: Phily14 (big blind) folded on the Flop
Seat 3: Nicolas Trin folded on the Turn
Seat 4: Ginnungagap7 folded before Flop (didn't bet)
Seat 5: DesignerAta showed [Kd Tc] and won ($1.88) with a straight, Four to Eight
Seat 6: rezabraba333 folded before Flop (didn't bet)
Seat 9: Maria'sDad77 (button) showed [4d 4s] and won ($1.87) with a straight, Four to Eight



PokerStars Hand #238019193431:  Hold'em No Limit ($0.02/$0.05 USD) - 2022/08/15 22:28:40 PT [2022/08/16 1:28:40 ET]
Table 'Alkurah III' 9-max Seat #1 is the button
Seat 1: Dorex2007 ($6.47 in chips) 
Seat 2: Phily14 ($2.54 in chips) 
Seat 3: Nicolas Trin ($14.11 in chips) 
Seat 4: Ginnungagap7 ($4.90 in chips) 
Seat 5: DesignerAta ($5.19 in chips) 
Seat 6: rezabraba333 ($1.16 in chips) 
Seat 9: Maria'sDad77 ($9.11 in chips) 
Phily14: posts small blind $0.02
Nicolas Trin: posts big blind $0.05
M@xium70: sits out 
*** HOLE CARDS ***
Dealt to Dorex2007 [5s 2d]
Ginnungagap7: raises $0.10 to $0.15
DesignerAta: folds 
rezabraba333: calls $0.15
Maria'sDad77: folds 
Dorex2007: folds 
Phily14: folds 
Nicolas Trin: folds 
*** FLOP *** [8h 4d Qd]
Ginnungagap7: bets $0.26
rezabraba333: folds 
Uncalled bet ($0.26) returned to Ginnungagap7
Ginnungagap7 collected $0.35 from pot
Ginnungagap7: doesn't show hand 
*** SUMMARY ***
Total pot $0.37 | Rake $0.02 
Board [8h 4d Qd]
Seat 1: Dorex2007 (button) folded before Flop (didn't bet)
Seat 2: Phily14 (small blind) folded before Flop
Seat 3: Nicolas Trin (big blind) folded before Flop
Seat 4: Ginnungagap7 collected ($0.35)
Seat 5: DesignerAta folded before Flop (didn't bet)
Seat 6: rezabraba333 folded on the Flop
Seat 9: Maria'sDad77 folded before Flop (didn't bet)



PokerStars Hand #238019196961:  Hold'em No Limit ($0.02/$0.05 USD) - 2022/08/15 22:29:14 PT [2022/08/16 1:29:14 ET]
Table 'Alkurah III' 9-max Seat #2 is the button
Seat 1: Dorex2007 ($6.47 in chips) 
Seat 2: Phily14 ($2.52 in chips) 
Seat 3: Nicolas Trin ($14.06 in chips) 
Seat 4: Ginnungagap7 ($5.10 in chips) 
Seat 5: DesignerAta ($5.19 in chips) 
Seat 6: rezabraba333 ($1.01 in chips) 
Seat 9: Maria'sDad77 ($9.11 in chips) 
Nicolas Trin: posts small blind $0.02
Ginnungagap7: posts big blind $0.05
M@xium70: sits out 
*** HOLE CARDS ***
Dealt to Dorex2007 [Ad Qd]
DesignerAta: folds 
rezabraba333: calls $0.05
Maria'sDad77: folds 
Dorex2007: raises $0.20 to $0.25
Phily14: folds 
Nicolas Trin: folds 
Ginnungagap7: calls $0.20
rezabraba333: calls $0.20
*** FLOP *** [8c Ks 5h]
Ginnungagap7: checks 
rezabraba333: checks 
Dorex2007: bets $0.37
Ginnungagap7: folds 
rezabraba333: folds 
Uncalled bet ($0.37) returned to Dorex2007
Dorex2007 collected $0.74 from pot
Dorex2007: doesn't show hand 
*** SUMMARY ***
Total pot $0.77 | Rake $0.03 
Board [8c Ks 5h]
Seat 1: Dorex2007 collected ($0.74)
Seat 2: Phily14 (button) folded before Flop (didn't bet)
Seat 3: Nicolas Trin (small blind) folded before Flop
Seat 4: Ginnungagap7 (big blind) folded on the Flop
Seat 5: DesignerAta folded before Flop (didn't bet)
Seat 6: rezabraba333 folded on the Flop
Seat 9: Maria'sDad77 folded before Flop (didn't bet)



PokerStars Hand #238019201096:  Hold'em No Limit ($0.02/$0.05 USD) - 2022/08/15 22:29:54 PT [2022/08/16 1:29:54 ET]
Table 'Alkurah III' 9-max Seat #3 is the button
Seat 1: Dorex2007 ($6.96 in chips) 
Seat 2: Phily14 ($2.52 in chips) 
Seat 3: Nicolas Trin ($14.04 in chips) 
Seat 4: Ginnungagap7 ($4.85 in chips) 
Seat 5: DesignerAta ($5.19 in chips) 
Seat 6: rezabraba333 ($0.76 in chips) 
Seat 9: Maria'sDad77 ($9.11 in chips) 
Ginnungagap7: posts small blind $0.02
DesignerAta: posts big blind $0.05
M@xium70: sits out 
*** HOLE CARDS ***
Dealt to Dorex2007 [9s 3s]
rezabraba333: folds 
Maria'sDad77 has timed out
Maria'sDad77: folds 
Dorex2007: folds 
Phily14: raises $0.10 to $0.15
Nicolas Trin: calls $0.15
Ginnungagap7: folds 
DesignerAta: folds 
*** FLOP *** [Qh Ks 5d]
Phily14: checks 
Nicolas Trin: checks 
*** TURN *** [Qh Ks 5d] [Qc]
Phily14: checks 
Nicolas Trin: checks 
*** RIVER *** [Qh Ks 5d Qc] [3d]
Phily14: bets $0.45
Nicolas Trin: calls $0.45
*** SHOW DOWN ***
Phily14: shows [Qs Jd] (three of a kind, Queens)
Nicolas Trin: mucks hand 
Phily14 collected $1.22 from pot
*** SUMMARY ***
Total pot $1.27 | Rake $0.05 
Board [Qh Ks 5d Qc 3d]
Seat 1: Dorex2007 folded before Flop (didn't bet)
Seat 2: Phily14 showed [Qs Jd] and won ($1.22) with three of a kind, Queens
Seat 3: Nicolas Trin (button) mucked [8s As]
Seat 4: Ginnungagap7 (small blind) folded before Flop
Seat 5: DesignerAta (big blind) folded before Flop
Seat 6: rezabraba333 folded before Flop (didn't bet)
Seat 9: Maria'sDad77 folded before Flop (didn't bet)



PokerStars Hand #238019207048:  Hold'em No Limit ($0.02/$0.05 USD) - 2022/08/15 22:30:51 PT [2022/08/16 1:30:51 ET]
Table 'Alkurah III' 9-max Seat #4 is the button
Seat 1: Dorex2007 ($6.96 in chips) 
Seat 2: Phily14 ($3.14 in chips) 
Seat 3: Nicolas Trin ($13.44 in chips) 
Seat 4: Ginnungagap7 ($4.83 in chips) 
Seat 5: DesignerAta ($5.14 in chips) 
Seat 6: rezabraba333 ($0.76 in chips) 
Seat 9: Maria'sDad77 ($9.11 in chips) 
DesignerAta: posts small blind $0.02
rezabraba333: posts big blind $0.05
M@xium70: sits out 
*** HOLE CARDS ***
Dealt to Dorex2007 [Jh 5d]
Maria'sDad77: folds 
Dorex2007: folds 
Phily14: calls $0.05
Nicolas Trin: calls $0.05
Ginnungagap7: folds 
DesignerAta: folds 
rezabraba333: checks 
*** FLOP *** [Tc 5c 2h]
rezabraba333: checks 
Phily14: checks 
Nicolas Trin: bets $0.15
rezabraba333: folds 
Phily14: folds 
Uncalled bet ($0.15) returned to Nicolas Trin
Nicolas Trin collected $0.16 from pot
*** SUMMARY ***
Total pot $0.17 | Rake $0.01 
Board [Tc 5c 2h]
Seat 1: Dorex2007 folded before Flop (didn't bet)
Seat 2: Phily14 folded on the Flop
Seat 3: Nicolas Trin collected ($0.16)
Seat 4: Ginnungagap7 (button) folded before Flop (didn't bet)
Seat 5: DesignerAta (small blind) folded before Flop
Seat 6: rezabraba333 (big blind) folded on the Flop
Seat 9: Maria'sDad77 folded before Flop (didn't bet)



PokerStars Hand #238019211375:  Hold'em No Limit ($0.02/$0.05 USD) - 2022/08/15 22:31:32 PT [2022/08/16 1:31:32 ET]
Table 'Alkurah III' 9-max Seat #5 is the button
Seat 1: Dorex2007 ($6.96 in chips) 
Seat 2: Phily14 ($3.09 in chips) 
Seat 3: Nicolas Trin ($13.55 in chips) 
Seat 4: Ginnungagap7 ($4.83 in chips) 
Seat 5: DesignerAta ($5.12 in chips) 
Seat 6: rezabraba333 ($0.71 in chips) 
Seat 7: zoepaul ($14.54 in chips) 
Seat 9: Maria'sDad77 ($9.11 in chips) 
rezabraba333: posts small blind $0.02
zoepaul: posts big blind $0.05
M@xium70: sits out 
*** HOLE CARDS ***
Dealt to Dorex2007 [5s 3h]
Maria'sDad77: raises $0.05 to $0.10
Dorex2007: folds 
Phily14: folds 
Nicolas Trin: calls $0.10
Ginnungagap7: folds 
DesignerAta: folds 
rezabraba333: raises $0.05 to $0.15
zoepaul: folds 
Maria'sDad77: calls $0.05
Nicolas Trin: calls $0.05
*** FLOP *** [Ah 6d As]
rezabraba333: checks 
Maria'sDad77: bets $0.24
Nicolas Trin: folds 
rezabraba333: calls $0.24
*** TURN *** [Ah 6d As] [7s]
rezabraba333: bets $0.05
Maria'sDad77: calls $0.05
*** RIVER *** [Ah 6d As 7s] [5c]
rezabraba333: bets $0.27 and is all-in
Maria'sDad77: calls $0.27
*** SHOW DOWN ***
rezabraba333: shows [Ac Qs] (three of a kind, Aces)
Maria'sDad77: shows [8d 8s] (two pair, Aces and Eights)
rezabraba333 collected $1.55 from pot
*** SUMMARY ***
Total pot $1.62 | Rake $0.07 
Board [Ah 6d As 7s 5c]
Seat 1: Dorex2007 folded before Flop (didn't bet)
Seat 2: Phily14 folded before Flop (didn't bet)
Seat 3: Nicolas Trin folded on the Flop
Seat 4: Ginnungagap7 folded before Flop (didn't bet)
Seat 5: DesignerAta (button) folded before Flop (didn't bet)
Seat 6: rezabraba333 (small blind) showed [Ac Qs] and won ($1.55) with three of a kind, Aces
Seat 7: zoepaul (big blind) folded before Flop
Seat 9: Maria'sDad77 showed [8d 8s] and lost with two pair, Aces and Eights



PokerStars Hand #238019218935:  Hold'em No Limit ($0.02/$0.05 USD) - 2022/08/15 22:32:46 PT [2022/08/16 1:32:46 ET]
Table 'Alkurah III' 9-max Seat #6 is the button
Seat 1: Dorex2007 ($6.96 in chips) 
Seat 2: Phily14 ($3.09 in chips) 
Seat 3: Nicolas Trin ($13.40 in chips) 
Seat 4: Ginnungagap7 ($4.83 in chips) 
Seat 5: DesignerAta ($5.12 in chips) 
Seat 6: rezabraba333 ($1.55 in chips) 
Seat 7: zoepaul ($14.49 in chips) 
Seat 8: M@xium70 ($4 in chips) 
Seat 9: Maria'sDad77 ($8.40 in chips) 
zoepaul: posts small blind $0.02
M@xium70: posts big blind $0.05
*** HOLE CARDS ***
Dealt to Dorex2007 [Qc 2c]
Maria'sDad77: folds 
Dorex2007: folds 
Phily14: folds 
Nicolas Trin: calls $0.05
Ginnungagap7: folds 
DesignerAta: calls $0.05
rezabraba333: folds 
zoepaul has timed out
zoepaul: folds 
M@xium70 has timed out
M@xium70: checks 
*** FLOP *** [Jd Td 7c]
M@xium70: checks 
Nicolas Trin: checks 
DesignerAta: checks 
*** TURN *** [Jd Td 7c] [Jc]
M@xium70: checks 
Nicolas Trin: checks 
DesignerAta: checks 
*** RIVER *** [Jd Td 7c Jc] [9d]
M@xium70: bets $0.08
Nicolas Trin: folds 
DesignerAta: folds 
Uncalled bet ($0.08) returned to M@xium70
M@xium70 collected $0.16 from pot
*** SUMMARY ***
Total pot $0.17 | Rake $0.01 
Board [Jd Td 7c Jc 9d]
Seat 1: Dorex2007 folded before Flop (didn't bet)
Seat 2: Phily14 folded before Flop (didn't bet)
Seat 3: Nicolas Trin folded on the River
Seat 4: Ginnungagap7 folded before Flop (didn't bet)
Seat 5: DesignerAta folded on the River
Seat 6: rezabraba333 (button) folded before Flop (didn't bet)
Seat 7: zoepaul (small blind) folded before Flop
Seat 8: M@xium70 (big blind) collected ($0.16)
Seat 9: Maria'sDad77 folded before Flop (didn't bet)



PokerStars Hand #238019231363:  Hold'em No Limit ($0.02/$0.05 USD) - 2022/08/15 22:34:44 PT [2022/08/16 1:34:44 ET]
Table 'Alkurah III' 9-max Seat #7 is the button
Seat 1: Dorex2007 ($6.96 in chips) 
Seat 2: Phily14 ($3.09 in chips) 
Seat 3: Nicolas Trin ($13.35 in chips) 
Seat 4: Ginnungagap7 ($4.83 in chips) 
Seat 5: DesignerAta ($5.07 in chips) 
Seat 6: rezabraba333 ($1.55 in chips) 
Seat 7: zoepaul ($14.47 in chips) 
Seat 8: M@xium70 ($4.11 in chips) 
Seat 9: Maria'sDad77 ($8.40 in chips) 
M@xium70: posts small blind $0.02
Maria'sDad77: posts big blind $0.05
*** HOLE CARDS ***
Dealt to Dorex2007 [5s 8h]
Dorex2007: folds 
Phily14: folds 
Nicolas Trin: calls $0.05
Ginnungagap7: folds 
DesignerAta: folds 
rezabraba333: calls $0.05
zoepaul: folds 
M@xium70: raises $0.05 to $0.10
Maria'sDad77: folds 
Nicolas Trin: calls $0.05
rezabraba333: calls $0.05
*** FLOP *** [7d Ks 6d]
M@xium70: bets $0.17
Nicolas Trin: calls $0.17
rezabraba333: calls $0.17
*** TURN *** [7d Ks 6d] [7h]
M@xium70: bets $0.41
Nicolas Trin: raises $0.41 to $0.82
rezabraba333: folds 
M@xium70: calls $0.41
*** RIVER *** [7d Ks 6d 7h] [Qc]
M@xium70: bets $1.20
Nicolas Trin: calls $1.20
*** SHOW DOWN ***
M@xium70: shows [Kd As] (two pair, Kings and Sevens)
Nicolas Trin: shows [Ts 7s] (three of a kind, Sevens)
Nicolas Trin collected $4.70 from pot
*** SUMMARY ***
Total pot $4.90 | Rake $0.20 
Board [7d Ks 6d 7h Qc]
Seat 1: Dorex2007 folded before Flop (didn't bet)
Seat 2: Phily14 folded before Flop (didn't bet)
Seat 3: Nicolas Trin showed [Ts 7s] and won ($4.70) with three of a kind, Sevens
Seat 4: Ginnungagap7 folded before Flop (didn't bet)
Seat 5: DesignerAta folded before Flop (didn't bet)
Seat 6: rezabraba333 folded on the Turn
Seat 7: zoepaul (button) folded before Flop (didn't bet)
Seat 8: M@xium70 (small blind) showed [Kd As] and lost with two pair, Kings and Sevens
Seat 9: Maria'sDad77 (big blind) folded before Flop



PokerStars Hand #238019240711:  Hold'em No Limit ($0.02/$0.05 USD) - 2022/08/15 22:36:15 PT [2022/08/16 1:36:15 ET]
Table 'Alkurah III' 9-max Seat #8 is the button
Seat 1: Dorex2007 ($6.96 in chips) 
Seat 2: Phily14 ($3.09 in chips) 
Seat 3: Nicolas Trin ($15.76 in chips) 
Seat 4: Ginnungagap7 ($4.83 in chips) 
Seat 5: DesignerAta ($5.07 in chips) 
Seat 6: rezabraba333 ($1.28 in chips) 
Seat 7: zoepaul ($14.47 in chips) 
Seat 8: M@xium70 ($1.82 in chips) 
Seat 9: Maria'sDad77 ($8.35 in chips) 
Maria'sDad77: posts small blind $0.02
Dorex2007: posts big blind $0.05
*** HOLE CARDS ***
Dealt to Dorex2007 [9h 4h]
Phily14: folds 
Nicolas Trin: calls $0.05
Ginnungagap7: folds 
DesignerAta: calls $0.05
rezabraba333: calls $0.05
zoepaul: calls $0.05
M@xium70: folds 
Maria'sDad77: raises $0.15 to $0.20
Dorex2007: folds 
Nicolas Trin: calls $0.15
DesignerAta: calls $0.15
rezabraba333: calls $0.15
zoepaul: calls $0.15
*** FLOP *** [9s Jc 3d]
Maria'sDad77: bets $0.50
Nicolas Trin: folds 
DesignerAta: folds 
rezabraba333: folds 
zoepaul: folds 
Uncalled bet ($0.50) returned to Maria'sDad77
Maria'sDad77 collected $1.01 from pot
Maria'sDad77: doesn't show hand 
*** SUMMARY ***
Total pot $1.05 | Rake $0.04 
Board [9s Jc 3d]
Seat 1: Dorex2007 (big blind) folded before Flop
Seat 2: Phily14 folded before Flop (didn't bet)
Seat 3: Nicolas Trin folded on the Flop
Seat 4: Ginnungagap7 folded before Flop (didn't bet)
Seat 5: DesignerAta folded on the Flop
Seat 6: rezabraba333 folded on the Flop
Seat 7: zoepaul folded on the Flop
Seat 8: M@xium70 (button) folded before Flop (didn't bet)
Seat 9: Maria'sDad77 (small blind) collected ($1.01)



PokerStars Hand #238019245422:  Hold'em No Limit ($0.02/$0.05 USD) - 2022/08/15 22:37:01 PT [2022/08/16 1:37:01 ET]
Table 'Alkurah III' 9-max Seat #9 is the button
Seat 1: Dorex2007 ($6.91 in chips) 
Seat 2: Phily14 ($3.09 in chips) 
Seat 3: Nicolas Trin ($15.56 in chips) 
Seat 4: Ginnungagap7 ($4.83 in chips) 
Seat 5: DesignerAta ($4.87 in chips) 
Seat 6: rezabraba333 ($1.08 in chips) 
Seat 7: zoepaul ($14.27 in chips) 
Seat 8: M@xium70 ($1.82 in chips) 
Seat 9: Maria'sDad77 ($9.16 in chips) 
Dorex2007: posts small blind $0.02
Phily14: posts big blind $0.05
*** HOLE CARDS ***
Dealt to Dorex2007 [9c Th]
Nicolas Trin: calls $0.05
Ginnungagap7: folds 
DesignerAta: folds 
rezabraba333: folds 
zoepaul: folds 
M@xium70: calls $0.05
Maria'sDad77: folds 
Dorex2007: calls $0.03
Phily14: checks 
*** FLOP *** [7d Qd Qh]
Dorex2007: checks 
Phily14: checks 
Nicolas Trin: checks 
M@xium70: checks 
*** TURN *** [7d Qd Qh] [Jc]
Dorex2007: checks 
Phily14: checks 
Nicolas Trin: bets $0.10
M@xium70: folds 
Dorex2007: calls $0.10
Phily14: folds 
*** RIVER *** [7d Qd Qh Jc] [Kd]
Dorex2007: bets $0.38
Nicolas Trin: calls $0.38
*** SHOW DOWN ***
Dorex2007: shows [9c Th] (a straight, Nine to King)
Nicolas Trin: mucks hand 
Dorex2007 collected $1.11 from pot
*** SUMMARY ***
Total pot $1.16 | Rake $0.05 
Board [7d Qd Qh Jc Kd]
Seat 1: Dorex2007 (small blind) showed [9c Th] and won ($1.11) with a straight, Nine to King
Seat 2: Phily14 (big blind) folded on the Turn
Seat 3: Nicolas Trin mucked [6d Jh]
Seat 4: Ginnungagap7 folded before Flop (didn't bet)
Seat 5: DesignerAta folded before Flop (didn't bet)
Seat 6: rezabraba333 folded before Flop (didn't bet)
Seat 7: zoepaul folded before Flop (didn't bet)
Seat 8: M@xium70 folded on the Turn
Seat 9: Maria'sDad77 (button) folded before Flop (didn't bet)



PokerStars Hand #238019252579:  Hold'em No Limit ($0.02/$0.05 USD) - 2022/08/15 22:38:12 PT [2022/08/16 1:38:12 ET]
Table 'Alkurah III' 9-max Seat #1 is the button
Seat 1: Dorex2007 ($7.49 in chips) 
Seat 2: Phily14 ($3.04 in chips) 
Seat 3: Nicolas Trin ($15.03 in chips) 
Seat 4: Ginnungagap7 ($4.83 in chips) 
Seat 5: DesignerAta ($4.87 in chips) 
Seat 6: rezabraba333 ($1.08 in chips) 
Seat 7: zoepaul ($14.27 in chips) 
Seat 8: M@xium70 ($1.77 in chips) 
Seat 9: Maria'sDad77 ($9.16 in chips) 
Phily14: posts small blind $0.02
Nicolas Trin: posts big blind $0.05
*** HOLE CARDS ***
Dealt to Dorex2007 [7c 5c]
Ginnungagap7: folds 
DesignerAta: calls $0.05
rezabraba333: folds 
zoepaul: calls $0.05
M@xium70 has timed out
M@xium70: folds 
Maria'sDad77: folds 
Dorex2007: folds 
Phily14: calls $0.03
Nicolas Trin: checks 
*** FLOP *** [Td 2s 8s]
Phily14: checks 
Nicolas Trin: checks 
DesignerAta: bets $0.19
zoepaul: calls $0.19
Phily14: folds 
Nicolas Trin: calls $0.19
*** TURN *** [Td 2s 8s] [Jh]
Nicolas Trin: checks 
DesignerAta: bets $0.37
zoepaul: raises $0.74 to $1.11
Nicolas Trin: raises $0.74 to $1.85
DesignerAta: folds 
zoepaul: calls $0.74
*** RIVER *** [Td 2s 8s Jh] [Th]
Nicolas Trin: bets $2.85
zoepaul: raises $9.33 to $12.18 and is all-in
Nicolas Trin: calls $9.33
*** SHOW DOWN ***
zoepaul: shows [Jd Tc] (a full house, Tens full of Jacks)
Nicolas Trin: shows [7d 9s] (a straight, Seven to Jack)
zoepaul collected $28.20 from pot
*** SUMMARY ***
Total pot $29.20 | Rake $1 
Board [Td 2s 8s Jh Th]
Seat 1: Dorex2007 (button) folded before Flop (didn't bet)
Seat 2: Phily14 (small blind) folded on the Flop
Seat 3: Nicolas Trin (big blind) showed [7d 9s] and lost with a straight, Seven to Jack
Seat 4: Ginnungagap7 folded before Flop (didn't bet)
Seat 5: DesignerAta folded on the Turn
Seat 6: rezabraba333 folded before Flop (didn't bet)
Seat 7: zoepaul showed [Jd Tc] and won ($28.20) with a full house, Tens full of Jacks
Seat 8: M@xium70 folded before Flop (didn't bet)
Seat 9: Maria'sDad77 folded before Flop (didn't bet)



PokerStars Hand #238019265386:  Hold'em No Limit ($0.02/$0.05 USD) - 2022/08/15 22:40:12 PT [2022/08/16 1:40:12 ET]
Table 'Alkurah III' 9-max Seat #2 is the button
Seat 1: Dorex2007 ($7.49 in chips) 
Seat 2: Phily14 ($2.99 in chips) 
Seat 3: Nicolas Trin ($0.76 in chips) 
Seat 4: Ginnungagap7 ($4.83 in chips) 
Seat 5: DesignerAta ($4.26 in chips) 
Seat 6: rezabraba333 ($1.08 in chips) 
Seat 7: zoepaul ($28.20 in chips) 
Seat 9: Maria'sDad77 ($9.16 in chips) 
Nicolas Trin: posts small blind $0.02
Ginnungagap7: posts big blind $0.05
*** HOLE CARDS ***
Dealt to Dorex2007 [Jd Js]
DesignerAta: folds 
rezabraba333: calls $0.05
zoepaul has timed out
zoepaul: folds 
Maria'sDad77: folds 
Dorex2007: raises $0.15 to $0.20
Phily14: folds 
Nicolas Trin: raises $0.56 to $0.76 and is all-in
Ginnungagap7: raises $0.56 to $1.32
rezabraba333: folds 
Dorex2007: folds 
Uncalled bet ($0.56) returned to Ginnungagap7
*** FLOP *** [6d Jh 2d]
*** TURN *** [6d Jh 2d] [3d]
*** RIVER *** [6d Jh 2d 3d] [Qh]
*** SHOW DOWN ***
Nicolas Trin: shows [Qd 7c] (a pair of Queens)
Ginnungagap7: shows [Ah Kc] (high card Ace)
Nicolas Trin collected $1.70 from pot
*** SUMMARY ***
Total pot $1.77 | Rake $0.07 
Board [6d Jh 2d 3d Qh]
Seat 1: Dorex2007 folded before Flop
Seat 2: Phily14 (button) folded before Flop (didn't bet)
Seat 3: Nicolas Trin (small blind) showed [Qd 7c] and won ($1.70) with a pair of Queens
Seat 4: Ginnungagap7 (big blind) showed [Ah Kc] and lost with high card Ace
Seat 5: DesignerAta folded before Flop (didn't bet)
Seat 6: rezabraba333 folded before Flop
Seat 7: zoepaul folded before Flop (didn't bet)
Seat 9: Maria'sDad77 folded before Flop (didn't bet)



PokerStars Hand #238019271025:  Hold'em No Limit ($0.02/$0.05 USD) - 2022/08/15 22:41:08 PT [2022/08/16 1:41:08 ET]
Table 'Alkurah III' 9-max Seat #3 is the button
Seat 1: Dorex2007 ($7.29 in chips) 
Seat 2: Phily14 ($2.99 in chips) 
Seat 3: Nicolas Trin ($1.70 in chips) 
Seat 4: Ginnungagap7 ($4.07 in chips) 
Seat 5: DesignerAta ($4.26 in chips) 
Seat 6: rezabraba333 ($1.03 in chips) 
Seat 7: zoepaul ($28.20 in chips) 
Seat 9: Maria'sDad77 ($9.16 in chips) 
Ginnungagap7: posts small blind $0.02
DesignerAta: posts big blind $0.05
*** HOLE CARDS ***
Dealt to Dorex2007 [Qs 3h]
rezabraba333: folds 
zoepaul: folds 
Maria'sDad77: raises $0.05 to $0.10
Dorex2007: folds 
Phily14: folds 
Nicolas Trin: calls $0.10
Ginnungagap7: raises $0.35 to $0.45
DesignerAta: folds 
Maria'sDad77: folds 
Nicolas Trin: raises $1.25 to $1.70 and is all-in
Ginnungagap7: calls $1.25
*** FLOP *** [Tc Ad Qc]
*** TURN *** [Tc Ad Qc] [2s]
*** RIVER *** [Tc Ad Qc 2s] [4d]
*** SHOW DOWN ***
Ginnungagap7: shows [8s 8d] (a pair of Eights)
Nicolas Trin: shows [3d Kc] (high card Ace)
Ginnungagap7 collected $3.40 from pot
*** SUMMARY ***
Total pot $3.55 | Rake $0.15 
Board [Tc Ad Qc 2s 4d]
Seat 1: Dorex2007 folded before Flop (didn't bet)
Seat 2: Phily14 folded before Flop (didn't bet)
Seat 3: Nicolas Trin (button) showed [3d Kc] and lost with high card Ace
Seat 4: Ginnungagap7 (small blind) showed [8s 8d] and won ($3.40) with a pair of Eights
Seat 5: DesignerAta (big blind) folded before Flop
Seat 6: rezabraba333 folded before Flop (didn't bet)
Seat 7: zoepaul folded before Flop (didn't bet)
Seat 9: Maria'sDad77 folded before Flop



PokerStars Hand #238019284829:  Hold'em No Limit ($0.02/$0.05 USD) - 2022/08/15 22:42:04 PT [2022/08/16 1:42:04 ET]
Table 'Alkurah III' 9-max Seat #4 is the button
Seat 1: Dorex2007 ($7.29 in chips) 
Seat 2: Phily14 ($2.99 in chips) 
Seat 4: Ginnungagap7 ($5.77 in chips) 
Seat 5: DesignerAta ($4.21 in chips) 
Seat 6: rezabraba333 ($1.03 in chips) 
Seat 7: zoepaul ($28.20 in chips) 
Seat 8: M@xium70 ($1.77 in chips) 
Seat 9: Maria'sDad77 ($9.06 in chips) 
DesignerAta: posts small blind $0.02
rezabraba333: posts big blind $0.05
*** HOLE CARDS ***
Dealt to Dorex2007 [Qc Td]
zoepaul: folds 
Nicolas Trin leaves the table
M@xium70: folds 
Maria'sDad77: folds 
Dorex2007: folds 
Phily14: raises $0.10 to $0.15
Ginnungagap7: folds 
DesignerAta: folds 
rezabraba333: calls $0.10
*** FLOP *** [5c 6c 6h]
rezabraba333: checks 
Phily14: bets $0.31
rezabraba333: folds 
Uncalled bet ($0.31) returned to Phily14
Phily14 collected $0.31 from pot
Phily14: doesn't show hand 
*** SUMMARY ***
Total pot $0.32 | Rake $0.01 
Board [5c 6c 6h]
Seat 1: Dorex2007 folded before Flop (didn't bet)
Seat 2: Phily14 collected ($0.31)
Seat 4: Ginnungagap7 (button) folded before Flop (didn't bet)
Seat 5: DesignerAta (small blind) folded before Flop
Seat 6: rezabraba333 (big blind) folded on the Flop
Seat 7: zoepaul folded before Flop (didn't bet)
Seat 8: M@xium70 folded before Flop (didn't bet)
Seat 9: Maria'sDad77 folded before Flop (didn't bet)



PokerStars Hand #238019287814:  Hold'em No Limit ($0.02/$0.05 USD) - 2022/08/15 22:42:34 PT [2022/08/16 1:42:34 ET]
Table 'Alkurah III' 9-max Seat #5 is the button
Seat 1: Dorex2007 ($7.29 in chips) 
Seat 2: Phily14 ($3.15 in chips) 
Seat 4: Ginnungagap7 ($5.77 in chips) 
Seat 5: DesignerAta ($4.19 in chips) 
Seat 6: rezabraba333 ($0.88 in chips) 
Seat 7: zoepaul ($28.20 in chips) 
Seat 8: M@xium70 ($1.77 in chips) 
Seat 9: Maria'sDad77 ($9.06 in chips) 
rezabraba333: posts small blind $0.02
zoepaul: posts big blind $0.05
*** HOLE CARDS ***
Dealt to Dorex2007 [Qh 9d]
M@xium70: calls $0.05
Maria'sDad77: folds 
Dorex2007: folds 
Phily14: folds 
Ginnungagap7: folds 
DesignerAta: calls $0.05
rezabraba333: folds 
zoepaul: checks 
*** FLOP *** [7c Ah As]
zoepaul: checks 
M@xium70: bets $0.16
DesignerAta: folds 
zoepaul: folds 
Uncalled bet ($0.16) returned to M@xium70
M@xium70 collected $0.16 from pot
*** SUMMARY ***
Total pot $0.17 | Rake $0.01 
Board [7c Ah As]
Seat 1: Dorex2007 folded before Flop (didn't bet)
Seat 2: Phily14 folded before Flop (didn't bet)
Seat 4: Ginnungagap7 folded before Flop (didn't bet)
Seat 5: DesignerAta (button) folded on the Flop
Seat 6: rezabraba333 (small blind) folded before Flop
Seat 7: zoepaul (big blind) folded on the Flop
Seat 8: M@xium70 collected ($0.16)
Seat 9: Maria'sDad77 folded before Flop (didn't bet)



PokerStars Hand #238019291051:  Hold'em No Limit ($0.02/$0.05 USD) - 2022/08/15 22:43:06 PT [2022/08/16 1:43:06 ET]
Table 'Alkurah III' 9-max Seat #6 is the button
Seat 1: Dorex2007 ($7.29 in chips) 
Seat 2: Phily14 ($3.15 in chips) 
Seat 4: Ginnungagap7 ($5.77 in chips) 
Seat 5: DesignerAta ($4.14 in chips) 
Seat 6: rezabraba333 ($0.86 in chips) 
Seat 7: zoepaul ($28.15 in chips) 
Seat 8: M@xium70 ($1.88 in chips) 
Seat 9: Maria'sDad77 ($9.06 in chips) 
zoepaul: posts small blind $0.02
M@xium70: posts big blind $0.05
*** HOLE CARDS ***
Dealt to Dorex2007 [7s Ts]
Maria'sDad77: folds 
Dorex2007: folds 
Phily14: folds 
Ginnungagap7: folds 
DesignerAta: folds 
rezabraba333: folds 
zoepaul: folds 
Uncalled bet ($0.03) returned to M@xium70
M@xium70 collected $0.04 from pot
*** SUMMARY ***
Total pot $0.04 | Rake $0 
Seat 1: Dorex2007 folded before Flop (didn't bet)
Seat 2: Phily14 folded before Flop (didn't bet)
Seat 4: Ginnungagap7 folded before Flop (didn't bet)
Seat 5: DesignerAta folded before Flop (didn't bet)
Seat 6: rezabraba333 (button) folded before Flop (didn't bet)
Seat 7: zoepaul (small blind) folded before Flop
Seat 8: M@xium70 (big blind) collected ($0.04)
Seat 9: Maria'sDad77 folded before Flop (didn't bet)



PokerStars Hand #238019293560:  Hold'em No Limit ($0.02/$0.05 USD) - 2022/08/15 22:43:29 PT [2022/08/16 1:43:29 ET]
Table 'Alkurah III' 9-max Seat #7 is the button
Seat 1: Dorex2007 ($7.29 in chips) 
Seat 2: Phily14 ($3.15 in chips) 
Seat 4: Ginnungagap7 ($5.77 in chips) 
Seat 5: DesignerAta ($4.14 in chips) 
Seat 6: rezabraba333 ($0.86 in chips) 
Seat 7: zoepaul ($28.13 in chips) 
Seat 8: M@xium70 ($1.90 in chips) 
Seat 9: Maria'sDad77 ($9.06 in chips) 
M@xium70: posts small blind $0.02
Maria'sDad77: posts big blind $0.05
*** HOLE CARDS ***
Dealt to Dorex2007 [8h Ks]
Dorex2007: folds 
Phily14: folds 
Ginnungagap7: folds 
DesignerAta: folds 
rezabraba333: folds 
zoepaul: folds 
M@xium70: folds 
Uncalled bet ($0.03) returned to Maria'sDad77
Maria'sDad77 collected $0.04 from pot
*** SUMMARY ***
Total pot $0.04 | Rake $0 
Seat 1: Dorex2007 folded before Flop (didn't bet)
Seat 2: Phily14 folded before Flop (didn't bet)
Seat 4: Ginnungagap7 folded before Flop (didn't bet)
Seat 5: DesignerAta folded before Flop (didn't bet)
Seat 6: rezabraba333 folded before Flop (didn't bet)
Seat 7: zoepaul (button) folded before Flop (didn't bet)
Seat 8: M@xium70 (small blind) folded before Flop
Seat 9: Maria'sDad77 (big blind) collected ($0.04)



PokerStars Hand #238019295888:  Hold'em No Limit ($0.02/$0.05 USD) - 2022/08/15 22:43:52 PT [2022/08/16 1:43:52 ET]
Table 'Alkurah III' 9-max Seat #8 is the button
Seat 1: Dorex2007 ($7.29 in chips) 
Seat 2: Phily14 ($3.15 in chips) 
Seat 4: Ginnungagap7 ($5.77 in chips) 
Seat 5: DesignerAta ($4.14 in chips) 
Seat 6: rezabraba333 ($0.86 in chips) 
Seat 7: zoepaul ($28.13 in chips) 
Seat 8: M@xium70 ($1.88 in chips) 
Seat 9: Maria'sDad77 ($9.08 in chips) 
Maria'sDad77: posts small blind $0.02
Dorex2007: posts big blind $0.05
*** HOLE CARDS ***
Dealt to Dorex2007 [7s 6d]
Phily14: calls $0.05
Ginnungagap7: folds 
DesignerAta: folds 
rezabraba333: folds 
zoepaul: folds 
M@xium70: folds 
Maria'sDad77: raises $0.10 to $0.15
Dorex2007: folds 
Phily14: calls $0.10
*** FLOP *** [9s 6c Th]
Maria'sDad77: bets $0.27
Phily14: raises $0.88 to $1.15
Maria'sDad77: folds 
Uncalled bet ($0.88) returned to Phily14
Phily14 collected $0.85 from pot
Phily14: doesn't show hand 
*** SUMMARY ***
Total pot $0.89 | Rake $0.04 
Board [9s 6c Th]
Seat 1: Dorex2007 (big blind) folded before Flop
Seat 2: Phily14 collected ($0.85)
Seat 4: Ginnungagap7 folded before Flop (didn't bet)
Seat 5: DesignerAta folded before Flop (didn't bet)
Seat 6: rezabraba333 folded before Flop (didn't bet)
Seat 7: zoepaul folded before Flop (didn't bet)
Seat 8: M@xium70 (button) folded before Flop (didn't bet)
Seat 9: Maria'sDad77 (small blind) folded on the Flop



PokerStars Hand #238019303138:  Hold'em No Limit ($0.02/$0.05 USD) - 2022/08/15 22:45:03 PT [2022/08/16 1:45:03 ET]
Table 'Alkurah III' 9-max Seat #9 is the button
Seat 1: Dorex2007 ($7.24 in chips) 
Seat 2: Phily14 ($3.58 in chips) 
Seat 4: Ginnungagap7 ($5.77 in chips) 
Seat 5: DesignerAta ($4.14 in chips) 
Seat 6: rezabraba333 ($0.86 in chips) 
Seat 7: zoepaul ($28.13 in chips) 
Seat 8: M@xium70 ($1.88 in chips) 
Seat 9: Maria'sDad77 ($8.66 in chips) 
Dorex2007: posts small blind $0.02
Phily14: posts big blind $0.05
*** HOLE CARDS ***
Dealt to Dorex2007 [7c 2h]
Ginnungagap7: folds 
DesignerAta: folds 
rezabraba333: folds 
zoepaul: folds 
M@xium70: folds 
Maria'sDad77: raises $0.10 to $0.15
Dorex2007: folds 
Phily14: raises $0.45 to $0.60
Maria'sDad77: folds 
Uncalled bet ($0.45) returned to Phily14
Phily14 collected $0.32 from pot
Phily14: doesn't show hand 
*** SUMMARY ***
Total pot $0.32 | Rake $0 
Seat 1: Dorex2007 (small blind) folded before Flop
Seat 2: Phily14 (big blind) collected ($0.32)
Seat 4: Ginnungagap7 folded before Flop (didn't bet)
Seat 5: DesignerAta folded before Flop (didn't bet)
Seat 6: rezabraba333 folded before Flop (didn't bet)
Seat 7: zoepaul folded before Flop (didn't bet)
Seat 8: M@xium70 folded before Flop (didn't bet)
Seat 9: Maria'sDad77 (button) folded before Flop



PokerStars Hand #238019306316:  Hold'em No Limit ($0.02/$0.05 USD) - 2022/08/15 22:45:32 PT [2022/08/16 1:45:32 ET]
Table 'Alkurah III' 9-max Seat #1 is the button
Seat 1: Dorex2007 ($7.22 in chips) 
Seat 2: Phily14 ($3.75 in chips) 
Seat 4: Ginnungagap7 ($5.77 in chips) 
Seat 5: DesignerAta ($4.14 in chips) 
Seat 6: rezabraba333 ($0.86 in chips) 
Seat 7: zoepaul ($28.13 in chips) 
Seat 8: M@xium70 ($1.88 in chips) 
Seat 9: Maria'sDad77 ($8.51 in chips) 
Phily14: posts small blind $0.02
Ginnungagap7: posts big blind $0.05
*** HOLE CARDS ***
Dealt to Dorex2007 [9d Kh]
DesignerAta: folds 
rezabraba333: folds 
zoepaul: folds 
M@xium70: folds 
Maria'sDad77: folds 
Dorex2007: folds 
Phily14: calls $0.03
Ginnungagap7: checks 
*** FLOP *** [Jh 3s 4s]
Phily14: bets $0.10
Ginnungagap7: folds 
Uncalled bet ($0.10) returned to Phily14
MOONSP3LL joins the table at seat #3 
Phily14 collected $0.10 from pot
Phily14: doesn't show hand 
*** SUMMARY ***
Total pot $0.10 | Rake $0 
Board [Jh 3s 4s]
Seat 1: Dorex2007 (button) folded before Flop (didn't bet)
Seat 2: Phily14 (small blind) collected ($0.10)
Seat 4: Ginnungagap7 (big blind) folded on the Flop
Seat 5: DesignerAta folded before Flop (didn't bet)
Seat 6: rezabraba333 folded before Flop (didn't bet)
Seat 7: zoepaul folded before Flop (didn't bet)
Seat 8: M@xium70 folded before Flop (didn't bet)
Seat 9: Maria'sDad77 folded before Flop (didn't bet)



PokerStars Hand #238019310076:  Hold'em No Limit ($0.02/$0.05 USD) - 2022/08/15 22:46:09 PT [2022/08/16 1:46:09 ET]
Table 'Alkurah III' 9-max Seat #2 is the button
Seat 1: Dorex2007 ($7.22 in chips) 
Seat 2: Phily14 ($3.80 in chips) 
Seat 4: Ginnungagap7 ($5.72 in chips) 
Seat 5: DesignerAta ($4.14 in chips) 
Seat 6: rezabraba333 ($0.86 in chips) 
Seat 7: zoepaul ($28.13 in chips) 
Seat 8: M@xium70 ($1.88 in chips) 
Seat 9: Maria'sDad77 ($8.51 in chips) 
Ginnungagap7: posts small blind $0.02
DesignerAta: posts big blind $0.05
*** HOLE CARDS ***
Dealt to Dorex2007 [Kc Ah]
rezabraba333: folds 
zoepaul: raises $0.05 to $0.10
M@xium70: folds 
Maria'sDad77: folds 
Dorex2007: raises $0.30 to $0.40
Phily14: folds 
Ginnungagap7: folds 
DesignerAta: folds 
zoepaul: folds 
Uncalled bet ($0.30) returned to Dorex2007
Dorex2007 collected $0.27 from pot
Dorex2007: doesn't show hand 
*** SUMMARY ***
Total pot $0.27 | Rake $0 
Seat 1: Dorex2007 collected ($0.27)
Seat 2: Phily14 (button) folded before Flop (didn't bet)
Seat 4: Ginnungagap7 (small blind) folded before Flop
Seat 5: DesignerAta (big blind) folded before Flop
Seat 6: rezabraba333 folded before Flop (didn't bet)
Seat 7: zoepaul folded before Flop
Seat 8: M@xium70 folded before Flop (didn't bet)
Seat 9: Maria'sDad77 folded before Flop (didn't bet)



PokerStars Hand #238019313195:  Hold'em No Limit ($0.02/$0.05 USD) - 2022/08/15 22:46:38 PT [2022/08/16 1:46:38 ET]
Table 'Alkurah III' 9-max Seat #4 is the button
Seat 1: Dorex2007 ($7.39 in chips) 
Seat 2: Phily14 ($3.80 in chips) 
Seat 4: Ginnungagap7 ($5.70 in chips) 
Seat 5: DesignerAta ($4.09 in chips) 
Seat 6: rezabraba333 ($0.86 in chips) 
Seat 7: zoepaul ($28.03 in chips) 
Seat 8: M@xium70 ($1.88 in chips) 
Seat 9: Maria'sDad77 ($8.51 in chips) 
DesignerAta: posts small blind $0.02
rezabraba333: posts big blind $0.05
MOONSP3LL: sits out 
*** HOLE CARDS ***
Dealt to Dorex2007 [Th 5h]
zoepaul: folds 
M@xium70: folds 
Maria'sDad77: raises $0.05 to $0.10
Dorex2007: folds 
Phily14: folds 
Ginnungagap7: folds 
DesignerAta: folds 
rezabraba333: folds 
Uncalled bet ($0.05) returned to Maria'sDad77
Maria'sDad77 collected $0.12 from pot
Maria'sDad77: doesn't show hand 
*** SUMMARY ***
Total pot $0.12 | Rake $0 
Seat 1: Dorex2007 folded before Flop (didn't bet)
Seat 2: Phily14 folded before Flop (didn't bet)
Seat 4: Ginnungagap7 (button) folded before Flop (didn't bet)
Seat 5: DesignerAta (small blind) folded before Flop
Seat 6: rezabraba333 (big blind) folded before Flop
Seat 7: zoepaul folded before Flop (didn't bet)
Seat 8: M@xium70 folded before Flop (didn't bet)
Seat 9: Maria'sDad77 collected ($0.12)



PokerStars Hand #238019315206:  Hold'em No Limit ($0.02/$0.05 USD) - 2022/08/15 22:46:58 PT [2022/08/16 1:46:58 ET]
Table 'Alkurah III' 9-max Seat #5 is the button
Seat 1: Dorex2007 ($7.39 in chips) 
Seat 2: Phily14 ($3.80 in chips) 
Seat 4: Ginnungagap7 ($5.70 in chips) 
Seat 5: DesignerAta ($4.07 in chips) 
Seat 6: rezabraba333 ($0.81 in chips) 
Seat 7: zoepaul ($28.03 in chips) 
Seat 8: M@xium70 ($1.88 in chips) 
Seat 9: Maria'sDad77 ($8.58 in chips) 
rezabraba333: posts small blind $0.02
zoepaul: posts big blind $0.05
MOONSP3LL: sits out 
*** HOLE CARDS ***
Dealt to Dorex2007 [4h 8d]
M@xium70: folds 
Maria'sDad77: folds 
Dorex2007: folds 
Phily14: calls $0.05
Ginnungagap7: folds 
DesignerAta: folds 
rezabraba333: folds 
zoepaul: checks 
*** FLOP *** [6c 8c Jc]
zoepaul: checks 
Phily14: checks 
*** TURN *** [6c 8c Jc] [Kc]
zoepaul: checks 
Phily14: bets $0.15
zoepaul: folds 
Uncalled bet ($0.15) returned to Phily14
Phily14 collected $0.12 from pot
Phily14: doesn't show hand 
*** SUMMARY ***
Total pot $0.12 | Rake $0 
Board [6c 8c Jc Kc]
Seat 1: Dorex2007 folded before Flop (didn't bet)
Seat 2: Phily14 collected ($0.12)
Seat 4: Ginnungagap7 folded before Flop (didn't bet)
Seat 5: DesignerAta (button) folded before Flop (didn't bet)
Seat 6: rezabraba333 (small blind) folded before Flop
Seat 7: zoepaul (big blind) folded on the Turn
Seat 8: M@xium70 folded before Flop (didn't bet)
Seat 9: Maria'sDad77 folded before Flop (didn't bet)



PokerStars Hand #238019318760:  Hold'em No Limit ($0.02/$0.05 USD) - 2022/08/15 22:47:32 PT [2022/08/16 1:47:32 ET]
Table 'Alkurah III' 9-max Seat #6 is the button
Seat 1: Dorex2007 ($7.39 in chips) 
Seat 2: Phily14 ($3.87 in chips) 
Seat 4: Ginnungagap7 ($5.70 in chips) 
Seat 5: DesignerAta ($4.07 in chips) 
Seat 6: rezabraba333 ($0.79 in chips) 
Seat 7: zoepaul ($27.98 in chips) 
Seat 8: M@xium70 ($1.88 in chips) 
Seat 9: Maria'sDad77 ($8.58 in chips) 
zoepaul: posts small blind $0.02
M@xium70: posts big blind $0.05
MOONSP3LL: sits out 
*** HOLE CARDS ***
Dealt to Dorex2007 [9c Ts]
Maria'sDad77: folds 
Dorex2007: folds 
Phily14: folds 
Ginnungagap7: folds 
DesignerAta: calls $0.05
rezabraba333: folds 
zoepaul: calls $0.03
M@xium70: checks 
*** FLOP *** [4h 6c 5s]
zoepaul: checks 
M@xium70: checks 
DesignerAta: bets $0.14
zoepaul: calls $0.14
M@xium70: calls $0.14
*** TURN *** [4h 6c 5s] [2c]
zoepaul: checks 
M@xium70: checks 
DesignerAta: bets $0.55
zoepaul: folds 
M@xium70: folds 
Uncalled bet ($0.55) returned to DesignerAta
DesignerAta collected $0.55 from pot
*** SUMMARY ***
Total pot $0.57 | Rake $0.02 
Board [4h 6c 5s 2c]
Seat 1: Dorex2007 folded before Flop (didn't bet)
Seat 2: Phily14 folded before Flop (didn't bet)
Seat 4: Ginnungagap7 folded before Flop (didn't bet)
Seat 5: DesignerAta collected ($0.55)
Seat 6: rezabraba333 (button) folded before Flop (didn't bet)
Seat 7: zoepaul (small blind) folded on the Turn
Seat 8: M@xium70 (big blind) folded on the Turn
Seat 9: Maria'sDad77 folded before Flop (didn't bet)



PokerStars Hand #238019331327:  Hold'em No Limit ($0.02/$0.05 USD) - 2022/08/15 22:48:53 PT [2022/08/16 1:48:53 ET]
Table 'Alkurah III' 9-max Seat #7 is the button
Seat 1: Dorex2007 ($7.39 in chips) 
Seat 2: Phily14 ($3.87 in chips) 
Seat 4: Ginnungagap7 ($5.70 in chips) 
Seat 5: DesignerAta ($4.43 in chips) 
Seat 6: rezabraba333 ($0.79 in chips) 
Seat 7: zoepaul ($27.79 in chips) 
Seat 8: M@xium70 ($1.69 in chips) 
Seat 9: Maria'sDad77 ($8.58 in chips) 
M@xium70: posts small blind $0.02
Maria'sDad77: posts big blind $0.05
MOONSP3LL: sits out 
*** HOLE CARDS ***
Dealt to Dorex2007 [3h 8c]
Dorex2007: folds 
Phily14: folds 
Ginnungagap7: folds 
DesignerAta: calls $0.05
rezabraba333: folds 
zoepaul: raises $0.10 to $0.15
M@xium70: folds 
Maria'sDad77: folds 
DesignerAta: calls $0.10
*** FLOP *** [8s Qd Ac]
DesignerAta: checks 
zoepaul: bets $0.20
DesignerAta: calls $0.20
*** TURN *** [8s Qd Ac] [9c]
DesignerAta: checks 
zoepaul: checks 
*** RIVER *** [8s Qd Ac 9c] [3c]
DesignerAta: bets $0.37
zoepaul: folds 
Uncalled bet ($0.37) returned to DesignerAta
DesignerAta collected $0.74 from pot
*** SUMMARY ***
Total pot $0.77 | Rake $0.03 
Board [8s Qd Ac 9c 3c]
Seat 1: Dorex2007 folded before Flop (didn't bet)
Seat 2: Phily14 folded before Flop (didn't bet)
Seat 4: Ginnungagap7 folded before Flop (didn't bet)
Seat 5: DesignerAta collected ($0.74)
Seat 6: rezabraba333 folded before Flop (didn't bet)
Seat 7: zoepaul (button) folded on the River
Seat 8: M@xium70 (small blind) folded before Flop
Seat 9: Maria'sDad77 (big blind) folded before Flop



PokerStars Hand #238019338308:  Hold'em No Limit ($0.02/$0.05 USD) - 2022/08/15 22:50:01 PT [2022/08/16 1:50:01 ET]
Table 'Alkurah III' 9-max Seat #8 is the button
Seat 1: Dorex2007 ($7.39 in chips) 
Seat 2: Phily14 ($3.87 in chips) 
Seat 4: Ginnungagap7 ($5.70 in chips) 
Seat 5: DesignerAta ($4.82 in chips) 
Seat 6: rezabraba333 ($0.79 in chips) 
Seat 7: zoepaul ($27.44 in chips) 
Seat 8: M@xium70 ($1.67 in chips) 
Seat 9: Maria'sDad77 ($8.53 in chips) 
Maria'sDad77: posts small blind $0.02
Dorex2007: posts big blind $0.05
MOONSP3LL: sits out 
*** HOLE CARDS ***
Dealt to Dorex2007 [Js 9s]
Phily14: folds 
Ginnungagap7: folds 
DesignerAta: calls $0.05
rezabraba333: calls $0.05
zoepaul: raises $0.15 to $0.20
M@xium70: folds 
Maria'sDad77: folds 
Dorex2007: folds 
DesignerAta: calls $0.15
rezabraba333: calls $0.15
*** FLOP *** [8s 8h 3h]
DesignerAta: checks 
rezabraba333: checks 
zoepaul: bets $0.32
DesignerAta: folds 
rezabraba333: folds 
Uncalled bet ($0.32) returned to zoepaul
zoepaul collected $0.64 from pot
*** SUMMARY ***
Total pot $0.67 | Rake $0.03 
Board [8s 8h 3h]
Seat 1: Dorex2007 (big blind) folded before Flop
Seat 2: Phily14 folded before Flop (didn't bet)
Seat 4: Ginnungagap7 folded before Flop (didn't bet)
Seat 5: DesignerAta folded on the Flop
Seat 6: rezabraba333 folded on the Flop
Seat 7: zoepaul collected ($0.64)
Seat 8: M@xium70 (button) folded before Flop (didn't bet)
Seat 9: Maria'sDad77 (small blind) folded before Flop



PokerStars Hand #238019341682:  Hold'em No Limit ($0.02/$0.05 USD) - 2022/08/15 22:50:34 PT [2022/08/16 1:50:34 ET]
Table 'Alkurah III' 9-max Seat #9 is the button
Seat 1: Dorex2007 ($7.34 in chips) 
Seat 2: Phily14 ($3.87 in chips) 
Seat 4: Ginnungagap7 ($5.70 in chips) 
Seat 5: DesignerAta ($4.62 in chips) 
Seat 6: rezabraba333 ($0.59 in chips) 
Seat 7: zoepaul ($27.88 in chips) 
Seat 8: M@xium70 ($1.67 in chips) 
Seat 9: Maria'sDad77 ($8.51 in chips) 
Dorex2007: posts small blind $0.02
Phily14: posts big blind $0.05
MOONSP3LL: sits out 
*** HOLE CARDS ***
Dealt to Dorex2007 [5h 9d]
Ginnungagap7: folds 
DesignerAta: folds 
rezabraba333: folds 
zoepaul: folds 
M@xium70: folds 
Maria'sDad77: folds 
Dorex2007: folds 
Uncalled bet ($0.03) returned to Phily14
Phily14 collected $0.04 from pot
Phily14: doesn't show hand 
*** SUMMARY ***
Total pot $0.04 | Rake $0 
Seat 1: Dorex2007 (small blind) folded before Flop
Seat 2: Phily14 (big blind) collected ($0.04)
Seat 4: Ginnungagap7 folded before Flop (didn't bet)
Seat 5: DesignerAta folded before Flop (didn't bet)
Seat 6: rezabraba333 folded before Flop (didn't bet)
Seat 7: zoepaul folded before Flop (didn't bet)
Seat 8: M@xium70 folded before Flop (didn't bet)
Seat 9: Maria'sDad77 (button) folded before Flop (didn't bet)



PokerStars Hand #238019342703:  Hold'em No Limit ($0.02/$0.05 USD) - 2022/08/15 22:50:44 PT [2022/08/16 1:50:44 ET]
Table 'Alkurah III' 9-max Seat #1 is the button
Seat 1: Dorex2007 ($7.32 in chips) 
Seat 2: Phily14 ($3.89 in chips) 
Seat 3: MOONSP3LL ($5 in chips) 
Seat 4: Ginnungagap7 ($5.70 in chips) 
Seat 5: DesignerAta ($4.62 in chips) 
Seat 6: rezabraba333 ($0.59 in chips) 
Seat 7: zoepaul ($27.88 in chips) 
Seat 8: M@xium70 ($1.67 in chips) 
Seat 9: Maria'sDad77 ($8.51 in chips) 
Phily14: posts small blind $0.02
MOONSP3LL: posts big blind $0.05
*** HOLE CARDS ***
Dealt to Dorex2007 [5d 9c]
Ginnungagap7: folds 
DesignerAta: folds 
rezabraba333: calls $0.05
zoepaul: folds 
M@xium70 has timed out
M@xium70: folds 
Maria'sDad77: folds 
Dorex2007: folds 
Phily14: folds 
MOONSP3LL: checks 
*** FLOP *** [Ad 8d Qs]
MOONSP3LL: checks 
rezabraba333: checks 
*** TURN *** [Ad 8d Qs] [9s]
MOONSP3LL: checks 
rezabraba333: checks 
*** RIVER *** [Ad 8d Qs 9s] [7c]
MOONSP3LL: checks 
rezabraba333: checks 
*** SHOW DOWN ***
MOONSP3LL: shows [2h 6h] (high card Ace)
rezabraba333: shows [Jh Kd] (high card Ace - King kicker)
rezabraba333 collected $0.12 from pot
*** SUMMARY ***
Total pot $0.12 | Rake $0 
Board [Ad 8d Qs 9s 7c]
Seat 1: Dorex2007 (button) folded before Flop (didn't bet)
Seat 2: Phily14 (small blind) folded before Flop
Seat 3: MOONSP3LL (big blind) showed [2h 6h] and lost with high card Ace
Seat 4: Ginnungagap7 folded before Flop (didn't bet)
Seat 5: DesignerAta folded before Flop (didn't bet)
Seat 6: rezabraba333 showed [Jh Kd] and won ($0.12) with high card Ace
Seat 7: zoepaul folded before Flop (didn't bet)
Seat 8: M@xium70 folded before Flop (didn't bet)
Seat 9: Maria'sDad77 folded before Flop (didn't bet)



PokerStars Hand #238019349522:  Hold'em No Limit ($0.02/$0.05 USD) - 2022/08/15 22:51:49 PT [2022/08/16 1:51:49 ET]
Table 'Alkurah III' 9-max Seat #2 is the button
Seat 1: Dorex2007 ($7.32 in chips) 
Seat 2: Phily14 ($3.87 in chips) 
Seat 3: MOONSP3LL ($4.95 in chips) 
Seat 4: Ginnungagap7 ($5.70 in chips) 
Seat 5: DesignerAta ($4.62 in chips) 
Seat 6: rezabraba333 ($0.66 in chips) 
Seat 7: zoepaul ($27.88 in chips) 
Seat 8: M@xium70 ($1.67 in chips) 
Seat 9: Maria'sDad77 ($8.51 in chips) 
MOONSP3LL: posts small blind $0.02
Ginnungagap7: posts big blind $0.05
*** HOLE CARDS ***
Dealt to Dorex2007 [Ah 2s]
DesignerAta: folds 
rezabraba333: folds 
zoepaul: folds 
M@xium70: folds 
Maria'sDad77: folds 
Dorex2007: folds 
Phily14: raises $0.10 to $0.15
MOONSP3LL: raises $0.35 to $0.50
Ginnungagap7: folds 
Phily14: folds 
Uncalled bet ($0.35) returned to MOONSP3LL
MOONSP3LL collected $0.35 from pot
MOONSP3LL: doesn't show hand 
*** SUMMARY ***
Total pot $0.35 | Rake $0 
Seat 1: Dorex2007 folded before Flop (didn't bet)
Seat 2: Phily14 (button) folded before Flop
Seat 3: MOONSP3LL (small blind) collected ($0.35)
Seat 4: Ginnungagap7 (big blind) folded before Flop
Seat 5: DesignerAta folded before Flop (didn't bet)
Seat 6: rezabraba333 folded before Flop (didn't bet)
Seat 7: zoepaul folded before Flop (didn't bet)
Seat 8: M@xium70 folded before Flop (didn't bet)
Seat 9: Maria'sDad77 folded before Flop (didn't bet)



PokerStars Hand #238019352081:  Hold'em No Limit ($0.02/$0.05 USD) - 2022/08/15 22:52:15 PT [2022/08/16 1:52:15 ET]
Table 'Alkurah III' 9-max Seat #3 is the button
Seat 1: Dorex2007 ($7.32 in chips) 
Seat 2: Phily14 ($3.72 in chips) 
Seat 3: MOONSP3LL ($5.15 in chips) 
Seat 4: Ginnungagap7 ($5.65 in chips) 
Seat 5: DesignerAta ($4.62 in chips) 
Seat 6: rezabraba333 ($0.66 in chips) 
Seat 7: zoepaul ($27.88 in chips) 
Seat 8: M@xium70 ($1.67 in chips) 
Seat 9: Maria'sDad77 ($8.51 in chips) 
Ginnungagap7: posts small blind $0.02
DesignerAta: posts big blind $0.05
*** HOLE CARDS ***
Dealt to Dorex2007 [9h Ad]
rezabraba333: folds 
zoepaul has timed out
zoepaul: folds 
M@xium70: folds 
Maria'sDad77: folds 
Dorex2007: folds 
Phily14: calls $0.05
MOONSP3LL: raises $0.15 to $0.20
Ginnungagap7: folds 
DesignerAta: calls $0.15
Phily14: calls $0.15
*** FLOP *** [2h As 9d]
DesignerAta: checks 
Phily14: checks 
MOONSP3LL: checks 
*** TURN *** [2h As 9d] [Jc]
DesignerAta: checks 
Phily14: checks 
MOONSP3LL: bets $0.31
DesignerAta: calls $0.31
Phily14: calls $0.31
*** RIVER *** [2h As 9d Jc] [Ks]
DesignerAta: checks 
Phily14: checks 
MOONSP3LL: bets $1.04
DesignerAta: folds 
Phily14: folds 
Uncalled bet ($1.04) returned to MOONSP3LL
MOONSP3LL collected $1.47 from pot
MOONSP3LL: doesn't show hand 
*** SUMMARY ***
Total pot $1.55 | Rake $0.08 
Board [2h As 9d Jc Ks]
Seat 1: Dorex2007 folded before Flop (didn't bet)
Seat 2: Phily14 folded on the River
Seat 3: MOONSP3LL (button) collected ($1.47)
Seat 4: Ginnungagap7 (small blind) folded before Flop
Seat 5: DesignerAta (big blind) folded on the River
Seat 6: rezabraba333 folded before Flop (didn't bet)
Seat 7: zoepaul folded before Flop (didn't bet)
Seat 8: M@xium70 folded before Flop (didn't bet)
Seat 9: Maria'sDad77 folded before Flop (didn't bet)



PokerStars Hand #238019360272:  Hold'em No Limit ($0.02/$0.05 USD) - 2022/08/15 22:53:35 PT [2022/08/16 1:53:35 ET]
Table 'Alkurah III' 9-max Seat #4 is the button
Seat 1: Dorex2007 ($7.32 in chips) 
Seat 2: Phily14 ($3.21 in chips) 
Seat 3: MOONSP3LL ($6.11 in chips) 
Seat 4: Ginnungagap7 ($5.63 in chips) 
Seat 5: DesignerAta ($4.11 in chips) 
Seat 6: rezabraba333 ($0.66 in chips) 
Seat 7: zoepaul ($27.88 in chips) 
Seat 8: M@xium70 ($1.67 in chips) 
Seat 9: Maria'sDad77 ($8.51 in chips) 
DesignerAta: posts small blind $0.02
rezabraba333: posts big blind $0.05
*** HOLE CARDS ***
Dealt to Dorex2007 [5h Ad]
zoepaul: folds 
M@xium70 has timed out
M@xium70: folds 
Maria'sDad77: folds 
Dorex2007: folds 
Phily14: folds 
MOONSP3LL: folds 
Ginnungagap7: folds 
DesignerAta: folds 
Uncalled bet ($0.03) returned to rezabraba333
DesignerAta leaves the table
rezabraba333 collected $0.04 from pot
*** SUMMARY ***
Total pot $0.04 | Rake $0 
Seat 1: Dorex2007 folded before Flop (didn't bet)
Seat 2: Phily14 folded before Flop (didn't bet)
Seat 3: MOONSP3LL folded before Flop (didn't bet)
Seat 4: Ginnungagap7 (button) folded before Flop (didn't bet)
Seat 5: DesignerAta (small blind) folded before Flop
Seat 6: rezabraba333 (big blind) collected ($0.04)
Seat 7: zoepaul folded before Flop (didn't bet)
Seat 8: M@xium70 folded before Flop (didn't bet)
Seat 9: Maria'sDad77 folded before Flop (didn't bet)



PokerStars Hand #238019365480:  Hold'em No Limit ($0.02/$0.05 USD) - 2022/08/15 22:54:26 PT [2022/08/16 1:54:26 ET]
Table 'Alkurah III' 9-max Seat #6 is the button
Seat 1: Dorex2007 ($7.32 in chips) 
Seat 2: Phily14 ($3.21 in chips) 
Seat 3: MOONSP3LL ($6.11 in chips) 
Seat 4: Ginnungagap7 ($5.63 in chips) 
Seat 6: rezabraba333 ($0.68 in chips) 
Seat 7: zoepaul ($27.88 in chips) 
Seat 8: M@xium70 ($1.67 in chips) 
Seat 9: Maria'sDad77 ($8.51 in chips) 
zoepaul: posts small blind $0.02
M@xium70: posts big blind $0.05
*** HOLE CARDS ***
Dealt to Dorex2007 [6h 3h]
Maria'sDad77: raises $0.15 to $0.20
Dorex2007: folds 
Phily14: folds 
MOONSP3LL: folds 
Ginnungagap7: calls $0.20
rezabraba333: folds 
zoepaul: folds 
M@xium70: folds 
*** FLOP *** [5s Ks 8h]
DEdPo0L joins the table at seat #5 
Maria'sDad77: bets $0.32
Ginnungagap7: raises $0.48 to $0.80
Maria'sDad77: folds 
Uncalled bet ($0.48) returned to Ginnungagap7
Ginnungagap7 collected $1.06 from pot
Ginnungagap7: doesn't show hand 
*** SUMMARY ***
Total pot $1.11 | Rake $0.05 
Board [5s Ks 8h]
Seat 1: Dorex2007 folded before Flop (didn't bet)
Seat 2: Phily14 folded before Flop (didn't bet)
Seat 3: MOONSP3LL folded before Flop (didn't bet)
Seat 4: Ginnungagap7 collected ($1.06)
Seat 6: rezabraba333 (button) folded before Flop (didn't bet)
Seat 7: zoepaul (small blind) folded before Flop
Seat 8: M@xium70 (big blind) folded before Flop
Seat 9: Maria'sDad77 folded on the Flop



PokerStars Hand #238019372169:  Hold'em No Limit ($0.02/$0.05 USD) - 2022/08/15 22:55:33 PT [2022/08/16 1:55:33 ET]
Table 'Alkurah III' 9-max Seat #7 is the button
Seat 1: Dorex2007 ($7.32 in chips) 
Seat 2: Phily14 ($3.21 in chips) 
Seat 3: MOONSP3LL ($6.11 in chips) 
Seat 4: Ginnungagap7 ($6.17 in chips) 
Seat 6: rezabraba333 ($0.68 in chips) 
Seat 7: zoepaul ($27.86 in chips) 
Seat 8: M@xium70 ($1.62 in chips) 
Seat 9: Maria'sDad77 ($7.99 in chips) 
M@xium70: posts small blind $0.02
Maria'sDad77: posts big blind $0.05
DEdPo0L: sits out 
*** HOLE CARDS ***
Dealt to Dorex2007 [9s 9c]
Dorex2007: raises $0.05 to $0.10
Phily14: folds 
MOONSP3LL: folds 
Ginnungagap7: folds 
rezabraba333: folds 
zoepaul: calls $0.10
M@xium70: folds 
Maria'sDad77: calls $0.05
*** FLOP *** [4c 8s 2h]
Maria'sDad77: checks 
Dorex2007: bets $0.31
zoepaul: folds 
Maria'sDad77: folds 
Uncalled bet ($0.31) returned to Dorex2007
Dorex2007 collected $0.31 from pot
Dorex2007: doesn't show hand 
*** SUMMARY ***
Total pot $0.32 | Rake $0.01 
Board [4c 8s 2h]
Seat 1: Dorex2007 collected ($0.31)
Seat 2: Phily14 folded before Flop (didn't bet)
Seat 3: MOONSP3LL folded before Flop (didn't bet)
Seat 4: Ginnungagap7 folded before Flop (didn't bet)
Seat 6: rezabraba333 folded before Flop (didn't bet)
Seat 7: zoepaul (button) folded on the Flop
Seat 8: M@xium70 (small blind) folded before Flop
Seat 9: Maria'sDad77 (big blind) folded on the Flop



PokerStars Hand #238019378081:  Hold'em No Limit ($0.02/$0.05 USD) - 2022/08/15 22:56:38 PT [2022/08/16 1:56:38 ET]
Table 'Alkurah III' 9-max Seat #8 is the button
Seat 1: Dorex2007 ($7.53 in chips) 
Seat 2: Phily14 ($3.21 in chips) 
Seat 3: MOONSP3LL ($6.11 in chips) 
Seat 4: Ginnungagap7 ($6.17 in chips) 
Seat 6: rezabraba333 ($0.68 in chips) 
Seat 7: zoepaul ($27.76 in chips) 
Seat 8: M@xium70 ($1.60 in chips) 
Seat 9: Maria'sDad77 ($7.89 in chips) 
Maria'sDad77: posts small blind $0.02
Dorex2007: posts big blind $0.05
DEdPo0L: sits out 
*** HOLE CARDS ***
Dealt to Dorex2007 [4h 8h]
Phily14: folds 
MOONSP3LL: folds 
Ginnungagap7: folds 
rezabraba333: raises $0.63 to $0.68 and is all-in
zoepaul: folds 
DEdPo0L leaves the table
M@xium70 has timed out
M@xium70: folds 
Maria'sDad77: calls $0.66
Dorex2007: folds 
*** FLOP *** [6c Kc As]
*** TURN *** [6c Kc As] [Jh]
*** RIVER *** [6c Kc As Jh] [Kd]
*** SHOW DOWN ***
Maria'sDad77: shows [2s 2h] (two pair, Kings and Deuces)
rezabraba333: shows [Qh Ac] (two pair, Aces and Kings)
rezabraba333 collected $1.35 from pot
*** SUMMARY ***
Total pot $1.41 | Rake $0.06 
Board [6c Kc As Jh Kd]
Seat 1: Dorex2007 (big blind) folded before Flop
Seat 2: Phily14 folded before Flop (didn't bet)
Seat 3: MOONSP3LL folded before Flop (didn't bet)
Seat 4: Ginnungagap7 folded before Flop (didn't bet)
Seat 6: rezabraba333 showed [Qh Ac] and won ($1.35) with two pair, Aces and Kings
Seat 7: zoepaul folded before Flop (didn't bet)
Seat 8: M@xium70 (button) folded before Flop (didn't bet)
Seat 9: Maria'sDad77 (small blind) showed [2s 2h] and lost with two pair, Kings and Deuces



PokerStars Hand #238019381651:  Hold'em No Limit ($0.02/$0.05 USD) - 2022/08/15 22:57:18 PT [2022/08/16 1:57:18 ET]
Table 'Alkurah III' 9-max Seat #9 is the button
Seat 1: Dorex2007 ($7.48 in chips) 
Seat 2: Phily14 ($3.21 in chips) 
Seat 3: MOONSP3LL ($6.11 in chips) 
Seat 4: Ginnungagap7 ($6.17 in chips) 
Seat 6: rezabraba333 ($1.35 in chips) 
Seat 7: zoepaul ($27.76 in chips) 
Seat 9: Maria'sDad77 ($7.21 in chips) 
Dorex2007: posts small blind $0.02
Phily14: posts big blind $0.05
*** HOLE CARDS ***
Dealt to Dorex2007 [8h 4d]
MOONSP3LL: folds 
Ginnungagap7: folds 
joseluis76 joins the table at seat #5 
rezabraba333: folds 
zoepaul: raises $0.10 to $0.15
Maria'sDad77: folds 
Dorex2007: folds 
Phily14: calls $0.10
*** FLOP *** [5c 9h 6s]
Phily14: checks 
zoepaul: bets $0.15
Phily14: calls $0.15
*** TURN *** [5c 9h 6s] [6d]
Phily14: checks 
zoepaul: checks 
*** RIVER *** [5c 9h 6s 6d] [Ad]
Phily14: bets $0.30
zoepaul: calls $0.30
*** SHOW DOWN ***
Phily14: shows [7c Ac] (two pair, Aces and Sixes)
zoepaul: shows [As 3s] (two pair, Aces and Sixes)
Phily14 collected $0.59 from pot
zoepaul collected $0.58 from pot
*** SUMMARY ***
Total pot $1.22 | Rake $0.05 
Board [5c 9h 6s 6d Ad]
Seat 1: Dorex2007 (small blind) folded before Flop
Seat 2: Phily14 (big blind) showed [7c Ac] and won ($0.59) with two pair, Aces and Sixes
Seat 3: MOONSP3LL folded before Flop (didn't bet)
Seat 4: Ginnungagap7 folded before Flop (didn't bet)
Seat 6: rezabraba333 folded before Flop (didn't bet)
Seat 7: zoepaul showed [As 3s] and won ($0.58) with two pair, Aces and Sixes
Seat 9: Maria'sDad77 (button) folded before Flop (didn't bet)



PokerStars Hand #238019385496:  Hold'em No Limit ($0.02/$0.05 USD) - 2022/08/15 22:58:01 PT [2022/08/16 1:58:01 ET]
Table 'Alkurah III' 9-max Seat #1 is the button
Seat 1: Dorex2007 ($7.46 in chips) 
Seat 2: Phily14 ($3.20 in chips) 
Seat 3: MOONSP3LL ($6.11 in chips) 
Seat 4: Ginnungagap7 ($6.17 in chips) 
Seat 6: rezabraba333 ($1.35 in chips) 
Seat 7: zoepaul ($27.74 in chips) 
Seat 8: M@xium70 ($1.60 in chips) 
Seat 9: Maria'sDad77 ($7.21 in chips) 
Phily14: posts small blind $0.02
MOONSP3LL: posts big blind $0.05
joseluis76: sits out 
*** HOLE CARDS ***
Dealt to Dorex2007 [9c 8d]
Ginnungagap7: folds 
rezabraba333: folds 
zoepaul: folds 
M@xium70: calls $0.05
Maria'sDad77: folds 
Dorex2007: folds 
Phily14: folds 
MOONSP3LL: checks 
*** FLOP *** [Js 7h 8h]
Phily14 leaves the table
MOONSP3LL: checks 
M@xium70: bets $0.06
MOONSP3LL: calls $0.06
*** TURN *** [Js 7h 8h] [As]
MOONSP3LL: checks 
M.zanoza joins the table at seat #2 
M@xium70: bets $0.11
MOONSP3LL: calls $0.11
*** RIVER *** [Js 7h 8h As] [Kc]
MOONSP3LL: checks 
M@xium70: checks 
*** SHOW DOWN ***
MOONSP3LL: shows [6d 9s] (high card Ace)
M@xium70: shows [8s 7s] (two pair, Eights and Sevens)
M@xium70 collected $0.44 from pot
*** SUMMARY ***
Total pot $0.46 | Rake $0.02 
Board [Js 7h 8h As Kc]
Seat 1: Dorex2007 (button) folded before Flop (didn't bet)
Seat 2: Phily14 (small blind) folded before Flop
Seat 3: MOONSP3LL (big blind) showed [6d 9s] and lost with high card Ace
Seat 4: Ginnungagap7 folded before Flop (didn't bet)
Seat 6: rezabraba333 folded before Flop (didn't bet)
Seat 7: zoepaul folded before Flop (didn't bet)
Seat 8: M@xium70 showed [8s 7s] and won ($0.44) with two pair, Eights and Sevens
Seat 9: Maria'sDad77 folded before Flop (didn't bet)



PokerStars Hand #238019392632:  Hold'em No Limit ($0.02/$0.05 USD) - 2022/08/15 22:59:18 PT [2022/08/16 1:59:18 ET]
Table 'Alkurah III' 9-max Seat #3 is the button
Seat 1: Dorex2007 ($7.46 in chips) 
Seat 3: MOONSP3LL ($5.89 in chips) 
Seat 4: Ginnungagap7 ($6.17 in chips) 
Seat 5: joseluis76 ($4 in chips) 
Seat 6: rezabraba333 ($1.35 in chips) 
Seat 7: zoepaul ($27.74 in chips) 
Seat 8: M@xium70 ($1.82 in chips) 
Seat 9: Maria'sDad77 ($7.21 in chips) 
Ginnungagap7: posts small blind $0.02
joseluis76: posts big blind $0.05
M.zanoza: sits out 
*** HOLE CARDS ***
Dealt to Dorex2007 [Qs 6h]
rezabraba333: folds 
zoepaul: raises $0.10 to $0.15
M@xium70: folds 
Maria'sDad77: folds 
Dorex2007: folds 
MOONSP3LL: calls $0.15
Ginnungagap7: folds 
joseluis76: calls $0.10
*** FLOP *** [2d 9h 3d]
joseluis76: checks 
zoepaul: bets $0.25
MOONSP3LL: calls $0.25
joseluis76: folds 
*** TURN *** [2d 9h 3d] [Kd]
zoepaul: bets $0.46
MOONSP3LL: folds 
Uncalled bet ($0.46) returned to zoepaul
zoepaul collected $0.93 from pot
*** SUMMARY ***
Total pot $0.97 | Rake $0.04 
Board [2d 9h 3d Kd]
Seat 1: Dorex2007 folded before Flop (didn't bet)
Seat 3: MOONSP3LL (button) folded on the Turn
Seat 4: Ginnungagap7 (small blind) folded before Flop
Seat 5: joseluis76 (big blind) folded on the Flop
Seat 6: rezabraba333 folded before Flop (didn't bet)
Seat 7: zoepaul collected ($0.93)
Seat 8: M@xium70 folded before Flop (didn't bet)
Seat 9: Maria'sDad77 folded before Flop (didn't bet)



PokerStars Hand #238019399493:  Hold'em No Limit ($0.02/$0.05 USD) - 2022/08/15 23:00:33 PT [2022/08/16 2:00:33 ET]
Table 'Alkurah III' 9-max Seat #4 is the button
Seat 1: Dorex2007 ($7.46 in chips) 
Seat 3: MOONSP3LL ($5.49 in chips) 
Seat 4: Ginnungagap7 ($6.15 in chips) 
Seat 5: joseluis76 ($3.85 in chips) 
Seat 6: rezabraba333 ($1.35 in chips) 
Seat 7: zoepaul ($28.27 in chips) 
Seat 8: M@xium70 ($1.82 in chips) 
Seat 9: Maria'sDad77 ($7.21 in chips) 
joseluis76: posts small blind $0.02
rezabraba333: posts big blind $0.05
M.zanoza: sits out 
*** HOLE CARDS ***
Dealt to Dorex2007 [8s 2d]
zoepaul: calls $0.05
M@xium70: folds 
Maria'sDad77: folds 
Dorex2007: folds 
MOONSP3LL: folds 
Ginnungagap7: folds 
joseluis76: calls $0.03
rezabraba333: checks 
*** FLOP *** [3s 6s 9d]
joseluis76: checks 
rezabraba333: checks 
zoepaul: checks 
*** TURN *** [3s 6s 9d] [Qs]
joseluis76: checks 
rezabraba333: checks 
zoepaul: checks 
*** RIVER *** [3s 6s 9d Qs] [Kd]
joseluis76: checks 
rezabraba333: checks 
zoepaul: checks 
*** SHOW DOWN ***
joseluis76: shows [4c 4h] (a pair of Fours)
rezabraba333: mucks hand 
zoepaul: mucks hand 
joseluis76 collected $0.14 from pot
*** SUMMARY ***
Total pot $0.15 | Rake $0.01 
Board [3s 6s 9d Qs Kd]
Seat 1: Dorex2007 folded before Flop (didn't bet)
Seat 3: MOONSP3LL folded before Flop (didn't bet)
Seat 4: Ginnungagap7 (button) folded before Flop (didn't bet)
Seat 5: joseluis76 (small blind) showed [4c 4h] and won ($0.14) with a pair of Fours
Seat 6: rezabraba333 (big blind) mucked [Th 4d]
Seat 7: zoepaul mucked [2h As]
Seat 8: M@xium70 folded before Flop (didn't bet)
Seat 9: Maria'sDad77 folded before Flop (didn't bet)



PokerStars Hand #238019406677:  Hold'em No Limit ($0.02/$0.05 USD) - 2022/08/15 23:01:47 PT [2022/08/16 2:01:47 ET]
Table 'Alkurah III' 9-max Seat #5 is the button
Seat 1: Dorex2007 ($7.46 in chips) 
Seat 3: MOONSP3LL ($5.49 in chips) 
Seat 4: Ginnungagap7 ($6.15 in chips) 
Seat 5: joseluis76 ($3.94 in chips) 
Seat 6: rezabraba333 ($1.30 in chips) 
Seat 7: zoepaul ($28.22 in chips) 
Seat 8: M@xium70 ($1.82 in chips) 
Seat 9: Maria'sDad77 ($7.21 in chips) 
rezabraba333: posts small blind $0.02
zoepaul: posts big blind $0.05
M.zanoza: sits out 
*** HOLE CARDS ***
Dealt to Dorex2007 [Tc 9s]
M@xium70: folds 
Maria'sDad77: folds 
Dorex2007: folds 
MOONSP3LL: folds 
Ginnungagap7: folds 
joseluis76: calls $0.05
rezabraba333: folds 
zoepaul: checks 
*** FLOP *** [2s Ad 6h]
zoepaul: checks 
joseluis76: checks 
*** TURN *** [2s Ad 6h] [2d]
zoepaul: checks 
joseluis76: checks 
*** RIVER *** [2s Ad 6h 2d] [6c]
zoepaul: checks 
joseluis76: checks 
*** SHOW DOWN ***
zoepaul: shows [Ts 9d] (two pair, Sixes and Deuces)
joseluis76: shows [7d 9c] (two pair, Sixes and Deuces)
zoepaul collected $0.06 from pot
joseluis76 collected $0.06 from pot
*** SUMMARY ***
Total pot $0.12 | Rake $0 
Board [2s Ad 6h 2d 6c]
Seat 1: Dorex2007 folded before Flop (didn't bet)
Seat 3: MOONSP3LL folded before Flop (didn't bet)
Seat 4: Ginnungagap7 folded before Flop (didn't bet)
Seat 5: joseluis76 (button) showed [7d 9c] and won ($0.06) with two pair, Sixes and Deuces
Seat 6: rezabraba333 (small blind) folded before Flop
Seat 7: zoepaul (big blind) showed [Ts 9d] and won ($0.06) with two pair, Sixes and Deuces
Seat 8: M@xium70 folded before Flop (didn't bet)
Seat 9: Maria'sDad77 folded before Flop (didn't bet)



PokerStars Hand #238019410632:  Hold'em No Limit ($0.02/$0.05 USD) - 2022/08/15 23:02:27 PT [2022/08/16 2:02:27 ET]
Table 'Alkurah III' 9-max Seat #6 is the button
Seat 1: Dorex2007 ($7.46 in chips) 
Seat 3: MOONSP3LL ($5.49 in chips) 
Seat 4: Ginnungagap7 ($6.15 in chips) 
Seat 5: joseluis76 ($3.95 in chips) 
Seat 6: rezabraba333 ($1.28 in chips) 
Seat 7: zoepaul ($28.23 in chips) 
Seat 8: M@xium70 ($1.82 in chips) 
Seat 9: Maria'sDad77 ($7.21 in chips) 
zoepaul: posts small blind $0.02
M@xium70: posts big blind $0.05
M.zanoza: sits out 
*** HOLE CARDS ***
Dealt to Dorex2007 [Qh Ac]
Maria'sDad77: folds 
Dorex2007: raises $0.20 to $0.25
MOONSP3LL: folds 
Ginnungagap7: folds 
joseluis76: calls $0.25
rezabraba333: folds 
zoepaul: calls $0.23
M@xium70: folds 
*** FLOP *** [Jd Kc Kd]
zoepaul: checks 
Dorex2007: bets $0.38
joseluis76: folds 
zoepaul: folds 
Uncalled bet ($0.38) returned to Dorex2007
Dorex2007 collected $0.77 from pot
Dorex2007: doesn't show hand 
*** SUMMARY ***
Total pot $0.80 | Rake $0.03 
Board [Jd Kc Kd]
Seat 1: Dorex2007 collected ($0.77)
Seat 3: MOONSP3LL folded before Flop (didn't bet)
Seat 4: Ginnungagap7 folded before Flop (didn't bet)
Seat 5: joseluis76 folded on the Flop
Seat 6: rezabraba333 (button) folded before Flop (didn't bet)
Seat 7: zoepaul (small blind) folded on the Flop
Seat 8: M@xium70 (big blind) folded before Flop
Seat 9: Maria'sDad77 folded before Flop (didn't bet)



PokerStars Hand #238019414477:  Hold'em No Limit ($0.02/$0.05 USD) - 2022/08/15 23:03:06 PT [2022/08/16 2:03:06 ET]
Table 'Alkurah III' 9-max Seat #7 is the button
Seat 1: Dorex2007 ($7.98 in chips) 
Seat 3: MOONSP3LL ($5.49 in chips) 
Seat 4: Ginnungagap7 ($6.15 in chips) 
Seat 5: joseluis76 ($3.70 in chips) 
Seat 6: rezabraba333 ($1.28 in chips) 
Seat 7: zoepaul ($27.98 in chips) 
Seat 8: M@xium70 ($1.77 in chips) 
Seat 9: Maria'sDad77 ($7.21 in chips) 
M@xium70: posts small blind $0.02
Maria'sDad77: posts big blind $0.05
M.zanoza: sits out 
*** HOLE CARDS ***
Dealt to Dorex2007 [4h 5s]
Dorex2007: folds 
MOONSP3LL: folds 
Ginnungagap7: folds 
joseluis76: folds 
rezabraba333: folds 
zoepaul: folds 
M@xium70: folds 
Uncalled bet ($0.03) returned to Maria'sDad77
Maria'sDad77 collected $0.04 from pot
*** SUMMARY ***
Total pot $0.04 | Rake $0 
Seat 1: Dorex2007 folded before Flop (didn't bet)
Seat 3: MOONSP3LL folded before Flop (didn't bet)
Seat 4: Ginnungagap7 folded before Flop (didn't bet)
Seat 5: joseluis76 folded before Flop (didn't bet)
Seat 6: rezabraba333 folded before Flop (didn't bet)
Seat 7: zoepaul (button) folded before Flop (didn't bet)
Seat 8: M@xium70 (small blind) folded before Flop
Seat 9: Maria'sDad77 (big blind) collected ($0.04)



PokerStars Hand #238019416675:  Hold'em No Limit ($0.02/$0.05 USD) - 2022/08/15 23:03:29 PT [2022/08/16 2:03:29 ET]
Table 'Alkurah III' 9-max Seat #8 is the button
Seat 1: Dorex2007 ($7.98 in chips) 
Seat 3: MOONSP3LL ($5.49 in chips) 
Seat 4: Ginnungagap7 ($6.15 in chips) 
Seat 5: joseluis76 ($3.70 in chips) 
Seat 6: rezabraba333 ($1.28 in chips) 
Seat 7: zoepaul ($27.98 in chips) 
Seat 8: M@xium70 ($1.75 in chips) 
Seat 9: Maria'sDad77 ($7.23 in chips) 
Maria'sDad77: posts small blind $0.02
Dorex2007: posts big blind $0.05
M.zanoza: sits out 
*** HOLE CARDS ***
Dealt to Dorex2007 [7s 7h]
MOONSP3LL: folds 
Ginnungagap7: folds 
joseluis76: folds 
rezabraba333 has timed out
rezabraba333: folds 
zoepaul: raises $0.10 to $0.15
M@xium70: folds 
Maria'sDad77: folds 
Dorex2007: calls $0.10
*** FLOP *** [Ts 4h Qh]
Dorex2007: checks 
zoepaul: bets $0.31
Dorex2007: folds 
Uncalled bet ($0.31) returned to zoepaul
zoepaul collected $0.31 from pot
*** SUMMARY ***
Total pot $0.32 | Rake $0.01 
Board [Ts 4h Qh]
Seat 1: Dorex2007 (big blind) folded on the Flop
Seat 3: MOONSP3LL folded before Flop (didn't bet)
Seat 4: Ginnungagap7 folded before Flop (didn't bet)
Seat 5: joseluis76 folded before Flop (didn't bet)
Seat 6: rezabraba333 folded before Flop (didn't bet)
Seat 7: zoepaul collected ($0.31)
Seat 8: M@xium70 (button) folded before Flop (didn't bet)
Seat 9: Maria'sDad77 (small blind) folded before Flop



PokerStars Hand #238019421293:  Hold'em No Limit ($0.02/$0.05 USD) - 2022/08/15 23:04:14 PT [2022/08/16 2:04:14 ET]
Table 'Alkurah III' 9-max Seat #9 is the button
Seat 1: Dorex2007 ($7.83 in chips) 
Seat 2: M.zanoza ($5 in chips) 
Seat 3: MOONSP3LL ($5.49 in chips) 
Seat 4: Ginnungagap7 ($6.15 in chips) 
Seat 5: joseluis76 ($3.70 in chips) 
Seat 7: zoepaul ($28.14 in chips) 
Seat 8: M@xium70 ($1.75 in chips) 
Seat 9: Maria'sDad77 ($7.21 in chips) 
Dorex2007: posts small blind $0.02
M.zanoza: posts big blind $0.05
*** HOLE CARDS ***
Dealt to Dorex2007 [4h 5d]
MOONSP3LL: folds 
Ginnungagap7: folds 
joseluis76: calls $0.05
zoepaul: folds 
M@xium70: calls $0.05
Maria'sDad77: folds 
Dorex2007: folds 
M.zanoza: checks 
*** FLOP *** [4d As Qc]
M.zanoza: checks 
joseluis76: checks 
M@xium70: bets $0.05
M.zanoza: folds 
joseluis76: calls $0.05
*** TURN *** [4d As Qc] [Jd]
joseluis76: checks 
M@xium70: bets $0.05
joseluis76: calls $0.05
*** RIVER *** [4d As Qc Jd] [5c]
joseluis76: checks 
M@xium70: checks 
*** SHOW DOWN ***
joseluis76: shows [Kh Js] (a pair of Jacks)
M@xium70: shows [6h Ah] (a pair of Aces)
M@xium70 collected $0.35 from pot
*** SUMMARY ***
Total pot $0.37 | Rake $0.02 
Board [4d As Qc Jd 5c]
Seat 1: Dorex2007 (small blind) folded before Flop
Seat 2: M.zanoza (big blind) folded on the Flop
Seat 3: MOONSP3LL folded before Flop (didn't bet)
Seat 4: Ginnungagap7 folded before Flop (didn't bet)
Seat 5: joseluis76 showed [Kh Js] and lost with a pair of Jacks
Seat 7: zoepaul folded before Flop (didn't bet)
Seat 8: M@xium70 showed [6h Ah] and won ($0.35) with a pair of Aces
Seat 9: Maria'sDad77 (button) folded before Flop (didn't bet)



PokerStars Hand #238019427517:  Hold'em No Limit ($0.02/$0.05 USD) - 2022/08/15 23:05:16 PT [2022/08/16 2:05:16 ET]
Table 'Alkurah III' 9-max Seat #1 is the button
Seat 1: Dorex2007 ($7.81 in chips) 
Seat 2: M.zanoza ($5 in chips) 
Seat 3: MOONSP3LL ($5.49 in chips) 
Seat 4: Ginnungagap7 ($6.15 in chips) 
Seat 5: joseluis76 ($3.55 in chips) 
Seat 7: zoepaul ($28.14 in chips) 
Seat 8: M@xium70 ($1.95 in chips) 
Seat 9: Maria'sDad77 ($7.21 in chips) 
M.zanoza: posts small blind $0.02
MOONSP3LL: posts big blind $0.05
*** HOLE CARDS ***
Dealt to Dorex2007 [7h 2d]
Ginnungagap7: folds 
joseluis76: folds 
zoepaul: folds 
M@xium70: folds 
Maria'sDad77: folds 
Dorex2007: folds 
M.zanoza: raises $0.10 to $0.15
MOONSP3LL: raises $0.30 to $0.45
M.zanoza: folds 
Uncalled bet ($0.30) returned to MOONSP3LL
MOONSP3LL collected $0.30 from pot
MOONSP3LL: doesn't show hand 
*** SUMMARY ***
Total pot $0.30 | Rake $0 
Seat 1: Dorex2007 (button) folded before Flop (didn't bet)
Seat 2: M.zanoza (small blind) folded before Flop
Seat 3: MOONSP3LL (big blind) collected ($0.30)
Seat 4: Ginnungagap7 folded before Flop (didn't bet)
Seat 5: joseluis76 folded before Flop (didn't bet)
Seat 7: zoepaul folded before Flop (didn't bet)
Seat 8: M@xium70 folded before Flop (didn't bet)
Seat 9: Maria'sDad77 folded before Flop (didn't bet)



PokerStars Hand #238019430557:  Hold'em No Limit ($0.02/$0.05 USD) - 2022/08/15 23:05:46 PT [2022/08/16 2:05:46 ET]
Table 'Alkurah III' 9-max Seat #2 is the button
Seat 1: Dorex2007 ($7.81 in chips) 
Seat 2: M.zanoza ($5 in chips) 
Seat 3: MOONSP3LL ($5.64 in chips) 
Seat 4: Ginnungagap7 ($6.15 in chips) 
Seat 5: joseluis76 ($3.55 in chips) 
Seat 7: zoepaul ($28.14 in chips) 
Seat 8: M@xium70 ($1.95 in chips) 
Seat 9: Maria'sDad77 ($7.21 in chips) 
MOONSP3LL: posts small blind $0.02
Ginnungagap7: posts big blind $0.05
*** HOLE CARDS ***
Dealt to Dorex2007 [4h 5s]
joseluis76: folds 
zoepaul: folds 
M@xium70: folds 
Maria'sDad77: folds 
Dorex2007: folds 
M.zanoza: folds 
MOONSP3LL: folds 
Uncalled bet ($0.03) returned to Ginnungagap7
Ginnungagap7 collected $0.04 from pot
Ginnungagap7: doesn't show hand 
*** SUMMARY ***
Total pot $0.04 | Rake $0 
Seat 1: Dorex2007 folded before Flop (didn't bet)
Seat 2: M.zanoza (button) folded before Flop (didn't bet)
Seat 3: MOONSP3LL (small blind) folded before Flop
Seat 4: Ginnungagap7 (big blind) collected ($0.04)
Seat 5: joseluis76 folded before Flop (didn't bet)
Seat 7: zoepaul folded before Flop (didn't bet)
Seat 8: M@xium70 folded before Flop (didn't bet)
Seat 9: Maria'sDad77 folded before Flop (didn't bet)



PokerStars Hand #238019433196:  Hold'em No Limit ($0.02/$0.05 USD) - 2022/08/15 23:06:13 PT [2022/08/16 2:06:13 ET]
Table 'Alkurah III' 9-max Seat #3 is the button
Seat 1: Dorex2007 ($7.81 in chips) 
Seat 2: M.zanoza ($5 in chips) 
Seat 3: MOONSP3LL ($5.62 in chips) 
Seat 4: Ginnungagap7 ($6.17 in chips) 
Seat 5: joseluis76 ($3.55 in chips) 
Seat 7: zoepaul ($28.14 in chips) 
Seat 8: M@xium70 ($1.95 in chips) 
Seat 9: Maria'sDad77 ($7.21 in chips) 
Ginnungagap7: posts small blind $0.02
joseluis76: posts big blind $0.05
*** HOLE CARDS ***
Dealt to Dorex2007 [Jd 2s]
zoepaul: folds 
M@xium70: folds 
Maria'sDad77: folds 
Dorex2007: folds 
M.zanoza: folds 
MOONSP3LL: folds 
Ginnungagap7: folds 
Uncalled bet ($0.03) returned to joseluis76
joseluis76 collected $0.04 from pot
*** SUMMARY ***
Total pot $0.04 | Rake $0 
Seat 1: Dorex2007 folded before Flop (didn't bet)
Seat 2: M.zanoza folded before Flop (didn't bet)
Seat 3: MOONSP3LL (button) folded before Flop (didn't bet)
Seat 4: Ginnungagap7 (small blind) folded before Flop
Seat 5: joseluis76 (big blind) collected ($0.04)
Seat 7: zoepaul folded before Flop (didn't bet)
Seat 8: M@xium70 folded before Flop (didn't bet)
Seat 9: Maria'sDad77 folded before Flop (didn't bet)



PokerStars Hand #238019434338:  Hold'em No Limit ($0.02/$0.05 USD) - 2022/08/15 23:06:24 PT [2022/08/16 2:06:24 ET]
Table 'Alkurah III' 9-max Seat #4 is the button
Seat 1: Dorex2007 ($7.81 in chips) 
Seat 2: M.zanoza ($5 in chips) 
Seat 3: MOONSP3LL ($5.62 in chips) 
Seat 4: Ginnungagap7 ($6.15 in chips) 
Seat 5: joseluis76 ($3.57 in chips) 
Seat 7: zoepaul ($28.14 in chips) 
Seat 8: M@xium70 ($1.95 in chips) 
Seat 9: Maria'sDad77 ($7.21 in chips) 
joseluis76: posts small blind $0.02
zoepaul: posts big blind $0.05
*** HOLE CARDS ***
Dealt to Dorex2007 [8c Td]
M@xium70: folds 
Maria'sDad77: calls $0.05
Dorex2007: folds 
M.zanoza: folds 
MOONSP3LL: folds 
Ginnungagap7: folds 
joseluis76: calls $0.03
zoepaul: checks 
*** FLOP *** [Qh Th 5d]
joseluis76: checks 
zoepaul: checks 
Maria'sDad77: checks 
*** TURN *** [Qh Th 5d] [3c]
joseluis76: bets $0.10
zoepaul: folds 
Maria'sDad77: folds 
Uncalled bet ($0.10) returned to joseluis76
joseluis76 collected $0.14 from pot
*** SUMMARY ***
Total pot $0.15 | Rake $0.01 
Board [Qh Th 5d 3c]
Seat 1: Dorex2007 folded before Flop (didn't bet)
Seat 2: M.zanoza folded before Flop (didn't bet)
Seat 3: MOONSP3LL folded before Flop (didn't bet)
Seat 4: Ginnungagap7 (button) folded before Flop (didn't bet)
Seat 5: joseluis76 (small blind) collected ($0.14)
Seat 7: zoepaul (big blind) folded on the Turn
Seat 8: M@xium70 folded before Flop (didn't bet)
Seat 9: Maria'sDad77 folded on the Turn



PokerStars Hand #238019438962:  Hold'em No Limit ($0.02/$0.05 USD) - 2022/08/15 23:07:10 PT [2022/08/16 2:07:10 ET]
Table 'Alkurah III' 9-max Seat #5 is the button
Seat 1: Dorex2007 ($7.81 in chips) 
Seat 2: M.zanoza ($5 in chips) 
Seat 3: MOONSP3LL ($5.62 in chips) 
Seat 4: Ginnungagap7 ($6.15 in chips) 
Seat 5: joseluis76 ($3.66 in chips) 
Seat 7: zoepaul ($28.09 in chips) 
Seat 8: M@xium70 ($1.95 in chips) 
Seat 9: Maria'sDad77 ($7.16 in chips) 
zoepaul: posts small blind $0.02
M@xium70: posts big blind $0.05
*** HOLE CARDS ***
Dealt to Dorex2007 [9c Kh]
Maria'sDad77: folds 
Dorex2007: folds 
M.zanoza: folds 
MOONSP3LL: folds 
Ginnungagap7: folds 
joseluis76: calls $0.05
zoepaul: calls $0.03
M@xium70: checks 
*** FLOP *** [2d Jd 8s]
zoepaul: checks 
M@xium70: checks 
joseluis76: checks 
*** TURN *** [2d Jd 8s] [Ks]
zoepaul: checks 
M@xium70: checks 
joseluis76: checks 
*** RIVER *** [2d Jd 8s Ks] [Td]
zoepaul: checks 
M@xium70: checks 
joseluis76: checks 
*** SHOW DOWN ***
zoepaul: shows [5h Ah] (high card Ace)
M@xium70: shows [Ts 4h] (a pair of Tens)
joseluis76: shows [Tc 7s] (a pair of Tens)
M@xium70 collected $0.07 from pot
joseluis76 collected $0.07 from pot
*** SUMMARY ***
Total pot $0.15 | Rake $0.01 
Board [2d Jd 8s Ks Td]
Seat 1: Dorex2007 folded before Flop (didn't bet)
Seat 2: M.zanoza folded before Flop (didn't bet)
Seat 3: MOONSP3LL folded before Flop (didn't bet)
Seat 4: Ginnungagap7 folded before Flop (didn't bet)
Seat 5: joseluis76 (button) showed [Tc 7s] and won ($0.07) with a pair of Tens
Seat 7: zoepaul (small blind) showed [5h Ah] and lost with high card Ace
Seat 8: M@xium70 (big blind) showed [Ts 4h] and won ($0.07) with a pair of Tens
Seat 9: Maria'sDad77 folded before Flop (didn't bet)



PokerStars Hand #238019445137:  Hold'em No Limit ($0.02/$0.05 USD) - 2022/08/15 23:08:12 PT [2022/08/16 2:08:12 ET]
Table 'Alkurah III' 9-max Seat #7 is the button
Seat 1: Dorex2007 ($7.81 in chips) 
Seat 2: M.zanoza ($5 in chips) 
Seat 3: MOONSP3LL ($5.62 in chips) 
Seat 4: Ginnungagap7 ($6.15 in chips) 
Seat 5: joseluis76 ($3.68 in chips) 
Seat 7: zoepaul ($28.04 in chips) 
Seat 8: M@xium70 ($1.97 in chips) 
Seat 9: Maria'sDad77 ($7.16 in chips) 
M@xium70: posts small blind $0.02
Maria'sDad77: posts big blind $0.05
*** HOLE CARDS ***
Dealt to Dorex2007 [2h 8h]
Dorex2007: folds 
M.zanoza: folds 
MOONSP3LL: folds 
Ginnungagap7: folds 
joseluis76: calls $0.05
zoepaul has timed out
zoepaul: folds 
M@xium70: raises $0.05 to $0.10
Maria'sDad77: folds 
joseluis76: calls $0.05
*** FLOP *** [9c Kh Ts]
M@xium70: bets $0.12
joseluis76: calls $0.12
*** TURN *** [9c Kh Ts] [9s]
M@xium70: bets $0.23
joseluis76: folds 
Uncalled bet ($0.23) returned to M@xium70
M@xium70 collected $0.47 from pot
*** SUMMARY ***
Total pot $0.49 | Rake $0.02 
Board [9c Kh Ts 9s]
Seat 1: Dorex2007 folded before Flop (didn't bet)
Seat 2: M.zanoza folded before Flop (didn't bet)
Seat 3: MOONSP3LL folded before Flop (didn't bet)
Seat 4: Ginnungagap7 folded before Flop (didn't bet)
Seat 5: joseluis76 folded on the Turn
Seat 7: zoepaul (button) folded before Flop (didn't bet)
Seat 8: M@xium70 (small blind) collected ($0.47)
Seat 9: Maria'sDad77 (big blind) folded before Flop



PokerStars Hand #238019450005:  Hold'em No Limit ($0.02/$0.05 USD) - 2022/08/15 23:09:01 PT [2022/08/16 2:09:01 ET]
Table 'Alkurah III' 9-max Seat #8 is the button
Seat 1: Dorex2007 ($7.81 in chips) 
Seat 2: M.zanoza ($5 in chips) 
Seat 3: MOONSP3LL ($5.62 in chips) 
Seat 4: Ginnungagap7 ($6.15 in chips) 
Seat 5: joseluis76 ($3.46 in chips) 
Seat 7: zoepaul ($28.04 in chips) 
Seat 8: M@xium70 ($2.22 in chips) 
Seat 9: Maria'sDad77 ($7.11 in chips) 
Maria'sDad77: posts small blind $0.02
Dorex2007: posts big blind $0.05
*** HOLE CARDS ***
Dealt to Dorex2007 [Td Jh]
M.zanoza: folds 
M.zanoza leaves the table
MOONSP3LL: folds 
Vorontsov28 joins the table at seat #2 
Ginnungagap7: folds 
joseluis76: calls $0.05
zoepaul: folds 
M@xium70: folds 
Maria'sDad77: folds 
Dorex2007: checks 
*** FLOP *** [8h Qd 7d]
Dorex2007: checks 
joseluis76: bets $0.10
Dorex2007: calls $0.10
*** TURN *** [8h Qd 7d] [2c]
Dorex2007: checks 
joseluis76: bets $0.10
Dorex2007: calls $0.10
*** RIVER *** [8h Qd 7d 2c] [Ac]
Dorex2007: checks 
joseluis76: checks 
*** SHOW DOWN ***
Dorex2007: shows [Td Jh] (high card Ace)
joseluis76: shows [Kc 8c] (a pair of Eights)
joseluis76 collected $0.50 from pot
*** SUMMARY ***
Total pot $0.52 | Rake $0.02 
Board [8h Qd 7d 2c Ac]
Seat 1: Dorex2007 (big blind) showed [Td Jh] and lost with high card Ace
Seat 2: M.zanoza folded before Flop (didn't bet)
Seat 3: MOONSP3LL folded before Flop (didn't bet)
Seat 4: Ginnungagap7 folded before Flop (didn't bet)
Seat 5: joseluis76 showed [Kc 8c] and won ($0.50) with a pair of Eights
Seat 7: zoepaul folded before Flop (didn't bet)
Seat 8: M@xium70 (button) folded before Flop (didn't bet)
Seat 9: Maria'sDad77 (small blind) folded before Flop



PokerStars Hand #238019456271:  Hold'em No Limit ($0.02/$0.05 USD) - 2022/08/15 23:10:05 PT [2022/08/16 2:10:05 ET]
Table 'Alkurah III' 9-max Seat #9 is the button
Seat 1: Dorex2007 ($7.56 in chips) 
Seat 2: Vorontsov28 ($5 in chips) 
Seat 3: MOONSP3LL ($5.62 in chips) 
Seat 4: Ginnungagap7 ($6.15 in chips) 
Seat 5: joseluis76 ($3.71 in chips) 
Seat 7: zoepaul ($28.04 in chips) 
Seat 8: M@xium70 ($2.22 in chips) 
Seat 9: Maria'sDad77 ($7.09 in chips) 
Dorex2007: posts small blind $0.02
Vorontsov28: posts big blind $0.05
*** HOLE CARDS ***
Dealt to Dorex2007 [6c 4d]
MOONSP3LL: folds 
Ginnungagap7: folds 
joseluis76: calls $0.05
zoepaul: folds 
M@xium70: folds 
Maria'sDad77: folds 
Dorex2007: folds 
Vorontsov28: checks 
*** FLOP *** [Qc 7d 5h]
Vorontsov28: checks 
joseluis76: checks 
*** TURN *** [Qc 7d 5h] [7h]
Vorontsov28: checks 
joseluis76: checks 
*** RIVER *** [Qc 7d 5h 7h] [3s]
Vorontsov28: checks 
joseluis76: checks 
*** SHOW DOWN ***
Vorontsov28: shows [As 6s] (a pair of Sevens)
joseluis76: mucks hand 
Vorontsov28 collected $0.12 from pot
*** SUMMARY ***
Total pot $0.12 | Rake $0 
Board [Qc 7d 5h 7h 3s]
Seat 1: Dorex2007 (small blind) folded before Flop
Seat 2: Vorontsov28 (big blind) showed [As 6s] and won ($0.12) with a pair of Sevens
Seat 3: MOONSP3LL folded before Flop (didn't bet)
Seat 4: Ginnungagap7 folded before Flop (didn't bet)
Seat 5: joseluis76 mucked [2c Tc]
Seat 7: zoepaul folded before Flop (didn't bet)
Seat 8: M@xium70 folded before Flop (didn't bet)
Seat 9: Maria'sDad77 (button) folded before Flop (didn't bet)



PokerStars Hand #238019460949:  Hold'em No Limit ($0.02/$0.05 USD) - 2022/08/15 23:10:51 PT [2022/08/16 2:10:51 ET]
Table 'Alkurah III' 9-max Seat #1 is the button
Seat 1: Dorex2007 ($7.54 in chips) 
Seat 2: Vorontsov28 ($5.07 in chips) 
Seat 3: MOONSP3LL ($5.62 in chips) 
Seat 4: Ginnungagap7 ($6.15 in chips) 
Seat 5: joseluis76 ($3.66 in chips) 
Seat 7: zoepaul ($28.04 in chips) 
Seat 8: M@xium70 ($2.22 in chips) 
Seat 9: Maria'sDad77 ($7.09 in chips) 
Vorontsov28: posts small blind $0.02
MOONSP3LL: posts big blind $0.05
*** HOLE CARDS ***
Dealt to Dorex2007 [Ks Th]
Ginnungagap7: folds 
joseluis76: folds 
zoepaul: raises $0.05 to $0.10
M@xium70: folds 
Maria'sDad77: folds 
Dorex2007: calls $0.10
Vorontsov28: folds 
MOONSP3LL: folds 
*** FLOP *** [7d Kd 2s]
zoepaul: checks 
Dorex2007: bets $0.26
zoepaul: folds 
Uncalled bet ($0.26) returned to Dorex2007
Dorex2007 collected $0.26 from pot
Dorex2007: doesn't show hand 
*** SUMMARY ***
Total pot $0.27 | Rake $0.01 
Board [7d Kd 2s]
Seat 1: Dorex2007 (button) collected ($0.26)
Seat 2: Vorontsov28 (small blind) folded before Flop
Seat 3: MOONSP3LL (big blind) folded before Flop
Seat 4: Ginnungagap7 folded before Flop (didn't bet)
Seat 5: joseluis76 folded before Flop (didn't bet)
Seat 7: zoepaul folded on the Flop
Seat 8: M@xium70 folded before Flop (didn't bet)
Seat 9: Maria'sDad77 folded before Flop (didn't bet)



PokerStars Hand #238019467032:  Hold'em No Limit ($0.02/$0.05 USD) - 2022/08/15 23:11:53 PT [2022/08/16 2:11:53 ET]
Table 'Alkurah III' 9-max Seat #2 is the button
Seat 1: Dorex2007 ($7.70 in chips) 
Seat 2: Vorontsov28 ($5.05 in chips) 
Seat 3: MOONSP3LL ($5.57 in chips) 
Seat 4: Ginnungagap7 ($6.15 in chips) 
Seat 5: joseluis76 ($3.66 in chips) 
Seat 7: zoepaul ($27.94 in chips) 
Seat 8: M@xium70 ($2.22 in chips) 
Seat 9: Maria'sDad77 ($7.09 in chips) 
MOONSP3LL: posts small blind $0.02
Ginnungagap7: posts big blind $0.05
*** HOLE CARDS ***
Dealt to Dorex2007 [5h Ad]
joseluis76: calls $0.05
zoepaul: calls $0.05
M@xium70 has timed out
M@xium70: folds 
Maria'sDad77: raises $0.10 to $0.15
Dorex2007: folds 
Vorontsov28: folds 
MOONSP3LL: folds 
Ginnungagap7: calls $0.10
joseluis76: calls $0.10
zoepaul: calls $0.10
*** FLOP *** [9s 3s 7c]
Ginnungagap7: bets $0.44
joseluis76: calls $0.44
zoepaul: folds 
Maria'sDad77: folds 
*** TURN *** [9s 3s 7c] [Kc]
Ginnungagap7: bets $1.08
joseluis76: folds 
Uncalled bet ($1.08) returned to Ginnungagap7
Ginnungagap7 collected $1.44 from pot
Ginnungagap7: doesn't show hand 
*** SUMMARY ***
Total pot $1.50 | Rake $0.06 
Board [9s 3s 7c Kc]
Seat 1: Dorex2007 folded before Flop (didn't bet)
Seat 2: Vorontsov28 (button) folded before Flop (didn't bet)
Seat 3: MOONSP3LL (small blind) folded before Flop
Seat 4: Ginnungagap7 (big blind) collected ($1.44)
Seat 5: joseluis76 folded on the Turn
Seat 7: zoepaul folded on the Flop
Seat 8: M@xium70 folded before Flop (didn't bet)
Seat 9: Maria'sDad77 folded on the Flop



PokerStars Hand #238019474676:  Hold'em No Limit ($0.02/$0.05 USD) - 2022/08/15 23:13:11 PT [2022/08/16 2:13:11 ET]
Table 'Alkurah III' 9-max Seat #3 is the button
Seat 1: Dorex2007 ($7.70 in chips) 
Seat 2: Vorontsov28 ($5.05 in chips) 
Seat 3: MOONSP3LL ($5.55 in chips) 
Seat 4: Ginnungagap7 ($7 in chips) 
Seat 5: joseluis76 ($3.07 in chips) 
Seat 7: zoepaul ($27.79 in chips) 
Seat 8: M@xium70 ($2.22 in chips) 
Seat 9: Maria'sDad77 ($6.94 in chips) 
Ginnungagap7: posts small blind $0.02
joseluis76: posts big blind $0.05
*** HOLE CARDS ***
Dealt to Dorex2007 [Ac Td]
zoepaul: folds 
M@xium70: folds 
Maria'sDad77: folds 
Dorex2007: calls $0.05
Vorontsov28: folds 
MOONSP3LL: folds 
Ginnungagap7: folds 
joseluis76: checks 
*** FLOP *** [4h Ad 4c]
joseluis76: checks 
Dorex2007: checks 
*** TURN *** [4h Ad 4c] [Qc]
joseluis76: checks 
Dorex2007: bets $0.12
joseluis76: folds 
Uncalled bet ($0.12) returned to Dorex2007
Dorex2007 collected $0.12 from pot
Dorex2007: doesn't show hand 
*** SUMMARY ***
Total pot $0.12 | Rake $0 
Board [4h Ad 4c Qc]
Seat 1: Dorex2007 collected ($0.12)
Seat 2: Vorontsov28 folded before Flop (didn't bet)
Seat 3: MOONSP3LL (button) folded before Flop (didn't bet)
Seat 4: Ginnungagap7 (small blind) folded before Flop
Seat 5: joseluis76 (big blind) folded on the Turn
Seat 7: zoepaul folded before Flop (didn't bet)
Seat 8: M@xium70 folded before Flop (didn't bet)
Seat 9: Maria'sDad77 folded before Flop (didn't bet)



PokerStars Hand #238019479706:  Hold'em No Limit ($0.02/$0.05 USD) - 2022/08/15 23:14:01 PT [2022/08/16 2:14:01 ET]
Table 'Alkurah III' 9-max Seat #4 is the button
Seat 1: Dorex2007 ($7.77 in chips) 
Seat 2: Vorontsov28 ($5.05 in chips) 
Seat 3: MOONSP3LL ($5.55 in chips) 
Seat 4: Ginnungagap7 ($6.98 in chips) 
Seat 5: joseluis76 ($3.02 in chips) 
Seat 7: zoepaul ($27.79 in chips) 
Seat 8: M@xium70 ($2.22 in chips) 
Seat 9: Maria'sDad77 ($6.94 in chips) 
joseluis76: posts small blind $0.02
zoepaul: posts big blind $0.05
*** HOLE CARDS ***
Dealt to Dorex2007 [Ad Qh]
M@xium70 has timed out
M@xium70: folds 
Maria'sDad77: folds 
Dorex2007: raises $0.15 to $0.20
Vorontsov28: folds 
MOONSP3LL: folds 
Ginnungagap7: calls $0.20
joseluis76: calls $0.18
zoepaul: calls $0.15
*** FLOP *** [As Td 4s]
joseluis76: checks 
zoepaul: checks 
Dorex2007: bets $0.77
Ginnungagap7: folds 
joseluis76: calls $0.77
zoepaul: folds 
*** TURN *** [As Td 4s] [9d]
joseluis76: checks 
Dorex2007: bets $6.80 and is all-in
joseluis76: folds 
Uncalled bet ($6.80) returned to Dorex2007
Dorex2007 collected $2.24 from pot
Dorex2007: doesn't show hand 
*** SUMMARY ***
Total pot $2.34 | Rake $0.10 
Board [As Td 4s 9d]
Seat 1: Dorex2007 collected ($2.24)
Seat 2: Vorontsov28 folded before Flop (didn't bet)
Seat 3: MOONSP3LL folded before Flop (didn't bet)
Seat 4: Ginnungagap7 (button) folded on the Flop
Seat 5: joseluis76 (small blind) folded on the Turn
Seat 7: zoepaul (big blind) folded on the Flop
Seat 8: M@xium70 folded before Flop (didn't bet)
Seat 9: Maria'sDad77 folded before Flop (didn't bet)



PokerStars Hand #238019489283:  Hold'em No Limit ($0.02/$0.05 USD) - 2022/08/15 23:15:37 PT [2022/08/16 2:15:37 ET]
Table 'Alkurah III' 9-max Seat #5 is the button
Seat 1: Dorex2007 ($9.04 in chips) 
Seat 2: Vorontsov28 ($5.05 in chips) 
Seat 3: MOONSP3LL ($5.55 in chips) 
Seat 4: Ginnungagap7 ($6.78 in chips) 
Seat 5: joseluis76 ($2.05 in chips) 
Seat 7: zoepaul ($27.59 in chips) 
Seat 8: M@xium70 ($2.22 in chips) 
zoepaul: posts small blind $0.02
M@xium70: posts big blind $0.05
*** HOLE CARDS ***
Dealt to Dorex2007 [6h 9h]
Dorex2007: folds 
Maria'sDad77 is disconnected 
Vorontsov28: raises $0.10 to $0.15
MOONSP3LL: folds 
Ginnungagap7: folds 
joseluis76: calls $0.15
zoepaul: calls $0.13
M@xium70: calls $0.10
*** FLOP *** [2s 9d Jd]
zoepaul: checks 
M@xium70: checks 
Vorontsov28: bets $0.45
joseluis76: folds 
zoepaul: calls $0.45
M@xium70: folds 
*** TURN *** [2s 9d Jd] [8s]
zoepaul: checks 
Vorontsov28: bets $1.70
zoepaul: raises $4.84 to $6.54
Vorontsov28: calls $2.75 and is all-in
Uncalled bet ($2.09) returned to zoepaul
*** RIVER *** [2s 9d Jd 8s] [9c]
*** SHOW DOWN ***
zoepaul: shows [Td 7d] (a straight, Seven to Jack)
Vorontsov28: shows [2d 2c] (a full house, Deuces full of Nines)
Vorontsov28 collected $9.97 from pot
zoepaul cashed out the hand for $7.86 | Cash Out Fee $0.08
*** SUMMARY ***
Total pot $10.40 | Rake $0.43 
Board [2s 9d Jd 8s 9c]
Seat 1: Dorex2007 folded before Flop (didn't bet)
Seat 2: Vorontsov28 showed [2d 2c] and won ($9.97) with a full house, Deuces full of Nines
Seat 3: MOONSP3LL folded before Flop (didn't bet)
Seat 4: Ginnungagap7 folded before Flop (didn't bet)
Seat 5: joseluis76 (button) folded on the Flop
Seat 7: zoepaul (small blind) showed [Td 7d] and lost with a straight, Seven to Jack (cashed out).
Seat 8: M@xium70 (big blind) folded on the Flop



PokerStars Hand #238019496612:  Hold'em No Limit ($0.02/$0.05 USD) - 2022/08/15 23:16:49 PT [2022/08/16 2:16:49 ET]
Table 'Alkurah III' 9-max Seat #7 is the button
Seat 1: Dorex2007 ($9.04 in chips) 
Seat 2: Vorontsov28 ($9.97 in chips) 
Seat 3: MOONSP3LL ($5.55 in chips) 
Seat 4: Ginnungagap7 ($6.78 in chips) 
Seat 5: joseluis76 ($1.90 in chips) 
Seat 7: zoepaul ($30.40 in chips) 
Seat 8: M@xium70 ($2.07 in chips) 
M@xium70: posts small blind $0.02
Dorex2007: posts big blind $0.05
*** HOLE CARDS ***
Dealt to Dorex2007 [Ks 2d]
Vorontsov28: raises $0.10 to $0.15
MOONSP3LL: folds 
Ginnungagap7: folds 
joseluis76: calls $0.15
zoepaul: folds 
M@xium70: folds 
Dorex2007: folds 
*** FLOP *** [7h Td 3d]
Vorontsov28: checks 
joseluis76: checks 
*** TURN *** [7h Td 3d] [Ac]
Vorontsov28: bets $0.25
joseluis76: calls $0.25
*** RIVER *** [7h Td 3d Ac] [9d]
Vorontsov28: checks 
joseluis76: checks 
*** SHOW DOWN ***
Vorontsov28: shows [6h 6s] (a pair of Sixes)
joseluis76: shows [Kc Ad] (a pair of Aces)
joseluis76 collected $0.83 from pot
*** SUMMARY ***
Total pot $0.87 | Rake $0.04 
Board [7h Td 3d Ac 9d]
Seat 1: Dorex2007 (big blind) folded before Flop
Seat 2: Vorontsov28 showed [6h 6s] and lost with a pair of Sixes
Seat 3: MOONSP3LL folded before Flop (didn't bet)
Seat 4: Ginnungagap7 folded before Flop (didn't bet)
Seat 5: joseluis76 showed [Kc Ad] and won ($0.83) with a pair of Aces
Seat 7: zoepaul (button) folded before Flop (didn't bet)
Seat 8: M@xium70 (small blind) folded before Flop



