PokerStars Hand #227663063112:  Hold'em No Limit ($0.01/$0.02 USD) - 2021/06/17 23:09:05 PT [2021/06/18 2:09:05 ET]
Table 'Komppa II' 9-max Seat #3 is the button
Seat 1: tridmax ($2.03 in chips) 
Seat 2: Dorex2007 ($2 in chips) 
Seat 3: grimpop_87 ($5.12 in chips) 
Seat 4: veall95 ($2.38 in chips) 
Seat 6: edvards92 ($3.91 in chips) 
Seat 7: deadmazayyyyy ($0.76 in chips) 
Seat 8: Eishockey47 ($0.45 in chips) 
Seat 9: ZeitzeugeNr1 ($0.73 in chips) 
veall95: posts small blind $0.01
edvards92: posts big blind $0.02
Dorex2007: posts big blind $0.02
*** HOLE CARDS ***
Dealt to Dorex2007 [8s 6h]
brasa1zl joins the table at seat #5 
deadmazayyyyy: raises $0.02 to $0.04
Eishockey47: folds 
ZeitzeugeNr1: folds 
tridmax: folds 
Dorex2007: folds 
grimpop_87: folds 
veall95: folds 
edvards92: folds 
Uncalled bet ($0.02) returned to deadmazayyyyy
deadmazayyyyy collected $0.07 from pot
deadmazayyyyy: doesn't show hand 
*** SUMMARY ***
Total pot $0.07 | Rake $0 
Seat 1: tridmax folded before Flop (didn't bet)
Seat 2: Dorex2007 folded before Flop (didn't bet)
Seat 3: grimpop_87 (button) folded before Flop (didn't bet)
Seat 4: veall95 (small blind) folded before Flop
Seat 6: edvards92 (big blind) folded before Flop
Seat 7: deadmazayyyyy collected ($0.07)
Seat 8: Eishockey47 folded before Flop (didn't bet)
Seat 9: ZeitzeugeNr1 folded before Flop (didn't bet)



PokerStars Hand #227663067228:  Hold'em No Limit ($0.01/$0.02 USD) - 2021/06/17 23:09:35 PT [2021/06/18 2:09:35 ET]
Table 'Komppa II' 9-max Seat #4 is the button
Seat 1: tridmax ($2.03 in chips) 
Seat 2: Dorex2007 ($1.98 in chips) 
Seat 3: grimpop_87 ($5.12 in chips) 
Seat 4: veall95 ($2.37 in chips) 
Seat 6: edvards92 ($3.89 in chips) 
Seat 7: deadmazayyyyy ($0.81 in chips) 
Seat 8: Eishockey47 ($0.45 in chips) 
Seat 9: ZeitzeugeNr1 ($0.73 in chips) 
edvards92: posts small blind $0.01
deadmazayyyyy: posts big blind $0.02
*** HOLE CARDS ***
Dealt to Dorex2007 [4h 2s]
Eishockey47: calls $0.02
ZeitzeugeNr1: folds 
tridmax: folds 
Dorex2007: folds 
brasa1zl leaves the table
grimpop_87: raises $0.06 to $0.08
veall95: folds 
edvards92: folds 
deadmazayyyyy: folds 
Eishockey47: calls $0.06
*** FLOP *** [5d 2c 9d]
vazelin789 joins the table at seat #5 
Eishockey47: bets $0.06
grimpop_87: calls $0.06
*** TURN *** [5d 2c 9d] [7s]
Eishockey47: bets $0.08
grimpop_87: raises $0.28 to $0.36
Eishockey47: folds 
Uncalled bet ($0.28) returned to grimpop_87
grimpop_87 collected $0.45 from pot
*** SUMMARY ***
Total pot $0.47 | Rake $0.02 
Board [5d 2c 9d 7s]
Seat 1: tridmax folded before Flop (didn't bet)
Seat 2: Dorex2007 folded before Flop (didn't bet)
Seat 3: grimpop_87 collected ($0.45)
Seat 4: veall95 (button) folded before Flop (didn't bet)
Seat 6: edvards92 (small blind) folded before Flop
Seat 7: deadmazayyyyy (big blind) folded before Flop
Seat 8: Eishockey47 folded on the Turn
Seat 9: ZeitzeugeNr1 folded before Flop (didn't bet)



PokerStars Hand #227663075373:  Hold'em No Limit ($0.01/$0.02 USD) - 2021/06/17 23:10:35 PT [2021/06/18 2:10:35 ET]
Table 'Komppa II' 9-max Seat #6 is the button
Seat 1: tridmax ($2.03 in chips) 
Seat 2: Dorex2007 ($1.98 in chips) 
Seat 3: grimpop_87 ($5.35 in chips) 
Seat 4: veall95 ($2.37 in chips) 
Seat 6: edvards92 ($3.88 in chips) 
Seat 7: deadmazayyyyy ($0.79 in chips) 
Seat 8: Eishockey47 ($0.23 in chips) 
Seat 9: ZeitzeugeNr1 ($0.73 in chips) 
deadmazayyyyy: posts small blind $0.01
Eishockey47: posts big blind $0.02
vazelin789: sits out 
*** HOLE CARDS ***
Dealt to Dorex2007 [6d As]
ZeitzeugeNr1: folds 
tridmax: folds 
Dorex2007: folds 
grimpop_87: raises $0.04 to $0.06
veall95: folds 
edvards92: calls $0.06
deadmazayyyyy: folds 
Eishockey47: calls $0.04
*** FLOP *** [5h Qc 3s]
Eishockey47: checks 
grimpop_87: bets $0.11
edvards92: folds 
Eishockey47: folds 
Uncalled bet ($0.11) returned to grimpop_87
grimpop_87 collected $0.18 from pot
*** SUMMARY ***
Total pot $0.19 | Rake $0.01 
Board [5h Qc 3s]
Seat 1: tridmax folded before Flop (didn't bet)
Seat 2: Dorex2007 folded before Flop (didn't bet)
Seat 3: grimpop_87 collected ($0.18)
Seat 4: veall95 folded before Flop (didn't bet)
Seat 6: edvards92 (button) folded on the Flop
Seat 7: deadmazayyyyy (small blind) folded before Flop
Seat 8: Eishockey47 (big blind) folded on the Flop
Seat 9: ZeitzeugeNr1 folded before Flop (didn't bet)



PokerStars Hand #227663079505:  Hold'em No Limit ($0.01/$0.02 USD) - 2021/06/17 23:11:05 PT [2021/06/18 2:11:05 ET]
Table 'Komppa II' 9-max Seat #7 is the button
Seat 1: tridmax ($2.03 in chips) 
Seat 2: Dorex2007 ($1.98 in chips) 
Seat 3: grimpop_87 ($5.47 in chips) 
Seat 4: veall95 ($2.37 in chips) 
Seat 6: edvards92 ($3.82 in chips) 
Seat 7: deadmazayyyyy ($0.78 in chips) 
Seat 8: Eishockey47 ($0.17 in chips) 
Seat 9: ZeitzeugeNr1 ($0.73 in chips) 
Eishockey47: posts small blind $0.01
ZeitzeugeNr1: posts big blind $0.02
vazelin789: sits out 
*** HOLE CARDS ***
Dealt to Dorex2007 [Ad Jh]
tridmax: folds 
Dorex2007: raises $0.02 to $0.04
grimpop_87: folds 
veall95: folds 
edvards92: folds 
deadmazayyyyy: folds 
Eishockey47: calls $0.03
ZeitzeugeNr1: folds 
*** FLOP *** [As 9d 9h]
Eishockey47: checks 
Dorex2007: bets $0.14
Eishockey47: folds 
Uncalled bet ($0.14) returned to Dorex2007
Dorex2007 collected $0.10 from pot
Dorex2007: doesn't show hand 
*** SUMMARY ***
Total pot $0.10 | Rake $0 
Board [As 9d 9h]
Seat 1: tridmax folded before Flop (didn't bet)
Seat 2: Dorex2007 collected ($0.10)
Seat 3: grimpop_87 folded before Flop (didn't bet)
Seat 4: veall95 folded before Flop (didn't bet)
Seat 6: edvards92 folded before Flop (didn't bet)
Seat 7: deadmazayyyyy (button) folded before Flop (didn't bet)
Seat 8: Eishockey47 (small blind) folded on the Flop
Seat 9: ZeitzeugeNr1 (big blind) folded before Flop



PokerStars Hand #227663083770:  Hold'em No Limit ($0.01/$0.02 USD) - 2021/06/17 23:11:37 PT [2021/06/18 2:11:37 ET]
Table 'Komppa II' 9-max Seat #8 is the button
Seat 1: tridmax ($2.03 in chips) 
Seat 2: Dorex2007 ($2.04 in chips) 
Seat 3: grimpop_87 ($5.47 in chips) 
Seat 4: veall95 ($2.37 in chips) 
Seat 6: edvards92 ($3.82 in chips) 
Seat 7: deadmazayyyyy ($0.78 in chips) 
Seat 8: Eishockey47 ($0.13 in chips) 
Seat 9: ZeitzeugeNr1 ($0.71 in chips) 
ZeitzeugeNr1: posts small blind $0.01
tridmax: posts big blind $0.02
vazelin789: sits out 
*** HOLE CARDS ***
Dealt to Dorex2007 [7d Qc]
Dorex2007: folds 
grimpop_87: raises $0.04 to $0.06
veall95: folds 
edvards92: raises $0.12 to $0.18
deadmazayyyyy: folds 
Eishockey47: folds 
ZeitzeugeNr1: folds 
tridmax: folds 
grimpop_87: calls $0.12
*** FLOP *** [7c As Ad]
grimpop_87: checks 
edvards92: bets $0.13
grimpop_87: calls $0.13
*** TURN *** [7c As Ad] [2d]
grimpop_87: checks 
edvards92: bets $0.35
grimpop_87: calls $0.35
*** RIVER *** [7c As Ad 2d] [9d]
grimpop_87: checks 
edvards92: checks 
*** SHOW DOWN ***
grimpop_87: shows [Ah Th] (three of a kind, Aces)
edvards92: shows [Ac Qd] (three of a kind, Aces - Queen kicker)
edvards92 collected $1.30 from pot
*** SUMMARY ***
Total pot $1.35 | Rake $0.05 
Board [7c As Ad 2d 9d]
Seat 1: tridmax (big blind) folded before Flop
Seat 2: Dorex2007 folded before Flop (didn't bet)
Seat 3: grimpop_87 showed [Ah Th] and lost with three of a kind, Aces
Seat 4: veall95 folded before Flop (didn't bet)
Seat 6: edvards92 showed [Ac Qd] and won ($1.30) with three of a kind, Aces
Seat 7: deadmazayyyyy folded before Flop (didn't bet)
Seat 8: Eishockey47 (button) folded before Flop (didn't bet)
Seat 9: ZeitzeugeNr1 (small blind) folded before Flop



PokerStars Hand #227663091971:  Hold'em No Limit ($0.01/$0.02 USD) - 2021/06/17 23:12:37 PT [2021/06/18 2:12:37 ET]
Table 'Komppa II' 9-max Seat #9 is the button
Seat 1: tridmax ($2.01 in chips) 
Seat 2: Dorex2007 ($2.04 in chips) 
Seat 3: grimpop_87 ($4.81 in chips) 
Seat 4: veall95 ($2.37 in chips) 
Seat 6: edvards92 ($4.46 in chips) 
Seat 7: deadmazayyyyy ($0.78 in chips) 
Seat 8: Eishockey47 ($0.13 in chips) 
Seat 9: ZeitzeugeNr1 ($0.70 in chips) 
tridmax: posts small blind $0.01
Dorex2007: posts big blind $0.02
vazelin789: sits out 
*** HOLE CARDS ***
Dealt to Dorex2007 [4d 9h]
grimpop_87: folds 
veall95: folds 
edvards92: folds 
deadmazayyyyy: folds 
Eishockey47: folds 
ZeitzeugeNr1: folds 
tridmax: folds 
Uncalled bet ($0.01) returned to Dorex2007
Dorex2007 collected $0.02 from pot
Dorex2007: doesn't show hand 
*** SUMMARY ***
Total pot $0.02 | Rake $0 
Seat 1: tridmax (small blind) folded before Flop
Seat 2: Dorex2007 (big blind) collected ($0.02)
Seat 3: grimpop_87 folded before Flop (didn't bet)
Seat 4: veall95 folded before Flop (didn't bet)
Seat 6: edvards92 folded before Flop (didn't bet)
Seat 7: deadmazayyyyy folded before Flop (didn't bet)
Seat 8: Eishockey47 folded before Flop (didn't bet)
Seat 9: ZeitzeugeNr1 (button) folded before Flop (didn't bet)



PokerStars Hand #227663094053:  Hold'em No Limit ($0.01/$0.02 USD) - 2021/06/17 23:12:52 PT [2021/06/18 2:12:52 ET]
Table 'Komppa II' 9-max Seat #1 is the button
Seat 1: tridmax ($2 in chips) 
Seat 2: Dorex2007 ($2.05 in chips) 
Seat 3: grimpop_87 ($4.81 in chips) 
Seat 4: veall95 ($2.37 in chips) 
Seat 6: edvards92 ($4.46 in chips) 
Seat 7: deadmazayyyyy ($0.78 in chips) 
Seat 8: Eishockey47 ($0.13 in chips) 
Seat 9: ZeitzeugeNr1 ($0.70 in chips) 
Dorex2007: posts small blind $0.01
grimpop_87: posts big blind $0.02
vazelin789: sits out 
*** HOLE CARDS ***
Dealt to Dorex2007 [Jc Th]
veall95: folds 
edvards92: folds 
deadmazayyyyy: folds 
Eishockey47: folds 
ZeitzeugeNr1: raises $0.04 to $0.06
tridmax: folds 
Dorex2007: folds 
grimpop_87: folds 
Uncalled bet ($0.04) returned to ZeitzeugeNr1
ZeitzeugeNr1 collected $0.05 from pot
ZeitzeugeNr1: doesn't show hand 
*** SUMMARY ***
Total pot $0.05 | Rake $0 
Seat 1: tridmax (button) folded before Flop (didn't bet)
Seat 2: Dorex2007 (small blind) folded before Flop
Seat 3: grimpop_87 (big blind) folded before Flop
Seat 4: veall95 folded before Flop (didn't bet)
Seat 6: edvards92 folded before Flop (didn't bet)
Seat 7: deadmazayyyyy folded before Flop (didn't bet)
Seat 8: Eishockey47 folded before Flop (didn't bet)
Seat 9: ZeitzeugeNr1 collected ($0.05)



PokerStars Hand #227663101463:  Hold'em No Limit ($0.01/$0.02 USD) - 2021/06/17 23:13:46 PT [2021/06/18 2:13:46 ET]
Table 'Komppa II' 9-max Seat #2 is the button
Seat 1: tridmax ($2 in chips) 
Seat 2: Dorex2007 ($2.04 in chips) 
Seat 3: grimpop_87 ($4.79 in chips) 
Seat 4: veall95 ($2.37 in chips) 
Seat 6: edvards92 ($4.46 in chips) 
Seat 7: deadmazayyyyy ($0.78 in chips) 
Seat 8: Eishockey47 ($0.13 in chips) 
Seat 9: ZeitzeugeNr1 ($0.73 in chips) 
grimpop_87: posts small blind $0.01
veall95: posts big blind $0.02
vazelin789: sits out 
*** HOLE CARDS ***
Dealt to Dorex2007 [3d As]
edvards92: raises $0.03 to $0.05
deadmazayyyyy: folds 
Eishockey47: folds 
ZeitzeugeNr1: folds 
tridmax: folds 
Dorex2007: folds 
grimpop_87: folds 
veall95: folds 
Uncalled bet ($0.03) returned to edvards92
edvards92 collected $0.05 from pot
edvards92: doesn't show hand 
*** SUMMARY ***
Total pot $0.05 | Rake $0 
Seat 1: tridmax folded before Flop (didn't bet)
Seat 2: Dorex2007 (button) folded before Flop (didn't bet)
Seat 3: grimpop_87 (small blind) folded before Flop
Seat 4: veall95 (big blind) folded before Flop
Seat 6: edvards92 collected ($0.05)
Seat 7: deadmazayyyyy folded before Flop (didn't bet)
Seat 8: Eishockey47 folded before Flop (didn't bet)
Seat 9: ZeitzeugeNr1 folded before Flop (didn't bet)



PokerStars Hand #227663104208:  Hold'em No Limit ($0.01/$0.02 USD) - 2021/06/17 23:14:07 PT [2021/06/18 2:14:07 ET]
Table 'Komppa II' 9-max Seat #3 is the button
Seat 1: tridmax ($2 in chips) 
Seat 2: Dorex2007 ($2.04 in chips) 
Seat 3: grimpop_87 ($4.78 in chips) 
Seat 4: veall95 ($2.35 in chips) 
Seat 5: vazelin789 ($1.60 in chips) 
Seat 6: edvards92 ($4.49 in chips) 
Seat 7: deadmazayyyyy ($0.78 in chips) 
Seat 8: Eishockey47 ($0.13 in chips) 
Seat 9: ZeitzeugeNr1 ($0.73 in chips) 
veall95: posts small blind $0.01
vazelin789: posts big blind $0.02
*** HOLE CARDS ***
Dealt to Dorex2007 [9s Td]
edvards92: raises $0.03 to $0.05
deadmazayyyyy: calls $0.05
Eishockey47 has timed out
Eishockey47: folds 
ZeitzeugeNr1: folds 
tridmax: folds 
Dorex2007: folds 
grimpop_87: calls $0.05
veall95: folds 
vazelin789: folds 
*** FLOP *** [7s 8s Ts]
edvards92: checks 
deadmazayyyyy: checks 
grimpop_87: checks 
*** TURN *** [7s 8s Ts] [Th]
edvards92: checks 
deadmazayyyyy: checks 
grimpop_87: checks 
*** RIVER *** [7s 8s Ts Th] [Qd]
edvards92: checks 
deadmazayyyyy: checks 
grimpop_87: checks 
*** SHOW DOWN ***
edvards92: shows [Ks Ah] (a pair of Tens)
deadmazayyyyy: mucks hand 
grimpop_87: shows [Qh Kh] (two pair, Queens and Tens)
grimpop_87 collected $0.17 from pot
*** SUMMARY ***
Total pot $0.18 | Rake $0.01 
Board [7s 8s Ts Th Qd]
Seat 1: tridmax folded before Flop (didn't bet)
Seat 2: Dorex2007 folded before Flop (didn't bet)
Seat 3: grimpop_87 (button) showed [Qh Kh] and won ($0.17) with two pair, Queens and Tens
Seat 4: veall95 (small blind) folded before Flop
Seat 5: vazelin789 (big blind) folded before Flop
Seat 6: edvards92 showed [Ks Ah] and lost with a pair of Tens
Seat 7: deadmazayyyyy mucked [Jh As]
Seat 8: Eishockey47 folded before Flop (didn't bet)
Seat 9: ZeitzeugeNr1 folded before Flop (didn't bet)



PokerStars Hand #227663112986:  Hold'em No Limit ($0.01/$0.02 USD) - 2021/06/17 23:15:12 PT [2021/06/18 2:15:12 ET]
Table 'Komppa II' 9-max Seat #4 is the button
Seat 1: tridmax ($2 in chips) 
Seat 2: Dorex2007 ($2.04 in chips) 
Seat 3: grimpop_87 ($4.90 in chips) 
Seat 4: veall95 ($2.34 in chips) 
Seat 5: vazelin789 ($1.58 in chips) 
Seat 6: edvards92 ($4.44 in chips) 
Seat 7: deadmazayyyyy ($0.73 in chips) 
Seat 8: Eishockey47 ($0.13 in chips) 
Seat 9: ZeitzeugeNr1 ($0.73 in chips) 
vazelin789: posts small blind $0.01
edvards92: posts big blind $0.02
*** HOLE CARDS ***
Dealt to Dorex2007 [7s 6c]
deadmazayyyyy: folds 
Eishockey47: folds 
ZeitzeugeNr1: folds 
tridmax: folds 
Dorex2007: folds 
grimpop_87 has timed out
grimpop_87: folds 
veall95: folds 
vazelin789: calls $0.01
edvards92: checks 
*** FLOP *** [4d Qh 4s]
vazelin789: checks 
edvards92: bets $0.02
vazelin789: calls $0.02
*** TURN *** [4d Qh 4s] [Js]
vazelin789: checks 
edvards92: bets $0.06
vazelin789: calls $0.06
*** RIVER *** [4d Qh 4s Js] [3h]
vazelin789: checks 
edvards92: checks 
*** SHOW DOWN ***
vazelin789: shows [Kh Kd] (two pair, Kings and Fours)
edvards92: mucks hand 
vazelin789 collected $0.19 from pot
*** SUMMARY ***
Total pot $0.20 | Rake $0.01 
Board [4d Qh 4s Js 3h]
Seat 1: tridmax folded before Flop (didn't bet)
Seat 2: Dorex2007 folded before Flop (didn't bet)
Seat 3: grimpop_87 folded before Flop (didn't bet)
Seat 4: veall95 (button) folded before Flop (didn't bet)
Seat 5: vazelin789 (small blind) showed [Kh Kd] and won ($0.19) with two pair, Kings and Fours
Seat 6: edvards92 (big blind) mucked [8s 3s]
Seat 7: deadmazayyyyy folded before Flop (didn't bet)
Seat 8: Eishockey47 folded before Flop (didn't bet)
Seat 9: ZeitzeugeNr1 folded before Flop (didn't bet)



PokerStars Hand #227663123649:  Hold'em No Limit ($0.01/$0.02 USD) - 2021/06/17 23:16:30 PT [2021/06/18 2:16:30 ET]
Table 'Komppa II' 9-max Seat #6 is the button
Seat 1: tridmax ($2 in chips) 
Seat 2: Dorex2007 ($2.04 in chips) 
Seat 3: grimpop_87 ($4.90 in chips) 
Seat 4: veall95 ($2.37 in chips) 
Seat 5: vazelin789 ($1.67 in chips) 
Seat 6: edvards92 ($4.33 in chips) 
Seat 7: deadmazayyyyy ($0.71 in chips) 
Seat 8: Eishockey47 ($0.13 in chips) 
Seat 9: ZeitzeugeNr1 ($0.73 in chips) 
deadmazayyyyy: posts small blind $0.01
Eishockey47: posts big blind $0.02
*** HOLE CARDS ***
Dealt to Dorex2007 [Kc 4d]
ZeitzeugeNr1: folds 
tridmax: folds 
Dorex2007: folds 
grimpop_87 has timed out
grimpop_87: folds 
veall95: folds 
vazelin789: calls $0.02
edvards92: raises $0.06 to $0.08
deadmazayyyyy: folds 
Eishockey47: folds 
vazelin789: calls $0.06
*** FLOP *** [Jc 9s Qs]
vazelin789: checks 
edvards92: bets $0.10
vazelin789: calls $0.10
*** TURN *** [Jc 9s Qs] [6d]
vazelin789: checks 
edvards92: checks 
*** RIVER *** [Jc 9s Qs 6d] [7h]
vazelin789: checks 
edvards92: checks 
*** SHOW DOWN ***
vazelin789: shows [Kd 9d] (a pair of Nines)
edvards92: mucks hand 
vazelin789 collected $0.38 from pot
*** SUMMARY ***
Total pot $0.39 | Rake $0.01 
Board [Jc 9s Qs 6d 7h]
Seat 1: tridmax folded before Flop (didn't bet)
Seat 2: Dorex2007 folded before Flop (didn't bet)
Seat 3: grimpop_87 folded before Flop (didn't bet)
Seat 4: veall95 folded before Flop (didn't bet)
Seat 5: vazelin789 showed [Kd 9d] and won ($0.38) with a pair of Nines
Seat 6: edvards92 (button) mucked [As Ks]
Seat 7: deadmazayyyyy (small blind) folded before Flop
Seat 8: Eishockey47 (big blind) folded before Flop
Seat 9: ZeitzeugeNr1 folded before Flop (didn't bet)



PokerStars Hand #227663135131:  Hold'em No Limit ($0.01/$0.02 USD) - 2021/06/17 23:17:57 PT [2021/06/18 2:17:57 ET]
Table 'Komppa II' 9-max Seat #7 is the button
Seat 1: tridmax ($2 in chips) 
Seat 2: Dorex2007 ($2.04 in chips) 
Seat 3: grimpop_87 ($4.90 in chips) 
Seat 4: veall95 ($2.37 in chips) 
Seat 5: vazelin789 ($1.87 in chips) 
Seat 6: edvards92 ($4.15 in chips) 
Seat 7: deadmazayyyyy ($0.70 in chips) 
Seat 8: Eishockey47 ($0.11 in chips) 
Seat 9: ZeitzeugeNr1 ($0.73 in chips) 
Eishockey47: posts small blind $0.01
ZeitzeugeNr1: posts big blind $0.02
*** HOLE CARDS ***
Dealt to Dorex2007 [7d 5c]
tridmax: raises $0.04 to $0.06
Dorex2007: folds 
grimpop_87: folds 
veall95: folds 
vazelin789: calls $0.06
edvards92: raises $0.19 to $0.25
deadmazayyyyy: folds 
Eishockey47: folds 
ZeitzeugeNr1: folds 
deadmazayyyyy is disconnected 
tridmax: folds 
vazelin789: raises $0.47 to $0.72
edvards92: raises $3.43 to $4.15 and is all-in
vazelin789: calls $1.15 and is all-in
Uncalled bet ($2.28) returned to edvards92
*** FLOP *** [4s 3c 6d]
*** TURN *** [4s 3c 6d] [6c]
*** RIVER *** [4s 3c 6d 6c] [Qs]
*** SHOW DOWN ***
vazelin789: shows [Ad As] (two pair, Aces and Sixes)
edvards92: shows [Ts Th] (two pair, Tens and Sixes)
vazelin789 collected $3.70 from pot
edvards92 cashed out the hand for $0.70 | Cash Out Fee $0.01
*** SUMMARY ***
Total pot $3.83 | Rake $0.13 
Board [4s 3c 6d 6c Qs]
Seat 1: tridmax folded before Flop
Seat 2: Dorex2007 folded before Flop (didn't bet)
Seat 3: grimpop_87 folded before Flop (didn't bet)
Seat 4: veall95 folded before Flop (didn't bet)
Seat 5: vazelin789 showed [Ad As] and won ($3.70) with two pair, Aces and Sixes
Seat 6: edvards92 showed [Ts Th] and lost with two pair, Tens and Sixes (cashed out).
Seat 7: deadmazayyyyy (button) folded before Flop (didn't bet)
Seat 8: Eishockey47 (small blind) folded before Flop
Seat 9: ZeitzeugeNr1 (big blind) folded before Flop



PokerStars Hand #227663143827:  Hold'em No Limit ($0.01/$0.02 USD) - 2021/06/17 23:19:01 PT [2021/06/18 2:19:01 ET]
Table 'Komppa II' 9-max Seat #8 is the button
Seat 1: tridmax ($2 in chips) 
Seat 2: Dorex2007 ($2.04 in chips) 
Seat 3: grimpop_87 ($4.90 in chips) 
Seat 4: veall95 ($2.37 in chips) 
Seat 5: vazelin789 ($3.70 in chips) 
Seat 6: edvards92 ($2.98 in chips) 
Seat 7: deadmazayyyyy ($0.70 in chips) 
Seat 8: Eishockey47 ($0.10 in chips) 
Seat 9: ZeitzeugeNr1 ($0.71 in chips) 
ZeitzeugeNr1: posts small blind $0.01
tridmax: posts big blind $0.02
*** HOLE CARDS ***
Dealt to Dorex2007 [5h 4h]
Dorex2007: folds 
ZeitzeugeNr1 said, "very lucky "
grimpop_87: folds 
veall95: folds 
vazelin789: calls $0.02
edvards92: folds 
deadmazayyyyy: folds 
Eishockey47: folds 
ZeitzeugeNr1: folds 
tridmax: checks 
*** FLOP *** [Td Jh 4d]
tridmax: checks 
vazelin789: checks 
*** TURN *** [Td Jh 4d] [2s]
tridmax: checks 
vazelin789: checks 
*** RIVER *** [Td Jh 4d 2s] [3s]
tridmax: checks 
vazelin789: checks 
*** SHOW DOWN ***
tridmax: shows [5c 9c] (high card Jack)
vazelin789: shows [8c Ac] (high card Ace)
vazelin789 collected $0.05 from pot
*** SUMMARY ***
Total pot $0.05 | Rake $0 
Board [Td Jh 4d 2s 3s]
Seat 1: tridmax (big blind) showed [5c 9c] and lost with high card Jack
Seat 2: Dorex2007 folded before Flop (didn't bet)
Seat 3: grimpop_87 folded before Flop (didn't bet)
Seat 4: veall95 folded before Flop (didn't bet)
Seat 5: vazelin789 showed [8c Ac] and won ($0.05) with high card Ace
Seat 6: edvards92 folded before Flop (didn't bet)
Seat 7: deadmazayyyyy folded before Flop (didn't bet)
Seat 8: Eishockey47 (button) folded before Flop (didn't bet)
Seat 9: ZeitzeugeNr1 (small blind) folded before Flop



PokerStars Hand #227663148903:  Hold'em No Limit ($0.01/$0.02 USD) - 2021/06/17 23:19:38 PT [2021/06/18 2:19:38 ET]
Table 'Komppa II' 9-max Seat #9 is the button
Seat 1: tridmax ($2 in chips) 
Seat 2: Dorex2007 ($2.04 in chips) 
Seat 3: grimpop_87 ($4.90 in chips) 
Seat 4: veall95 ($2.37 in chips) 
Seat 5: vazelin789 ($3.73 in chips) 
Seat 6: edvards92 ($2.98 in chips) 
Seat 7: deadmazayyyyy ($0.70 in chips) 
Seat 8: Eishockey47 ($0.10 in chips) 
Seat 9: ZeitzeugeNr1 ($0.70 in chips) 
tridmax: posts small blind $0.01
Dorex2007: posts big blind $0.02
*** HOLE CARDS ***
Dealt to Dorex2007 [7d Tc]
grimpop_87: folds 
veall95: folds 
vazelin789: calls $0.02
edvards92: folds 
deadmazayyyyy: folds 
Eishockey47: folds 
ZeitzeugeNr1: folds 
tridmax: folds 
Dorex2007: checks 
*** FLOP *** [8s Td 6d]
Dorex2007: bets $0.05
vazelin789: calls $0.05
*** TURN *** [8s Td 6d] [Ks]
Dorex2007: bets $0.07
vazelin789: calls $0.07
*** RIVER *** [8s Td 6d Ks] [Kc]
Dorex2007: bets $0.14
vazelin789: folds 
Uncalled bet ($0.14) returned to Dorex2007
Dorex2007 collected $0.28 from pot
Dorex2007: doesn't show hand 
*** SUMMARY ***
Total pot $0.29 | Rake $0.01 
Board [8s Td 6d Ks Kc]
Seat 1: tridmax (small blind) folded before Flop
Seat 2: Dorex2007 (big blind) collected ($0.28)
Seat 3: grimpop_87 folded before Flop (didn't bet)
Seat 4: veall95 folded before Flop (didn't bet)
Seat 5: vazelin789 folded on the River
Seat 6: edvards92 folded before Flop (didn't bet)
Seat 7: deadmazayyyyy folded before Flop (didn't bet)
Seat 8: Eishockey47 folded before Flop (didn't bet)
Seat 9: ZeitzeugeNr1 (button) folded before Flop (didn't bet)



PokerStars Hand #227663156347:  Hold'em No Limit ($0.01/$0.02 USD) - 2021/06/17 23:20:32 PT [2021/06/18 2:20:32 ET]
Table 'Komppa II' 9-max Seat #1 is the button
Seat 1: tridmax ($2 in chips) 
Seat 2: Dorex2007 ($2.18 in chips) 
Seat 3: grimpop_87 ($4.90 in chips) 
Seat 4: veall95 ($2.37 in chips) 
Seat 5: vazelin789 ($3.59 in chips) 
Seat 6: edvards92 ($2.98 in chips) 
Seat 7: deadmazayyyyy ($0.70 in chips) 
Seat 8: Eishockey47 ($0.10 in chips) 
Seat 9: ZeitzeugeNr1 ($0.70 in chips) 
Dorex2007: posts small blind $0.01
grimpop_87: posts big blind $0.02
*** HOLE CARDS ***
Dealt to Dorex2007 [8c Ac]
veall95: folds 
vazelin789: folds 
edvards92: folds 
deadmazayyyyy: folds 
Eishockey47: folds 
ZeitzeugeNr1: folds 
veall95 leaves the table
tridmax: raises $0.03 to $0.05
Dorex2007: raises $0.09 to $0.14
grimpop_87: folds 
tridmax: folds 
Uncalled bet ($0.09) returned to Dorex2007
Dorex2007 collected $0.12 from pot
Dorex2007: doesn't show hand 
*** SUMMARY ***
Total pot $0.12 | Rake $0 
Seat 1: tridmax (button) folded before Flop
Seat 2: Dorex2007 (small blind) collected ($0.12)
Seat 3: grimpop_87 (big blind) folded before Flop
Seat 4: veall95 folded before Flop (didn't bet)
Seat 5: vazelin789 folded before Flop (didn't bet)
Seat 6: edvards92 folded before Flop (didn't bet)
Seat 7: deadmazayyyyy folded before Flop (didn't bet)
Seat 8: Eishockey47 folded before Flop (didn't bet)
Seat 9: ZeitzeugeNr1 folded before Flop (didn't bet)



PokerStars Hand #227663162101:  Hold'em No Limit ($0.01/$0.02 USD) - 2021/06/17 23:21:15 PT [2021/06/18 2:21:15 ET]
Table 'Komppa II' 9-max Seat #2 is the button
Seat 1: tridmax ($2 in chips) 
Seat 2: Dorex2007 ($2.25 in chips) 
Seat 3: grimpop_87 ($4.88 in chips) 
Seat 5: vazelin789 ($3.59 in chips) 
Seat 6: edvards92 ($2.98 in chips) 
Seat 7: deadmazayyyyy ($0.70 in chips) 
Seat 8: Eishockey47 ($0.10 in chips) 
Seat 9: ZeitzeugeNr1 ($0.70 in chips) 
grimpop_87: posts small blind $0.01
vazelin789: posts big blind $0.02
*** HOLE CARDS ***
Dealt to Dorex2007 [5s Ks]
edvards92: raises $0.03 to $0.05
deadmazayyyyy: folds 
Eishockey47: folds 
ZeitzeugeNr1: folds 
tridmax: folds 
Dorex2007: folds 
grimpop_87: folds 
vazelin789: folds 
Uncalled bet ($0.03) returned to edvards92
edvards92 collected $0.05 from pot
edvards92: doesn't show hand 
*** SUMMARY ***
Total pot $0.05 | Rake $0 
Seat 1: tridmax folded before Flop (didn't bet)
Seat 2: Dorex2007 (button) folded before Flop (didn't bet)
Seat 3: grimpop_87 (small blind) folded before Flop
Seat 5: vazelin789 (big blind) folded before Flop
Seat 6: edvards92 collected ($0.05)
Seat 7: deadmazayyyyy folded before Flop (didn't bet)
Seat 8: Eishockey47 folded before Flop (didn't bet)
Seat 9: ZeitzeugeNr1 folded before Flop (didn't bet)



PokerStars Hand #227663164532:  Hold'em No Limit ($0.01/$0.02 USD) - 2021/06/17 23:21:33 PT [2021/06/18 2:21:33 ET]
Table 'Komppa II' 9-max Seat #3 is the button
Seat 1: tridmax ($2 in chips) 
Seat 2: Dorex2007 ($2.25 in chips) 
Seat 3: grimpop_87 ($4.87 in chips) 
Seat 5: vazelin789 ($3.57 in chips) 
Seat 6: edvards92 ($3.01 in chips) 
Seat 7: deadmazayyyyy ($0.70 in chips) 
Seat 8: Eishockey47 ($0.10 in chips) 
Seat 9: ZeitzeugeNr1 ($0.70 in chips) 
vazelin789: posts small blind $0.01
edvards92: posts big blind $0.02
*** HOLE CARDS ***
Dealt to Dorex2007 [4h Jc]
deadmazayyyyy: folds 
Eishockey47: folds 
ZeitzeugeNr1: folds 
tridmax: folds 
Dorex2007: folds 
grimpop_87: folds 
vazelin789: folds 
Uncalled bet ($0.01) returned to edvards92
edvards92 collected $0.02 from pot
edvards92: doesn't show hand 
*** SUMMARY ***
Total pot $0.02 | Rake $0 
Seat 1: tridmax folded before Flop (didn't bet)
Seat 2: Dorex2007 folded before Flop (didn't bet)
Seat 3: grimpop_87 (button) folded before Flop (didn't bet)
Seat 5: vazelin789 (small blind) folded before Flop
Seat 6: edvards92 (big blind) collected ($0.02)
Seat 7: deadmazayyyyy folded before Flop (didn't bet)
Seat 8: Eishockey47 folded before Flop (didn't bet)
Seat 9: ZeitzeugeNr1 folded before Flop (didn't bet)



PokerStars Hand #227663167183:  Hold'em No Limit ($0.01/$0.02 USD) - 2021/06/17 23:21:52 PT [2021/06/18 2:21:52 ET]
Table 'Komppa II' 9-max Seat #5 is the button
Seat 1: tridmax ($2 in chips) 
Seat 2: Dorex2007 ($2.25 in chips) 
Seat 3: grimpop_87 ($4.87 in chips) 
Seat 5: vazelin789 ($3.56 in chips) 
Seat 6: edvards92 ($3.02 in chips) 
Seat 7: deadmazayyyyy ($0.70 in chips) 
Seat 8: Eishockey47 ($0.10 in chips) 
Seat 9: ZeitzeugeNr1 ($0.70 in chips) 
edvards92: posts small blind $0.01
deadmazayyyyy: posts big blind $0.02
*** HOLE CARDS ***
Dealt to Dorex2007 [Kh 8c]
Eishockey47: folds 
Eishockey47 leaves the table
ZeitzeugeNr1: folds 
tridmax: raises $0.03 to $0.05
Dorex2007: folds 
grimpop_87: folds 
vazelin789: folds 
edvards92: folds 
deadmazayyyyy: folds 
Uncalled bet ($0.03) returned to tridmax
tridmax collected $0.05 from pot
tridmax: doesn't show hand 
*** SUMMARY ***
Total pot $0.05 | Rake $0 
Seat 1: tridmax collected ($0.05)
Seat 2: Dorex2007 folded before Flop (didn't bet)
Seat 3: grimpop_87 folded before Flop (didn't bet)
Seat 5: vazelin789 (button) folded before Flop (didn't bet)
Seat 6: edvards92 (small blind) folded before Flop
Seat 7: deadmazayyyyy (big blind) folded before Flop
Seat 8: Eishockey47 folded before Flop (didn't bet)
Seat 9: ZeitzeugeNr1 folded before Flop (didn't bet)



PokerStars Hand #227663170956:  Hold'em No Limit ($0.01/$0.02 USD) - 2021/06/17 23:22:20 PT [2021/06/18 2:22:20 ET]
Table 'Komppa II' 9-max Seat #6 is the button
Seat 1: tridmax ($2.03 in chips) 
Seat 2: Dorex2007 ($2.25 in chips) 
Seat 3: grimpop_87 ($4.87 in chips) 
Seat 5: vazelin789 ($3.56 in chips) 
Seat 6: edvards92 ($3.01 in chips) 
Seat 7: deadmazayyyyy ($0.68 in chips) 
Seat 9: ZeitzeugeNr1 ($0.70 in chips) 
deadmazayyyyy: posts small blind $0.01
ZeitzeugeNr1: posts big blind $0.02
*** HOLE CARDS ***
Dealt to Dorex2007 [Jc 3d]
tridmax: folds 
Dorex2007: folds 
grimpop_87: folds 
vazelin789: folds 
edvards92: raises $0.03 to $0.05
deadmazayyyyy: calls $0.04
ZeitzeugeNr1: folds 
*** FLOP *** [Kc Js Th]
deadmazayyyyy: bets $0.12
edvards92: calls $0.12
*** TURN *** [Kc Js Th] [Ks]
deadmazayyyyy: bets $0.04
edvards92: calls $0.04
*** RIVER *** [Kc Js Th Ks] [5h]
deadmazayyyyy: bets $0.07
edvards92: raises $0.44 to $0.51
deadmazayyyyy: folds 
Uncalled bet ($0.44) returned to edvards92
edvards92 collected $0.56 from pot
edvards92: doesn't show hand 
*** SUMMARY ***
Total pot $0.58 | Rake $0.02 
Board [Kc Js Th Ks 5h]
Seat 1: tridmax folded before Flop (didn't bet)
Seat 2: Dorex2007 folded before Flop (didn't bet)
Seat 3: grimpop_87 folded before Flop (didn't bet)
Seat 5: vazelin789 folded before Flop (didn't bet)
Seat 6: edvards92 (button) collected ($0.56)
Seat 7: deadmazayyyyy (small blind) folded on the River
Seat 9: ZeitzeugeNr1 (big blind) folded before Flop



PokerStars Hand #227663179844:  Hold'em No Limit ($0.01/$0.02 USD) - 2021/06/17 23:23:26 PT [2021/06/18 2:23:26 ET]
Table 'Komppa II' 9-max Seat #7 is the button
Seat 1: tridmax ($2.03 in chips) 
Seat 2: Dorex2007 ($2.25 in chips) 
Seat 3: grimpop_87 ($4.87 in chips) 
Seat 5: vazelin789 ($3.56 in chips) 
Seat 6: edvards92 ($3.29 in chips) 
Seat 7: deadmazayyyyy ($0.40 in chips) 
Seat 9: ZeitzeugeNr1 ($0.68 in chips) 
ZeitzeugeNr1: posts small blind $0.01
tridmax: posts big blind $0.02
*** HOLE CARDS ***
Dealt to Dorex2007 [Kh 4c]
Dorex2007: folds 
grimpop_87 has timed out
grimpop_87: folds 
vazelin789: folds 
edvards92: folds 
deadmazayyyyy: folds 
ZeitzeugeNr1: folds 
Uncalled bet ($0.01) returned to tridmax
tridmax collected $0.02 from pot
tridmax: doesn't show hand 
*** SUMMARY ***
Total pot $0.02 | Rake $0 
Seat 1: tridmax (big blind) collected ($0.02)
Seat 2: Dorex2007 folded before Flop (didn't bet)
Seat 3: grimpop_87 folded before Flop (didn't bet)
Seat 5: vazelin789 folded before Flop (didn't bet)
Seat 6: edvards92 folded before Flop (didn't bet)
Seat 7: deadmazayyyyy (button) folded before Flop (didn't bet)
Seat 9: ZeitzeugeNr1 (small blind) folded before Flop



PokerStars Hand #227663182179:  Hold'em No Limit ($0.01/$0.02 USD) - 2021/06/17 23:23:43 PT [2021/06/18 2:23:43 ET]
Table 'Komppa II' 9-max Seat #9 is the button
Seat 1: tridmax ($2.04 in chips) 
Seat 2: Dorex2007 ($2.25 in chips) 
Seat 5: vazelin789 ($3.56 in chips) 
Seat 6: edvards92 ($3.29 in chips) 
Seat 7: deadmazayyyyy ($0.40 in chips) 
Seat 9: ZeitzeugeNr1 ($0.67 in chips) 
tridmax: posts small blind $0.01
Dorex2007: posts big blind $0.02
*** HOLE CARDS ***
Dealt to Dorex2007 [4d Qh]
vazelin789: folds 
edvards92: raises $0.03 to $0.05
deadmazayyyyy: folds 
ZeitzeugeNr1: folds 
tridmax: folds 
Dorex2007: folds 
Uncalled bet ($0.03) returned to edvards92
edvards92 collected $0.05 from pot
edvards92: doesn't show hand 
*** SUMMARY ***
Total pot $0.05 | Rake $0 
Seat 1: tridmax (small blind) folded before Flop
Seat 2: Dorex2007 (big blind) folded before Flop
Seat 5: vazelin789 folded before Flop (didn't bet)
Seat 6: edvards92 collected ($0.05)
Seat 7: deadmazayyyyy folded before Flop (didn't bet)
Seat 9: ZeitzeugeNr1 (button) folded before Flop (didn't bet)



