PokerStars Hand #232112380172:  Hold'em No Limit ($0.01/$0.02 USD) - 2021/12/10 16:09:37 PT [2021/12/10 19:09:37 ET]
Table 'Kressida II' 9-max Seat #4 is the button
Seat 1: kendri588 ($1.08 in chips) 
Seat 2: N1ceGuyEddy ($2.18 in chips) 
Seat 3: Dorex2007 ($2 in chips) 
Seat 4: JPimp2323 ($6.44 in chips) 
Seat 5: DavSavBg ($1.13 in chips) 
Seat 6: JoPeBe ($2 in chips) 
Seat 7: JUMER989 ($1.72 in chips) 
Seat 8: Kuljok1 ($1.78 in chips) 
Seat 9: Tenorio422 ($3.72 in chips) 
DavSavBg: posts small blind $0.01
JoPeBe: posts big blind $0.02
Dorex2007: posts big blind $0.02
*** HOLE CARDS ***
Dealt to Dorex2007 [2d 7h]
JUMER989: folds 
Kuljok1: calls $0.02
Tenorio422: folds 
kendri588: folds 
N1ceGuyEddy: raises $0.06 to $0.08
Dorex2007: folds 
JPimp2323: folds 
DavSavBg: folds 
JoPeBe: folds 
Kuljok1: folds 
Uncalled bet ($0.06) returned to N1ceGuyEddy
N1ceGuyEddy collected $0.09 from pot
N1ceGuyEddy: doesn't show hand 
*** SUMMARY ***
Total pot $0.09 | Rake $0 
Seat 1: kendri588 folded before Flop (didn't bet)
Seat 2: N1ceGuyEddy collected ($0.09)
Seat 3: Dorex2007 folded before Flop (didn't bet)
Seat 4: JPimp2323 (button) folded before Flop (didn't bet)
Seat 5: DavSavBg (small blind) folded before Flop
Seat 6: JoPeBe (big blind) folded before Flop
Seat 7: JUMER989 folded before Flop (didn't bet)
Seat 8: Kuljok1 folded before Flop
Seat 9: Tenorio422 folded before Flop (didn't bet)



PokerStars Hand #232112394229:  Hold'em No Limit ($0.01/$0.02 USD) - 2021/12/10 16:10:15 PT [2021/12/10 19:10:15 ET]
Table 'Kressida II' 9-max Seat #5 is the button
Seat 1: kendri588 ($1.08 in chips) 
Seat 2: N1ceGuyEddy ($2.25 in chips) 
Seat 3: Dorex2007 ($2 in chips) 
Seat 4: JPimp2323 ($6.44 in chips) 
Seat 5: DavSavBg ($1.12 in chips) 
Seat 6: JoPeBe ($1.98 in chips) 
Seat 7: JUMER989 ($1.72 in chips) 
Seat 8: Kuljok1 ($1.76 in chips) 
Seat 9: Tenorio422 ($3.72 in chips) 
JoPeBe: posts small blind $0.01
JUMER989: posts big blind $0.02
*** HOLE CARDS ***
Dealt to Dorex2007 [Ad As]
Kuljok1: folds 
Tenorio422: folds 
kendri588: raises $0.04 to $0.06
N1ceGuyEddy: calls $0.06
Dorex2007: raises $0.12 to $0.18
JPimp2323: folds 
DavSavBg: folds 
JoPeBe: folds 
JUMER989: folds 
kendri588: calls $0.12
N1ceGuyEddy: folds 
*** FLOP *** [3c 3d Qh]
kendri588: checks 
Dorex2007: bets $0.22
kendri588: folds 
Uncalled bet ($0.22) returned to Dorex2007
Dorex2007 collected $0.43 from pot
Dorex2007: doesn't show hand 
*** SUMMARY ***
Total pot $0.45 | Rake $0.02 
Board [3c 3d Qh]
Seat 1: kendri588 folded on the Flop
Seat 2: N1ceGuyEddy folded before Flop
Seat 3: Dorex2007 collected ($0.43)
Seat 4: JPimp2323 folded before Flop (didn't bet)
Seat 5: DavSavBg (button) folded before Flop (didn't bet)
Seat 6: JoPeBe (small blind) folded before Flop
Seat 7: JUMER989 (big blind) folded before Flop
Seat 8: Kuljok1 folded before Flop (didn't bet)
Seat 9: Tenorio422 folded before Flop (didn't bet)



PokerStars Hand #232112422449:  Hold'em No Limit ($0.01/$0.02 USD) - 2021/12/10 16:11:32 PT [2021/12/10 19:11:32 ET]
Table 'Kressida II' 9-max Seat #6 is the button
Seat 1: kendri588 ($0.90 in chips) 
Seat 2: N1ceGuyEddy ($2.19 in chips) 
Seat 3: Dorex2007 ($2.25 in chips) 
Seat 4: JPimp2323 ($6.44 in chips) 
Seat 5: DavSavBg ($1.12 in chips) 
Seat 6: JoPeBe ($1.97 in chips) 
Seat 7: JUMER989 ($1.70 in chips) 
Seat 8: Kuljok1 ($1.76 in chips) 
Seat 9: Tenorio422 ($3.72 in chips) 
JUMER989: posts small blind $0.01
Kuljok1: posts big blind $0.02
*** HOLE CARDS ***
Dealt to Dorex2007 [5c Qs]
Tenorio422: raises $0.04 to $0.06
kendri588: folds 
N1ceGuyEddy: folds 
Dorex2007: folds 
JPimp2323: folds 
DavSavBg: folds 
JoPeBe: folds 
JUMER989: folds 
Kuljok1: folds 
Uncalled bet ($0.04) returned to Tenorio422
Tenorio422 collected $0.05 from pot
*** SUMMARY ***
Total pot $0.05 | Rake $0 
Seat 1: kendri588 folded before Flop (didn't bet)
Seat 2: N1ceGuyEddy folded before Flop (didn't bet)
Seat 3: Dorex2007 folded before Flop (didn't bet)
Seat 4: JPimp2323 folded before Flop (didn't bet)
Seat 5: DavSavBg folded before Flop (didn't bet)
Seat 6: JoPeBe (button) folded before Flop (didn't bet)
Seat 7: JUMER989 (small blind) folded before Flop
Seat 8: Kuljok1 (big blind) folded before Flop
Seat 9: Tenorio422 collected ($0.05)



PokerStars Hand #232112434349:  Hold'em No Limit ($0.01/$0.02 USD) - 2021/12/10 16:12:05 PT [2021/12/10 19:12:05 ET]
Table 'Kressida II' 9-max Seat #7 is the button
Seat 1: kendri588 ($0.90 in chips) 
Seat 2: N1ceGuyEddy ($2.19 in chips) 
Seat 3: Dorex2007 ($2.25 in chips) 
Seat 4: JPimp2323 ($6.44 in chips) 
Seat 5: DavSavBg ($1.12 in chips) 
Seat 6: JoPeBe ($1.97 in chips) 
Seat 7: JUMER989 ($1.69 in chips) 
Seat 8: Kuljok1 ($1.74 in chips) 
Seat 9: Tenorio422 ($3.75 in chips) 
Kuljok1: posts small blind $0.01
Tenorio422: posts big blind $0.02
*** HOLE CARDS ***
Dealt to Dorex2007 [8h Ad]
kendri588: calls $0.02
N1ceGuyEddy: folds 
Dorex2007: folds 
JPimp2323: folds 
DavSavBg: folds 
JoPeBe: folds 
JUMER989: calls $0.02
Kuljok1: calls $0.01
Tenorio422: checks 
*** FLOP *** [Ks Th Kc]
Kuljok1: checks 
Tenorio422: checks 
kendri588: checks 
JUMER989: bets $0.08
Kuljok1: folds 
Tenorio422: folds 
kendri588: folds 
Uncalled bet ($0.08) returned to JUMER989
JUMER989 collected $0.08 from pot
JUMER989: doesn't show hand 
*** SUMMARY ***
Total pot $0.08 | Rake $0 
Board [Ks Th Kc]
Seat 1: kendri588 folded on the Flop
Seat 2: N1ceGuyEddy folded before Flop (didn't bet)
Seat 3: Dorex2007 folded before Flop (didn't bet)
Seat 4: JPimp2323 folded before Flop (didn't bet)
Seat 5: DavSavBg folded before Flop (didn't bet)
Seat 6: JoPeBe folded before Flop (didn't bet)
Seat 7: JUMER989 (button) collected ($0.08)
Seat 8: Kuljok1 (small blind) folded on the Flop
Seat 9: Tenorio422 (big blind) folded on the Flop



PokerStars Hand #232112453128:  Hold'em No Limit ($0.01/$0.02 USD) - 2021/12/10 16:12:57 PT [2021/12/10 19:12:57 ET]
Table 'Kressida II' 9-max Seat #8 is the button
Seat 1: kendri588 ($0.88 in chips) 
Seat 2: N1ceGuyEddy ($2.19 in chips) 
Seat 3: Dorex2007 ($2.25 in chips) 
Seat 4: JPimp2323 ($6.44 in chips) 
Seat 5: DavSavBg ($1.12 in chips) 
Seat 6: JoPeBe ($1.97 in chips) 
Seat 7: JUMER989 ($1.75 in chips) 
Seat 8: Kuljok1 ($1.72 in chips) 
Seat 9: Tenorio422 ($3.73 in chips) 
Tenorio422: posts small blind $0.01
kendri588: posts big blind $0.02
*** HOLE CARDS ***
Dealt to Dorex2007 [5s 7d]
N1ceGuyEddy has timed out
N1ceGuyEddy: folds 
Dorex2007: folds 
JPimp2323: folds 
DavSavBg: raises $0.03 to $0.05
JoPeBe: folds 
JUMER989: folds 
Kuljok1: folds 
Tenorio422: folds 
kendri588: calls $0.03
*** FLOP *** [3d Ks 6d]
kendri588: checks 
DavSavBg: bets $0.05
kendri588: folds 
Uncalled bet ($0.05) returned to DavSavBg
DavSavBg collected $0.11 from pot
DavSavBg: doesn't show hand 
*** SUMMARY ***
Total pot $0.11 | Rake $0 
Board [3d Ks 6d]
Seat 1: kendri588 (big blind) folded on the Flop
Seat 2: N1ceGuyEddy folded before Flop (didn't bet)
Seat 3: Dorex2007 folded before Flop (didn't bet)
Seat 4: JPimp2323 folded before Flop (didn't bet)
Seat 5: DavSavBg collected ($0.11)
Seat 6: JoPeBe folded before Flop (didn't bet)
Seat 7: JUMER989 folded before Flop (didn't bet)
Seat 8: Kuljok1 (button) folded before Flop (didn't bet)
Seat 9: Tenorio422 (small blind) folded before Flop



PokerStars Hand #232112468090:  Hold'em No Limit ($0.01/$0.02 USD) - 2021/12/10 16:13:39 PT [2021/12/10 19:13:39 ET]
Table 'Kressida II' 9-max Seat #9 is the button
Seat 1: kendri588 ($0.83 in chips) 
Seat 3: Dorex2007 ($2.25 in chips) 
Seat 4: JPimp2323 ($6.44 in chips) 
Seat 5: DavSavBg ($1.18 in chips) 
Seat 6: JoPeBe ($1.97 in chips) 
Seat 7: JUMER989 ($1.75 in chips) 
Seat 8: Kuljok1 ($1.72 in chips) 
Seat 9: Tenorio422 ($3.72 in chips) 
kendri588: posts small blind $0.01
Dorex2007: posts big blind $0.02
*** HOLE CARDS ***
Dealt to Dorex2007 [6c 8s]
JPimp2323 has timed out
JPimp2323: folds 
DavSavBg: folds 
JoPeBe: calls $0.02
JUMER989: calls $0.02
Kuljok1: calls $0.02
Tenorio422: folds 
kendri588: raises $0.08 to $0.10
Dorex2007: folds 
JoPeBe: folds 
JUMER989: folds 
Kuljok1: calls $0.08
*** FLOP *** [5d Jh Ad]
kendri588: bets $0.10
Kuljok1: calls $0.10
*** TURN *** [5d Jh Ad] [Qd]
kendri588: bets $0.20
Kuljok1: folds 
Uncalled bet ($0.20) returned to kendri588
kendri588 collected $0.44 from pot
kendri588: doesn't show hand 
*** SUMMARY ***
Total pot $0.46 | Rake $0.02 
Board [5d Jh Ad Qd]
Seat 1: kendri588 (small blind) collected ($0.44)
Seat 3: Dorex2007 (big blind) folded before Flop
Seat 4: JPimp2323 folded before Flop (didn't bet)
Seat 5: DavSavBg folded before Flop (didn't bet)
Seat 6: JoPeBe folded before Flop
Seat 7: JUMER989 folded before Flop
Seat 8: Kuljok1 folded on the Turn
Seat 9: Tenorio422 (button) folded before Flop (didn't bet)



PokerStars Hand #232112487119:  Hold'em No Limit ($0.01/$0.02 USD) - 2021/12/10 16:14:32 PT [2021/12/10 19:14:32 ET]
Table 'Kressida II' 9-max Seat #1 is the button
Seat 1: kendri588 ($1.07 in chips) 
Seat 3: Dorex2007 ($2.23 in chips) 
Seat 4: JPimp2323 ($6.44 in chips) 
Seat 5: DavSavBg ($1.18 in chips) 
Seat 6: JoPeBe ($1.95 in chips) 
Seat 7: JUMER989 ($1.73 in chips) 
Seat 8: Kuljok1 ($1.52 in chips) 
Seat 9: Tenorio422 ($3.72 in chips) 
Dorex2007: posts small blind $0.01
JPimp2323: posts big blind $0.02
*** HOLE CARDS ***
Dealt to Dorex2007 [8c Qd]
DavSavBg: raises $0.03 to $0.05
JoPeBe: folds 
JUMER989: folds 
Kuljok1: folds 
Tenorio422: folds 
kendri588: folds 
Dorex2007: folds 
JPimp2323: folds 
Uncalled bet ($0.03) returned to DavSavBg
DavSavBg collected $0.05 from pot
DavSavBg: doesn't show hand 
*** SUMMARY ***
Total pot $0.05 | Rake $0 
Seat 1: kendri588 (button) folded before Flop (didn't bet)
Seat 3: Dorex2007 (small blind) folded before Flop
Seat 4: JPimp2323 (big blind) folded before Flop
Seat 5: DavSavBg collected ($0.05)
Seat 6: JoPeBe folded before Flop (didn't bet)
Seat 7: JUMER989 folded before Flop (didn't bet)
Seat 8: Kuljok1 folded before Flop (didn't bet)
Seat 9: Tenorio422 folded before Flop (didn't bet)



PokerStars Hand #232112496625:  Hold'em No Limit ($0.01/$0.02 USD) - 2021/12/10 16:14:58 PT [2021/12/10 19:14:58 ET]
Table 'Kressida II' 9-max Seat #3 is the button
Seat 1: kendri588 ($1.07 in chips) 
Seat 3: Dorex2007 ($2.22 in chips) 
Seat 4: JPimp2323 ($6.42 in chips) 
Seat 5: DavSavBg ($1.21 in chips) 
Seat 6: JoPeBe ($1.95 in chips) 
Seat 7: JUMER989 ($1.73 in chips) 
Seat 8: Kuljok1 ($1.52 in chips) 
Seat 9: Tenorio422 ($3.72 in chips) 
JPimp2323: posts small blind $0.01
DavSavBg: posts big blind $0.02
*** HOLE CARDS ***
Dealt to Dorex2007 [3c 2h]
JoPeBe: folds 
JUMER989: folds 
Kuljok1: folds 
Tenorio422: folds 
kendri588: raises $0.04 to $0.06
Dorex2007: folds 
JPimp2323: calls $0.05
DavSavBg: folds 
*** FLOP *** [7s 8h Ah]
JPimp2323: checks 
kendri588: checks 
*** TURN *** [7s 8h Ah] [8d]
JPimp2323: bets $0.07
kendri588: folds 
Uncalled bet ($0.07) returned to JPimp2323
JPimp2323 collected $0.14 from pot
JPimp2323: doesn't show hand 
*** SUMMARY ***
Total pot $0.14 | Rake $0 
Board [7s 8h Ah 8d]
Seat 1: kendri588 folded on the Turn
Seat 3: Dorex2007 (button) folded before Flop (didn't bet)
Seat 4: JPimp2323 (small blind) collected ($0.14)
Seat 5: DavSavBg (big blind) folded before Flop
Seat 6: JoPeBe folded before Flop (didn't bet)
Seat 7: JUMER989 folded before Flop (didn't bet)
Seat 8: Kuljok1 folded before Flop (didn't bet)
Seat 9: Tenorio422 folded before Flop (didn't bet)



PokerStars Hand #232112513156:  Hold'em No Limit ($0.01/$0.02 USD) - 2021/12/10 16:15:45 PT [2021/12/10 19:15:45 ET]
Table 'Kressida II' 9-max Seat #4 is the button
Seat 1: kendri588 ($1.01 in chips) 
Seat 3: Dorex2007 ($2.22 in chips) 
Seat 4: JPimp2323 ($6.50 in chips) 
Seat 5: DavSavBg ($1.19 in chips) 
Seat 6: JoPeBe ($1.95 in chips) 
Seat 7: JUMER989 ($1.73 in chips) 
Seat 8: Kuljok1 ($1.52 in chips) 
Seat 9: Tenorio422 ($3.72 in chips) 
DavSavBg: posts small blind $0.01
JoPeBe: posts big blind $0.02
*** HOLE CARDS ***
Dealt to Dorex2007 [3s 9c]
JUMER989: folds 
Kuljok1: calls $0.02
Tenorio422: folds 
kendri588: calls $0.02
Dorex2007: folds 
JPimp2323: calls $0.02
DavSavBg: calls $0.01
JoPeBe: checks 
*** FLOP *** [7h 8d Qc]
DavSavBg: checks 
JoPeBe: checks 
Kuljok1: checks 
kendri588: checks 
JPimp2323: bets $0.06
DavSavBg: folds 
JoPeBe: folds 
Kuljok1: folds 
kendri588: folds 
Uncalled bet ($0.06) returned to JPimp2323
JPimp2323 collected $0.10 from pot
JPimp2323: doesn't show hand 
*** SUMMARY ***
Total pot $0.10 | Rake $0 
Board [7h 8d Qc]
Seat 1: kendri588 folded on the Flop
Seat 3: Dorex2007 folded before Flop (didn't bet)
Seat 4: JPimp2323 (button) collected ($0.10)
Seat 5: DavSavBg (small blind) folded on the Flop
Seat 6: JoPeBe (big blind) folded on the Flop
Seat 7: JUMER989 folded before Flop (didn't bet)
Seat 8: Kuljok1 folded on the Flop
Seat 9: Tenorio422 folded before Flop (didn't bet)



PokerStars Hand #232112535851:  Hold'em No Limit ($0.01/$0.02 USD) - 2021/12/10 16:16:49 PT [2021/12/10 19:16:49 ET]
Table 'Kressida II' 9-max Seat #5 is the button
Seat 1: kendri588 ($0.99 in chips) 
Seat 3: Dorex2007 ($2.22 in chips) 
Seat 4: JPimp2323 ($6.58 in chips) 
Seat 5: DavSavBg ($1.17 in chips) 
Seat 6: JoPeBe ($1.93 in chips) 
Seat 7: JUMER989 ($1.73 in chips) 
Seat 8: Kuljok1 ($1.50 in chips) 
Seat 9: Tenorio422 ($3.72 in chips) 
JoPeBe: posts small blind $0.01
JUMER989: posts big blind $0.02
*** HOLE CARDS ***
Dealt to Dorex2007 [6h 8c]
Kuljok1: calls $0.02
Tenorio422: folds 
kendri588 has timed out
kendri588: folds 
Dorex2007: folds 
JPimp2323 has timed out
JPimp2323: folds 
DavSavBg: raises $0.05 to $0.07
JoPeBe: folds 
JUMER989: folds 
Kuljok1: calls $0.05
*** FLOP *** [3h Qh 4d]
Kuljok1: bets $0.02
DavSavBg: calls $0.02
*** TURN *** [3h Qh 4d] [7h]
Kuljok1: bets $0.20
DavSavBg: folds 
Uncalled bet ($0.20) returned to Kuljok1
Kuljok1 collected $0.20 from pot
Kuljok1: doesn't show hand 
*** SUMMARY ***
Total pot $0.21 | Rake $0.01 
Board [3h Qh 4d 7h]
Seat 1: kendri588 folded before Flop (didn't bet)
Seat 3: Dorex2007 folded before Flop (didn't bet)
Seat 4: JPimp2323 folded before Flop (didn't bet)
Seat 5: DavSavBg (button) folded on the Turn
Seat 6: JoPeBe (small blind) folded before Flop
Seat 7: JUMER989 (big blind) folded before Flop
Seat 8: Kuljok1 collected ($0.20)
Seat 9: Tenorio422 folded before Flop (didn't bet)



PokerStars Hand #232112559298:  Hold'em No Limit ($0.01/$0.02 USD) - 2021/12/10 16:17:55 PT [2021/12/10 19:17:55 ET]
Table 'Kressida II' 9-max Seat #6 is the button
Seat 1: kendri588 ($0.99 in chips) 
Seat 3: Dorex2007 ($2.22 in chips) 
Seat 4: JPimp2323 ($6.58 in chips) 
Seat 5: DavSavBg ($1.08 in chips) 
Seat 6: JoPeBe ($1.92 in chips) 
Seat 7: JUMER989 ($1.71 in chips) 
Seat 8: Kuljok1 ($1.61 in chips) 
Seat 9: Tenorio422 ($3.72 in chips) 
JUMER989: posts small blind $0.01
Kuljok1: posts big blind $0.02
N1ceGuyEddy: sits out 
*** HOLE CARDS ***
Dealt to Dorex2007 [As 3d]
Tenorio422: folds 
kendri588: raises $0.04 to $0.06
Dorex2007: folds 
JPimp2323: calls $0.06
DavSavBg: folds 
DavSavBg leaves the table
JoPeBe: folds 
JUMER989: folds 
Kuljok1: folds 
*** FLOP *** [2d 5c 4h]
kendri588: checks 
JPimp2323: bets $0.07
kendri588: calls $0.07
*** TURN *** [2d 5c 4h] [3h]
kendri588: checks 
JPimp2323: checks 
*** RIVER *** [2d 5c 4h 3h] [2h]
kendri588: bets $0.86 and is all-in
JPimp2323: calls $0.86
*** SHOW DOWN ***
kendri588: shows [5s 5d] (a full house, Fives full of Deuces)
JPimp2323: shows [Ts Ac] (a straight, Ace to Five)
kendri588 collected $1.94 from pot
*** SUMMARY ***
Total pot $2.01 | Rake $0.07 
Board [2d 5c 4h 3h 2h]
Seat 1: kendri588 showed [5s 5d] and won ($1.94) with a full house, Fives full of Deuces
Seat 3: Dorex2007 folded before Flop (didn't bet)
Seat 4: JPimp2323 showed [Ts Ac] and lost with a straight, Ace to Five
Seat 5: DavSavBg folded before Flop (didn't bet)
Seat 6: JoPeBe (button) folded before Flop (didn't bet)
Seat 7: JUMER989 (small blind) folded before Flop
Seat 8: Kuljok1 (big blind) folded before Flop
Seat 9: Tenorio422 folded before Flop (didn't bet)



PokerStars Hand #232112590378:  Hold'em No Limit ($0.01/$0.02 USD) - 2021/12/10 16:19:05 PT [2021/12/10 19:19:05 ET]
Table 'Kressida II' 9-max Seat #7 is the button
Seat 1: kendri588 ($1.94 in chips) 
Seat 3: Dorex2007 ($2.22 in chips) 
Seat 4: JPimp2323 ($5.59 in chips) 
Seat 6: JoPeBe ($1.92 in chips) 
Seat 7: JUMER989 ($1.70 in chips) 
Seat 8: Kuljok1 ($1.59 in chips) 
Seat 9: Tenorio422 ($3.72 in chips) 
Kuljok1: posts small blind $0.01
Tenorio422: posts big blind $0.02
N1ceGuyEddy: sits out 
*** HOLE CARDS ***
Dealt to Dorex2007 [8d Jd]
kendri588: folds 
Dorex2007: folds 
JPimp2323: folds 
JoPeBe: folds 
JUMER989: calls $0.02
Kuljok1: calls $0.01
Tenorio422: checks 
*** FLOP *** [7s Jh As]
kendri588 leaves the table
vikingoyabeja joins the table at seat #5 
Kuljok1: checks 
Tenorio422: checks 
JUMER989: checks 
*** TURN *** [7s Jh As] [5c]
Kuljok1: checks 
Tenorio422: checks 
JUMER989: checks 
*** RIVER *** [7s Jh As 5c] [Kc]
Kuinnq joins the table at seat #1 
Kuljok1: checks 
Tenorio422: checks 
JUMER989: checks 
*** SHOW DOWN ***
Kuljok1: shows [4s 6h] (high card Ace)
Tenorio422: shows [8h 7c] (a pair of Sevens)
JUMER989: shows [Tc Js] (a pair of Jacks)
JUMER989 collected $0.06 from pot
*** SUMMARY ***
Total pot $0.06 | Rake $0 
Board [7s Jh As 5c Kc]
Seat 1: kendri588 folded before Flop (didn't bet)
Seat 3: Dorex2007 folded before Flop (didn't bet)
Seat 4: JPimp2323 folded before Flop (didn't bet)
Seat 6: JoPeBe folded before Flop (didn't bet)
Seat 7: JUMER989 (button) showed [Tc Js] and won ($0.06) with a pair of Jacks
Seat 8: Kuljok1 (small blind) showed [4s 6h] and lost with high card Ace
Seat 9: Tenorio422 (big blind) showed [8h 7c] and lost with a pair of Sevens



PokerStars Hand #232112609337:  Hold'em No Limit ($0.01/$0.02 USD) - 2021/12/10 16:20:00 PT [2021/12/10 19:20:00 ET]
Table 'Kressida II' 9-max Seat #8 is the button
Seat 1: Kuinnq ($1 in chips) 
Seat 3: Dorex2007 ($2.22 in chips) 
Seat 4: JPimp2323 ($5.59 in chips) 
Seat 5: vikingoyabeja ($1.60 in chips) 
Seat 6: JoPeBe ($1.92 in chips) 
Seat 7: JUMER989 ($1.74 in chips) 
Seat 8: Kuljok1 ($1.57 in chips) 
Seat 9: Tenorio422 ($3.70 in chips) 
Tenorio422: posts small blind $0.01
Kuinnq: posts big blind $0.02
N1ceGuyEddy: sits out 
vikingoyabeja: posts big blind $0.02
*** HOLE CARDS ***
Dealt to Dorex2007 [7h Qs]
Dorex2007: folds 
JPimp2323: folds 
vikingoyabeja: checks 
JoPeBe: folds 
JUMER989: raises $0.07 to $0.09
Kuljok1: calls $0.09
Tenorio422: folds 
Kuinnq: folds 
vikingoyabeja: calls $0.07
*** FLOP *** [Kh 8c Qh]
vikingoyabeja: checks 
JUMER989: bets $0.29
Kuljok1: calls $0.29
vikingoyabeja: folds 
*** TURN *** [Kh 8c Qh] [3s]
JUMER989: bets $0.85
Kuljok1: raises $0.34 to $1.19 and is all-in
JUMER989: calls $0.34
*** RIVER *** [Kh 8c Qh 3s] [9d]
*** SHOW DOWN ***
JUMER989: shows [Qc Qd] (three of a kind, Queens)
Kuljok1: shows [Ks 8h] (two pair, Kings and Eights)
JUMER989 collected $3.15 from pot
*** SUMMARY ***
Total pot $3.26 | Rake $0.11 
Board [Kh 8c Qh 3s 9d]
Seat 1: Kuinnq (big blind) folded before Flop
Seat 3: Dorex2007 folded before Flop (didn't bet)
Seat 4: JPimp2323 folded before Flop (didn't bet)
Seat 5: vikingoyabeja folded on the Flop
Seat 6: JoPeBe folded before Flop (didn't bet)
Seat 7: JUMER989 showed [Qc Qd] and won ($3.15) with three of a kind, Queens
Seat 8: Kuljok1 (button) showed [Ks 8h] and lost with two pair, Kings and Eights
Seat 9: Tenorio422 (small blind) folded before Flop



PokerStars Hand #232112631946:  Hold'em No Limit ($0.01/$0.02 USD) - 2021/12/10 16:21:04 PT [2021/12/10 19:21:04 ET]
Table 'Kressida II' 9-max Seat #9 is the button
Seat 1: Kuinnq ($0.98 in chips) 
Seat 2: N1ceGuyEddy ($2.19 in chips) 
Seat 3: Dorex2007 ($2.22 in chips) 
Seat 4: JPimp2323 ($5.59 in chips) 
Seat 5: vikingoyabeja ($1.51 in chips) 
Seat 6: JoPeBe ($1.92 in chips) 
Seat 7: JUMER989 ($3.32 in chips) 
Seat 9: Tenorio422 ($3.69 in chips) 
Kuinnq: posts small blind $0.01
N1ceGuyEddy: posts big blind $0.02
*** HOLE CARDS ***
Dealt to Dorex2007 [Td 8h]
Dorex2007: folds 
JPimp2323: folds 
vikingoyabeja: calls $0.02
JoPeBe: folds 
JUMER989: folds 
Tenorio422: folds 
Kuinnq: raises $0.04 to $0.06
N1ceGuyEddy: folds 
vikingoyabeja: calls $0.04
*** FLOP *** [4d 7h Qh]
Kuinnq: bets $0.04
vikingoyabeja: folds 
Uncalled bet ($0.04) returned to Kuinnq
Kuinnq collected $0.14 from pot
Kuinnq: doesn't show hand 
*** SUMMARY ***
Total pot $0.14 | Rake $0 
Board [4d 7h Qh]
Seat 1: Kuinnq (small blind) collected ($0.14)
Seat 2: N1ceGuyEddy (big blind) folded before Flop
Seat 3: Dorex2007 folded before Flop (didn't bet)
Seat 4: JPimp2323 folded before Flop (didn't bet)
Seat 5: vikingoyabeja folded on the Flop
Seat 6: JoPeBe folded before Flop (didn't bet)
Seat 7: JUMER989 folded before Flop (didn't bet)
Seat 9: Tenorio422 (button) folded before Flop (didn't bet)



PokerStars Hand #232112644897:  Hold'em No Limit ($0.01/$0.02 USD) - 2021/12/10 16:21:42 PT [2021/12/10 19:21:42 ET]
Table 'Kressida II' 9-max Seat #1 is the button
Seat 1: Kuinnq ($1.06 in chips) 
Seat 2: N1ceGuyEddy ($2.17 in chips) 
Seat 3: Dorex2007 ($2.22 in chips) 
Seat 4: JPimp2323 ($5.59 in chips) 
Seat 5: vikingoyabeja ($1.45 in chips) 
Seat 6: JoPeBe ($1.92 in chips) 
Seat 7: JUMER989 ($3.32 in chips) 
Seat 8: Kuljok1 ($2 in chips) 
Seat 9: Tenorio422 ($3.69 in chips) 
N1ceGuyEddy: posts small blind $0.01
Dorex2007: posts big blind $0.02
*** HOLE CARDS ***
Dealt to Dorex2007 [Th Ac]
JPimp2323: folds 
vikingoyabeja: folds 
JoPeBe: folds 
JUMER989: folds 
Kuljok1: folds 
Tenorio422: folds 
Kuinnq: folds 
N1ceGuyEddy: folds 
Uncalled bet ($0.01) returned to Dorex2007
Dorex2007 collected $0.02 from pot
Dorex2007: doesn't show hand 
*** SUMMARY ***
Total pot $0.02 | Rake $0 
Seat 1: Kuinnq (button) folded before Flop (didn't bet)
Seat 2: N1ceGuyEddy (small blind) folded before Flop
Seat 3: Dorex2007 (big blind) collected ($0.02)
Seat 4: JPimp2323 folded before Flop (didn't bet)
Seat 5: vikingoyabeja folded before Flop (didn't bet)
Seat 6: JoPeBe folded before Flop (didn't bet)
Seat 7: JUMER989 folded before Flop (didn't bet)
Seat 8: Kuljok1 folded before Flop (didn't bet)
Seat 9: Tenorio422 folded before Flop (didn't bet)



PokerStars Hand #232112652626:  Hold'em No Limit ($0.01/$0.02 USD) - 2021/12/10 16:22:04 PT [2021/12/10 19:22:04 ET]
Table 'Kressida II' 9-max Seat #2 is the button
Seat 1: Kuinnq ($1.06 in chips) 
Seat 2: N1ceGuyEddy ($2.16 in chips) 
Seat 3: Dorex2007 ($2.23 in chips) 
Seat 4: JPimp2323 ($5.59 in chips) 
Seat 5: vikingoyabeja ($1.45 in chips) 
Seat 6: JoPeBe ($1.92 in chips) 
Seat 7: JUMER989 ($3.32 in chips) 
Seat 8: Kuljok1 ($2 in chips) 
Seat 9: Tenorio422 ($3.69 in chips) 
Dorex2007: posts small blind $0.01
JPimp2323: posts big blind $0.02
*** HOLE CARDS ***
Dealt to Dorex2007 [Kh 2h]
vikingoyabeja: calls $0.02
JoPeBe: calls $0.02
JUMER989: folds 
Kuljok1: folds 
Tenorio422: folds 
Kuinnq: folds 
N1ceGuyEddy: folds 
Dorex2007: calls $0.01
JPimp2323: checks 
*** FLOP *** [8s 7d 4s]
Dorex2007: checks 
JPimp2323: checks 
vikingoyabeja: checks 
JoPeBe: checks 
*** TURN *** [8s 7d 4s] [6d]
Dorex2007: checks 
JPimp2323: checks 
vikingoyabeja: checks 
JoPeBe: checks 
*** RIVER *** [8s 7d 4s 6d] [Ah]
Dorex2007: checks 
JPimp2323: checks 
vikingoyabeja: checks 
JoPeBe: bets $0.06
Dorex2007: folds 
JPimp2323: folds 
vikingoyabeja: folds 
Uncalled bet ($0.06) returned to JoPeBe
JoPeBe collected $0.08 from pot
JoPeBe: doesn't show hand 
*** SUMMARY ***
Total pot $0.08 | Rake $0 
Board [8s 7d 4s 6d Ah]
Seat 1: Kuinnq folded before Flop (didn't bet)
Seat 2: N1ceGuyEddy (button) folded before Flop (didn't bet)
Seat 3: Dorex2007 (small blind) folded on the River
Seat 4: JPimp2323 (big blind) folded on the River
Seat 5: vikingoyabeja folded on the River
Seat 6: JoPeBe collected ($0.08)
Seat 7: JUMER989 folded before Flop (didn't bet)
Seat 8: Kuljok1 folded before Flop (didn't bet)
Seat 9: Tenorio422 folded before Flop (didn't bet)



PokerStars Hand #232112685308:  Hold'em No Limit ($0.01/$0.02 USD) - 2021/12/10 16:23:33 PT [2021/12/10 19:23:33 ET]
Table 'Kressida II' 9-max Seat #3 is the button
Seat 1: Kuinnq ($1.06 in chips) 
Seat 2: N1ceGuyEddy ($2.16 in chips) 
Seat 3: Dorex2007 ($2.21 in chips) 
Seat 4: JPimp2323 ($5.57 in chips) 
Seat 5: vikingoyabeja ($1.43 in chips) 
Seat 7: JUMER989 ($3.32 in chips) 
Seat 8: Kuljok1 ($2 in chips) 
Seat 9: Tenorio422 ($3.69 in chips) 
JPimp2323: posts small blind $0.01
vikingoyabeja: posts big blind $0.02
*** HOLE CARDS ***
Dealt to Dorex2007 [7h 3h]
JUMER989: raises $0.05 to $0.07
Kuljok1: folds 
Tenorio422: folds 
Kuinnq: folds 
N1ceGuyEddy: folds 
Dorex2007: folds 
JPimp2323: folds 
vikingoyabeja: calls $0.05
*** FLOP *** [8d 8s 4c]
vikingoyabeja: checks 
JUMER989: bets $0.14
vikingoyabeja: folds 
Uncalled bet ($0.14) returned to JUMER989
JUMER989 collected $0.14 from pot
JUMER989: doesn't show hand 
*** SUMMARY ***
Total pot $0.15 | Rake $0.01 
Board [8d 8s 4c]
Seat 1: Kuinnq folded before Flop (didn't bet)
Seat 2: N1ceGuyEddy folded before Flop (didn't bet)
Seat 3: Dorex2007 (button) folded before Flop (didn't bet)
Seat 4: JPimp2323 (small blind) folded before Flop
Seat 5: vikingoyabeja (big blind) folded on the Flop
Seat 7: JUMER989 collected ($0.14)
Seat 8: Kuljok1 folded before Flop (didn't bet)
Seat 9: Tenorio422 folded before Flop (didn't bet)



PokerStars Hand #232112695323:  Hold'em No Limit ($0.01/$0.02 USD) - 2021/12/10 16:24:03 PT [2021/12/10 19:24:03 ET]
Table 'Kressida II' 9-max Seat #4 is the button
Seat 1: Kuinnq ($1.06 in chips) 
Seat 2: N1ceGuyEddy ($2.16 in chips) 
Seat 3: Dorex2007 ($2.21 in chips) 
Seat 4: JPimp2323 ($5.56 in chips) 
Seat 5: vikingoyabeja ($1.36 in chips) 
Seat 7: JUMER989 ($3.39 in chips) 
Seat 8: Kuljok1 ($2 in chips) 
Seat 9: Tenorio422 ($3.69 in chips) 
vikingoyabeja: posts small blind $0.01
JUMER989: posts big blind $0.02
*** HOLE CARDS ***
Dealt to Dorex2007 [Qd Ks]
Kuljok1: folds 
Tenorio422: folds 
Kuinnq: folds 
N1ceGuyEddy: folds 
Dorex2007: raises $0.04 to $0.06
JPimp2323: folds 
vikingoyabeja: folds 
JUMER989: calls $0.04
*** FLOP *** [Tc 6h 3d]
JUMER989: checks 
Dorex2007: checks 
*** TURN *** [Tc 6h 3d] [7c]
JUMER989 has timed out
JUMER989: checks 
Dorex2007: bets $0.09
JUMER989: folds 
Uncalled bet ($0.09) returned to Dorex2007
Dorex2007 collected $0.13 from pot
Dorex2007: doesn't show hand 
*** SUMMARY ***
Total pot $0.13 | Rake $0 
Board [Tc 6h 3d 7c]
Seat 1: Kuinnq folded before Flop (didn't bet)
Seat 2: N1ceGuyEddy folded before Flop (didn't bet)
Seat 3: Dorex2007 collected ($0.13)
Seat 4: JPimp2323 (button) folded before Flop (didn't bet)
Seat 5: vikingoyabeja (small blind) folded before Flop
Seat 7: JUMER989 (big blind) folded on the Turn
Seat 8: Kuljok1 folded before Flop (didn't bet)
Seat 9: Tenorio422 folded before Flop (didn't bet)



PokerStars Hand #232112726632:  Hold'em No Limit ($0.01/$0.02 USD) - 2021/12/10 16:25:35 PT [2021/12/10 19:25:35 ET]
Table 'Kressida II' 9-max Seat #5 is the button
Seat 1: Kuinnq ($1.06 in chips) 
Seat 2: N1ceGuyEddy ($2.16 in chips) 
Seat 3: Dorex2007 ($2.28 in chips) 
Seat 4: JPimp2323 ($5.56 in chips) 
Seat 5: vikingoyabeja ($1.35 in chips) 
Seat 7: JUMER989 ($3.33 in chips) 
Seat 8: Kuljok1 ($2 in chips) 
Seat 9: Tenorio422 ($3.69 in chips) 
JUMER989: posts small blind $0.01
Kuljok1: posts big blind $0.02
*** HOLE CARDS ***
Dealt to Dorex2007 [3c 4s]
Tenorio422: folds 
Kuinnq: folds 
N1ceGuyEddy: folds 
Dorex2007: folds 
JPimp2323: calls $0.02
vikingoyabeja: calls $0.02
JUMER989 is disconnected 
JUMER989 has timed out while disconnected
JUMER989: folds 
Kuljok1: checks 
*** FLOP *** [Qs 4d Jc]
Kuljok1: checks 
JPimp2323: bets $0.05
vikingoyabeja: folds 
Kuljok1: folds 
Uncalled bet ($0.05) returned to JPimp2323
JPimp2323 collected $0.07 from pot
JPimp2323: doesn't show hand 
*** SUMMARY ***
Total pot $0.07 | Rake $0 
Board [Qs 4d Jc]
Seat 1: Kuinnq folded before Flop (didn't bet)
Seat 2: N1ceGuyEddy folded before Flop (didn't bet)
Seat 3: Dorex2007 folded before Flop (didn't bet)
Seat 4: JPimp2323 collected ($0.07)
Seat 5: vikingoyabeja (button) folded on the Flop
Seat 7: JUMER989 (small blind) folded before Flop
Seat 8: Kuljok1 (big blind) folded on the Flop
Seat 9: Tenorio422 folded before Flop (didn't bet)



PokerStars Hand #232112756998:  Hold'em No Limit ($0.01/$0.02 USD) - 2021/12/10 16:26:49 PT [2021/12/10 19:26:49 ET]
Table 'Kressida II' 9-max Seat #8 is the button
Seat 1: Kuinnq ($1.06 in chips) 
Seat 2: N1ceGuyEddy ($2.16 in chips) 
Seat 3: Dorex2007 ($2.28 in chips) 
Seat 4: JPimp2323 ($5.61 in chips) 
Seat 5: vikingoyabeja ($1.33 in chips) 
Seat 8: Kuljok1 ($1.98 in chips) 
Seat 9: Tenorio422 ($3.69 in chips) 
Tenorio422: posts small blind $0.01
Kuinnq: posts big blind $0.02
*** HOLE CARDS ***
Dealt to Dorex2007 [2c 5d]
N1ceGuyEddy: folds 
Dorex2007: folds 
JPimp2323: folds 
vikingoyabeja: calls $0.02
Kuljok1: raises $0.02 to $0.04
Tenorio422: folds 
Kuinnq: calls $0.02
vikingoyabeja: calls $0.02
*** FLOP *** [Ks 2h 3s]
Kuinnq: bets $0.06
vikingoyabeja: folds 
Kuljok1: raises $0.06 to $0.12
Kuinnq: calls $0.06
*** TURN *** [Ks 2h 3s] [8c]
Kuinnq: checks 
Kuljok1: bets $0.18
Kuinnq: folds 
Uncalled bet ($0.18) returned to Kuljok1
Kuljok1 collected $0.36 from pot
Kuljok1: doesn't show hand 
*** SUMMARY ***
Total pot $0.37 | Rake $0.01 
Board [Ks 2h 3s 8c]
Seat 1: Kuinnq (big blind) folded on the Turn
Seat 2: N1ceGuyEddy folded before Flop (didn't bet)
Seat 3: Dorex2007 folded before Flop (didn't bet)
Seat 4: JPimp2323 folded before Flop (didn't bet)
Seat 5: vikingoyabeja folded on the Flop
Seat 8: Kuljok1 (button) collected ($0.36)
Seat 9: Tenorio422 (small blind) folded before Flop



PokerStars Hand #232112774776:  Hold'em No Limit ($0.01/$0.02 USD) - 2021/12/10 16:27:42 PT [2021/12/10 19:27:42 ET]
Table 'Kressida II' 9-max Seat #9 is the button
Seat 1: Kuinnq ($0.90 in chips) 
Seat 2: N1ceGuyEddy ($2.16 in chips) 
Seat 3: Dorex2007 ($2.28 in chips) 
Seat 4: JPimp2323 ($5.61 in chips) 
Seat 5: vikingoyabeja ($1.29 in chips) 
Seat 8: Kuljok1 ($2.18 in chips) 
Seat 9: Tenorio422 ($3.68 in chips) 
Kuinnq: posts small blind $0.01
N1ceGuyEddy: posts big blind $0.02
*** HOLE CARDS ***
Dealt to Dorex2007 [Qh 4h]
Dorex2007: folds 
JPimp2323: folds 
vikingoyabeja: calls $0.02
Kuljok1: calls $0.02
Tenorio422: folds 
Kuinnq: folds 
N1ceGuyEddy: checks 
*** FLOP *** [2s 9c 5s]
N1ceGuyEddy: checks 
vikingoyabeja: checks 
Kuljok1: checks 
*** TURN *** [2s 9c 5s] [2d]
N1ceGuyEddy: checks 
vikingoyabeja: checks 
Kuljok1: checks 
*** RIVER *** [2s 9c 5s 2d] [Kc]
N1ceGuyEddy: checks 
vikingoyabeja: checks 
Kuljok1: checks 
*** SHOW DOWN ***
N1ceGuyEddy: shows [Jc Qc] (a pair of Deuces)
vikingoyabeja: shows [Ad 3c] (a pair of Deuces - Ace kicker)
Kuljok1: mucks hand 
vikingoyabeja collected $0.07 from pot
*** SUMMARY ***
Total pot $0.07 | Rake $0 
Board [2s 9c 5s 2d Kc]
Seat 1: Kuinnq (small blind) folded before Flop
Seat 2: N1ceGuyEddy (big blind) showed [Jc Qc] and lost with a pair of Deuces
Seat 3: Dorex2007 folded before Flop (didn't bet)
Seat 4: JPimp2323 folded before Flop (didn't bet)
Seat 5: vikingoyabeja showed [Ad 3c] and won ($0.07) with a pair of Deuces
Seat 8: Kuljok1 mucked [Tc 8d]
Seat 9: Tenorio422 (button) folded before Flop (didn't bet)



PokerStars Hand #232112788244:  Hold'em No Limit ($0.01/$0.02 USD) - 2021/12/10 16:28:23 PT [2021/12/10 19:28:23 ET]
Table 'Kressida II' 9-max Seat #1 is the button
Seat 1: Kuinnq ($0.89 in chips) 
Seat 2: N1ceGuyEddy ($2.14 in chips) 
Seat 3: Dorex2007 ($2.28 in chips) 
Seat 4: JPimp2323 ($5.61 in chips) 
Seat 5: vikingoyabeja ($1.34 in chips) 
Seat 8: Kuljok1 ($2.16 in chips) 
Seat 9: Tenorio422 ($3.68 in chips) 
N1ceGuyEddy: posts small blind $0.01
Dorex2007: posts big blind $0.02
JoPeBe: sits out 
*** HOLE CARDS ***
Dealt to Dorex2007 [Qd 4c]
JPimp2323: folds 
vikingoyabeja: calls $0.02
Kuljok1: folds 
Tenorio422: folds 
Kuinnq: raises $0.04 to $0.06
N1ceGuyEddy: folds 
Dorex2007: folds 
vikingoyabeja: calls $0.04
*** FLOP *** [3d Kc 2d]
vikingoyabeja: checks 
Kuinnq: checks 
*** TURN *** [3d Kc 2d] [9h]
vikingoyabeja: bets $0.02
Kuinnq: calls $0.02
*** RIVER *** [3d Kc 2d 9h] [Jc]
vikingoyabeja: bets $0.22
Kuinnq: calls $0.22
*** SHOW DOWN ***
vikingoyabeja: shows [Kd 8h] (a pair of Kings)
Kuinnq: mucks hand 
vikingoyabeja collected $0.61 from pot
*** SUMMARY ***
Total pot $0.63 | Rake $0.02 
Board [3d Kc 2d 9h Jc]
Seat 1: Kuinnq (button) mucked [Ad Qh]
Seat 2: N1ceGuyEddy (small blind) folded before Flop
Seat 3: Dorex2007 (big blind) folded before Flop
Seat 4: JPimp2323 folded before Flop (didn't bet)
Seat 5: vikingoyabeja showed [Kd 8h] and won ($0.61) with a pair of Kings
Seat 8: Kuljok1 folded before Flop (didn't bet)
Seat 9: Tenorio422 folded before Flop (didn't bet)



PokerStars Hand #232112802241:  Hold'em No Limit ($0.01/$0.02 USD) - 2021/12/10 16:29:05 PT [2021/12/10 19:29:05 ET]
Table 'Kressida II' 9-max Seat #2 is the button
Seat 1: Kuinnq ($0.59 in chips) 
Seat 2: N1ceGuyEddy ($2.13 in chips) 
Seat 3: Dorex2007 ($2.26 in chips) 
Seat 5: vikingoyabeja ($1.65 in chips) 
Seat 6: JoPeBe ($1.98 in chips) 
Seat 8: Kuljok1 ($2.16 in chips) 
Seat 9: Tenorio422 ($3.68 in chips) 
Dorex2007: posts small blind $0.01
JPimp2323: is sitting out 
vikingoyabeja: posts big blind $0.02
JoPeBe: posts small & big blinds $0.03
*** HOLE CARDS ***
Dealt to Dorex2007 [Qh 5h]
JoPeBe: checks 
Kuljok1: calls $0.02
Tenorio422: folds 
Kuinnq: folds 
N1ceGuyEddy: folds 
Dorex2007: folds 
vikingoyabeja: checks 
*** FLOP *** [6h 8d 2h]
JPimp2323 leaves the table
vikingoyabeja: checks 
JoPeBe: bets $0.06
Kuljok1: folds 
vikingoyabeja: calls $0.06
*** TURN *** [6h 8d 2h] [5d]
vikingoyabeja: checks 
JoPeBe: bets $0.06
vikingoyabeja: folds 
Uncalled bet ($0.06) returned to JoPeBe
JoPeBe collected $0.19 from pot
JoPeBe: doesn't show hand 
*** SUMMARY ***
Total pot $0.20 | Rake $0.01 
Board [6h 8d 2h 5d]
Seat 1: Kuinnq folded before Flop (didn't bet)
Seat 2: N1ceGuyEddy (button) folded before Flop (didn't bet)
Seat 3: Dorex2007 (small blind) folded before Flop
Seat 5: vikingoyabeja (big blind) folded on the Turn
Seat 6: JoPeBe collected ($0.19)
Seat 8: Kuljok1 folded on the Flop
Seat 9: Tenorio422 folded before Flop (didn't bet)



PokerStars Hand #232112814053:  Hold'em No Limit ($0.01/$0.02 USD) - 2021/12/10 16:29:40 PT [2021/12/10 19:29:40 ET]
Table 'Kressida II' 9-max Seat #3 is the button
Seat 1: Kuinnq ($0.59 in chips) 
Seat 2: N1ceGuyEddy ($2.13 in chips) 
Seat 3: Dorex2007 ($2.25 in chips) 
Seat 5: vikingoyabeja ($1.57 in chips) 
Seat 6: JoPeBe ($2.08 in chips) 
Seat 8: Kuljok1 ($2.14 in chips) 
Seat 9: Tenorio422 ($3.68 in chips) 
vikingoyabeja: posts small blind $0.01
JoPeBe: posts big blind $0.02
*** HOLE CARDS ***
Dealt to Dorex2007 [4h 8c]
Kuljok1: folds 
Tenorio422: folds 
Kuinnq: folds 
N1ceGuyEddy has timed out
N1ceGuyEddy: folds 
Dorex2007: folds 
vikingoyabeja: calls $0.01
JoPeBe: checks 
*** FLOP *** [Ad 8h 9c]
vikingoyabeja: checks 
JoPeBe: checks 
*** TURN *** [Ad 8h 9c] [2d]
vikingoyabeja: checks 
JoPeBe: checks 
*** RIVER *** [Ad 8h 9c 2d] [Ks]
vikingoyabeja: checks 
JoPeBe: checks 
*** SHOW DOWN ***
vikingoyabeja: shows [5d 7d] (high card Ace)
JoPeBe: shows [6d 9d] (a pair of Nines)
JoPeBe collected $0.04 from pot
*** SUMMARY ***
Total pot $0.04 | Rake $0 
Board [Ad 8h 9c 2d Ks]
Seat 1: Kuinnq folded before Flop (didn't bet)
Seat 2: N1ceGuyEddy folded before Flop (didn't bet)
Seat 3: Dorex2007 (button) folded before Flop (didn't bet)
Seat 5: vikingoyabeja (small blind) showed [5d 7d] and lost with high card Ace
Seat 6: JoPeBe (big blind) showed [6d 9d] and won ($0.04) with a pair of Nines
Seat 8: Kuljok1 folded before Flop (didn't bet)
Seat 9: Tenorio422 folded before Flop (didn't bet)



PokerStars Hand #232112829177:  Hold'em No Limit ($0.01/$0.02 USD) - 2021/12/10 16:30:26 PT [2021/12/10 19:30:26 ET]
Table 'Kressida II' 9-max Seat #5 is the button
Seat 1: Kuinnq ($0.59 in chips) 
Seat 2: N1ceGuyEddy ($2.13 in chips) 
Seat 3: Dorex2007 ($2.25 in chips) 
Seat 5: vikingoyabeja ($1.55 in chips) 
Seat 6: JoPeBe ($2.10 in chips) 
Seat 8: Kuljok1 ($2.14 in chips) 
Seat 9: Tenorio422 ($3.68 in chips) 
JoPeBe: posts small blind $0.01
Kuljok1: posts big blind $0.02
*** HOLE CARDS ***
Dealt to Dorex2007 [2d Qd]
Tenorio422: raises $0.04 to $0.06
Kuinnq: folds 
N1ceGuyEddy: calls $0.06
Dorex2007: folds 
vikingoyabeja: folds 
JoPeBe: folds 
Kuljok1: calls $0.04
*** FLOP *** [Td Tc 7d]
vikingoyabeja leaves the table
Kuljok1: checks 
Tenorio422: bets $0.09
N1ceGuyEddy: calls $0.09
Kuljok1: folds 
*** TURN *** [Td Tc 7d] [Js]
Tenorio422: checks 
N1ceGuyEddy: checks 
*** RIVER *** [Td Tc 7d Js] [7c]
Tenorio422: checks 
N1ceGuyEddy: checks 
*** SHOW DOWN ***
Tenorio422: shows [7s 6s] (a full house, Sevens full of Tens)
N1ceGuyEddy: mucks hand 
Tenorio422 collected $0.36 from pot
*** SUMMARY ***
Total pot $0.37 | Rake $0.01 
Board [Td Tc 7d Js 7c]
Seat 1: Kuinnq folded before Flop (didn't bet)
Seat 2: N1ceGuyEddy mucked [3s 3c]
Seat 3: Dorex2007 folded before Flop (didn't bet)
Seat 5: vikingoyabeja (button) folded before Flop (didn't bet)
Seat 6: JoPeBe (small blind) folded before Flop
Seat 8: Kuljok1 (big blind) folded on the Flop
Seat 9: Tenorio422 showed [7s 6s] and won ($0.36) with a full house, Sevens full of Tens



PokerStars Hand #232112847430:  Hold'em No Limit ($0.01/$0.02 USD) - 2021/12/10 16:31:21 PT [2021/12/10 19:31:21 ET]
Table 'Kressida II' 9-max Seat #6 is the button
Seat 1: Kuinnq ($0.59 in chips) 
Seat 2: N1ceGuyEddy ($1.98 in chips) 
Seat 3: Dorex2007 ($2.25 in chips) 
Seat 6: JoPeBe ($2.09 in chips) 
Seat 8: Kuljok1 ($2.08 in chips) 
Seat 9: Tenorio422 ($3.89 in chips) 
Kuljok1: posts small blind $0.01
Tenorio422: posts big blind $0.02
*** HOLE CARDS ***
Dealt to Dorex2007 [7c 5h]
S0neidos joins the table at seat #4 
Kuinnq: raises $0.02 to $0.04
N1ceGuyEddy: folds 
Dorex2007: folds 
JoPeBe: calls $0.04
Kuljok1: folds 
Tenorio422: calls $0.02
*** FLOP *** [Kd 4s 8d]
Tenorio422: checks 
Kuinnq: checks 
JoPeBe: bets $0.06
Tenorio422: calls $0.06
Kuinnq: folds 
*** TURN *** [Kd 4s 8d] [7h]
Tenorio422: checks 
rtzghr joins the table at seat #5 
JoPeBe: bets $0.06
Tenorio422: calls $0.06
*** RIVER *** [Kd 4s 8d 7h] [5c]
Tenorio422: checks 
JoPeBe: checks 
*** SHOW DOWN ***
Tenorio422: shows [Jc Kc] (a pair of Kings)
JoPeBe: shows [Ah Ks] (a pair of Kings - Ace kicker)
JoPeBe collected $0.36 from pot
*** SUMMARY ***
Total pot $0.37 | Rake $0.01 
Board [Kd 4s 8d 7h 5c]
Seat 1: Kuinnq folded on the Flop
Seat 2: N1ceGuyEddy folded before Flop (didn't bet)
Seat 3: Dorex2007 folded before Flop (didn't bet)
Seat 6: JoPeBe (button) showed [Ah Ks] and won ($0.36) with a pair of Kings
Seat 8: Kuljok1 (small blind) folded before Flop
Seat 9: Tenorio422 (big blind) showed [Jc Kc] and lost with a pair of Kings



PokerStars Hand #232112862651:  Hold'em No Limit ($0.01/$0.02 USD) - 2021/12/10 16:32:07 PT [2021/12/10 19:32:07 ET]
Table 'Kressida II' 9-max Seat #8 is the button
Seat 1: Kuinnq ($0.55 in chips) 
Seat 2: N1ceGuyEddy ($1.98 in chips) 
Seat 3: Dorex2007 ($2.25 in chips) 
Seat 4: S0neidos ($1.60 in chips) 
Seat 5: rtzghr ($0.83 in chips) 
Seat 6: JoPeBe ($2.29 in chips) 
Seat 8: Kuljok1 ($2.07 in chips) 
Seat 9: Tenorio422 ($3.73 in chips) 
Tenorio422: posts small blind $0.01
Kuinnq: posts big blind $0.02
S0neidos: posts big blind $0.02
rtzghr: posts big blind $0.02
*** HOLE CARDS ***
Dealt to Dorex2007 [9d 5c]
N1ceGuyEddy: folds 
Dorex2007: folds 
S0neidos: checks 
rtzghr: checks 
JoPeBe: calls $0.02
Kuljok1: calls $0.02
Tenorio422: folds 
Kuinnq: checks 
*** FLOP *** [8d 2d 6d]
Kuinnq: checks 
S0neidos: checks 
rtzghr: checks 
JoPeBe: checks 
Kuljok1: checks 
*** TURN *** [8d 2d 6d] [5d]
Kuinnq: checks 
S0neidos: bets $0.06
rtzghr: folds 
JoPeBe: folds 
Kuljok1: calls $0.06
Kuinnq: folds 
*** RIVER *** [8d 2d 6d 5d] [Ah]
S0neidos: bets $0.10
Kuljok1: raises $0.42 to $0.52
S0neidos: calls $0.42
*** SHOW DOWN ***
Kuljok1: shows [Ad 7c] (a flush, Ace high)
S0neidos: mucks hand 
Kuljok1 collected $1.23 from pot
*** SUMMARY ***
Total pot $1.27 | Rake $0.04 
Board [8d 2d 6d 5d Ah]
Seat 1: Kuinnq (big blind) folded on the Turn
Seat 2: N1ceGuyEddy folded before Flop (didn't bet)
Seat 3: Dorex2007 folded before Flop (didn't bet)
Seat 4: S0neidos mucked [6s Jd]
Seat 5: rtzghr folded on the Turn (didn't bet)
Seat 6: JoPeBe folded on the Turn
Seat 8: Kuljok1 (button) showed [Ad 7c] and won ($1.23) with a flush, Ace high
Seat 9: Tenorio422 (small blind) folded before Flop



PokerStars Hand #232112892907:  Hold'em No Limit ($0.01/$0.02 USD) - 2021/12/10 16:33:40 PT [2021/12/10 19:33:40 ET]
Table 'Kressida II' 9-max Seat #9 is the button
Seat 1: Kuinnq ($0.53 in chips) 
Seat 2: N1ceGuyEddy ($1.98 in chips) 
Seat 3: Dorex2007 ($2.25 in chips) 
Seat 4: S0neidos ($1 in chips) 
Seat 5: rtzghr ($0.81 in chips) 
Seat 6: JoPeBe ($2.27 in chips) 
Seat 8: Kuljok1 ($2.70 in chips) 
Seat 9: Tenorio422 ($3.72 in chips) 
Kuinnq: posts small blind $0.01
N1ceGuyEddy: posts big blind $0.02
*** HOLE CARDS ***
Dealt to Dorex2007 [3s 7c]
Dorex2007: folds 
S0neidos: calls $0.02
rtzghr: folds 
JoPeBe: folds 
Kuljok1: calls $0.02
Tenorio422: raises $0.16 to $0.18
Kuinnq: raises $0.34 to $0.52
N1ceGuyEddy: folds 
S0neidos: folds 
Kuljok1: folds 
Tenorio422: raises $0.34 to $0.86
Kuinnq: calls $0.01 and is all-in
Uncalled bet ($0.33) returned to Tenorio422
*** FLOP *** [Th 3h Kc]
*** TURN *** [Th 3h Kc] [Jh]
*** RIVER *** [Th 3h Kc Jh] [Kd]
*** SHOW DOWN ***
Kuinnq: shows [5h 5d] (two pair, Kings and Fives)
Tenorio422: shows [Ac Ks] (three of a kind, Kings)
Tenorio422 collected $1.08 from pot
*** SUMMARY ***
Total pot $1.12 | Rake $0.04 
Board [Th 3h Kc Jh Kd]
Seat 1: Kuinnq (small blind) showed [5h 5d] and lost with two pair, Kings and Fives
Seat 2: N1ceGuyEddy (big blind) folded before Flop
Seat 3: Dorex2007 folded before Flop (didn't bet)
Seat 4: S0neidos folded before Flop
Seat 5: rtzghr folded before Flop (didn't bet)
Seat 6: JoPeBe folded before Flop (didn't bet)
Seat 8: Kuljok1 folded before Flop
Seat 9: Tenorio422 (button) showed [Ac Ks] and won ($1.08) with three of a kind, Kings



