PokerStars Hand #228334318034:  Hold'em No Limit ($0.01/$0.02 USD) - 2021/07/16 10:04:14 PT [2021/07/16 13:04:14 ET]
Table 'Sorga' 9-max Seat #2 is the button
Seat 2: Ooptimax ($3.55 in chips) 
Seat 3: Nejcek89 ($1.64 in chips) 
Seat 4: mattahario ($0.85 in chips) 
Seat 6: Dorex2007 ($2.08 in chips) 
Seat 7: fuckallu69 ($2.12 in chips) 
Seat 8: 1AUE ($0.76 in chips) 
Nejcek89: posts small blind $0.01
mattahario: posts big blind $0.02
pikasiki: sits out 
Dorex2007: posts big blind $0.02
LuisZeifer: sits out 
*** HOLE CARDS ***
Dealt to Dorex2007 [Th Ah]
Dorex2007: raises $0.04 to $0.06
fuckallu69: raises $0.04 to $0.10
1AUE: folds 
Ooptimax: folds 
Nejcek89: folds 
mattahario: folds 
Dorex2007: calls $0.04
*** FLOP *** [Jc 9s Qh]
Dorex2007: checks 
fuckallu69: bets $0.11
Dorex2007: calls $0.11
*** TURN *** [Jc 9s Qh] [5c]
Dorex2007: checks 
fuckallu69: bets $0.14
Dorex2007: calls $0.14
*** RIVER *** [Jc 9s Qh 5c] [2c]
Dorex2007: bets $0.35
fuckallu69: calls $0.35
*** SHOW DOWN ***
Dorex2007: shows [Th Ah] (high card Ace)
fuckallu69: shows [9h 8c] (a pair of Nines)
fuckallu69 collected $1.38 from pot
*** SUMMARY ***
Total pot $1.43 | Rake $0.05 
Board [Jc 9s Qh 5c 2c]
Seat 2: Ooptimax (button) folded before Flop (didn't bet)
Seat 3: Nejcek89 (small blind) folded before Flop
Seat 4: mattahario (big blind) folded before Flop
Seat 6: Dorex2007 showed [Th Ah] and lost with high card Ace
Seat 7: fuckallu69 showed [9h 8c] and won ($1.38) with a pair of Nines
Seat 8: 1AUE folded before Flop (didn't bet)



PokerStars Hand #228334343027:  Hold'em No Limit ($0.01/$0.02 USD) - 2021/07/16 10:05:17 PT [2021/07/16 13:05:17 ET]
Table 'Sorga' 9-max Seat #3 is the button
Seat 2: Ooptimax ($3.55 in chips) 
Seat 3: Nejcek89 ($1.63 in chips) 
Seat 4: mattahario ($0.85 in chips) 
Seat 5: pikasiki ($2.12 in chips) 
Seat 6: Dorex2007 ($1.38 in chips) 
Seat 7: fuckallu69 ($2.80 in chips) 
Seat 8: 1AUE ($0.76 in chips) 
mattahario: posts small blind $0.01
pikasiki: posts big blind $0.02
LuisZeifer: sits out 
*** HOLE CARDS ***
Dealt to Dorex2007 [3d 9h]
Dorex2007: folds 
fuckallu69: folds 
1AUE: folds 
Ooptimax: folds 
Nejcek89: raises $0.04 to $0.06
mattahario: folds 
pikasiki: calls $0.04
*** FLOP *** [Ks 3h 8d]
pikasiki: checks 
Nejcek89: checks 
*** TURN *** [Ks 3h 8d] [3c]
pikasiki: checks 
Nejcek89: checks 
*** RIVER *** [Ks 3h 8d 3c] [6c]
pikasiki: checks 
Nejcek89: checks 
*** SHOW DOWN ***
pikasiki: shows [Qd Ac] (a pair of Threes)
Nejcek89: shows [Jd Jc] (two pair, Jacks and Threes)
Nejcek89 collected $0.13 from pot
*** SUMMARY ***
Total pot $0.13 | Rake $0 
Board [Ks 3h 8d 3c 6c]
Seat 2: Ooptimax folded before Flop (didn't bet)
Seat 3: Nejcek89 (button) showed [Jd Jc] and won ($0.13) with two pair, Jacks and Threes
Seat 4: mattahario (small blind) folded before Flop
Seat 5: pikasiki (big blind) showed [Qd Ac] and lost with a pair of Threes
Seat 6: Dorex2007 folded before Flop (didn't bet)
Seat 7: fuckallu69 folded before Flop (didn't bet)
Seat 8: 1AUE folded before Flop (didn't bet)



PokerStars Hand #228334372307:  Hold'em No Limit ($0.01/$0.02 USD) - 2021/07/16 10:06:32 PT [2021/07/16 13:06:32 ET]
Table 'Sorga' 9-max Seat #4 is the button
Seat 2: Ooptimax ($3.55 in chips) 
Seat 3: Nejcek89 ($1.70 in chips) 
Seat 4: mattahario ($0.85 in chips) 
Seat 5: pikasiki ($2.06 in chips) 
Seat 6: Dorex2007 ($2 in chips) 
Seat 7: fuckallu69 ($2.80 in chips) 
Seat 8: 1AUE ($0.76 in chips) 
pikasiki: posts small blind $0.01
Dorex2007: posts big blind $0.02
LuisZeifer: sits out 
*** HOLE CARDS ***
Dealt to Dorex2007 [6d 7d]
fuckallu69: folds 
1AUE: folds 
Ooptimax: folds 
Nejcek89: folds 
mattahario: folds 
pikasiki: folds 
Uncalled bet ($0.01) returned to Dorex2007
Dorex2007 collected $0.02 from pot
Dorex2007: doesn't show hand 
*** SUMMARY ***
Total pot $0.02 | Rake $0 
Seat 2: Ooptimax folded before Flop (didn't bet)
Seat 3: Nejcek89 folded before Flop (didn't bet)
Seat 4: mattahario (button) folded before Flop (didn't bet)
Seat 5: pikasiki (small blind) folded before Flop
Seat 6: Dorex2007 (big blind) collected ($0.02)
Seat 7: fuckallu69 folded before Flop (didn't bet)
Seat 8: 1AUE folded before Flop (didn't bet)



PokerStars Hand #228334382034:  Hold'em No Limit ($0.01/$0.02 USD) - 2021/07/16 10:06:57 PT [2021/07/16 13:06:57 ET]
Table 'Sorga' 9-max Seat #5 is the button
Seat 2: Ooptimax ($3.55 in chips) 
Seat 3: Nejcek89 ($1.70 in chips) 
Seat 4: mattahario ($0.85 in chips) 
Seat 5: pikasiki ($2.05 in chips) 
Seat 6: Dorex2007 ($2.01 in chips) 
Seat 7: fuckallu69 ($2.80 in chips) 
Seat 8: 1AUE ($0.76 in chips) 
Dorex2007: posts small blind $0.01
fuckallu69: posts big blind $0.02
LuisZeifer: sits out 
*** HOLE CARDS ***
Dealt to Dorex2007 [As 8c]
1AUE: folds 
Ooptimax: folds 
Nejcek89: folds 
mattahario: folds 
pikasiki: calls $0.02
Dorex2007: calls $0.01
fuckallu69: raises $0.02 to $0.04
pikasiki: calls $0.02
Dorex2007: calls $0.02
*** FLOP *** [7d Ks 3d]
Dorex2007: checks 
fuckallu69: bets $0.02
pikasiki: raises $1.99 to $2.01 and is all-in
Dorex2007: folds 
fuckallu69: folds 
Uncalled bet ($1.99) returned to pikasiki
pikasiki collected $0.15 from pot
pikasiki: doesn't show hand 
*** SUMMARY ***
Total pot $0.16 | Rake $0.01 
Board [7d Ks 3d]
Seat 2: Ooptimax folded before Flop (didn't bet)
Seat 3: Nejcek89 folded before Flop (didn't bet)
Seat 4: mattahario folded before Flop (didn't bet)
Seat 5: pikasiki (button) collected ($0.15)
Seat 6: Dorex2007 (small blind) folded on the Flop
Seat 7: fuckallu69 (big blind) folded on the Flop
Seat 8: 1AUE folded before Flop (didn't bet)



PokerStars Hand #228334567454:  Hold'em No Limit ($0.01/$0.02 USD) - 2021/07/16 10:14:49 PT [2021/07/16 13:14:49 ET]
Table 'Sorga' 9-max Seat #9 is the button
Seat 1: rashidmoo ($1.90 in chips) 
Seat 2: Ooptimax ($3.41 in chips) 
Seat 3: Nejcek89 ($1.63 in chips) 
Seat 4: mattahario ($0.91 in chips) 
Seat 5: pikasiki ($2.21 in chips) 
Seat 6: Dorex2007 ($1.97 in chips) 
Seat 9: LuisZeifer ($1.45 in chips) 
rashidmoo: posts small blind $0.01
Ooptimax: posts big blind $0.02
Dorex2007: posts small & big blinds $0.03
*** HOLE CARDS ***
Dealt to Dorex2007 [3h 7d]
Nejcek89: calls $0.02
mattahario: folds 
pikasiki: calls $0.02
Dorex2007: checks 
LuisZeifer: folds 
rashidmoo: raises $0.10 to $0.12
Ooptimax: folds 
Nejcek89: folds 
pikasiki: folds 
Dorex2007: folds 
Uncalled bet ($0.10) returned to rashidmoo
rashidmoo collected $0.11 from pot
rashidmoo: doesn't show hand 
*** SUMMARY ***
Total pot $0.11 | Rake $0 
Seat 1: rashidmoo (small blind) collected ($0.11)
Seat 2: Ooptimax (big blind) folded before Flop
Seat 3: Nejcek89 folded before Flop
Seat 4: mattahario folded before Flop (didn't bet)
Seat 5: pikasiki folded before Flop
Seat 6: Dorex2007 folded before Flop (didn't bet)
Seat 9: LuisZeifer (button) folded before Flop (didn't bet)



PokerStars Hand #228334587206:  Hold'em No Limit ($0.01/$0.02 USD) - 2021/07/16 10:15:39 PT [2021/07/16 13:15:39 ET]
Table 'Sorga' 9-max Seat #1 is the button
Seat 1: rashidmoo ($1.99 in chips) 
Seat 2: Ooptimax ($3.39 in chips) 
Seat 3: Nejcek89 ($1.61 in chips) 
Seat 4: mattahario ($0.91 in chips) 
Seat 5: pikasiki ($2.19 in chips) 
Seat 6: Dorex2007 ($1.94 in chips) 
Seat 7: fuckallu69 ($2.87 in chips) 
Seat 9: LuisZeifer ($1.45 in chips) 
Ooptimax: posts small blind $0.01
Nejcek89: posts big blind $0.02
fuckallu69: posts small & big blinds $0.03
*** HOLE CARDS ***
Dealt to Dorex2007 [4s 2s]
mattahario: calls $0.02
pikasiki: calls $0.02
Dorex2007: folds 
fuckallu69: checks 
LuisZeifer: folds 
rashidmoo: folds 
Ooptimax: folds 
Nejcek89: checks 
*** FLOP *** [Kd 6d 3h]
Nejcek89: checks 
mattahario: checks 
pikasiki: bets $0.10
fuckallu69: folds 
Nejcek89: folds 
mattahario: calls $0.10
*** TURN *** [Kd 6d 3h] [4c]
mattahario: bets $0.06
pikasiki: calls $0.06
*** RIVER *** [Kd 6d 3h 4c] [Js]
mattahario: checks 
pikasiki: checks 
*** SHOW DOWN ***
mattahario: shows [Jd Qd] (a pair of Jacks)
pikasiki: shows [Ad Ks] (a pair of Kings)
pikasiki collected $0.41 from pot
*** SUMMARY ***
Total pot $0.42 | Rake $0.01 
Board [Kd 6d 3h 4c Js]
Seat 1: rashidmoo (button) folded before Flop (didn't bet)
Seat 2: Ooptimax (small blind) folded before Flop
Seat 3: Nejcek89 (big blind) folded on the Flop
Seat 4: mattahario showed [Jd Qd] and lost with a pair of Jacks
Seat 5: pikasiki showed [Ad Ks] and won ($0.41) with a pair of Kings
Seat 6: Dorex2007 folded before Flop (didn't bet)
Seat 7: fuckallu69 folded on the Flop (didn't bet)
Seat 9: LuisZeifer folded before Flop (didn't bet)



PokerStars Hand #228334622716:  Hold'em No Limit ($0.01/$0.02 USD) - 2021/07/16 10:16:46 PT [2021/07/16 13:16:46 ET]
Table 'Sorga' 9-max Seat #2 is the button
Seat 1: rashidmoo ($1.99 in chips) 
Seat 2: Ooptimax ($3.38 in chips) 
Seat 3: Nejcek89 ($1.59 in chips) 
Seat 4: mattahario ($0.85 in chips) 
Seat 5: pikasiki ($2.42 in chips) 
Seat 6: Dorex2007 ($1.94 in chips) 
Seat 7: fuckallu69 ($2.84 in chips) 
Seat 9: LuisZeifer ($1.45 in chips) 
Nejcek89: posts small blind $0.01
mattahario: posts big blind $0.02
*** HOLE CARDS ***
Dealt to Dorex2007 [Jh Jc]
pikasiki: folds 
Dorex2007: raises $0.02 to $0.04
fuckallu69: raises $0.11 to $0.15
LuisZeifer: folds 
rashidmoo: folds 
Ooptimax: folds 
Nejcek89: folds 
mattahario: folds 
Dorex2007: calls $0.11
*** FLOP *** [Tc 9d 5d]
Dorex2007: bets $1.79 and is all-in
fuckallu69: calls $1.79
*** TURN *** [Tc 9d 5d] [2h]
*** RIVER *** [Tc 9d 5d 2h] [Td]
*** SHOW DOWN ***
Dorex2007: shows [Jh Jc] (two pair, Jacks and Tens)
fuckallu69: shows [8c Qd] (a pair of Tens)
Dorex2007 cashed out the hand for $2.89 | Cash Out Fee $0.03
*** SUMMARY ***
Total pot $3.91 | Rake $0.14 
Board [Tc 9d 5d 2h Td]
Seat 1: rashidmoo folded before Flop (didn't bet)
Seat 2: Ooptimax (button) folded before Flop (didn't bet)
Seat 3: Nejcek89 (small blind) folded before Flop
Seat 4: mattahario (big blind) folded before Flop
Seat 5: pikasiki folded before Flop (didn't bet)
Seat 6: Dorex2007 showed [Jh Jc] and won ($3.77) with two pair, Jacks and Tens (pot not awarded as player cashed out)
Seat 7: fuckallu69 showed [8c Qd] and lost with a pair of Tens
Seat 9: LuisZeifer folded before Flop (didn't bet)



PokerStars Hand #228334644641:  Hold'em No Limit ($0.01/$0.02 USD) - 2021/07/16 10:17:42 PT [2021/07/16 13:17:42 ET]
Table 'Sorga' 9-max Seat #3 is the button
Seat 1: rashidmoo ($1.99 in chips) 
Seat 2: Ooptimax ($3.38 in chips) 
Seat 3: Nejcek89 ($1.58 in chips) 
Seat 4: mattahario ($0.85 in chips) 
Seat 5: pikasiki ($2.42 in chips) 
Seat 6: Dorex2007 ($2.89 in chips) 
Seat 7: fuckallu69 ($0.90 in chips) 
Seat 9: LuisZeifer ($1.45 in chips) 
mattahario: posts small blind $0.01
pikasiki: posts big blind $0.02
*** HOLE CARDS ***
Dealt to Dorex2007 [3d 8c]
Dorex2007: folds 
fuckallu69: folds 
LuisZeifer: folds 
rashidmoo: folds 
Ooptimax: folds 
Nejcek89: folds 
Nejcek89 leaves the table
mattahario: folds 
Uncalled bet ($0.01) returned to pikasiki
pikasiki collected $0.02 from pot
pikasiki: doesn't show hand 
*** SUMMARY ***
Total pot $0.02 | Rake $0 
Seat 1: rashidmoo folded before Flop (didn't bet)
Seat 2: Ooptimax folded before Flop (didn't bet)
Seat 3: Nejcek89 (button) folded before Flop (didn't bet)
Seat 4: mattahario (small blind) folded before Flop
Seat 5: pikasiki (big blind) collected ($0.02)
Seat 6: Dorex2007 folded before Flop (didn't bet)
Seat 7: fuckallu69 folded before Flop (didn't bet)
Seat 9: LuisZeifer folded before Flop (didn't bet)



PokerStars Hand #228334654047:  Hold'em No Limit ($0.01/$0.02 USD) - 2021/07/16 10:18:05 PT [2021/07/16 13:18:05 ET]
Table 'Sorga' 9-max Seat #4 is the button
Seat 1: rashidmoo ($1.99 in chips) 
Seat 2: Ooptimax ($3.38 in chips) 
Seat 4: mattahario ($0.85 in chips) 
Seat 5: pikasiki ($2.43 in chips) 
Seat 6: Dorex2007 ($2.89 in chips) 
Seat 7: fuckallu69 ($0.90 in chips) 
Seat 9: LuisZeifer ($1.45 in chips) 
pikasiki: posts small blind $0.01
Dorex2007: posts big blind $0.02
*** HOLE CARDS ***
Dealt to Dorex2007 [9d 5s]
fuckallu69: folds 
LuisZeifer: raises $0.04 to $0.06
rashidmoo: folds 
Ooptimax: folds 
mattahario: folds 
pikasiki: folds 
Dorex2007: folds 
Uncalled bet ($0.04) returned to LuisZeifer
LuisZeifer collected $0.05 from pot
*** SUMMARY ***
Total pot $0.05 | Rake $0 
Seat 1: rashidmoo folded before Flop (didn't bet)
Seat 2: Ooptimax folded before Flop (didn't bet)
Seat 4: mattahario (button) folded before Flop (didn't bet)
Seat 5: pikasiki (small blind) folded before Flop
Seat 6: Dorex2007 (big blind) folded before Flop
Seat 7: fuckallu69 folded before Flop (didn't bet)
Seat 9: LuisZeifer collected ($0.05)



PokerStars Hand #228334664410:  Hold'em No Limit ($0.01/$0.02 USD) - 2021/07/16 10:18:31 PT [2021/07/16 13:18:31 ET]
Table 'Sorga' 9-max Seat #5 is the button
Seat 1: rashidmoo ($1.99 in chips) 
Seat 2: Ooptimax ($3.38 in chips) 
Seat 4: mattahario ($0.85 in chips) 
Seat 5: pikasiki ($2.42 in chips) 
Seat 6: Dorex2007 ($2.87 in chips) 
Seat 7: fuckallu69 ($0.90 in chips) 
Seat 9: LuisZeifer ($1.48 in chips) 
Dorex2007: posts small blind $0.01
fuckallu69: posts big blind $0.02
*** HOLE CARDS ***
Dealt to Dorex2007 [Qs 7h]
LuisZeifer: folds 
rashidmoo: folds 
Ooptimax: folds 
mattahario: folds 
pikasiki: calls $0.02
Dorex2007: folds 
fuckallu69: checks 
*** FLOP *** [8h 2h 3s]
nl_kmas joins the table at seat #3 
fuckallu69: bets $0.02
pikasiki: folds 
Uncalled bet ($0.02) returned to fuckallu69
fuckallu69 collected $0.05 from pot
fuckallu69: doesn't show hand 
*** SUMMARY ***
Total pot $0.05 | Rake $0 
Board [8h 2h 3s]
Seat 1: rashidmoo folded before Flop (didn't bet)
Seat 2: Ooptimax folded before Flop (didn't bet)
Seat 4: mattahario folded before Flop (didn't bet)
Seat 5: pikasiki (button) folded on the Flop
Seat 6: Dorex2007 (small blind) folded before Flop
Seat 7: fuckallu69 (big blind) collected ($0.05)
Seat 9: LuisZeifer folded before Flop (didn't bet)



PokerStars Hand #228334676476:  Hold'em No Limit ($0.01/$0.02 USD) - 2021/07/16 10:19:02 PT [2021/07/16 13:19:02 ET]
Table 'Sorga' 9-max Seat #6 is the button
Seat 1: rashidmoo ($1.99 in chips) 
Seat 2: Ooptimax ($3.38 in chips) 
Seat 4: mattahario ($0.85 in chips) 
Seat 5: pikasiki ($2.40 in chips) 
Seat 6: Dorex2007 ($2.86 in chips) 
Seat 7: fuckallu69 ($0.93 in chips) 
Seat 9: LuisZeifer ($1.48 in chips) 
fuckallu69: posts small blind $0.01
LuisZeifer: posts big blind $0.02
nl_kmas: sits out 
*** HOLE CARDS ***
Dealt to Dorex2007 [4s 8s]
rashidmoo: folds 
Ooptimax: folds 
mattahario: folds 
pikasiki: folds 
Dorex2007: folds 
fuckallu69: raises $0.04 to $0.06
LuisZeifer: calls $0.04
*** FLOP *** [Ah Td 8h]
fuckallu69: bets $0.12
LuisZeifer: folds 
Uncalled bet ($0.12) returned to fuckallu69
fuckallu69 collected $0.12 from pot
fuckallu69: doesn't show hand 
*** SUMMARY ***
Total pot $0.12 | Rake $0 
Board [Ah Td 8h]
Seat 1: rashidmoo folded before Flop (didn't bet)
Seat 2: Ooptimax folded before Flop (didn't bet)
Seat 4: mattahario folded before Flop (didn't bet)
Seat 5: pikasiki folded before Flop (didn't bet)
Seat 6: Dorex2007 (button) folded before Flop (didn't bet)
Seat 7: fuckallu69 (small blind) collected ($0.12)
Seat 9: LuisZeifer (big blind) folded on the Flop



PokerStars Hand #228334701372:  Hold'em No Limit ($0.01/$0.02 USD) - 2021/07/16 10:20:05 PT [2021/07/16 13:20:05 ET]
Table 'Sorga' 9-max Seat #7 is the button
Seat 1: rashidmoo ($1.99 in chips) 
Seat 2: Ooptimax ($3.38 in chips) 
Seat 3: nl_kmas ($1.60 in chips) 
Seat 4: mattahario ($0.85 in chips) 
Seat 5: pikasiki ($2.40 in chips) 
Seat 6: Dorex2007 ($2.86 in chips) 
Seat 7: fuckallu69 ($0.99 in chips) 
Seat 9: LuisZeifer ($1.42 in chips) 
LuisZeifer: posts small blind $0.01
rashidmoo: posts big blind $0.02
nl_kmas: posts big blind $0.02
*** HOLE CARDS ***
Dealt to Dorex2007 [Jd 3h]
Ooptimax: folds 
nl_kmas: raises $0.04 to $0.06
mattahario: folds 
pikasiki: folds 
Dorex2007: folds 
fuckallu69 has timed out
fuckallu69: folds 
LuisZeifer: folds 
rashidmoo: folds 
Uncalled bet ($0.04) returned to nl_kmas
nl_kmas collected $0.05 from pot
nl_kmas: doesn't show hand 
*** SUMMARY ***
Total pot $0.05 | Rake $0 
Seat 1: rashidmoo (big blind) folded before Flop
Seat 2: Ooptimax folded before Flop (didn't bet)
Seat 3: nl_kmas collected ($0.05)
Seat 4: mattahario folded before Flop (didn't bet)
Seat 5: pikasiki folded before Flop (didn't bet)
Seat 6: Dorex2007 folded before Flop (didn't bet)
Seat 7: fuckallu69 (button) folded before Flop (didn't bet)
Seat 9: LuisZeifer (small blind) folded before Flop



PokerStars Hand #228334715948:  Hold'em No Limit ($0.01/$0.02 USD) - 2021/07/16 10:20:42 PT [2021/07/16 13:20:42 ET]
Table 'Sorga' 9-max Seat #9 is the button
Seat 1: rashidmoo ($1.97 in chips) 
Seat 2: Ooptimax ($3.38 in chips) 
Seat 3: nl_kmas ($1.63 in chips) 
Seat 4: mattahario ($0.85 in chips) 
Seat 5: pikasiki ($2.40 in chips) 
Seat 6: Dorex2007 ($2.86 in chips) 
Seat 9: LuisZeifer ($1.41 in chips) 
rashidmoo: posts small blind $0.01
Ooptimax: posts big blind $0.02
*** HOLE CARDS ***
Dealt to Dorex2007 [Kh 8c]
nl_kmas: raises $0.08 to $0.10
mattahario: folds 
pikasiki: folds 
pikasiki leaves the table
Dorex2007: folds 
LuisZeifer: folds 
rashidmoo: calls $0.09
Ooptimax: folds 
*** FLOP *** [Td Qs Ts]
rashidmoo: bets $0.14
agonzalezelh joins the table at seat #5 
nl_kmas: calls $0.14
*** TURN *** [Td Qs Ts] [Qd]
rashidmoo: checks 
nl_kmas: bets $0.78
rashidmoo: folds 
Uncalled bet ($0.78) returned to nl_kmas
nl_kmas collected $0.48 from pot
nl_kmas: doesn't show hand 
*** SUMMARY ***
Total pot $0.50 | Rake $0.02 
Board [Td Qs Ts Qd]
Seat 1: rashidmoo (small blind) folded on the Turn
Seat 2: Ooptimax (big blind) folded before Flop
Seat 3: nl_kmas collected ($0.48)
Seat 4: mattahario folded before Flop (didn't bet)
Seat 5: pikasiki folded before Flop (didn't bet)
Seat 6: Dorex2007 folded before Flop (didn't bet)
Seat 9: LuisZeifer (button) folded before Flop (didn't bet)



PokerStars Hand #228334743391:  Hold'em No Limit ($0.01/$0.02 USD) - 2021/07/16 10:21:52 PT [2021/07/16 13:21:52 ET]
Table 'Sorga' 9-max Seat #1 is the button
Seat 1: rashidmoo ($1.73 in chips) 
Seat 2: Ooptimax ($3.36 in chips) 
Seat 3: nl_kmas ($1.87 in chips) 
Seat 4: mattahario ($0.85 in chips) 
Seat 6: Dorex2007 ($2.86 in chips) 
Seat 7: fuckallu69 ($0.99 in chips) 
Seat 9: LuisZeifer ($1.41 in chips) 
Ooptimax: posts small blind $0.01
nl_kmas: posts big blind $0.02
agonzalezelh: sits out 
*** HOLE CARDS ***
Dealt to Dorex2007 [9d 6h]
mattahario: folds 
Dorex2007 has timed out
Dorex2007: folds 
fuckallu69: calls $0.02
LuisZeifer: folds 
rashidmoo: raises $0.06 to $0.08
Ooptimax: folds 
nl_kmas: folds 
fuckallu69: calls $0.06
*** FLOP *** [2c 4h 6c]
fuckallu69: checks 
rashidmoo: bets $0.12
fuckallu69: calls $0.12
*** TURN *** [2c 4h 6c] [Ah]
fuckallu69: checks 
rashidmoo: bets $0.21
fuckallu69: folds 
Uncalled bet ($0.21) returned to rashidmoo
rashidmoo collected $0.41 from pot
rashidmoo: doesn't show hand 
*** SUMMARY ***
Total pot $0.43 | Rake $0.02 
Board [2c 4h 6c Ah]
Seat 1: rashidmoo (button) collected ($0.41)
Seat 2: Ooptimax (small blind) folded before Flop
Seat 3: nl_kmas (big blind) folded before Flop
Seat 4: mattahario folded before Flop (didn't bet)
Seat 6: Dorex2007 folded before Flop (didn't bet)
Seat 7: fuckallu69 folded on the Turn
Seat 9: LuisZeifer folded before Flop (didn't bet)



PokerStars Hand #228334763794:  Hold'em No Limit ($0.01/$0.02 USD) - 2021/07/16 10:22:44 PT [2021/07/16 13:22:44 ET]
Table 'Sorga' 9-max Seat #2 is the button
Seat 1: rashidmoo ($1.94 in chips) 
Seat 2: Ooptimax ($3.35 in chips) 
Seat 3: nl_kmas ($1.85 in chips) 
Seat 4: mattahario ($0.85 in chips) 
Seat 6: Dorex2007 ($2.86 in chips) 
Seat 7: fuckallu69 ($0.79 in chips) 
Seat 9: LuisZeifer ($1.41 in chips) 
nl_kmas: posts small blind $0.01
mattahario: posts big blind $0.02
agonzalezelh: sits out 
1AUE: sits out 
*** HOLE CARDS ***
Dealt to Dorex2007 [3d Ah]
Dorex2007: folds 
fuckallu69: folds 
LuisZeifer: folds 
rashidmoo: raises $0.04 to $0.06
Ooptimax: raises $0.12 to $0.18
nl_kmas: raises $0.12 to $0.30
mattahario: folds 
rashidmoo: folds 
Ooptimax: calls $0.12
*** FLOP *** [5h Kc 6s]
nl_kmas: bets $0.10
Ooptimax: calls $0.10
*** TURN *** [5h Kc 6s] [Qh]
nl_kmas: bets $0.42
Ooptimax: folds 
Uncalled bet ($0.42) returned to nl_kmas
nl_kmas collected $0.85 from pot
nl_kmas: doesn't show hand 
*** SUMMARY ***
Total pot $0.88 | Rake $0.03 
Board [5h Kc 6s Qh]
Seat 1: rashidmoo folded before Flop
Seat 2: Ooptimax (button) folded on the Turn
Seat 3: nl_kmas (small blind) collected ($0.85)
Seat 4: mattahario (big blind) folded before Flop
Seat 6: Dorex2007 folded before Flop (didn't bet)
Seat 7: fuckallu69 folded before Flop (didn't bet)
Seat 9: LuisZeifer folded before Flop (didn't bet)



PokerStars Hand #228334797523:  Hold'em No Limit ($0.01/$0.02 USD) - 2021/07/16 10:23:57 PT [2021/07/16 13:23:57 ET]
Table 'Sorga' 9-max Seat #3 is the button
Seat 1: rashidmoo ($1.88 in chips) 
Seat 2: Ooptimax ($2.95 in chips) 
Seat 3: nl_kmas ($2.30 in chips) 
Seat 4: mattahario ($0.85 in chips) 
Seat 5: agonzalezelh ($0.80 in chips) 
Seat 6: Dorex2007 ($2.86 in chips) 
Seat 7: fuckallu69 ($0.79 in chips) 
Seat 9: LuisZeifer ($1.41 in chips) 
mattahario: posts small blind $0.01
agonzalezelh: posts big blind $0.02
1AUE: sits out 
*** HOLE CARDS ***
Dealt to Dorex2007 [3s 9s]
Dorex2007: folds 
fuckallu69: folds 
LuisZeifer: folds 
rashidmoo: folds 
Ooptimax: raises $0.04 to $0.06
nl_kmas: calls $0.06
mattahario: folds 
agonzalezelh: folds 
*** FLOP *** [5h 2s 7d]
Ooptimax: checks 
nl_kmas: checks 
*** TURN *** [5h 2s 7d] [3d]
Ooptimax: checks 
nl_kmas: bets $0.14
Ooptimax: calls $0.14
*** RIVER *** [5h 2s 7d 3d] [6d]
Ooptimax: checks 
nl_kmas: bets $0.47
Ooptimax: raises $0.72 to $1.19
nl_kmas: calls $0.72
*** SHOW DOWN ***
Ooptimax: shows [Kc Ad] (high card Ace)
nl_kmas: shows [6h 8c] (a pair of Sixes)
nl_kmas collected $2.71 from pot
*** SUMMARY ***
Total pot $2.81 | Rake $0.10 
Board [5h 2s 7d 3d 6d]
Seat 1: rashidmoo folded before Flop (didn't bet)
Seat 2: Ooptimax showed [Kc Ad] and lost with high card Ace
Seat 3: nl_kmas (button) showed [6h 8c] and won ($2.71) with a pair of Sixes
Seat 4: mattahario (small blind) folded before Flop
Seat 5: agonzalezelh (big blind) folded before Flop
Seat 6: Dorex2007 folded before Flop (didn't bet)
Seat 7: fuckallu69 folded before Flop (didn't bet)
Seat 9: LuisZeifer folded before Flop (didn't bet)



PokerStars Hand #228334836429:  Hold'em No Limit ($0.01/$0.02 USD) - 2021/07/16 10:25:37 PT [2021/07/16 13:25:37 ET]
Table 'Sorga' 9-max Seat #4 is the button
Seat 1: rashidmoo ($1.88 in chips) 
Seat 2: Ooptimax ($2 in chips) 
Seat 3: nl_kmas ($3.62 in chips) 
Seat 4: mattahario ($0.85 in chips) 
Seat 5: agonzalezelh ($0.78 in chips) 
Seat 6: Dorex2007 ($2.86 in chips) 
Seat 7: fuckallu69 ($0.79 in chips) 
Seat 9: LuisZeifer ($1.41 in chips) 
agonzalezelh: posts small blind $0.01
Dorex2007: posts big blind $0.02
1AUE: sits out 
*** HOLE CARDS ***
Dealt to Dorex2007 [9c 2h]
fuckallu69: calls $0.02
LuisZeifer: folds 
rashidmoo: folds 
Ooptimax: raises $0.07 to $0.09
nl_kmas: calls $0.09
mattahario: folds 
agonzalezelh: folds 
Dorex2007: folds 
fuckallu69: calls $0.07
*** FLOP *** [8c 6d Td]
fuckallu69: bets $0.10
Ooptimax: folds 
nl_kmas: calls $0.10
*** TURN *** [8c 6d Td] [5h]
fuckallu69: bets $0.18
nl_kmas: calls $0.18
*** RIVER *** [8c 6d Td 5h] [Qd]
fuckallu69: bets $0.42 and is all-in
nl_kmas: calls $0.42
*** SHOW DOWN ***
fuckallu69: shows [Ks Ad] (high card Ace)
nl_kmas: shows [9h Js] (a straight, Eight to Queen)
nl_kmas collected $1.64 from pot
*** SUMMARY ***
Total pot $1.70 | Rake $0.06 
Board [8c 6d Td 5h Qd]
Seat 1: rashidmoo folded before Flop (didn't bet)
Seat 2: Ooptimax folded on the Flop
Seat 3: nl_kmas showed [9h Js] and won ($1.64) with a straight, Eight to Queen
Seat 4: mattahario (button) folded before Flop (didn't bet)
Seat 5: agonzalezelh (small blind) folded before Flop
Seat 6: Dorex2007 (big blind) folded before Flop
Seat 7: fuckallu69 showed [Ks Ad] and lost with high card Ace
Seat 9: LuisZeifer folded before Flop (didn't bet)



PokerStars Hand #228334874451:  Hold'em No Limit ($0.01/$0.02 USD) - 2021/07/16 10:27:03 PT [2021/07/16 13:27:03 ET]
Table 'Sorga' 9-max Seat #5 is the button
Seat 1: rashidmoo ($1.88 in chips) 
Seat 2: Ooptimax ($2 in chips) 
Seat 3: nl_kmas ($4.47 in chips) 
Seat 4: mattahario ($0.85 in chips) 
Seat 5: agonzalezelh ($0.77 in chips) 
Seat 6: Dorex2007 ($2.84 in chips) 
Seat 8: 1AUE ($0.75 in chips) 
Seat 9: LuisZeifer ($1.41 in chips) 
Dorex2007: posts small blind $0.01
1AUE: posts big blind $0.02
*** HOLE CARDS ***
Dealt to Dorex2007 [Qd 5c]
LuisZeifer: folds 
rashidmoo: folds 
fuckallu69 leaves the table
Ooptimax: folds 
nl_kmas: calls $0.02
mattahario: folds 
jgino14 joins the table at seat #7 
agonzalezelh: calls $0.02
Dorex2007: calls $0.01
1AUE has timed out
1AUE: checks 
*** FLOP *** [5h Qc 2d]
Dorex2007: checks 
1AUE: checks 
nl_kmas: bets $0.02
agonzalezelh: raises $0.02 to $0.04
Dorex2007: calls $0.04
1AUE: folds 
nl_kmas: calls $0.02
*** TURN *** [5h Qc 2d] [6d]
Dorex2007: checks 
nl_kmas: bets $0.02
agonzalezelh: raises $0.12 to $0.14
Dorex2007: calls $0.14
nl_kmas: calls $0.12
*** RIVER *** [5h Qc 2d 6d] [7h]
Dorex2007: checks 
nl_kmas: checks 
agonzalezelh: bets $0.30
Dorex2007: calls $0.30
1AUE is disconnected 
nl_kmas: calls $0.30
*** SHOW DOWN ***
agonzalezelh: shows [2h 2c] (three of a kind, Deuces)
Dorex2007: mucks hand 
nl_kmas: mucks hand 
agonzalezelh collected $1.47 from pot
*** SUMMARY ***
Total pot $1.52 | Rake $0.05 
Board [5h Qc 2d 6d 7h]
Seat 1: rashidmoo folded before Flop (didn't bet)
Seat 2: Ooptimax folded before Flop (didn't bet)
Seat 3: nl_kmas mucked [4s 6h]
Seat 4: mattahario folded before Flop (didn't bet)
Seat 5: agonzalezelh (button) showed [2h 2c] and won ($1.47) with three of a kind, Deuces
Seat 6: Dorex2007 (small blind) mucked [Qd 5c]
Seat 8: 1AUE (big blind) folded on the Flop
Seat 9: LuisZeifer folded before Flop (didn't bet)



PokerStars Hand #228334935066:  Hold'em No Limit ($0.01/$0.02 USD) - 2021/07/16 10:29:38 PT [2021/07/16 13:29:38 ET]
Table 'Sorga' 9-max Seat #6 is the button
Seat 1: rashidmoo ($1.88 in chips) 
Seat 2: Ooptimax ($2 in chips) 
Seat 3: nl_kmas ($3.97 in chips) 
Seat 4: mattahario ($0.85 in chips) 
Seat 5: agonzalezelh ($1.74 in chips) 
Seat 6: Dorex2007 ($2.34 in chips) 
Seat 9: LuisZeifer ($1.41 in chips) 
1AUE has timed out while disconnected
1AUE: is sitting out 
LuisZeifer: posts small blind $0.01
rashidmoo: posts big blind $0.02
*** HOLE CARDS ***
Dealt to Dorex2007 [3s Qc]
Ooptimax: folds 
nl_kmas: calls $0.02
mattahario: folds 
agonzalezelh: raises $0.04 to $0.06
Dorex2007: folds 
LuisZeifer: folds 
rashidmoo: calls $0.04
nl_kmas: raises $0.04 to $0.10
agonzalezelh: calls $0.04
rashidmoo: calls $0.04
*** FLOP *** [7h 6d Kh]
Dorex2007 is disconnected 
rashidmoo: checks 
nl_kmas has timed out
nl_kmas: checks 
agonzalezelh: bets $0.15
rashidmoo: folds 
nl_kmas: calls $0.15
*** TURN *** [7h 6d Kh] [7s]
nl_kmas: checks 
agonzalezelh: bets $0.59
nl_kmas: folds 
Uncalled bet ($0.59) returned to agonzalezelh
agonzalezelh collected $0.59 from pot
agonzalezelh: doesn't show hand 
*** SUMMARY ***
Total pot $0.61 | Rake $0.02 
Board [7h 6d Kh 7s]
Seat 1: rashidmoo (big blind) folded on the Flop
Seat 2: Ooptimax folded before Flop (didn't bet)
Seat 3: nl_kmas folded on the Turn
Seat 4: mattahario folded before Flop (didn't bet)
Seat 5: agonzalezelh collected ($0.59)
Seat 6: Dorex2007 (button) folded before Flop (didn't bet)
Seat 9: LuisZeifer (small blind) folded before Flop



PokerStars Hand #228334992020:  Hold'em No Limit ($0.01/$0.02 USD) - 2021/07/16 10:32:01 PT [2021/07/16 13:32:01 ET]
Table 'Sorga' 9-max Seat #9 is the button
Seat 1: rashidmoo ($1.78 in chips) 
Seat 2: Ooptimax ($2 in chips) 
Seat 3: nl_kmas ($3.72 in chips) 
Seat 4: mattahario ($0.85 in chips) 
Seat 5: agonzalezelh ($2.08 in chips) 
Seat 6: Dorex2007 ($2.34 in chips) 
Seat 9: LuisZeifer ($1.40 in chips) 
rashidmoo: posts small blind $0.01
Ooptimax: posts big blind $0.02
jgino14: sits out 
*** HOLE CARDS ***
Dealt to Dorex2007 [Td 5d]
nl_kmas has timed out
nl_kmas: folds 
mattahario: folds 
agonzalezelh: calls $0.02
Dorex2007: folds 
LuisZeifer: folds 
rashidmoo: folds 
Ooptimax: checks 
*** FLOP *** [4c 5h 8h]
Ooptimax: checks 
agonzalezelh: checks 
*** TURN *** [4c 5h 8h] [3c]
Ooptimax: bets $0.04
agonzalezelh: calls $0.04
*** RIVER *** [4c 5h 8h 3c] [7s]
Ooptimax: checks 
agonzalezelh: bets $0.07
Ooptimax: folds 
Uncalled bet ($0.07) returned to agonzalezelh
agonzalezelh collected $0.13 from pot
agonzalezelh: doesn't show hand 
*** SUMMARY ***
Total pot $0.13 | Rake $0 
Board [4c 5h 8h 3c 7s]
Seat 1: rashidmoo (small blind) folded before Flop
Seat 2: Ooptimax (big blind) folded on the River
Seat 3: nl_kmas folded before Flop (didn't bet)
Seat 4: mattahario folded before Flop (didn't bet)
Seat 5: agonzalezelh collected ($0.13)
Seat 6: Dorex2007 folded before Flop (didn't bet)
Seat 9: LuisZeifer (button) folded before Flop (didn't bet)



PokerStars Hand #228335017034:  Hold'em No Limit ($0.01/$0.02 USD) - 2021/07/16 10:33:03 PT [2021/07/16 13:33:03 ET]
Table 'Sorga' 9-max Seat #1 is the button
Seat 1: rashidmoo ($1.77 in chips) 
Seat 2: Ooptimax ($2 in chips) 
Seat 3: nl_kmas ($3.72 in chips) 
Seat 4: mattahario ($0.85 in chips) 
Seat 5: agonzalezelh ($2.15 in chips) 
Seat 6: Dorex2007 ($2.34 in chips) 
Seat 9: LuisZeifer ($1.40 in chips) 
Ooptimax: posts small blind $0.01
nl_kmas: posts big blind $0.02
jgino14: sits out 
*** HOLE CARDS ***
Dealt to Dorex2007 [Kc Ad]
mattahario: folds 
agonzalezelh: folds 
mattahario leaves the table
Dorex2007: raises $0.02 to $0.04
LuisZeifer: folds 
rashidmoo: folds 
GB155 joins the table at seat #4 
Ooptimax: calls $0.03
nl_kmas: calls $0.02
*** FLOP *** [8c Ks Qd]
Ooptimax: checks 
nl_kmas: bets $0.02
Dorex2007: raises $0.04 to $0.06
Ooptimax: calls $0.06
nl_kmas: calls $0.04
*** TURN *** [8c Ks Qd] [4d]
Ooptimax: checks 
nl_kmas: bets $0.02
Dorex2007: raises $0.04 to $0.06
Ooptimax: calls $0.06
nl_kmas: calls $0.04
*** RIVER *** [8c Ks Qd 4d] [2c]
Ooptimax: checks 
nl_kmas: checks 
Dorex2007: checks 
*** SHOW DOWN ***
Ooptimax: shows [Jh Th] (high card King)
nl_kmas: mucks hand 
Dorex2007: shows [Kc Ad] (a pair of Kings)
Dorex2007 collected $0.46 from pot
*** SUMMARY ***
Total pot $0.48 | Rake $0.02 
Board [8c Ks Qd 4d 2c]
Seat 1: rashidmoo (button) folded before Flop (didn't bet)
Seat 2: Ooptimax (small blind) showed [Jh Th] and lost with high card King
Seat 3: nl_kmas (big blind) mucked [6d 5c]
Seat 4: mattahario folded before Flop (didn't bet)
Seat 5: agonzalezelh folded before Flop (didn't bet)
Seat 6: Dorex2007 showed [Kc Ad] and won ($0.46) with a pair of Kings
Seat 9: LuisZeifer folded before Flop (didn't bet)



PokerStars Hand #228335067570:  Hold'em No Limit ($0.01/$0.02 USD) - 2021/07/16 10:35:10 PT [2021/07/16 13:35:10 ET]
Table 'Sorga' 9-max Seat #2 is the button
Seat 1: rashidmoo ($1.77 in chips) 
Seat 2: Ooptimax ($2 in chips) 
Seat 3: nl_kmas ($3.56 in chips) 
Seat 4: GB155 ($1.60 in chips) 
Seat 5: agonzalezelh ($2.15 in chips) 
Seat 6: Dorex2007 ($2.64 in chips) 
Seat 9: LuisZeifer ($1.40 in chips) 
nl_kmas: posts small blind $0.01
GB155: posts big blind $0.02
jgino14: sits out 
*** HOLE CARDS ***
Dealt to Dorex2007 [4h Ks]
agonzalezelh: folds 
Dorex2007: folds 
LuisZeifer: folds 
rashidmoo: folds 
Ooptimax: folds 
nl_kmas: calls $0.01
GB155: checks 
*** FLOP *** [9d 3c 8c]
nl_kmas: bets $0.02
GB155: calls $0.02
*** TURN *** [9d 3c 8c] [9c]
nl_kmas: bets $0.02
GB155: folds 
Uncalled bet ($0.02) returned to nl_kmas
nl_kmas collected $0.08 from pot
nl_kmas: doesn't show hand 
*** SUMMARY ***
Total pot $0.08 | Rake $0 
Board [9d 3c 8c 9c]
Seat 1: rashidmoo folded before Flop (didn't bet)
Seat 2: Ooptimax (button) folded before Flop (didn't bet)
Seat 3: nl_kmas (small blind) collected ($0.08)
Seat 4: GB155 (big blind) folded on the Turn
Seat 5: agonzalezelh folded before Flop (didn't bet)
Seat 6: Dorex2007 folded before Flop (didn't bet)
Seat 9: LuisZeifer folded before Flop (didn't bet)



PokerStars Hand #228335086759:  Hold'em No Limit ($0.01/$0.02 USD) - 2021/07/16 10:35:58 PT [2021/07/16 13:35:58 ET]
Table 'Sorga' 9-max Seat #3 is the button
Seat 1: rashidmoo ($1.77 in chips) 
Seat 2: Ooptimax ($2 in chips) 
Seat 3: nl_kmas ($3.60 in chips) 
Seat 4: GB155 ($1.56 in chips) 
Seat 5: agonzalezelh ($2.15 in chips) 
Seat 6: Dorex2007 ($2.64 in chips) 
Seat 9: LuisZeifer ($1.40 in chips) 
GB155: posts small blind $0.01
agonzalezelh: posts big blind $0.02
jgino14: sits out 
*** HOLE CARDS ***
Dealt to Dorex2007 [8c 4c]
Dorex2007: folds 
LuisZeifer: folds 
rashidmoo: folds 
Ooptimax: folds 
nl_kmas has timed out
nl_kmas: folds 
GB155: raises $0.04 to $0.06
agonzalezelh: calls $0.04
*** FLOP *** [Qs Js Kc]
GB155: bets $0.06
agonzalezelh: calls $0.06
*** TURN *** [Qs Js Kc] [2s]
GB155: bets $0.12
agonzalezelh: folds 
Uncalled bet ($0.12) returned to GB155
GB155 collected $0.23 from pot
GB155: doesn't show hand 
*** SUMMARY ***
Total pot $0.24 | Rake $0.01 
Board [Qs Js Kc 2s]
Seat 1: rashidmoo folded before Flop (didn't bet)
Seat 2: Ooptimax folded before Flop (didn't bet)
Seat 3: nl_kmas (button) folded before Flop (didn't bet)
Seat 4: GB155 (small blind) collected ($0.23)
Seat 5: agonzalezelh (big blind) folded on the Turn
Seat 6: Dorex2007 folded before Flop (didn't bet)
Seat 9: LuisZeifer folded before Flop (didn't bet)



PokerStars Hand #228335111307:  Hold'em No Limit ($0.01/$0.02 USD) - 2021/07/16 10:37:00 PT [2021/07/16 13:37:00 ET]
Table 'Sorga' 9-max Seat #4 is the button
Seat 1: rashidmoo ($1.77 in chips) 
Seat 2: Ooptimax ($2 in chips) 
Seat 3: nl_kmas ($3.60 in chips) 
Seat 4: GB155 ($1.67 in chips) 
Seat 5: agonzalezelh ($2.03 in chips) 
Seat 6: Dorex2007 ($2.64 in chips) 
Seat 9: LuisZeifer ($1.40 in chips) 
agonzalezelh: posts small blind $0.01
Dorex2007: posts big blind $0.02
jgino14: sits out 
*** HOLE CARDS ***
Dealt to Dorex2007 [Qs Ad]
LuisZeifer: raises $0.04 to $0.06
rashidmoo: folds 
Ooptimax: folds 
nl_kmas has timed out
nl_kmas: folds 
GB155: folds 
agonzalezelh: folds 
Dorex2007: calls $0.04
*** FLOP *** [8h Td 2h]
Dorex2007: checks 
LuisZeifer: bets $0.13
Dorex2007: folds 
Uncalled bet ($0.13) returned to LuisZeifer
LuisZeifer collected $0.13 from pot
*** SUMMARY ***
Total pot $0.13 | Rake $0 
Board [8h Td 2h]
Seat 1: rashidmoo folded before Flop (didn't bet)
Seat 2: Ooptimax folded before Flop (didn't bet)
Seat 3: nl_kmas folded before Flop (didn't bet)
Seat 4: GB155 (button) folded before Flop (didn't bet)
Seat 5: agonzalezelh (small blind) folded before Flop
Seat 6: Dorex2007 (big blind) folded on the Flop
Seat 9: LuisZeifer collected ($0.13)



PokerStars Hand #228335134154:  Hold'em No Limit ($0.01/$0.02 USD) - 2021/07/16 10:37:57 PT [2021/07/16 13:37:57 ET]
Table 'Sorga' 9-max Seat #5 is the button
Seat 1: rashidmoo ($1.77 in chips) 
Seat 2: Ooptimax ($2 in chips) 
Seat 4: GB155 ($1.67 in chips) 
Seat 5: agonzalezelh ($2.02 in chips) 
Seat 6: Dorex2007 ($2.58 in chips) 
Seat 7: jgino14 ($2 in chips) 
Seat 9: LuisZeifer ($1.47 in chips) 
Dorex2007: posts small blind $0.01
jgino14: posts big blind $0.02
*** HOLE CARDS ***
Dealt to Dorex2007 [7c 8s]
nl_kmas is disconnected 
LuisZeifer: raises $0.02 to $0.04
rashidmoo: folds 
Ooptimax: folds 
GB155: folds 
agonzalezelh: raises $0.02 to $0.06
Dorex2007: folds 
jgino14: folds 
LuisZeifer: calls $0.02
*** FLOP *** [Ac 5s Qd]
LuisZeifer: checks 
agonzalezelh: bets $0.07
LuisZeifer: calls $0.07
*** TURN *** [Ac 5s Qd] [Ks]
LuisZeifer: checks 
agonzalezelh: bets $0.28
LuisZeifer: calls $0.28
*** RIVER *** [Ac 5s Qd Ks] [2c]
LuisZeifer: checks 
agonzalezelh: checks 
*** SHOW DOWN ***
LuisZeifer: shows [As Jc] (a pair of Aces)
agonzalezelh: shows [Ah Kc] (two pair, Aces and Kings)
agonzalezelh collected $0.82 from pot
*** SUMMARY ***
Total pot $0.85 | Rake $0.03 
Board [Ac 5s Qd Ks 2c]
Seat 1: rashidmoo folded before Flop (didn't bet)
Seat 2: Ooptimax folded before Flop (didn't bet)
Seat 4: GB155 folded before Flop (didn't bet)
Seat 5: agonzalezelh (button) showed [Ah Kc] and won ($0.82) with two pair, Aces and Kings
Seat 6: Dorex2007 (small blind) folded before Flop
Seat 7: jgino14 (big blind) folded before Flop
Seat 9: LuisZeifer showed [As Jc] and lost with a pair of Aces



PokerStars Hand #228335158611:  Hold'em No Limit ($0.01/$0.02 USD) - 2021/07/16 10:38:58 PT [2021/07/16 13:38:58 ET]
Table 'Sorga' 9-max Seat #6 is the button
Seat 1: rashidmoo ($1.77 in chips) 
Seat 2: Ooptimax ($2 in chips) 
Seat 4: GB155 ($1.67 in chips) 
Seat 5: agonzalezelh ($2.43 in chips) 
Seat 6: Dorex2007 ($2.57 in chips) 
Seat 7: jgino14 ($1.98 in chips) 
Seat 9: LuisZeifer ($1.06 in chips) 
jgino14: posts small blind $0.01
LuisZeifer: posts big blind $0.02
*** HOLE CARDS ***
Dealt to Dorex2007 [Js Kh]
rashidmoo: folds 
Ooptimax: folds 
GB155: folds 
agonzalezelh: raises $0.04 to $0.06
Dorex2007: folds 
jgino14: folds 
LuisZeifer: folds 
Uncalled bet ($0.04) returned to agonzalezelh
agonzalezelh collected $0.05 from pot
agonzalezelh: doesn't show hand 
*** SUMMARY ***
Total pot $0.05 | Rake $0 
Seat 1: rashidmoo folded before Flop (didn't bet)
Seat 2: Ooptimax folded before Flop (didn't bet)
Seat 4: GB155 folded before Flop (didn't bet)
Seat 5: agonzalezelh collected ($0.05)
Seat 6: Dorex2007 (button) folded before Flop (didn't bet)
Seat 7: jgino14 (small blind) folded before Flop
Seat 9: LuisZeifer (big blind) folded before Flop



PokerStars Hand #228335166594:  Hold'em No Limit ($0.01/$0.02 USD) - 2021/07/16 10:39:18 PT [2021/07/16 13:39:18 ET]
Table 'Sorga' 9-max Seat #7 is the button
Seat 1: rashidmoo ($1.77 in chips) 
Seat 2: Ooptimax ($2 in chips) 
Seat 4: GB155 ($1.67 in chips) 
Seat 5: agonzalezelh ($2.46 in chips) 
Seat 6: Dorex2007 ($2.57 in chips) 
Seat 7: jgino14 ($1.97 in chips) 
Seat 9: LuisZeifer ($1.04 in chips) 
LuisZeifer: posts small blind $0.01
rashidmoo: posts big blind $0.02
*** HOLE CARDS ***
Dealt to Dorex2007 [3c 9h]
Ooptimax: folds 
GB155: folds 
agonzalezelh: folds 
Dorex2007: folds 
jgino14: raises $0.03 to $0.05
1AUE leaves the table
LuisZeifer: folds 
rashidmoo: calls $0.03
*** FLOP *** [Qc 8h 4c]
rashidmoo: checks 
AlekxSly joins the table at seat #8 
jgino14: bets $0.04
rashidmoo: folds 
Uncalled bet ($0.04) returned to jgino14
jgino14 collected $0.11 from pot
jgino14: doesn't show hand 
*** SUMMARY ***
Total pot $0.11 | Rake $0 
Board [Qc 8h 4c]
Seat 1: rashidmoo (big blind) folded on the Flop
Seat 2: Ooptimax folded before Flop (didn't bet)
Seat 4: GB155 folded before Flop (didn't bet)
Seat 5: agonzalezelh folded before Flop (didn't bet)
Seat 6: Dorex2007 folded before Flop (didn't bet)
Seat 7: jgino14 (button) collected ($0.11)
Seat 9: LuisZeifer (small blind) folded before Flop



PokerStars Hand #228335183779:  Hold'em No Limit ($0.01/$0.02 USD) - 2021/07/16 10:40:01 PT [2021/07/16 13:40:01 ET]
Table 'Sorga' 9-max Seat #9 is the button
Seat 1: rashidmoo ($1.72 in chips) 
Seat 2: Ooptimax ($2 in chips) 
Seat 4: GB155 ($1.67 in chips) 
Seat 5: agonzalezelh ($2.46 in chips) 
Seat 6: Dorex2007 ($2.57 in chips) 
Seat 7: jgino14 ($2.03 in chips) 
Seat 9: LuisZeifer ($1.03 in chips) 
rashidmoo: posts small blind $0.01
Ooptimax: posts big blind $0.02
AlekxSly: sits out 
*** HOLE CARDS ***
Dealt to Dorex2007 [4s 6s]
GB155: folds 
agonzalezelh: raises $0.04 to $0.06
Dorex2007: folds 
jgino14: folds 
LuisZeifer: folds 
rashidmoo: calls $0.05
Ooptimax: calls $0.04
*** FLOP *** [2s 7s 6c]
rashidmoo: bets $0.09
Ooptimax: calls $0.09
agonzalezelh: calls $0.09
*** TURN *** [2s 7s 6c] [Ad]
rashidmoo: bets $0.22
Ooptimax: calls $0.22
agonzalezelh: folds 
*** RIVER *** [2s 7s 6c Ad] [4c]
rashidmoo: bets $0.29
Ooptimax: calls $0.29
*** SHOW DOWN ***
rashidmoo: shows [Js Ah] (a pair of Aces)
Ooptimax: mucks hand 
rashidmoo collected $1.42 from pot
*** SUMMARY ***
Total pot $1.47 | Rake $0.05 
Board [2s 7s 6c Ad 4c]
Seat 1: rashidmoo (small blind) showed [Js Ah] and won ($1.42) with a pair of Aces
Seat 2: Ooptimax (big blind) mucked [9c Ac]
Seat 4: GB155 folded before Flop (didn't bet)
Seat 5: agonzalezelh folded on the Turn
Seat 6: Dorex2007 folded before Flop (didn't bet)
Seat 7: jgino14 folded before Flop (didn't bet)
Seat 9: LuisZeifer (button) folded before Flop (didn't bet)



PokerStars Hand #228335223874:  Hold'em No Limit ($0.01/$0.02 USD) - 2021/07/16 10:41:40 PT [2021/07/16 13:41:40 ET]
Table 'Sorga' 9-max Seat #1 is the button
Seat 1: rashidmoo ($2.48 in chips) 
Seat 2: Ooptimax ($2 in chips) 
Seat 3: nl_kmas ($3.60 in chips) 
Seat 4: GB155 ($1.67 in chips) 
Seat 5: agonzalezelh ($2.31 in chips) 
Seat 6: Dorex2007 ($2.57 in chips) 
Seat 7: jgino14 ($2.03 in chips) 
Seat 9: LuisZeifer ($1.03 in chips) 
Ooptimax: posts small blind $0.01
nl_kmas: posts big blind $0.02
AlekxSly: sits out 
*** HOLE CARDS ***
Dealt to Dorex2007 [8s 2c]
GB155: folds 
agonzalezelh: folds 
Dorex2007: folds 
jgino14: folds 
LuisZeifer: raises $0.04 to $0.06
rashidmoo: folds 
Ooptimax: folds 
nl_kmas: raises $0.04 to $0.10
LuisZeifer: calls $0.04
*** FLOP *** [Ac Ad Tc]
nl_kmas: bets $0.06
LuisZeifer: calls $0.06
*** TURN *** [Ac Ad Tc] [Kc]
nl_kmas: bets $0.26
LuisZeifer: calls $0.26
*** RIVER *** [Ac Ad Tc Kc] [9s]
nl_kmas: bets $0.64
LuisZeifer: calls $0.61 and is all-in
Uncalled bet ($0.03) returned to nl_kmas
*** SHOW DOWN ***
nl_kmas: shows [Kh Qd] (two pair, Aces and Kings)
LuisZeifer: shows [Jc Ah] (three of a kind, Aces)
LuisZeifer collected $1.98 from pot
*** SUMMARY ***
Total pot $2.07 | Rake $0.09 
Board [Ac Ad Tc Kc 9s]
Seat 1: rashidmoo (button) folded before Flop (didn't bet)
Seat 2: Ooptimax (small blind) folded before Flop
Seat 3: nl_kmas (big blind) showed [Kh Qd] and lost with two pair, Aces and Kings
Seat 4: GB155 folded before Flop (didn't bet)
Seat 5: agonzalezelh folded before Flop (didn't bet)
Seat 6: Dorex2007 folded before Flop (didn't bet)
Seat 7: jgino14 folded before Flop (didn't bet)
Seat 9: LuisZeifer showed [Jc Ah] and won ($1.98) with three of a kind, Aces



PokerStars Hand #228335251792:  Hold'em No Limit ($0.01/$0.02 USD) - 2021/07/16 10:42:50 PT [2021/07/16 13:42:50 ET]
Table 'Sorga' 9-max Seat #2 is the button
Seat 1: rashidmoo ($2.48 in chips) 
Seat 2: Ooptimax ($2 in chips) 
Seat 3: nl_kmas ($2.57 in chips) 
Seat 4: GB155 ($1.67 in chips) 
Seat 5: agonzalezelh ($2.31 in chips) 
Seat 6: Dorex2007 ($2.57 in chips) 
Seat 7: jgino14 ($2.03 in chips) 
Seat 9: LuisZeifer ($1.98 in chips) 
nl_kmas: posts small blind $0.01
GB155: posts big blind $0.02
AlekxSly: sits out 
*** HOLE CARDS ***
Dealt to Dorex2007 [2c 3c]
agonzalezelh: calls $0.02
Dorex2007: folds 
jgino14: folds 
LuisZeifer: folds 
rashidmoo: raises $0.06 to $0.08
Ooptimax: folds 
nl_kmas: calls $0.07
GB155: folds 
agonzalezelh: folds 
*** FLOP *** [Qh Kc Td]
nl_kmas: checks 
rashidmoo: checks 
*** TURN *** [Qh Kc Td] [7c]
nl_kmas: bets $0.02
rashidmoo: calls $0.02
*** RIVER *** [Qh Kc Td 7c] [2s]
nl_kmas: bets $0.02
rashidmoo: folds 
Uncalled bet ($0.02) returned to nl_kmas
nl_kmas collected $0.23 from pot
nl_kmas: doesn't show hand 
*** SUMMARY ***
Total pot $0.24 | Rake $0.01 
Board [Qh Kc Td 7c 2s]
Seat 1: rashidmoo folded on the River
Seat 2: Ooptimax (button) folded before Flop (didn't bet)
Seat 3: nl_kmas (small blind) collected ($0.23)
Seat 4: GB155 (big blind) folded before Flop
Seat 5: agonzalezelh folded before Flop
Seat 6: Dorex2007 folded before Flop (didn't bet)
Seat 7: jgino14 folded before Flop (didn't bet)
Seat 9: LuisZeifer folded before Flop (didn't bet)



PokerStars Hand #228335270528:  Hold'em No Limit ($0.01/$0.02 USD) - 2021/07/16 10:43:37 PT [2021/07/16 13:43:37 ET]
Table 'Sorga' 9-max Seat #3 is the button
Seat 1: rashidmoo ($2.38 in chips) 
Seat 2: Ooptimax ($2 in chips) 
Seat 3: nl_kmas ($2.70 in chips) 
Seat 4: GB155 ($1.65 in chips) 
Seat 5: agonzalezelh ($2.29 in chips) 
Seat 6: Dorex2007 ($2.57 in chips) 
Seat 7: jgino14 ($2.03 in chips) 
Seat 9: LuisZeifer ($1.98 in chips) 
GB155: posts small blind $0.01
agonzalezelh: posts big blind $0.02
AlekxSly has timed out
AlekxSly: is sitting out 
*** HOLE CARDS ***
Dealt to Dorex2007 [2c Ah]
Dorex2007: folds 
jgino14: folds 
AlekxSly is disconnected 
LuisZeifer: folds 
rashidmoo: raises $0.04 to $0.06
Ooptimax: folds 
nl_kmas: calls $0.06
GB155: folds 
agonzalezelh: folds 
*** FLOP *** [8s Td Qd]
rashidmoo: checks 
nl_kmas: bets $0.02
rashidmoo: folds 
Uncalled bet ($0.02) returned to nl_kmas
nl_kmas collected $0.14 from pot
nl_kmas: doesn't show hand 
*** SUMMARY ***
Total pot $0.15 | Rake $0.01 
Board [8s Td Qd]
Seat 1: rashidmoo folded on the Flop
Seat 2: Ooptimax folded before Flop (didn't bet)
Seat 3: nl_kmas (button) collected ($0.14)
Seat 4: GB155 (small blind) folded before Flop
Seat 5: agonzalezelh (big blind) folded before Flop
Seat 6: Dorex2007 folded before Flop (didn't bet)
Seat 7: jgino14 folded before Flop (didn't bet)
Seat 9: LuisZeifer folded before Flop (didn't bet)



PokerStars Hand #228335295122:  Hold'em No Limit ($0.01/$0.02 USD) - 2021/07/16 10:44:39 PT [2021/07/16 13:44:39 ET]
Table 'Sorga' 9-max Seat #4 is the button
Seat 2: Ooptimax ($2 in chips) 
Seat 3: nl_kmas ($2.78 in chips) 
Seat 4: GB155 ($1.64 in chips) 
Seat 5: agonzalezelh ($2.27 in chips) 
Seat 6: Dorex2007 ($2.57 in chips) 
Seat 7: jgino14 ($2.03 in chips) 
Seat 9: LuisZeifer ($1.98 in chips) 
agonzalezelh: posts small blind $0.01
Dorex2007: posts big blind $0.02
AlekxSly: sits out 
*** HOLE CARDS ***
Dealt to Dorex2007 [7s Ts]
jgino14: folds 
LuisZeifer: folds 
Ooptimax: folds 
nl_kmas: calls $0.02
GB155: folds 
agonzalezelh: calls $0.01
Dorex2007: checks 
*** FLOP *** [5h Jc 7c]
agonzalezelh: checks 
Dorex2007: checks 
nl_kmas: checks 
*** TURN *** [5h Jc 7c] [5c]
agonzalezelh: bets $0.03
Dorex2007: folds 
nl_kmas: calls $0.03
*** RIVER *** [5h Jc 7c 5c] [As]
agonzalezelh: bets $0.12
nl_kmas: folds 
Uncalled bet ($0.12) returned to agonzalezelh
agonzalezelh collected $0.12 from pot
agonzalezelh: doesn't show hand 
*** SUMMARY ***
Total pot $0.12 | Rake $0 
Board [5h Jc 7c 5c As]
Seat 2: Ooptimax folded before Flop (didn't bet)
Seat 3: nl_kmas folded on the River
Seat 4: GB155 (button) folded before Flop (didn't bet)
Seat 5: agonzalezelh (small blind) collected ($0.12)
Seat 6: Dorex2007 (big blind) folded on the Turn
Seat 7: jgino14 folded before Flop (didn't bet)
Seat 9: LuisZeifer folded before Flop (didn't bet)



PokerStars Hand #228335324962:  Hold'em No Limit ($0.01/$0.02 USD) - 2021/07/16 10:45:53 PT [2021/07/16 13:45:53 ET]
Table 'Sorga' 9-max Seat #5 is the button
Seat 2: Ooptimax ($2 in chips) 
Seat 3: nl_kmas ($2.73 in chips) 
Seat 4: GB155 ($1.64 in chips) 
Seat 5: agonzalezelh ($2.34 in chips) 
Seat 6: Dorex2007 ($2.55 in chips) 
Seat 7: jgino14 ($2.03 in chips) 
Seat 9: LuisZeifer ($1.98 in chips) 
Dorex2007: posts small blind $0.01
jgino14: posts big blind $0.02
AlekxSly: sits out 
*** HOLE CARDS ***
Dealt to Dorex2007 [9c Ad]
LuisZeifer: folds 
Ooptimax: folds 
nl_kmas has timed out
nl_kmas: folds 
GB155: folds 
agonzalezelh: folds 
Dorex2007: calls $0.01
jgino14: raises $0.04 to $0.06
Dorex2007: calls $0.04
*** FLOP *** [3h 2s Jc]
Dorex2007: checks 
jgino14: bets $0.08
Dorex2007: folds 
Uncalled bet ($0.08) returned to jgino14
jgino14 collected $0.12 from pot
jgino14: doesn't show hand 
*** SUMMARY ***
Total pot $0.12 | Rake $0 
Board [3h 2s Jc]
Seat 2: Ooptimax folded before Flop (didn't bet)
Seat 3: nl_kmas folded before Flop (didn't bet)
Seat 4: GB155 folded before Flop (didn't bet)
Seat 5: agonzalezelh (button) folded before Flop (didn't bet)
Seat 6: Dorex2007 (small blind) folded on the Flop
Seat 7: jgino14 (big blind) collected ($0.12)
Seat 9: LuisZeifer folded before Flop (didn't bet)



PokerStars Hand #228335346397:  Hold'em No Limit ($0.01/$0.02 USD) - 2021/07/16 10:46:46 PT [2021/07/16 13:46:46 ET]
Table 'Sorga' 9-max Seat #6 is the button
Seat 2: Ooptimax ($2 in chips) 
Seat 4: GB155 ($1.64 in chips) 
Seat 5: agonzalezelh ($2.34 in chips) 
Seat 6: Dorex2007 ($2.49 in chips) 
Seat 7: jgino14 ($2.09 in chips) 
Seat 8: AlekxSly ($1 in chips) 
Seat 9: LuisZeifer ($1.98 in chips) 
jgino14: posts small blind $0.01
AlekxSly: posts big blind $0.02
*** HOLE CARDS ***
Dealt to Dorex2007 [Jh 7s]
LuisZeifer: folds 
Ooptimax: folds 
GB155: calls $0.02
agonzalezelh: raises $0.04 to $0.06
Dorex2007: folds 
jgino14: raises $0.16 to $0.22
nl_kmas is disconnected 
AlekxSly: folds 
GB155: folds 
agonzalezelh: folds 
Uncalled bet ($0.16) returned to jgino14
jgino14 collected $0.16 from pot
jgino14: doesn't show hand 
*** SUMMARY ***
Total pot $0.16 | Rake $0 
Seat 2: Ooptimax folded before Flop (didn't bet)
Seat 4: GB155 folded before Flop
Seat 5: agonzalezelh folded before Flop
Seat 6: Dorex2007 (button) folded before Flop (didn't bet)
Seat 7: jgino14 (small blind) collected ($0.16)
Seat 8: AlekxSly (big blind) folded before Flop
Seat 9: LuisZeifer folded before Flop (didn't bet)



PokerStars Hand #228335361816:  Hold'em No Limit ($0.01/$0.02 USD) - 2021/07/16 10:47:25 PT [2021/07/16 13:47:25 ET]
Table 'Sorga' 9-max Seat #7 is the button
Seat 2: Ooptimax ($2 in chips) 
Seat 4: GB155 ($1.62 in chips) 
Seat 5: agonzalezelh ($2.28 in chips) 
Seat 6: Dorex2007 ($2.49 in chips) 
Seat 7: jgino14 ($2.19 in chips) 
Seat 8: AlekxSly ($0.98 in chips) 
Seat 9: LuisZeifer ($1.98 in chips) 
AlekxSly: posts small blind $0.01
LuisZeifer: posts big blind $0.02
*** HOLE CARDS ***
Dealt to Dorex2007 [6s 4c]
Ooptimax: folds 
GB155: folds 
agonzalezelh: calls $0.02
Dorex2007: folds 
jgino14: folds 
AlekxSly: raises $0.02 to $0.04
LuisZeifer: calls $0.02
agonzalezelh: calls $0.02
*** FLOP *** [Qd 3d 7s]
AlekxSly: checks 
LuisZeifer: checks 
agonzalezelh: checks 
*** TURN *** [Qd 3d 7s] [8s]
AlekxSly: checks 
LuisZeifer: checks 
agonzalezelh: checks 
*** RIVER *** [Qd 3d 7s 8s] [6c]
AlekxSly: checks 
LuisZeifer: bets $0.12
agonzalezelh: folds 
AlekxSly: folds 
Uncalled bet ($0.12) returned to LuisZeifer
LuisZeifer collected $0.12 from pot
LuisZeifer: shows [9h 5h] (a straight, Five to Nine)
*** SUMMARY ***
Total pot $0.12 | Rake $0 
Board [Qd 3d 7s 8s 6c]
Seat 2: Ooptimax folded before Flop (didn't bet)
Seat 4: GB155 folded before Flop (didn't bet)
Seat 5: agonzalezelh folded on the River
Seat 6: Dorex2007 folded before Flop (didn't bet)
Seat 7: jgino14 (button) folded before Flop (didn't bet)
Seat 8: AlekxSly (small blind) folded on the River
Seat 9: LuisZeifer (big blind) collected ($0.12)



PokerStars Hand #228335392943:  Hold'em No Limit ($0.01/$0.02 USD) - 2021/07/16 10:48:42 PT [2021/07/16 13:48:42 ET]
Table 'Sorga' 9-max Seat #8 is the button
Seat 2: Ooptimax ($2 in chips) 
Seat 4: GB155 ($1.62 in chips) 
Seat 5: agonzalezelh ($2.24 in chips) 
Seat 6: Dorex2007 ($2.49 in chips) 
Seat 7: jgino14 ($2.19 in chips) 
Seat 8: AlekxSly ($0.94 in chips) 
Seat 9: LuisZeifer ($2.06 in chips) 
LuisZeifer: posts small blind $0.01
Ooptimax: posts big blind $0.02
*** HOLE CARDS ***
Dealt to Dorex2007 [2d 7c]
GB155: folds 
agonzalezelh: raises $0.04 to $0.06
Dorex2007: folds 
jgino14: folds 
AlekxSly: folds 
LuisZeifer: folds 
Ooptimax: folds 
Uncalled bet ($0.04) returned to agonzalezelh
agonzalezelh collected $0.05 from pot
agonzalezelh: doesn't show hand 
*** SUMMARY ***
Total pot $0.05 | Rake $0 
Seat 2: Ooptimax (big blind) folded before Flop
Seat 4: GB155 folded before Flop (didn't bet)
Seat 5: agonzalezelh collected ($0.05)
Seat 6: Dorex2007 folded before Flop (didn't bet)
Seat 7: jgino14 folded before Flop (didn't bet)
Seat 8: AlekxSly (button) folded before Flop (didn't bet)
Seat 9: LuisZeifer (small blind) folded before Flop



PokerStars Hand #228335400928:  Hold'em No Limit ($0.01/$0.02 USD) - 2021/07/16 10:49:02 PT [2021/07/16 13:49:02 ET]
Table 'Sorga' 9-max Seat #9 is the button
Seat 2: Ooptimax ($2 in chips) 
Seat 4: GB155 ($1.62 in chips) 
Seat 5: agonzalezelh ($2.27 in chips) 
Seat 6: Dorex2007 ($2.49 in chips) 
Seat 7: jgino14 ($2.19 in chips) 
Seat 8: AlekxSly ($0.94 in chips) 
Seat 9: LuisZeifer ($2.05 in chips) 
Ooptimax: posts small blind $0.01
GB155: posts big blind $0.02
*** HOLE CARDS ***
Dealt to Dorex2007 [Kh 7s]
agonzalezelh: folds 
Dorex2007: folds 
jgino14: folds 
AlekxSly: calls $0.02
LuisZeifer has timed out
LuisZeifer: folds 
Ooptimax: folds 
GB155: checks 
*** FLOP *** [Jc 2d 9c]
GB155: bets $0.02
AlekxSly: folds 
Uncalled bet ($0.02) returned to GB155
GB155 collected $0.05 from pot
GB155: doesn't show hand 
*** SUMMARY ***
Total pot $0.05 | Rake $0 
Board [Jc 2d 9c]
Seat 2: Ooptimax (small blind) folded before Flop
Seat 4: GB155 (big blind) collected ($0.05)
Seat 5: agonzalezelh folded before Flop (didn't bet)
Seat 6: Dorex2007 folded before Flop (didn't bet)
Seat 7: jgino14 folded before Flop (didn't bet)
Seat 8: AlekxSly folded on the Flop
Seat 9: LuisZeifer (button) folded before Flop (didn't bet)



PokerStars Hand #228335413889:  Hold'em No Limit ($0.01/$0.02 USD) - 2021/07/16 10:49:35 PT [2021/07/16 13:49:35 ET]
Table 'Sorga' 9-max Seat #2 is the button
Seat 2: Ooptimax ($2 in chips) 
Seat 4: GB155 ($1.65 in chips) 
Seat 5: agonzalezelh ($2.27 in chips) 
Seat 6: Dorex2007 ($2.49 in chips) 
Seat 7: jgino14 ($2.19 in chips) 
Seat 8: AlekxSly ($0.92 in chips) 
Seat 9: LuisZeifer ($2.05 in chips) 
GB155: posts small blind $0.01
agonzalezelh: posts big blind $0.02
*** HOLE CARDS ***
Dealt to Dorex2007 [7s Qd]
Dorex2007: folds 
jgino14: raises $0.04 to $0.06
AlekxSly: folds 
LuisZeifer: folds 
Ooptimax: folds 
GB155: calls $0.05
agonzalezelh: calls $0.04
*** FLOP *** [Qs 2s Kc]
GB155: checks 
agonzalezelh: checks 
jgino14: bets $0.04
GB155: folds 
agonzalezelh: calls $0.04
*** TURN *** [Qs 2s Kc] [3d]
agonzalezelh: checks 
jgino14: bets $0.08
agonzalezelh: folds 
Uncalled bet ($0.08) returned to jgino14
jgino14 collected $0.25 from pot
jgino14: doesn't show hand 
*** SUMMARY ***
Total pot $0.26 | Rake $0.01 
Board [Qs 2s Kc 3d]
Seat 2: Ooptimax (button) folded before Flop (didn't bet)
Seat 4: GB155 (small blind) folded on the Flop
Seat 5: agonzalezelh (big blind) folded on the Turn
Seat 6: Dorex2007 folded before Flop (didn't bet)
Seat 7: jgino14 collected ($0.25)
Seat 8: AlekxSly folded before Flop (didn't bet)
Seat 9: LuisZeifer folded before Flop (didn't bet)



PokerStars Hand #228335448075:  Hold'em No Limit ($0.01/$0.02 USD) - 2021/07/16 10:51:00 PT [2021/07/16 13:51:00 ET]
Table 'Sorga' 9-max Seat #4 is the button
Seat 2: Ooptimax ($2 in chips) 
Seat 4: GB155 ($1.59 in chips) 
Seat 5: agonzalezelh ($2.17 in chips) 
Seat 6: Dorex2007 ($2.49 in chips) 
Seat 7: jgino14 ($2.34 in chips) 
Seat 8: AlekxSly ($0.92 in chips) 
Seat 9: LuisZeifer ($2.05 in chips) 
agonzalezelh: posts small blind $0.01
Dorex2007: posts big blind $0.02
*** HOLE CARDS ***
Dealt to Dorex2007 [4s Ts]
jgino14: folds 
AlekxSly: folds 
LuisZeifer: folds 
Ooptimax: folds 
agonzalezelh said, "salio el bluff"
GB155: raises $0.04 to $0.06
agonzalezelh said, "jaja"
agonzalezelh: folds 
Dorex2007: folds 
Uncalled bet ($0.04) returned to GB155
GB155 collected $0.05 from pot
GB155: doesn't show hand 
*** SUMMARY ***
Total pot $0.05 | Rake $0 
Seat 2: Ooptimax folded before Flop (didn't bet)
Seat 4: GB155 (button) collected ($0.05)
Seat 5: agonzalezelh (small blind) folded before Flop
Seat 6: Dorex2007 (big blind) folded before Flop
Seat 7: jgino14 folded before Flop (didn't bet)
Seat 8: AlekxSly folded before Flop (didn't bet)
Seat 9: LuisZeifer folded before Flop (didn't bet)



PokerStars Hand #228335459372:  Hold'em No Limit ($0.01/$0.02 USD) - 2021/07/16 10:51:29 PT [2021/07/16 13:51:29 ET]
Table 'Sorga' 9-max Seat #5 is the button
Seat 4: GB155 ($1.62 in chips) 
Seat 5: agonzalezelh ($2.16 in chips) 
Seat 6: Dorex2007 ($2.47 in chips) 
Seat 7: jgino14 ($2.34 in chips) 
Seat 8: AlekxSly ($0.92 in chips) 
Seat 9: LuisZeifer ($2.05 in chips) 
Dorex2007: posts small blind $0.01
jgino14: posts big blind $0.02
*** HOLE CARDS ***
Dealt to Dorex2007 [7d Kh]
AlekxSly: folds 
LuisZeifer: folds 
GB155: raises $0.04 to $0.06
agonzalezelh: folds 
Dorex2007: folds 
jgino14: folds 
Uncalled bet ($0.04) returned to GB155
GB155 collected $0.05 from pot
GB155: doesn't show hand 
*** SUMMARY ***
Total pot $0.05 | Rake $0 
Seat 4: GB155 collected ($0.05)
Seat 5: agonzalezelh (button) folded before Flop (didn't bet)
Seat 6: Dorex2007 (small blind) folded before Flop
Seat 7: jgino14 (big blind) folded before Flop
Seat 8: AlekxSly folded before Flop (didn't bet)
Seat 9: LuisZeifer folded before Flop (didn't bet)



PokerStars Hand #228335467371:  Hold'em No Limit ($0.01/$0.02 USD) - 2021/07/16 10:51:49 PT [2021/07/16 13:51:49 ET]
Table 'Sorga' 9-max Seat #6 is the button
Seat 4: GB155 ($1.65 in chips) 
Seat 5: agonzalezelh ($2.16 in chips) 
Seat 6: Dorex2007 ($2.46 in chips) 
Seat 7: jgino14 ($2.32 in chips) 
Seat 8: AlekxSly ($0.92 in chips) 
Seat 9: LuisZeifer ($2.05 in chips) 
jgino14: posts small blind $0.01
AlekxSly: posts big blind $0.02
rashidmoo: sits out 
*** HOLE CARDS ***
Dealt to Dorex2007 [9h As]
LuisZeifer: folds 
GB155: calls $0.02
agonzalezelh: calls $0.02
Dorex2007: calls $0.02
jgino14: folds 
AlekxSly: checks 
*** FLOP *** [6h 6s Td]
AlekxSly: checks 
GB155: bets $0.05
agonzalezelh: folds 
Dorex2007: folds 
AlekxSly: folds 
Uncalled bet ($0.05) returned to GB155
GB155 collected $0.09 from pot
GB155: doesn't show hand 
*** SUMMARY ***
Total pot $0.09 | Rake $0 
Board [6h 6s Td]
Seat 4: GB155 collected ($0.09)
Seat 5: agonzalezelh folded on the Flop
Seat 6: Dorex2007 (button) folded on the Flop
Seat 7: jgino14 (small blind) folded before Flop
Seat 8: AlekxSly (big blind) folded on the Flop
Seat 9: LuisZeifer folded before Flop (didn't bet)



PokerStars Hand #228335492393:  Hold'em No Limit ($0.01/$0.02 USD) - 2021/07/16 10:52:28 PT [2021/07/16 13:52:28 ET]
Table 'Sorga' 9-max Seat #7 is the button
Seat 4: GB155 ($1.72 in chips) 
Seat 5: agonzalezelh ($2.14 in chips) 
Seat 6: Dorex2007 ($2.44 in chips) 
Seat 7: jgino14 ($2.31 in chips) 
Seat 8: AlekxSly ($0.90 in chips) 
Seat 9: LuisZeifer ($2.05 in chips) 
AlekxSly: posts small blind $0.01
LuisZeifer: posts big blind $0.02
rashidmoo: sits out 
*** HOLE CARDS ***
Dealt to Dorex2007 [Tc Jc]
GB155: folds 
agonzalezelh: folds 
Dorex2007: raises $0.04 to $0.06
jgino14: folds 
AlekxSly: folds 
LuisZeifer: folds 
Uncalled bet ($0.04) returned to Dorex2007
Dorex2007 collected $0.05 from pot
Dorex2007: doesn't show hand 
*** SUMMARY ***
Total pot $0.05 | Rake $0 
Seat 4: GB155 folded before Flop (didn't bet)
Seat 5: agonzalezelh folded before Flop (didn't bet)
Seat 6: Dorex2007 collected ($0.05)
Seat 7: jgino14 (button) folded before Flop (didn't bet)
Seat 8: AlekxSly (small blind) folded before Flop
Seat 9: LuisZeifer (big blind) folded before Flop



PokerStars Hand #228335500555:  Hold'em No Limit ($0.01/$0.02 USD) - 2021/07/16 10:52:48 PT [2021/07/16 13:52:48 ET]
Table 'Sorga' 9-max Seat #8 is the button
Seat 1: rashidmoo ($2.32 in chips) 
Seat 4: GB155 ($1.72 in chips) 
Seat 5: agonzalezelh ($2.14 in chips) 
Seat 6: Dorex2007 ($2.47 in chips) 
Seat 7: jgino14 ($2.31 in chips) 
Seat 8: AlekxSly ($0.89 in chips) 
Seat 9: LuisZeifer ($2.03 in chips) 
LuisZeifer: posts small blind $0.01
rashidmoo: posts big blind $0.02
*** HOLE CARDS ***
Dealt to Dorex2007 [Kh Qs]
GB155 has timed out
GB155: folds 
agonzalezelh: folds 
Dorex2007: raises $0.04 to $0.06
jgino14: folds 
AlekxSly: folds 
LuisZeifer: folds 
rashidmoo: folds 
Uncalled bet ($0.04) returned to Dorex2007
Dorex2007 collected $0.05 from pot
Dorex2007: doesn't show hand 
*** SUMMARY ***
Total pot $0.05 | Rake $0 
Seat 1: rashidmoo (big blind) folded before Flop
Seat 4: GB155 folded before Flop (didn't bet)
Seat 5: agonzalezelh folded before Flop (didn't bet)
Seat 6: Dorex2007 collected ($0.05)
Seat 7: jgino14 folded before Flop (didn't bet)
Seat 8: AlekxSly (button) folded before Flop (didn't bet)
Seat 9: LuisZeifer (small blind) folded before Flop



PokerStars Hand #228335512334:  Hold'em No Limit ($0.01/$0.02 USD) - 2021/07/16 10:53:18 PT [2021/07/16 13:53:18 ET]
Table 'Sorga' 9-max Seat #9 is the button
Seat 1: rashidmoo ($2.30 in chips) 
Seat 4: GB155 ($1.72 in chips) 
Seat 5: agonzalezelh ($2.14 in chips) 
Seat 6: Dorex2007 ($2.50 in chips) 
Seat 7: jgino14 ($2.31 in chips) 
Seat 8: AlekxSly ($0.89 in chips) 
Seat 9: LuisZeifer ($2.02 in chips) 
rashidmoo: posts small blind $0.01
GB155: posts big blind $0.02
*** HOLE CARDS ***
Dealt to Dorex2007 [3h 7c]
agonzalezelh: folds 
Dorex2007: folds 
jgino14: folds 
AlekxSly: calls $0.02
LuisZeifer: folds 
rashidmoo: folds 
GB155: checks 
*** FLOP *** [9c 2s 4h]
GB155: checks 
AlekxSly: checks 
*** TURN *** [9c 2s 4h] [Td]
GB155: checks 
AlekxSly: checks 
*** RIVER *** [9c 2s 4h Td] [2d]
GB155: checks 
AlekxSly: checks 
*** SHOW DOWN ***
GB155: shows [7d 5h] (a pair of Deuces)
AlekxSly: shows [3d 3c] (two pair, Threes and Deuces)
AlekxSly collected $0.05 from pot
*** SUMMARY ***
Total pot $0.05 | Rake $0 
Board [9c 2s 4h Td 2d]
Seat 1: rashidmoo (small blind) folded before Flop
Seat 4: GB155 (big blind) showed [7d 5h] and lost with a pair of Deuces
Seat 5: agonzalezelh folded before Flop (didn't bet)
Seat 6: Dorex2007 folded before Flop (didn't bet)
Seat 7: jgino14 folded before Flop (didn't bet)
Seat 8: AlekxSly showed [3d 3c] and won ($0.05) with two pair, Threes and Deuces
Seat 9: LuisZeifer (button) folded before Flop (didn't bet)



PokerStars Hand #228335545940:  Hold'em No Limit ($0.01/$0.02 USD) - 2021/07/16 10:54:43 PT [2021/07/16 13:54:43 ET]
Table 'Sorga' 9-max Seat #1 is the button
Seat 1: rashidmoo ($2.29 in chips) 
Seat 4: GB155 ($1.70 in chips) 
Seat 5: agonzalezelh ($2.14 in chips) 
Seat 6: Dorex2007 ($2.50 in chips) 
Seat 7: jgino14 ($2.31 in chips) 
Seat 8: AlekxSly ($0.92 in chips) 
Seat 9: LuisZeifer ($2.02 in chips) 
GB155: posts small blind $0.01
agonzalezelh: posts big blind $0.02
*** HOLE CARDS ***
Dealt to Dorex2007 [7c Jh]
Dorex2007: folds 
jgino14: folds 
AlekxSly has timed out
AlekxSly: folds 
LuisZeifer: folds 
rashidmoo: folds 
GB155: calls $0.01
agonzalezelh: checks 
*** FLOP *** [Ad 6s Kh]
GB155: checks 
agonzalezelh: checks 
*** TURN *** [Ad 6s Kh] [8d]
GB155: checks 
agonzalezelh: bets $0.04
GB155: folds 
Uncalled bet ($0.04) returned to agonzalezelh
agonzalezelh collected $0.04 from pot
agonzalezelh: doesn't show hand 
*** SUMMARY ***
Total pot $0.04 | Rake $0 
Board [Ad 6s Kh 8d]
Seat 1: rashidmoo (button) folded before Flop (didn't bet)
Seat 4: GB155 (small blind) folded on the Turn
Seat 5: agonzalezelh (big blind) collected ($0.04)
Seat 6: Dorex2007 folded before Flop (didn't bet)
Seat 7: jgino14 folded before Flop (didn't bet)
Seat 8: AlekxSly folded before Flop (didn't bet)
Seat 9: LuisZeifer folded before Flop (didn't bet)



PokerStars Hand #228335561238:  Hold'em No Limit ($0.01/$0.02 USD) - 2021/07/16 10:55:30 PT [2021/07/16 13:55:30 ET]
Table 'Sorga' 9-max Seat #4 is the button
Seat 1: rashidmoo ($2.29 in chips) 
Seat 4: GB155 ($1.68 in chips) 
Seat 5: agonzalezelh ($2.16 in chips) 
Seat 6: Dorex2007 ($2.50 in chips) 
Seat 7: jgino14 ($2.31 in chips) 
Seat 8: AlekxSly ($0.92 in chips) 
Seat 9: LuisZeifer ($2.02 in chips) 
agonzalezelh: posts small blind $0.01
Dorex2007: posts big blind $0.02
*** HOLE CARDS ***
Dealt to Dorex2007 [2d Qh]
jgino14: folds 
AlekxSly: folds 
LuisZeifer: raises $0.02 to $0.04
rashidmoo: folds 
GB155: raises $0.02 to $0.06
agonzalezelh: calls $0.05
Dorex2007: folds 
LuisZeifer: calls $0.02
*** FLOP *** [6d 4c 3h]
agonzalezelh: bets $0.10
LuisZeifer: folds 
GB155: folds 
Uncalled bet ($0.10) returned to agonzalezelh
agonzalezelh collected $0.19 from pot
agonzalezelh: doesn't show hand 
*** SUMMARY ***
Total pot $0.20 | Rake $0.01 
Board [6d 4c 3h]
Seat 1: rashidmoo folded before Flop (didn't bet)
Seat 4: GB155 (button) folded on the Flop
Seat 5: agonzalezelh (small blind) collected ($0.19)
Seat 6: Dorex2007 (big blind) folded before Flop
Seat 7: jgino14 folded before Flop (didn't bet)
Seat 8: AlekxSly folded before Flop (didn't bet)
Seat 9: LuisZeifer folded on the Flop



PokerStars Hand #228335580720:  Hold'em No Limit ($0.01/$0.02 USD) - 2021/07/16 10:56:17 PT [2021/07/16 13:56:17 ET]
Table 'Sorga' 9-max Seat #5 is the button
Seat 1: rashidmoo ($2.29 in chips) 
Seat 4: GB155 ($1.62 in chips) 
Seat 5: agonzalezelh ($2.29 in chips) 
Seat 6: Dorex2007 ($2.48 in chips) 
Seat 7: jgino14 ($2.31 in chips) 
Seat 8: AlekxSly ($0.92 in chips) 
Seat 9: LuisZeifer ($1.96 in chips) 
Dorex2007: posts small blind $0.01
jgino14: posts big blind $0.02
*** HOLE CARDS ***
Dealt to Dorex2007 [Jd Jh]
AlekxSly: calls $0.02
LuisZeifer has timed out
LuisZeifer: folds 
rashidmoo: folds 
GB155: folds 
agonzalezelh: calls $0.02
Dorex2007: raises $0.10 to $0.12
jgino14: folds 
AlekxSly: folds 
agonzalezelh: folds 
Uncalled bet ($0.10) returned to Dorex2007
Dorex2007 collected $0.08 from pot
Dorex2007: doesn't show hand 
*** SUMMARY ***
Total pot $0.08 | Rake $0 
Seat 1: rashidmoo folded before Flop (didn't bet)
Seat 4: GB155 folded before Flop (didn't bet)
Seat 5: agonzalezelh (button) folded before Flop
Seat 6: Dorex2007 (small blind) collected ($0.08)
Seat 7: jgino14 (big blind) folded before Flop
Seat 8: AlekxSly folded before Flop
Seat 9: LuisZeifer folded before Flop (didn't bet)



PokerStars Hand #228335589130:  Hold'em No Limit ($0.01/$0.02 USD) - 2021/07/16 10:56:48 PT [2021/07/16 13:56:48 ET]
Table 'Sorga' 9-max Seat #6 is the button
Seat 1: rashidmoo ($2.29 in chips) 
Seat 4: GB155 ($1.62 in chips) 
Seat 5: agonzalezelh ($2.27 in chips) 
Seat 6: Dorex2007 ($2.54 in chips) 
Seat 7: jgino14 ($2.29 in chips) 
Seat 8: AlekxSly ($0.90 in chips) 
Seat 9: LuisZeifer ($1.96 in chips) 
jgino14: posts small blind $0.01
AlekxSly: posts big blind $0.02
*** HOLE CARDS ***
Dealt to Dorex2007 [Jc Ac]
LuisZeifer: calls $0.02
rashidmoo: folds 
GB155 has timed out
GB155: folds 
agonzalezelh: raises $0.04 to $0.06
Dorex2007: calls $0.06
nl_kmas leaves the table
jgino14: folds 
AlekxSly: calls $0.04
LuisZeifer: calls $0.04
*** FLOP *** [7s 3c 9d]
AlekxSly: checks 
LuisZeifer: bets $0.12
agonzalezelh: folds 
djiga.1215 joins the table at seat #3 
Dorex2007: folds 
AlekxSly: calls $0.12
*** TURN *** [7s 3c 9d] [3d]
AlekxSly: checks 
LuisZeifer: bets $0.28
AlekxSly: folds 
Uncalled bet ($0.28) returned to LuisZeifer
LuisZeifer collected $0.47 from pot
*** SUMMARY ***
Total pot $0.49 | Rake $0.02 
Board [7s 3c 9d 3d]
Seat 1: rashidmoo folded before Flop (didn't bet)
Seat 4: GB155 folded before Flop (didn't bet)
Seat 5: agonzalezelh folded on the Flop
Seat 6: Dorex2007 (button) folded on the Flop
Seat 7: jgino14 (small blind) folded before Flop
Seat 8: AlekxSly (big blind) folded on the Turn
Seat 9: LuisZeifer collected ($0.47)



PokerStars Hand #228335616085:  Hold'em No Limit ($0.01/$0.02 USD) - 2021/07/16 10:58:24 PT [2021/07/16 13:58:24 ET]
Table 'Sorga' 9-max Seat #7 is the button
Seat 1: rashidmoo ($2.29 in chips) 
Seat 4: GB155 ($1.62 in chips) 
Seat 5: agonzalezelh ($2.21 in chips) 
Seat 6: Dorex2007 ($2.48 in chips) 
Seat 7: jgino14 ($2.28 in chips) 
Seat 8: AlekxSly ($1 in chips) 
Seat 9: LuisZeifer ($2.25 in chips) 
AlekxSly: posts small blind $0.01
LuisZeifer: posts big blind $0.02
djiga.1215: sits out 
*** HOLE CARDS ***
Dealt to Dorex2007 [7s 7d]
rashidmoo: folds 
GB155: folds 
agonzalezelh: raises $0.04 to $0.06
Dorex2007: calls $0.06
jgino14: folds 
AlekxSly: folds 
LuisZeifer: folds 
*** FLOP *** [Jc Ks As]
agonzalezelh: bets $0.07
Dorex2007: folds 
Uncalled bet ($0.07) returned to agonzalezelh
agonzalezelh collected $0.14 from pot
agonzalezelh: doesn't show hand 
*** SUMMARY ***
Total pot $0.15 | Rake $0.01 
Board [Jc Ks As]
Seat 1: rashidmoo folded before Flop (didn't bet)
Seat 4: GB155 folded before Flop (didn't bet)
Seat 5: agonzalezelh collected ($0.14)
Seat 6: Dorex2007 folded on the Flop
Seat 7: jgino14 (button) folded before Flop (didn't bet)
Seat 8: AlekxSly (small blind) folded before Flop
Seat 9: LuisZeifer (big blind) folded before Flop



PokerStars Hand #228335622330:  Hold'em No Limit ($0.01/$0.02 USD) - 2021/07/16 10:58:47 PT [2021/07/16 13:58:47 ET]
Table 'Sorga' 9-max Seat #8 is the button
Seat 1: rashidmoo ($2.29 in chips) 
Seat 4: GB155 ($1.62 in chips) 
Seat 5: agonzalezelh ($2.29 in chips) 
Seat 6: Dorex2007 ($2.42 in chips) 
Seat 7: jgino14 ($2.28 in chips) 
Seat 8: AlekxSly ($0.99 in chips) 
Seat 9: LuisZeifer ($2.23 in chips) 
LuisZeifer: posts small blind $0.01
rashidmoo: posts big blind $0.02
djiga.1215: sits out 
*** HOLE CARDS ***
Dealt to Dorex2007 [8s Qd]
GB155: folds 
agonzalezelh: calls $0.02
Dorex2007: folds 
jgino14: folds 
AlekxSly: calls $0.02
LuisZeifer: calls $0.01
rashidmoo: checks 
*** FLOP *** [Qh 7h 9h]
LuisZeifer: checks 
rashidmoo: checks 
agonzalezelh: checks 
AlekxSly: checks 
*** TURN *** [Qh 7h 9h] [2h]
LuisZeifer: checks 
rashidmoo: checks 
agonzalezelh: bets $0.08
AlekxSly: folds 
LuisZeifer: folds 
rashidmoo: folds 
Uncalled bet ($0.08) returned to agonzalezelh
agonzalezelh collected $0.08 from pot
agonzalezelh: doesn't show hand 
*** SUMMARY ***
Total pot $0.08 | Rake $0 
Board [Qh 7h 9h 2h]
Seat 1: rashidmoo (big blind) folded on the Turn
Seat 4: GB155 folded before Flop (didn't bet)
Seat 5: agonzalezelh collected ($0.08)
Seat 6: Dorex2007 folded before Flop (didn't bet)
Seat 7: jgino14 folded before Flop (didn't bet)
Seat 8: AlekxSly (button) folded on the Turn
Seat 9: LuisZeifer (small blind) folded on the Turn



PokerStars Hand #228335643136:  Hold'em No Limit ($0.01/$0.02 USD) - 2021/07/16 11:00:01 PT [2021/07/16 14:00:01 ET]
Table 'Sorga' 9-max Seat #9 is the button
Seat 1: rashidmoo ($2.27 in chips) 
Seat 3: djiga.1215 ($1.35 in chips) 
Seat 4: GB155 ($1.62 in chips) 
Seat 5: agonzalezelh ($2.35 in chips) 
Seat 6: Dorex2007 ($2.42 in chips) 
Seat 7: jgino14 ($2.28 in chips) 
Seat 8: AlekxSly ($0.97 in chips) 
Seat 9: LuisZeifer ($2.21 in chips) 
rashidmoo: posts small blind $0.01
djiga.1215: posts big blind $0.02
*** HOLE CARDS ***
Dealt to Dorex2007 [Kd 8s]
GB155: folds 
agonzalezelh: folds 
Dorex2007: folds 
jgino14: folds 
AlekxSly: calls $0.02
LuisZeifer: folds 
rashidmoo: folds 
djiga.1215: raises $0.03 to $0.05
AlekxSly: folds 
Uncalled bet ($0.03) returned to djiga.1215
djiga.1215 collected $0.05 from pot
djiga.1215: doesn't show hand 
*** SUMMARY ***
Total pot $0.05 | Rake $0 
Seat 1: rashidmoo (small blind) folded before Flop
Seat 3: djiga.1215 (big blind) collected ($0.05)
Seat 4: GB155 folded before Flop (didn't bet)
Seat 5: agonzalezelh folded before Flop (didn't bet)
Seat 6: Dorex2007 folded before Flop (didn't bet)
Seat 7: jgino14 folded before Flop (didn't bet)
Seat 8: AlekxSly folded before Flop
Seat 9: LuisZeifer (button) folded before Flop (didn't bet)



PokerStars Hand #228335650920:  Hold'em No Limit ($0.01/$0.02 USD) - 2021/07/16 11:00:27 PT [2021/07/16 14:00:27 ET]
Table 'Sorga' 9-max Seat #1 is the button
Seat 1: rashidmoo ($2.26 in chips) 
Seat 3: djiga.1215 ($1.38 in chips) 
Seat 4: GB155 ($1.62 in chips) 
Seat 5: agonzalezelh ($2.35 in chips) 
Seat 6: Dorex2007 ($2.42 in chips) 
Seat 7: jgino14 ($2.28 in chips) 
Seat 8: AlekxSly ($0.95 in chips) 
Seat 9: LuisZeifer ($2.21 in chips) 
djiga.1215: posts small blind $0.01
GB155: posts big blind $0.02
*** HOLE CARDS ***
Dealt to Dorex2007 [Jh 6c]
agonzalezelh: raises $0.04 to $0.06
Dorex2007: folds 
jgino14: folds 
AlekxSly: folds 
LuisZeifer: calls $0.06
rashidmoo: raises $0.12 to $0.18
djiga.1215: folds 
GB155: folds 
agonzalezelh: calls $0.12
LuisZeifer: calls $0.12
*** FLOP *** [3h 6d 7s]
agonzalezelh: checks 
LuisZeifer: checks 
rashidmoo: bets $0.19
agonzalezelh: folds 
LuisZeifer: folds 
Uncalled bet ($0.19) returned to rashidmoo
rashidmoo collected $0.55 from pot
rashidmoo: doesn't show hand 
*** SUMMARY ***
Total pot $0.57 | Rake $0.02 
Board [3h 6d 7s]
Seat 1: rashidmoo (button) collected ($0.55)
Seat 3: djiga.1215 (small blind) folded before Flop
Seat 4: GB155 (big blind) folded before Flop
Seat 5: agonzalezelh folded on the Flop
Seat 6: Dorex2007 folded before Flop (didn't bet)
Seat 7: jgino14 folded before Flop (didn't bet)
Seat 8: AlekxSly folded before Flop (didn't bet)
Seat 9: LuisZeifer folded on the Flop



PokerStars Hand #228335682328:  Hold'em No Limit ($0.01/$0.02 USD) - 2021/07/16 11:01:56 PT [2021/07/16 14:01:56 ET]
Table 'Sorga' 9-max Seat #3 is the button
Seat 1: rashidmoo ($2.63 in chips) 
Seat 3: djiga.1215 ($1.37 in chips) 
Seat 4: GB155 ($1.60 in chips) 
Seat 5: agonzalezelh ($2.17 in chips) 
Seat 6: Dorex2007 ($2.42 in chips) 
Seat 7: jgino14 ($2.28 in chips) 
Seat 8: AlekxSly ($0.95 in chips) 
Seat 9: LuisZeifer ($2.03 in chips) 
GB155: posts small blind $0.01
agonzalezelh: posts big blind $0.02
*** HOLE CARDS ***
Dealt to Dorex2007 [Ad Th]
Dorex2007: folds 
jgino14: folds 
Ooptimax leaves the table
AlekxSly: folds 
LuisZeifer: raises $0.02 to $0.04
rashidmoo: folds 
djiga.1215: folds 
GB155: folds 
agonzalezelh: calls $0.02
*** FLOP *** [Ks 2d 7h]
agonzalezelh: bets $0.05
4col-fel7 joins the table at seat #2 
LuisZeifer: raises $0.10 to $0.15
agonzalezelh: calls $0.10
*** TURN *** [Ks 2d 7h] [5d]
agonzalezelh: bets $0.38
LuisZeifer: calls $0.38
*** RIVER *** [Ks 2d 7h 5d] [8c]
agonzalezelh: checks 
LuisZeifer: checks 
*** SHOW DOWN ***
agonzalezelh: shows [Kh 3d] (a pair of Kings)
LuisZeifer: shows [Qh Kd] (a pair of Kings - Queen kicker)
LuisZeifer collected $1.10 from pot
*** SUMMARY ***
Total pot $1.15 | Rake $0.05 
Board [Ks 2d 7h 5d 8c]
Seat 1: rashidmoo folded before Flop (didn't bet)
Seat 3: djiga.1215 (button) folded before Flop (didn't bet)
Seat 4: GB155 (small blind) folded before Flop
Seat 5: agonzalezelh (big blind) showed [Kh 3d] and lost with a pair of Kings
Seat 6: Dorex2007 folded before Flop (didn't bet)
Seat 7: jgino14 folded before Flop (didn't bet)
Seat 8: AlekxSly folded before Flop (didn't bet)
Seat 9: LuisZeifer showed [Qh Kd] and won ($1.10) with a pair of Kings



PokerStars Hand #228335705830:  Hold'em No Limit ($0.01/$0.02 USD) - 2021/07/16 11:02:56 PT [2021/07/16 14:02:56 ET]
Table 'Sorga' 9-max Seat #4 is the button
Seat 1: rashidmoo ($2.63 in chips) 
Seat 3: djiga.1215 ($1.37 in chips) 
Seat 4: GB155 ($1.59 in chips) 
Seat 5: agonzalezelh ($1.60 in chips) 
Seat 6: Dorex2007 ($2.42 in chips) 
Seat 7: jgino14 ($2.28 in chips) 
Seat 8: AlekxSly ($0.95 in chips) 
Seat 9: LuisZeifer ($2.56 in chips) 
agonzalezelh: posts small blind $0.01
Dorex2007: posts big blind $0.02
4col-fel7: sits out 
*** HOLE CARDS ***
Dealt to Dorex2007 [3c Ad]
jgino14: folds 
AlekxSly: folds 
LuisZeifer: folds 
rashidmoo: folds 
djiga.1215: folds 
GB155: calls $0.02
agonzalezelh: calls $0.01
Dorex2007: checks 
*** FLOP *** [3h Js 3d]
agonzalezelh: checks 
Dorex2007: checks 
GB155: checks 
*** TURN *** [3h Js 3d] [5c]
agonzalezelh: bets $0.06
Dorex2007: calls $0.06
GB155: calls $0.06
*** RIVER *** [3h Js 3d 5c] [Qs]
agonzalezelh: checks 
Dorex2007: bets $0.15
GB155: raises $0.15 to $0.30
agonzalezelh: folds 
Dorex2007: raises $0.15 to $0.45
GB155: raises $1.06 to $1.51 and is all-in
Dorex2007: calls $1.06
*** SHOW DOWN ***
GB155: shows [Kc 3s] (three of a kind, Threes)
Dorex2007: shows [3c Ad] (three of a kind, Threes - Ace kicker)
Dorex2007 collected $3.15 from pot
*** SUMMARY ***
Total pot $3.26 | Rake $0.11 
Board [3h Js 3d 5c Qs]
Seat 1: rashidmoo folded before Flop (didn't bet)
Seat 3: djiga.1215 folded before Flop (didn't bet)
Seat 4: GB155 (button) showed [Kc 3s] and lost with three of a kind, Threes
Seat 5: agonzalezelh (small blind) folded on the River
Seat 6: Dorex2007 (big blind) showed [3c Ad] and won ($3.15) with three of a kind, Threes
Seat 7: jgino14 folded before Flop (didn't bet)
Seat 8: AlekxSly folded before Flop (didn't bet)
Seat 9: LuisZeifer folded before Flop (didn't bet)



PokerStars Hand #228335742326:  Hold'em No Limit ($0.01/$0.02 USD) - 2021/07/16 11:04:28 PT [2021/07/16 14:04:28 ET]
Table 'Sorga' 9-max Seat #5 is the button
Seat 1: rashidmoo ($2.63 in chips) 
Seat 3: djiga.1215 ($1.37 in chips) 
Seat 5: agonzalezelh ($1.52 in chips) 
Seat 6: Dorex2007 ($3.98 in chips) 
Seat 7: jgino14 ($2.28 in chips) 
Seat 8: AlekxSly ($0.95 in chips) 
Seat 9: LuisZeifer ($2.56 in chips) 
Dorex2007: posts small blind $0.01
jgino14: posts big blind $0.02
4col-fel7: sits out 
*** HOLE CARDS ***
Dealt to Dorex2007 [9d 6s]
AlekxSly: folds 
LuisZeifer: folds 
rashidmoo: folds 
djiga.1215: folds 
GB155 leaves the table
Dorex2007 said, "squeeker"
agonzalezelh: calls $0.02
Dorex2007: folds 
jgino14: checks 
*** FLOP *** [Jh Ac 2h]
Dr_Poliakov joins the table at seat #4 
jgino14: checks 
agonzalezelh: bets $0.05
jgino14: calls $0.05
*** TURN *** [Jh Ac 2h] [3d]
jgino14: checks 
agonzalezelh: checks 
*** RIVER *** [Jh Ac 2h 3d] [Kh]
jgino14: bets $0.09
agonzalezelh: raises $0.16 to $0.25
jgino14: calls $0.16
*** SHOW DOWN ***
agonzalezelh: shows [Ts 2s] (a pair of Deuces)
jgino14: shows [4s Ah] (a pair of Aces)
jgino14 collected $0.63 from pot
*** SUMMARY ***
Total pot $0.65 | Rake $0.02 
Board [Jh Ac 2h 3d Kh]
Seat 1: rashidmoo folded before Flop (didn't bet)
Seat 3: djiga.1215 folded before Flop (didn't bet)
Seat 5: agonzalezelh (button) showed [Ts 2s] and lost with a pair of Deuces
Seat 6: Dorex2007 (small blind) folded before Flop
Seat 7: jgino14 (big blind) showed [4s Ah] and won ($0.63) with a pair of Aces
Seat 8: AlekxSly folded before Flop (didn't bet)
Seat 9: LuisZeifer folded before Flop (didn't bet)



PokerStars Hand #228335777602:  Hold'em No Limit ($0.01/$0.02 USD) - 2021/07/16 11:05:55 PT [2021/07/16 14:05:55 ET]
Table 'Sorga' 9-max Seat #6 is the button
Seat 1: rashidmoo ($2.63 in chips) 
Seat 3: djiga.1215 ($1.37 in chips) 
Seat 5: agonzalezelh ($1.20 in chips) 
Seat 6: Dorex2007 ($3.97 in chips) 
Seat 7: jgino14 ($2.59 in chips) 
Seat 8: AlekxSly ($0.95 in chips) 
Seat 9: LuisZeifer ($2.56 in chips) 
jgino14: posts small blind $0.01
AlekxSly: posts big blind $0.02
4col-fel7: sits out 
Dr_Poliakov: sits out 
*** HOLE CARDS ***
Dealt to Dorex2007 [7s 4d]
LuisZeifer: folds 
rashidmoo: folds 
djiga.1215: folds 
agonzalezelh: raises $0.04 to $0.06
Dorex2007: folds 
jgino14: calls $0.05
AlekxSly: folds 
*** FLOP *** [9c 5s Jh]
jgino14: checks 
agonzalezelh: bets $0.07
jgino14: calls $0.07
*** TURN *** [9c 5s Jh] [Th]
jgino14: checks 
agonzalezelh: bets $0.14
jgino14: calls $0.14
*** RIVER *** [9c 5s Jh Th] [6c]
jgino14: checks 
agonzalezelh: bets $0.27
jgino14: folds 
Uncalled bet ($0.27) returned to agonzalezelh
agonzalezelh collected $0.54 from pot
agonzalezelh: doesn't show hand 
*** SUMMARY ***
Total pot $0.56 | Rake $0.02 
Board [9c 5s Jh Th 6c]
Seat 1: rashidmoo folded before Flop (didn't bet)
Seat 3: djiga.1215 folded before Flop (didn't bet)
Seat 5: agonzalezelh collected ($0.54)
Seat 6: Dorex2007 (button) folded before Flop (didn't bet)
Seat 7: jgino14 (small blind) folded on the River
Seat 8: AlekxSly (big blind) folded before Flop
Seat 9: LuisZeifer folded before Flop (didn't bet)



PokerStars Hand #228335809378:  Hold'em No Limit ($0.01/$0.02 USD) - 2021/07/16 11:07:13 PT [2021/07/16 14:07:13 ET]
Table 'Sorga' 9-max Seat #7 is the button
Seat 1: rashidmoo ($2.63 in chips) 
Seat 3: djiga.1215 ($1.37 in chips) 
Seat 5: agonzalezelh ($1.47 in chips) 
Seat 6: Dorex2007 ($3.97 in chips) 
Seat 7: jgino14 ($2.32 in chips) 
Seat 8: AlekxSly ($0.93 in chips) 
Seat 9: LuisZeifer ($2.56 in chips) 
AlekxSly: posts small blind $0.01
LuisZeifer: posts big blind $0.02
4col-fel7: sits out 
Dr_Poliakov: sits out 
*** HOLE CARDS ***
Dealt to Dorex2007 [Jh Ah]
rashidmoo: folds 
djiga.1215: calls $0.02
agonzalezelh: folds 
Dorex2007: raises $0.04 to $0.06
jgino14: folds 
AlekxSly: folds 
LuisZeifer: folds 
djiga.1215: calls $0.04
*** FLOP *** [8c Tc Ks]
djiga.1215: checks 
Dorex2007: checks 
*** TURN *** [8c Tc Ks] [2h]
djiga.1215: checks 
Dorex2007: checks 
*** RIVER *** [8c Tc Ks 2h] [3c]
djiga.1215: checks 
Dorex2007: checks 
*** SHOW DOWN ***
djiga.1215: shows [As 2d] (a pair of Deuces)
Dorex2007: mucks hand 
djiga.1215 collected $0.14 from pot
*** SUMMARY ***
Total pot $0.15 | Rake $0.01 
Board [8c Tc Ks 2h 3c]
Seat 1: rashidmoo folded before Flop (didn't bet)
Seat 3: djiga.1215 showed [As 2d] and won ($0.14) with a pair of Deuces
Seat 5: agonzalezelh folded before Flop (didn't bet)
Seat 6: Dorex2007 mucked [Jh Ah]
Seat 7: jgino14 (button) folded before Flop (didn't bet)
Seat 8: AlekxSly (small blind) folded before Flop
Seat 9: LuisZeifer (big blind) folded before Flop



PokerStars Hand #228335826703:  Hold'em No Limit ($0.01/$0.02 USD) - 2021/07/16 11:07:56 PT [2021/07/16 14:07:56 ET]
Table 'Sorga' 9-max Seat #8 is the button
Seat 1: rashidmoo ($2.63 in chips) 
Seat 3: djiga.1215 ($1.45 in chips) 
Seat 5: agonzalezelh ($1.47 in chips) 
Seat 6: Dorex2007 ($3.91 in chips) 
Seat 7: jgino14 ($2.32 in chips) 
Seat 8: AlekxSly ($0.92 in chips) 
Seat 9: LuisZeifer ($2.54 in chips) 
LuisZeifer: posts small blind $0.01
rashidmoo: posts big blind $0.02
4col-fel7: sits out 
Dr_Poliakov: sits out 
*** HOLE CARDS ***
Dealt to Dorex2007 [9d 3d]
djiga.1215: folds 
agonzalezelh: folds 
Dorex2007: folds 
jgino14: folds 
AlekxSly: raises $0.02 to $0.04
LuisZeifer: folds 
rashidmoo: folds 
Uncalled bet ($0.02) returned to AlekxSly
AlekxSly collected $0.05 from pot
AlekxSly: doesn't show hand 
*** SUMMARY ***
Total pot $0.05 | Rake $0 
Seat 1: rashidmoo (big blind) folded before Flop
Seat 3: djiga.1215 folded before Flop (didn't bet)
Seat 5: agonzalezelh folded before Flop (didn't bet)
Seat 6: Dorex2007 folded before Flop (didn't bet)
Seat 7: jgino14 folded before Flop (didn't bet)
Seat 8: AlekxSly (button) collected ($0.05)
Seat 9: LuisZeifer (small blind) folded before Flop



PokerStars Hand #228335851186:  Hold'em No Limit ($0.01/$0.02 USD) - 2021/07/16 11:09:03 PT [2021/07/16 14:09:03 ET]
Table 'Sorga' 9-max Seat #9 is the button
Seat 1: rashidmoo ($2.61 in chips) 
Seat 2: 4col-fel7 ($0.80 in chips) 
Seat 3: djiga.1215 ($1.45 in chips) 
Seat 5: agonzalezelh ($1.47 in chips) 
Seat 6: Dorex2007 ($3.91 in chips) 
Seat 7: jgino14 ($2.32 in chips) 
Seat 8: AlekxSly ($0.95 in chips) 
Seat 9: LuisZeifer ($2.53 in chips) 
rashidmoo: posts small blind $0.01
4col-fel7: posts big blind $0.02
Dr_Poliakov: sits out 
*** HOLE CARDS ***
Dealt to Dorex2007 [Kc Ah]
djiga.1215: raises $0.03 to $0.05
agonzalezelh: calls $0.05
Dorex2007: calls $0.05
jgino14: folds 
AlekxSly: folds 
LuisZeifer has timed out
LuisZeifer: folds 
rashidmoo: folds 
4col-fel7: folds 
*** FLOP *** [7h 3d Ts]
djiga.1215: bets $0.08
agonzalezelh: folds 
Dorex2007: folds 
Uncalled bet ($0.08) returned to djiga.1215
djiga.1215 collected $0.17 from pot
djiga.1215: doesn't show hand 
*** SUMMARY ***
Total pot $0.18 | Rake $0.01 
Board [7h 3d Ts]
Seat 1: rashidmoo (small blind) folded before Flop
Seat 2: 4col-fel7 (big blind) folded before Flop
Seat 3: djiga.1215 collected ($0.17)
Seat 5: agonzalezelh folded on the Flop
Seat 6: Dorex2007 folded on the Flop
Seat 7: jgino14 folded before Flop (didn't bet)
Seat 8: AlekxSly folded before Flop (didn't bet)
Seat 9: LuisZeifer (button) folded before Flop (didn't bet)



PokerStars Hand #228335873365:  Hold'em No Limit ($0.01/$0.02 USD) - 2021/07/16 11:09:56 PT [2021/07/16 14:09:56 ET]
Table 'Sorga' 9-max Seat #1 is the button
Seat 1: rashidmoo ($2.60 in chips) 
Seat 2: 4col-fel7 ($0.80 in chips) 
Seat 3: djiga.1215 ($1.57 in chips) 
Seat 5: agonzalezelh ($1.42 in chips) 
Seat 6: Dorex2007 ($3.86 in chips) 
Seat 7: jgino14 ($2.32 in chips) 
Seat 8: AlekxSly ($0.95 in chips) 
4col-fel7: posts small blind $0.01
djiga.1215: posts big blind $0.02
Dr_Poliakov: sits out 
*** HOLE CARDS ***
Dealt to Dorex2007 [4d 3s]
agonzalezelh: calls $0.02
Dorex2007: raises $0.02 to $0.04
jgino14: folds 
AlekxSly: folds 
rashidmoo: calls $0.04
4col-fel7: folds 
djiga.1215: raises $0.13 to $0.17
agonzalezelh: folds 
Dorex2007: folds 
rashidmoo: folds 
Uncalled bet ($0.13) returned to djiga.1215
djiga.1215 collected $0.15 from pot
djiga.1215: doesn't show hand 
*** SUMMARY ***
Total pot $0.15 | Rake $0 
Seat 1: rashidmoo (button) folded before Flop
Seat 2: 4col-fel7 (small blind) folded before Flop
Seat 3: djiga.1215 (big blind) collected ($0.15)
Seat 5: agonzalezelh folded before Flop
Seat 6: Dorex2007 folded before Flop
Seat 7: jgino14 folded before Flop (didn't bet)
Seat 8: AlekxSly folded before Flop (didn't bet)



PokerStars Hand #228335886150:  Hold'em No Limit ($0.01/$0.02 USD) - 2021/07/16 11:10:28 PT [2021/07/16 14:10:28 ET]
Table 'Sorga' 9-max Seat #2 is the button
Seat 1: rashidmoo ($2.56 in chips) 
Seat 2: 4col-fel7 ($0.80 in chips) 
Seat 3: djiga.1215 ($1.68 in chips) 
Seat 4: Dr_Poliakov ($2 in chips) 
Seat 5: agonzalezelh ($1.40 in chips) 
Seat 6: Dorex2007 ($3.82 in chips) 
Seat 7: jgino14 ($2.32 in chips) 
Seat 8: AlekxSly ($0.95 in chips) 
djiga.1215: posts small blind $0.01
Dr_Poliakov: posts big blind $0.02
*** HOLE CARDS ***
Dealt to Dorex2007 [Qh 3h]
agonzalezelh: calls $0.02
Dorex2007: folds 
jgino14: folds 
AlekxSly: folds 
rashidmoo: folds 
4col-fel7: calls $0.02
djiga.1215: calls $0.01
Dr_Poliakov: checks 
*** FLOP *** [Ks 7s 8c]
djiga.1215: checks 
Dr_Poliakov: checks 
agonzalezelh: checks 
4col-fel7: checks 
*** TURN *** [Ks 7s 8c] [5d]
djiga.1215: checks 
Dr_Poliakov: checks 
agonzalezelh: bets $0.08
4col-fel7: folds 
djiga.1215: calls $0.08
Dr_Poliakov: folds 
*** RIVER *** [Ks 7s 8c 5d] [6c]
djiga.1215: bets $0.23
agonzalezelh: folds 
Uncalled bet ($0.23) returned to djiga.1215
djiga.1215 collected $0.23 from pot
djiga.1215: doesn't show hand 
*** SUMMARY ***
Total pot $0.24 | Rake $0.01 
Board [Ks 7s 8c 5d 6c]
Seat 1: rashidmoo folded before Flop (didn't bet)
Seat 2: 4col-fel7 (button) folded on the Turn
Seat 3: djiga.1215 (small blind) collected ($0.23)
Seat 4: Dr_Poliakov (big blind) folded on the Turn
Seat 5: agonzalezelh folded on the River
Seat 6: Dorex2007 folded before Flop (didn't bet)
Seat 7: jgino14 folded before Flop (didn't bet)
Seat 8: AlekxSly folded before Flop (didn't bet)



PokerStars Hand #228335921027:  Hold'em No Limit ($0.01/$0.02 USD) - 2021/07/16 11:11:35 PT [2021/07/16 14:11:35 ET]
Table 'Sorga' 9-max Seat #3 is the button
Seat 1: rashidmoo ($2.56 in chips) 
Seat 2: 4col-fel7 ($0.80 in chips) 
Seat 3: djiga.1215 ($1.81 in chips) 
Seat 4: Dr_Poliakov ($2 in chips) 
Seat 5: agonzalezelh ($1.30 in chips) 
Seat 6: Dorex2007 ($3.82 in chips) 
Seat 7: jgino14 ($2.32 in chips) 
Seat 8: AlekxSly ($0.95 in chips) 
Seat 9: LuisZeifer ($2.53 in chips) 
Dr_Poliakov: posts small blind $0.01
agonzalezelh: posts big blind $0.02
*** HOLE CARDS ***
Dealt to Dorex2007 [2d As]
Dorex2007: folds 
jgino14: folds 
AlekxSly: folds 
LuisZeifer: folds 
rashidmoo: raises $0.04 to $0.06
4col-fel7: folds 
djiga.1215: folds 
Dr_Poliakov: folds 
agonzalezelh: calls $0.04
*** FLOP *** [Jc Tc 6c]
agonzalezelh: checks 
rashidmoo: checks 
*** TURN *** [Jc Tc 6c] [6s]
agonzalezelh: bets $0.13
rashidmoo: folds 
Uncalled bet ($0.13) returned to agonzalezelh
agonzalezelh collected $0.13 from pot
agonzalezelh: doesn't show hand 
*** SUMMARY ***
Total pot $0.13 | Rake $0 
Board [Jc Tc 6c 6s]
Seat 1: rashidmoo folded on the Turn
Seat 2: 4col-fel7 folded before Flop (didn't bet)
Seat 3: djiga.1215 (button) folded before Flop (didn't bet)
Seat 4: Dr_Poliakov (small blind) folded before Flop
Seat 5: agonzalezelh (big blind) collected ($0.13)
Seat 6: Dorex2007 folded before Flop (didn't bet)
Seat 7: jgino14 folded before Flop (didn't bet)
Seat 8: AlekxSly folded before Flop (didn't bet)
Seat 9: LuisZeifer folded before Flop (didn't bet)



PokerStars Hand #228335939489:  Hold'em No Limit ($0.01/$0.02 USD) - 2021/07/16 11:12:21 PT [2021/07/16 14:12:21 ET]
Table 'Sorga' 9-max Seat #4 is the button
Seat 1: rashidmoo ($2.50 in chips) 
Seat 2: 4col-fel7 ($0.80 in chips) 
Seat 3: djiga.1215 ($1.81 in chips) 
Seat 4: Dr_Poliakov ($2 in chips) 
Seat 5: agonzalezelh ($1.37 in chips) 
Seat 6: Dorex2007 ($3.82 in chips) 
Seat 7: jgino14 ($2.32 in chips) 
Seat 8: AlekxSly ($0.95 in chips) 
Seat 9: LuisZeifer ($2.53 in chips) 
agonzalezelh: posts small blind $0.01
Dorex2007: posts big blind $0.02
*** HOLE CARDS ***
Dealt to Dorex2007 [As 7d]
jgino14: folds 
AlekxSly: folds 
LuisZeifer: folds 
rashidmoo: folds 
4col-fel7: folds 
djiga.1215: folds 
Dr_Poliakov: raises $0.02 to $0.04
agonzalezelh: calls $0.03
Dorex2007: folds 
*** FLOP *** [Td Ac 5c]
agonzalezelh: checks 
Dr_Poliakov: bets $0.03
agonzalezelh: calls $0.03
*** TURN *** [Td Ac 5c] [Kc]
agonzalezelh: checks 
Dr_Poliakov: checks 
*** RIVER *** [Td Ac 5c Kc] [8s]
agonzalezelh: bets $0.15
Dr_Poliakov: folds 
Uncalled bet ($0.15) returned to agonzalezelh
agonzalezelh collected $0.15 from pot
agonzalezelh: doesn't show hand 
*** SUMMARY ***
Total pot $0.16 | Rake $0.01 
Board [Td Ac 5c Kc 8s]
Seat 1: rashidmoo folded before Flop (didn't bet)
Seat 2: 4col-fel7 folded before Flop (didn't bet)
Seat 3: djiga.1215 folded before Flop (didn't bet)
Seat 4: Dr_Poliakov (button) folded on the River
Seat 5: agonzalezelh (small blind) collected ($0.15)
Seat 6: Dorex2007 (big blind) folded before Flop
Seat 7: jgino14 folded before Flop (didn't bet)
Seat 8: AlekxSly folded before Flop (didn't bet)
Seat 9: LuisZeifer folded before Flop (didn't bet)



PokerStars Hand #228335960871:  Hold'em No Limit ($0.01/$0.02 USD) - 2021/07/16 11:13:13 PT [2021/07/16 14:13:13 ET]
Table 'Sorga' 9-max Seat #5 is the button
Seat 1: rashidmoo ($2.50 in chips) 
Seat 2: 4col-fel7 ($0.80 in chips) 
Seat 3: djiga.1215 ($1.81 in chips) 
Seat 4: Dr_Poliakov ($2 in chips) 
Seat 5: agonzalezelh ($1.45 in chips) 
Seat 6: Dorex2007 ($3.80 in chips) 
Seat 7: jgino14 ($2.32 in chips) 
Seat 8: AlekxSly ($0.95 in chips) 
Seat 9: LuisZeifer ($2.53 in chips) 
Dorex2007: posts small blind $0.01
jgino14: posts big blind $0.02
*** HOLE CARDS ***
Dealt to Dorex2007 [5d Qc]
AlekxSly: folds 
LuisZeifer: folds 
rashidmoo: folds 
4col-fel7: calls $0.02
djiga.1215: raises $0.09 to $0.11
Dr_Poliakov: folds 
agonzalezelh: folds 
Dorex2007: folds 
jgino14: folds 
4col-fel7: calls $0.09
*** FLOP *** [Qh Jh 8h]
4col-fel7: checks 
djiga.1215: bets $0.25
4col-fel7: folds 
Uncalled bet ($0.25) returned to djiga.1215
djiga.1215 collected $0.24 from pot
djiga.1215: doesn't show hand 
*** SUMMARY ***
Total pot $0.25 | Rake $0.01 
Board [Qh Jh 8h]
Seat 1: rashidmoo folded before Flop (didn't bet)
Seat 2: 4col-fel7 folded on the Flop
Seat 3: djiga.1215 collected ($0.24)
Seat 4: Dr_Poliakov folded before Flop (didn't bet)
Seat 5: agonzalezelh (button) folded before Flop (didn't bet)
Seat 6: Dorex2007 (small blind) folded before Flop
Seat 7: jgino14 (big blind) folded before Flop
Seat 8: AlekxSly folded before Flop (didn't bet)
Seat 9: LuisZeifer folded before Flop (didn't bet)



PokerStars Hand #228335975024:  Hold'em No Limit ($0.01/$0.02 USD) - 2021/07/16 11:13:49 PT [2021/07/16 14:13:49 ET]
Table 'Sorga' 9-max Seat #6 is the button
Seat 1: rashidmoo ($2.50 in chips) 
Seat 2: 4col-fel7 ($0.80 in chips) 
Seat 3: djiga.1215 ($1.94 in chips) 
Seat 4: Dr_Poliakov ($2 in chips) 
Seat 5: agonzalezelh ($1.45 in chips) 
Seat 6: Dorex2007 ($3.79 in chips) 
Seat 7: jgino14 ($2.30 in chips) 
Seat 8: AlekxSly ($0.95 in chips) 
Seat 9: LuisZeifer ($2.53 in chips) 
jgino14: posts small blind $0.01
AlekxSly: posts big blind $0.02
*** HOLE CARDS ***
Dealt to Dorex2007 [Jd Ac]
LuisZeifer: folds 
rashidmoo: folds 
4col-fel7: calls $0.02
djiga.1215: raises $0.02 to $0.04
Dr_Poliakov: folds 
agonzalezelh: folds 
Dorex2007: calls $0.04
jgino14: folds 
AlekxSly: folds 
4col-fel7: calls $0.02
*** FLOP *** [Qd 2d Th]
4col-fel7: checks 
djiga.1215: bets $0.10
Dorex2007: calls $0.10
4col-fel7: calls $0.10
*** TURN *** [Qd 2d Th] [Qc]
4col-fel7: checks 
djiga.1215: checks 
Dorex2007: checks 
*** RIVER *** [Qd 2d Th Qc] [2c]
4col-fel7: checks 
djiga.1215: bets $0.21
Dorex2007: folds 
4col-fel7: calls $0.21
*** SHOW DOWN ***
djiga.1215: shows [Qs 2s] (a full house, Queens full of Deuces)
4col-fel7: mucks hand 
djiga.1215 collected $0.84 from pot
*** SUMMARY ***
Total pot $0.87 | Rake $0.03 
Board [Qd 2d Th Qc 2c]
Seat 1: rashidmoo folded before Flop (didn't bet)
Seat 2: 4col-fel7 mucked [3c 3s]
Seat 3: djiga.1215 showed [Qs 2s] and won ($0.84) with a full house, Queens full of Deuces
Seat 4: Dr_Poliakov folded before Flop (didn't bet)
Seat 5: agonzalezelh folded before Flop (didn't bet)
Seat 6: Dorex2007 (button) folded on the River
Seat 7: jgino14 (small blind) folded before Flop
Seat 8: AlekxSly (big blind) folded before Flop
Seat 9: LuisZeifer folded before Flop (didn't bet)



PokerStars Hand #228336007727:  Hold'em No Limit ($0.01/$0.02 USD) - 2021/07/16 11:15:09 PT [2021/07/16 14:15:09 ET]
Table 'Sorga' 9-max Seat #7 is the button
Seat 1: rashidmoo ($2.50 in chips) 
Seat 2: 4col-fel7 ($0.80 in chips) 
Seat 3: djiga.1215 ($2.43 in chips) 
Seat 4: Dr_Poliakov ($2 in chips) 
Seat 5: agonzalezelh ($1.45 in chips) 
Seat 6: Dorex2007 ($3.65 in chips) 
Seat 7: jgino14 ($2.29 in chips) 
Seat 8: AlekxSly ($0.93 in chips) 
Seat 9: LuisZeifer ($2.53 in chips) 
AlekxSly: posts small blind $0.01
LuisZeifer: posts big blind $0.02
*** HOLE CARDS ***
Dealt to Dorex2007 [6c Qc]
rashidmoo: folds 
4col-fel7: folds 
djiga.1215: folds 
Dr_Poliakov: folds 
rashidmoo leaves the table
agonzalezelh: calls $0.02
Dorex2007: folds 
jgino14: folds 
AlekxSly: folds 
LuisZeifer: checks 
*** FLOP *** [6h Ts 2c]
LuisZeifer: checks 
agonzalezelh: bets $0.05
LuisZeifer: calls $0.05
*** TURN *** [6h Ts 2c] [Kd]
LuisZeifer: checks 
agonzalezelh: bets $0.14
LuisZeifer: calls $0.14
*** RIVER *** [6h Ts 2c Kd] [Kh]
LuisZeifer: bets $0.44
bigmars1 joins the table at seat #1 
agonzalezelh: folds 
Uncalled bet ($0.44) returned to LuisZeifer
LuisZeifer collected $0.41 from pot
*** SUMMARY ***
Total pot $0.43 | Rake $0.02 
Board [6h Ts 2c Kd Kh]
Seat 1: rashidmoo folded before Flop (didn't bet)
Seat 2: 4col-fel7 folded before Flop (didn't bet)
Seat 3: djiga.1215 folded before Flop (didn't bet)
Seat 4: Dr_Poliakov folded before Flop (didn't bet)
Seat 5: agonzalezelh folded on the River
Seat 6: Dorex2007 folded before Flop (didn't bet)
Seat 7: jgino14 (button) folded before Flop (didn't bet)
Seat 8: AlekxSly (small blind) folded before Flop
Seat 9: LuisZeifer (big blind) collected ($0.41)



PokerStars Hand #228336034285:  Hold'em No Limit ($0.01/$0.02 USD) - 2021/07/16 11:16:16 PT [2021/07/16 14:16:16 ET]
Table 'Sorga' 9-max Seat #8 is the button
Seat 1: bigmars1 ($0.80 in chips) 
Seat 2: 4col-fel7 ($0.80 in chips) 
Seat 3: djiga.1215 ($2.43 in chips) 
Seat 4: Dr_Poliakov ($2 in chips) 
Seat 5: agonzalezelh ($1.24 in chips) 
Seat 6: Dorex2007 ($3.65 in chips) 
Seat 7: jgino14 ($2.29 in chips) 
Seat 8: AlekxSly ($0.92 in chips) 
Seat 9: LuisZeifer ($2.73 in chips) 
LuisZeifer: posts small blind $0.01
bigmars1: posts big blind $0.02
*** HOLE CARDS ***
Dealt to Dorex2007 [As 5d]
4col-fel7: folds 
djiga.1215: folds 
Dr_Poliakov has timed out
Dr_Poliakov: folds 
agonzalezelh: raises $0.04 to $0.06
Dorex2007: folds 
jgino14: folds 
AlekxSly: folds 
LuisZeifer: folds 
bigmars1: folds 
Uncalled bet ($0.04) returned to agonzalezelh
agonzalezelh collected $0.05 from pot
agonzalezelh: doesn't show hand 
*** SUMMARY ***
Total pot $0.05 | Rake $0 
Seat 1: bigmars1 (big blind) folded before Flop
Seat 2: 4col-fel7 folded before Flop (didn't bet)
Seat 3: djiga.1215 folded before Flop (didn't bet)
Seat 4: Dr_Poliakov folded before Flop (didn't bet)
Seat 5: agonzalezelh collected ($0.05)
Seat 6: Dorex2007 folded before Flop (didn't bet)
Seat 7: jgino14 folded before Flop (didn't bet)
Seat 8: AlekxSly (button) folded before Flop (didn't bet)
Seat 9: LuisZeifer (small blind) folded before Flop



PokerStars Hand #228336046425:  Hold'em No Limit ($0.01/$0.02 USD) - 2021/07/16 11:16:46 PT [2021/07/16 14:16:46 ET]
Table 'Sorga' 9-max Seat #9 is the button
Seat 1: bigmars1 ($0.78 in chips) 
Seat 2: 4col-fel7 ($0.80 in chips) 
Seat 3: djiga.1215 ($2.43 in chips) 
Seat 4: Dr_Poliakov ($2 in chips) 
Seat 5: agonzalezelh ($1.27 in chips) 
Seat 6: Dorex2007 ($3.65 in chips) 
Seat 7: jgino14 ($2.29 in chips) 
Seat 8: AlekxSly ($0.92 in chips) 
Seat 9: LuisZeifer ($2.72 in chips) 
bigmars1: posts small blind $0.01
4col-fel7: posts big blind $0.02
*** HOLE CARDS ***
Dealt to Dorex2007 [2c 5h]
djiga.1215: calls $0.02
Dr_Poliakov: folds 
agonzalezelh: folds 
Dorex2007: folds 
jgino14 has timed out
jgino14: folds 
AlekxSly: calls $0.02
LuisZeifer: folds 
bigmars1: calls $0.01
4col-fel7: checks 
*** FLOP *** [4d 7s 9s]
bigmars1: bets $0.02
4col-fel7: calls $0.02
djiga.1215: raises $0.09 to $0.11
AlekxSly: folds 
bigmars1: calls $0.09
4col-fel7: calls $0.09
*** TURN *** [4d 7s 9s] [9h]
bigmars1: bets $0.04
4col-fel7: calls $0.04
djiga.1215: raises $0.26 to $0.30
bigmars1: calls $0.26
4col-fel7: calls $0.26
*** RIVER *** [4d 7s 9s 9h] [Qc]
bigmars1: bets $0.35 and is all-in
4col-fel7: folds 
djiga.1215: calls $0.35
*** SHOW DOWN ***
bigmars1: shows [9d Qd] (a full house, Nines full of Queens)
djiga.1215: shows [4c 4h] (a full house, Fours full of Nines)
bigmars1 collected $1.94 from pot
*** SUMMARY ***
Total pot $2.01 | Rake $0.07 
Board [4d 7s 9s 9h Qc]
Seat 1: bigmars1 (small blind) showed [9d Qd] and won ($1.94) with a full house, Nines full of Queens
Seat 2: 4col-fel7 (big blind) folded on the River
Seat 3: djiga.1215 showed [4c 4h] and lost with a full house, Fours full of Nines
Seat 4: Dr_Poliakov folded before Flop (didn't bet)
Seat 5: agonzalezelh folded before Flop (didn't bet)
Seat 6: Dorex2007 folded before Flop (didn't bet)
Seat 7: jgino14 folded before Flop (didn't bet)
Seat 8: AlekxSly folded on the Flop
Seat 9: LuisZeifer (button) folded before Flop (didn't bet)



PokerStars Hand #228336076111:  Hold'em No Limit ($0.01/$0.02 USD) - 2021/07/16 11:18:00 PT [2021/07/16 14:18:00 ET]
Table 'Sorga' 9-max Seat #1 is the button
Seat 1: bigmars1 ($1.94 in chips) 
Seat 2: 4col-fel7 ($0.80 in chips) 
Seat 3: djiga.1215 ($1.65 in chips) 
Seat 4: Dr_Poliakov ($2 in chips) 
Seat 5: agonzalezelh ($1.27 in chips) 
Seat 6: Dorex2007 ($3.65 in chips) 
Seat 7: jgino14 ($2.29 in chips) 
Seat 8: AlekxSly ($0.90 in chips) 
Seat 9: LuisZeifer ($2.72 in chips) 
4col-fel7: posts small blind $0.01
djiga.1215: posts big blind $0.02
*** HOLE CARDS ***
Dealt to Dorex2007 [Qs 5h]
Dr_Poliakov: folds 
agonzalezelh: calls $0.02
Dorex2007: folds 
jgino14: folds 
AlekxSly: folds 
LuisZeifer: calls $0.02
bigmars1: calls $0.02
4col-fel7: folds 
djiga.1215: raises $0.03 to $0.05
agonzalezelh: calls $0.03
LuisZeifer: calls $0.03
bigmars1: calls $0.03
*** FLOP *** [4h Tc Ts]
djiga.1215: checks 
agonzalezelh: checks 
LuisZeifer: checks 
bigmars1: checks 
*** TURN *** [4h Tc Ts] [8h]
djiga.1215: checks 
agonzalezelh: checks 
LuisZeifer: checks 
bigmars1: checks 
*** RIVER *** [4h Tc Ts 8h] [9c]
djiga.1215: bets $0.10
agonzalezelh: folds 
LuisZeifer: folds 
bigmars1: folds 
Uncalled bet ($0.10) returned to djiga.1215
djiga.1215 collected $0.20 from pot
djiga.1215: doesn't show hand 
*** SUMMARY ***
Total pot $0.21 | Rake $0.01 
Board [4h Tc Ts 8h 9c]
Seat 1: bigmars1 (button) folded on the River
Seat 2: 4col-fel7 (small blind) folded before Flop
Seat 3: djiga.1215 (big blind) collected ($0.20)
Seat 4: Dr_Poliakov folded before Flop (didn't bet)
Seat 5: agonzalezelh folded on the River
Seat 6: Dorex2007 folded before Flop (didn't bet)
Seat 7: jgino14 folded before Flop (didn't bet)
Seat 8: AlekxSly folded before Flop (didn't bet)
Seat 9: LuisZeifer folded on the River



PokerStars Hand #228336120345:  Hold'em No Limit ($0.01/$0.02 USD) - 2021/07/16 11:19:50 PT [2021/07/16 14:19:50 ET]
Table 'Sorga' 9-max Seat #2 is the button
Seat 1: bigmars1 ($1.89 in chips) 
Seat 2: 4col-fel7 ($0.80 in chips) 
Seat 3: djiga.1215 ($1.80 in chips) 
Seat 4: Dr_Poliakov ($2 in chips) 
Seat 5: agonzalezelh ($1.22 in chips) 
Seat 6: Dorex2007 ($3.65 in chips) 
Seat 7: jgino14 ($2.29 in chips) 
Seat 8: AlekxSly ($0.90 in chips) 
Seat 9: LuisZeifer ($2.67 in chips) 
djiga.1215: posts small blind $0.01
Dr_Poliakov: posts big blind $0.02
*** HOLE CARDS ***
Dealt to Dorex2007 [Jh 5h]
agonzalezelh: folds 
Dorex2007: folds 
jgino14: folds 
AlekxSly: calls $0.02
LuisZeifer: folds 
bigmars1: folds 
4col-fel7: folds 
djiga.1215: calls $0.01
Dr_Poliakov: raises $0.06 to $0.08
AlekxSly: folds 
djiga.1215: calls $0.06
*** FLOP *** [Jc 7c Qd]
djiga.1215: checks 
Dr_Poliakov: checks 
*** TURN *** [Jc 7c Qd] [Jd]
djiga.1215: bets $0.08
Dr_Poliakov: folds 
Uncalled bet ($0.08) returned to djiga.1215
djiga.1215 collected $0.17 from pot
djiga.1215: doesn't show hand 
*** SUMMARY ***
Total pot $0.18 | Rake $0.01 
Board [Jc 7c Qd Jd]
Seat 1: bigmars1 folded before Flop (didn't bet)
Seat 2: 4col-fel7 (button) folded before Flop (didn't bet)
Seat 3: djiga.1215 (small blind) collected ($0.17)
Seat 4: Dr_Poliakov (big blind) folded on the Turn
Seat 5: agonzalezelh folded before Flop (didn't bet)
Seat 6: Dorex2007 folded before Flop (didn't bet)
Seat 7: jgino14 folded before Flop (didn't bet)
Seat 8: AlekxSly folded before Flop
Seat 9: LuisZeifer folded before Flop (didn't bet)



PokerStars Hand #228336144843:  Hold'em No Limit ($0.01/$0.02 USD) - 2021/07/16 11:20:51 PT [2021/07/16 14:20:51 ET]
Table 'Sorga' 9-max Seat #3 is the button
Seat 1: bigmars1 ($1.89 in chips) 
Seat 2: 4col-fel7 ($0.80 in chips) 
Seat 3: djiga.1215 ($1.89 in chips) 
Seat 4: Dr_Poliakov ($2 in chips) 
Seat 5: agonzalezelh ($1.22 in chips) 
Seat 6: Dorex2007 ($3.65 in chips) 
Seat 7: jgino14 ($2.29 in chips) 
Seat 8: AlekxSly ($0.88 in chips) 
Seat 9: LuisZeifer ($2.67 in chips) 
Dr_Poliakov: posts small blind $0.01
agonzalezelh: posts big blind $0.02
*** HOLE CARDS ***
Dealt to Dorex2007 [8s 8c]
Dorex2007: raises $0.02 to $0.04
jgino14: folds 
AlekxSly: folds 
LuisZeifer: folds 
bigmars1: calls $0.04
4col-fel7: folds 
djiga.1215: calls $0.04
Dr_Poliakov: folds 
agonzalezelh: folds 
*** FLOP *** [3h Kh Qs]
Dorex2007: checks 
bigmars1: checks 
djiga.1215: checks 
*** TURN *** [3h Kh Qs] [8h]
Dorex2007: bets $0.09
bigmars1: calls $0.09
djiga.1215: raises $0.41 to $0.50
Dorex2007: folds 
bigmars1: folds 
Uncalled bet ($0.41) returned to djiga.1215
djiga.1215 collected $0.41 from pot
djiga.1215: doesn't show hand 
*** SUMMARY ***
Total pot $0.42 | Rake $0.01 
Board [3h Kh Qs 8h]
Seat 1: bigmars1 folded on the Turn
Seat 2: 4col-fel7 folded before Flop (didn't bet)
Seat 3: djiga.1215 (button) collected ($0.41)
Seat 4: Dr_Poliakov (small blind) folded before Flop
Seat 5: agonzalezelh (big blind) folded before Flop
Seat 6: Dorex2007 folded on the Turn
Seat 7: jgino14 folded before Flop (didn't bet)
Seat 8: AlekxSly folded before Flop (didn't bet)
Seat 9: LuisZeifer folded before Flop (didn't bet)



PokerStars Hand #228336172878:  Hold'em No Limit ($0.01/$0.02 USD) - 2021/07/16 11:21:59 PT [2021/07/16 14:21:59 ET]
Table 'Sorga' 9-max Seat #4 is the button
Seat 1: bigmars1 ($1.76 in chips) 
Seat 2: 4col-fel7 ($0.80 in chips) 
Seat 3: djiga.1215 ($2.17 in chips) 
Seat 4: Dr_Poliakov ($2 in chips) 
Seat 5: agonzalezelh ($1.20 in chips) 
Seat 6: Dorex2007 ($3.52 in chips) 
Seat 7: jgino14 ($2.29 in chips) 
Seat 8: AlekxSly ($0.88 in chips) 
Seat 9: LuisZeifer ($2.67 in chips) 
agonzalezelh: posts small blind $0.01
Dorex2007: posts big blind $0.02
*** HOLE CARDS ***
Dealt to Dorex2007 [4s 5s]
jgino14: raises $0.04 to $0.06
AlekxSly: folds 
LuisZeifer has timed out
LuisZeifer: folds 
bigmars1: calls $0.06
4col-fel7: folds 
djiga.1215: folds 
Dr_Poliakov: calls $0.06
agonzalezelh: calls $0.05
Dorex2007: folds 
*** FLOP *** [3c Ac Qh]
agonzalezelh: checks 
jgino14: checks 
bigmars1: bets $0.04
Dr_Poliakov: folds 
agonzalezelh: calls $0.04
jgino14: calls $0.04
*** TURN *** [3c Ac Qh] [5c]
agonzalezelh: checks 
jgino14: checks 
bigmars1: checks 
*** RIVER *** [3c Ac Qh 5c] [4c]
agonzalezelh: bets $0.37
jgino14: folds 
bigmars1: folds 
Uncalled bet ($0.37) returned to agonzalezelh
agonzalezelh collected $0.37 from pot
agonzalezelh: doesn't show hand 
*** SUMMARY ***
Total pot $0.38 | Rake $0.01 
Board [3c Ac Qh 5c 4c]
Seat 1: bigmars1 folded on the River
Seat 2: 4col-fel7 folded before Flop (didn't bet)
Seat 3: djiga.1215 folded before Flop (didn't bet)
Seat 4: Dr_Poliakov (button) folded on the Flop
Seat 5: agonzalezelh (small blind) collected ($0.37)
Seat 6: Dorex2007 (big blind) folded before Flop
Seat 7: jgino14 folded on the River
Seat 8: AlekxSly folded before Flop (didn't bet)
Seat 9: LuisZeifer folded before Flop (didn't bet)



PokerStars Hand #228336210520:  Hold'em No Limit ($0.01/$0.02 USD) - 2021/07/16 11:23:15 PT [2021/07/16 14:23:15 ET]
Table 'Sorga' 9-max Seat #5 is the button
Seat 1: bigmars1 ($1.66 in chips) 
Seat 2: 4col-fel7 ($0.80 in chips) 
Seat 3: djiga.1215 ($2.17 in chips) 
Seat 4: Dr_Poliakov ($2 in chips) 
Seat 5: agonzalezelh ($1.47 in chips) 
Seat 6: Dorex2007 ($3.50 in chips) 
Seat 7: jgino14 ($2.19 in chips) 
Seat 8: AlekxSly ($0.88 in chips) 
Seat 9: LuisZeifer ($2.67 in chips) 
Dorex2007: posts small blind $0.01
jgino14: posts big blind $0.02
*** HOLE CARDS ***
Dealt to Dorex2007 [7s 2s]
AlekxSly: folds 
LuisZeifer: raises $0.04 to $0.06
bigmars1: calls $0.06
4col-fel7: folds 
djiga.1215: raises $0.21 to $0.27
Dr_Poliakov: folds 
agonzalezelh: folds 
Dorex2007: folds 
jgino14: folds 
LuisZeifer: folds 
bigmars1: calls $0.21
*** FLOP *** [Kd Ts 2d]
bigmars1: bets $0.02
djiga.1215: raises $1.88 to $1.90 and is all-in
bigmars1: calls $1.37 and is all-in
Uncalled bet ($0.51) returned to djiga.1215
*** TURN *** [Kd Ts 2d] [3d]
*** RIVER *** [Kd Ts 2d 3d] [Qs]
*** SHOW DOWN ***
bigmars1: shows [Ac As] (a pair of Aces)
djiga.1215: shows [Ks Ah] (a pair of Kings)
bigmars1 collected $3.29 from pot
*** SUMMARY ***
Total pot $3.41 | Rake $0.12 
Board [Kd Ts 2d 3d Qs]
Seat 1: bigmars1 showed [Ac As] and won ($3.29) with a pair of Aces
Seat 2: 4col-fel7 folded before Flop (didn't bet)
Seat 3: djiga.1215 showed [Ks Ah] and lost with a pair of Kings
Seat 4: Dr_Poliakov folded before Flop (didn't bet)
Seat 5: agonzalezelh (button) folded before Flop (didn't bet)
Seat 6: Dorex2007 (small blind) folded before Flop
Seat 7: jgino14 (big blind) folded before Flop
Seat 8: AlekxSly folded before Flop (didn't bet)
Seat 9: LuisZeifer folded before Flop



PokerStars Hand #228336232761:  Hold'em No Limit ($0.01/$0.02 USD) - 2021/07/16 11:24:10 PT [2021/07/16 14:24:10 ET]
Table 'Sorga' 9-max Seat #6 is the button
Seat 1: bigmars1 ($3.29 in chips) 
Seat 2: 4col-fel7 ($0.80 in chips) 
Seat 3: djiga.1215 ($0.51 in chips) 
Seat 4: Dr_Poliakov ($2 in chips) 
Seat 5: agonzalezelh ($1.47 in chips) 
Seat 6: Dorex2007 ($3.49 in chips) 
Seat 7: jgino14 ($2.17 in chips) 
Seat 8: AlekxSly ($0.88 in chips) 
Seat 9: LuisZeifer ($2.61 in chips) 
jgino14: posts small blind $0.01
AlekxSly: posts big blind $0.02
*** HOLE CARDS ***
Dealt to Dorex2007 [7s Ks]
LuisZeifer: folds 
bigmars1: calls $0.02
4col-fel7: folds 
djiga.1215: folds 
Dr_Poliakov: folds 
agonzalezelh: folds 
Dorex2007: folds 
jgino14: raises $0.08 to $0.10
4col-fel7 leaves the table
AlekxSly: folds 
bigmars1: calls $0.08
*** FLOP *** [Jh 8s Td]
jgino14: checks 
bigmars1: checks 
*** TURN *** [Jh 8s Td] [2h]
jgino14: checks 
bigmars1: checks 
*** RIVER *** [Jh 8s Td 2h] [8d]
jgino14: bets $0.04
bigmars1: raises $0.29 to $0.33
jgino14: folds 
Uncalled bet ($0.29) returned to bigmars1
bigmars1 collected $0.29 from pot
bigmars1: doesn't show hand 
*** SUMMARY ***
Total pot $0.30 | Rake $0.01 
Board [Jh 8s Td 2h 8d]
Seat 1: bigmars1 collected ($0.29)
Seat 2: 4col-fel7 folded before Flop (didn't bet)
Seat 3: djiga.1215 folded before Flop (didn't bet)
Seat 4: Dr_Poliakov folded before Flop (didn't bet)
Seat 5: agonzalezelh folded before Flop (didn't bet)
Seat 6: Dorex2007 (button) folded before Flop (didn't bet)
Seat 7: jgino14 (small blind) folded on the River
Seat 8: AlekxSly (big blind) folded before Flop
Seat 9: LuisZeifer folded before Flop (didn't bet)



PokerStars Hand #228336254913:  Hold'em No Limit ($0.01/$0.02 USD) - 2021/07/16 11:25:04 PT [2021/07/16 14:25:04 ET]
Table 'Sorga' 9-max Seat #7 is the button
Seat 1: bigmars1 ($3.44 in chips) 
Seat 3: djiga.1215 ($0.51 in chips) 
Seat 4: Dr_Poliakov ($2 in chips) 
Seat 5: agonzalezelh ($1.47 in chips) 
Seat 6: Dorex2007 ($3.49 in chips) 
Seat 7: jgino14 ($2.03 in chips) 
Seat 8: AlekxSly ($0.86 in chips) 
Seat 9: LuisZeifer ($2.61 in chips) 
AlekxSly: posts small blind $0.01
LuisZeifer: posts big blind $0.02
*** HOLE CARDS ***
Dealt to Dorex2007 [5h Ah]
bigmars1: folds 
djiga.1215: raises $0.03 to $0.05
Dr_Poliakov: folds 
agonzalezelh: folds 
Dorex2007: calls $0.05
jgino14: folds 
AlekxSly: folds 
LuisZeifer: folds 
*** FLOP *** [7d 7c Ks]
djiga.1215: checks 
Dorex2007: checks 
*** TURN *** [7d 7c Ks] [9c]
djiga.1215: bets $0.06
bofeca4321 joins the table at seat #2 
Dorex2007: folds 
Uncalled bet ($0.06) returned to djiga.1215
bigmars1 leaves the table
djiga.1215 collected $0.13 from pot
djiga.1215: doesn't show hand 
*** SUMMARY ***
Total pot $0.13 | Rake $0 
Board [7d 7c Ks 9c]
Seat 1: bigmars1 folded before Flop (didn't bet)
Seat 3: djiga.1215 collected ($0.13)
Seat 4: Dr_Poliakov folded before Flop (didn't bet)
Seat 5: agonzalezelh folded before Flop (didn't bet)
Seat 6: Dorex2007 folded on the Turn
Seat 7: jgino14 (button) folded before Flop (didn't bet)
Seat 8: AlekxSly (small blind) folded before Flop
Seat 9: LuisZeifer (big blind) folded before Flop



PokerStars Hand #228336270536:  Hold'em No Limit ($0.01/$0.02 USD) - 2021/07/16 11:25:43 PT [2021/07/16 14:25:43 ET]
Table 'Sorga' 9-max Seat #8 is the button
Seat 2: bofeca4321 ($2 in chips) 
Seat 3: djiga.1215 ($0.59 in chips) 
Seat 4: Dr_Poliakov ($2 in chips) 
Seat 5: agonzalezelh ($1.47 in chips) 
Seat 6: Dorex2007 ($3.44 in chips) 
Seat 7: jgino14 ($2.03 in chips) 
Seat 8: AlekxSly ($0.85 in chips) 
Seat 9: LuisZeifer ($2.59 in chips) 
LuisZeifer: posts small blind $0.01
bofeca4321: posts big blind $0.02
*** HOLE CARDS ***
Dealt to Dorex2007 [8c 9d]
djiga.1215: folds 
Dr_Poliakov: folds 
TrancaRua2021 joins the table at seat #1 
agonzalezelh: folds 
Dorex2007: folds 
jgino14: folds 
AlekxSly: folds 
LuisZeifer: raises $0.04 to $0.06
bofeca4321: folds 
Uncalled bet ($0.04) returned to LuisZeifer
LuisZeifer collected $0.04 from pot
*** SUMMARY ***
Total pot $0.04 | Rake $0 
Seat 2: bofeca4321 (big blind) folded before Flop
Seat 3: djiga.1215 folded before Flop (didn't bet)
Seat 4: Dr_Poliakov folded before Flop (didn't bet)
Seat 5: agonzalezelh folded before Flop (didn't bet)
Seat 6: Dorex2007 folded before Flop (didn't bet)
Seat 7: jgino14 folded before Flop (didn't bet)
Seat 8: AlekxSly (button) folded before Flop (didn't bet)
Seat 9: LuisZeifer (small blind) collected ($0.04)



PokerStars Hand #228336286863:  Hold'em No Limit ($0.01/$0.02 USD) - 2021/07/16 11:26:23 PT [2021/07/16 14:26:23 ET]
Table 'Sorga' 9-max Seat #9 is the button
Seat 2: bofeca4321 ($1.98 in chips) 
Seat 3: djiga.1215 ($0.59 in chips) 
Seat 4: Dr_Poliakov ($2 in chips) 
Seat 5: agonzalezelh ($1.47 in chips) 
Seat 6: Dorex2007 ($3.44 in chips) 
Seat 7: jgino14 ($2.03 in chips) 
Seat 8: AlekxSly ($0.85 in chips) 
Seat 9: LuisZeifer ($2.61 in chips) 
bofeca4321: posts small blind $0.01
djiga.1215: posts big blind $0.02
*** HOLE CARDS ***
Dealt to Dorex2007 [7s 5h]
Dr_Poliakov: folds 
agonzalezelh: folds 
Dorex2007: folds 
jgino14: folds 
AlekxSly: folds 
LuisZeifer: raises $0.02 to $0.04
bofeca4321: folds 
djiga.1215: calls $0.02
*** FLOP *** [Th 8c 3h]
djiga.1215: bets $0.05
LuisZeifer: folds 
Uncalled bet ($0.05) returned to djiga.1215
djiga.1215 collected $0.09 from pot
djiga.1215: doesn't show hand 
*** SUMMARY ***
Total pot $0.09 | Rake $0 
Board [Th 8c 3h]
Seat 2: bofeca4321 (small blind) folded before Flop
Seat 3: djiga.1215 (big blind) collected ($0.09)
Seat 4: Dr_Poliakov folded before Flop (didn't bet)
Seat 5: agonzalezelh folded before Flop (didn't bet)
Seat 6: Dorex2007 folded before Flop (didn't bet)
Seat 7: jgino14 folded before Flop (didn't bet)
Seat 8: AlekxSly folded before Flop (didn't bet)
Seat 9: LuisZeifer (button) folded on the Flop



PokerStars Hand #228336299695:  Hold'em No Limit ($0.01/$0.02 USD) - 2021/07/16 11:26:54 PT [2021/07/16 14:26:54 ET]
Table 'Sorga' 9-max Seat #2 is the button
Seat 1: TrancaRua2021 ($2 in chips) 
Seat 2: bofeca4321 ($1.97 in chips) 
Seat 3: djiga.1215 ($0.64 in chips) 
Seat 4: Dr_Poliakov ($2 in chips) 
Seat 5: agonzalezelh ($1.47 in chips) 
Seat 6: Dorex2007 ($3.44 in chips) 
Seat 7: jgino14 ($2.03 in chips) 
Seat 8: AlekxSly ($0.85 in chips) 
Seat 9: LuisZeifer ($2.57 in chips) 
djiga.1215: posts small blind $0.01
Dr_Poliakov: posts big blind $0.02
TrancaRua2021: posts big blind $0.02
*** HOLE CARDS ***
Dealt to Dorex2007 [5c 6d]
agonzalezelh: folds 
Dorex2007: folds 
jgino14: folds 
AlekxSly: folds 
LuisZeifer: raises $0.04 to $0.06
TrancaRua2021: folds 
bofeca4321: folds 
djiga.1215: raises $0.58 to $0.64 and is all-in
Dr_Poliakov: raises $1.36 to $2 and is all-in
LuisZeifer has timed out
LuisZeifer: folds 
Uncalled bet ($1.36) returned to Dr_Poliakov
*** FLOP *** [3h Ks 9c]
*** TURN *** [3h Ks 9c] [Qc]
*** RIVER *** [3h Ks 9c Qc] [2c]
*** SHOW DOWN ***
djiga.1215: shows [As 4h] (high card Ace)
Dr_Poliakov: shows [Jc Jh] (a pair of Jacks)
Dr_Poliakov collected $1.31 from pot
*** SUMMARY ***
Total pot $1.36 | Rake $0.05 
Board [3h Ks 9c Qc 2c]
Seat 1: TrancaRua2021 folded before Flop (didn't bet)
Seat 2: bofeca4321 (button) folded before Flop (didn't bet)
Seat 3: djiga.1215 (small blind) showed [As 4h] and lost with high card Ace
Seat 4: Dr_Poliakov (big blind) showed [Jc Jh] and won ($1.31) with a pair of Jacks
Seat 5: agonzalezelh folded before Flop (didn't bet)
Seat 6: Dorex2007 folded before Flop (didn't bet)
Seat 7: jgino14 folded before Flop (didn't bet)
Seat 8: AlekxSly folded before Flop (didn't bet)
Seat 9: LuisZeifer folded before Flop



PokerStars Hand #228336328107:  Hold'em No Limit ($0.01/$0.02 USD) - 2021/07/16 11:28:03 PT [2021/07/16 14:28:03 ET]
Table 'Sorga' 9-max Seat #4 is the button
Seat 1: TrancaRua2021 ($2 in chips) 
Seat 2: bofeca4321 ($1.97 in chips) 
Seat 4: Dr_Poliakov ($2.67 in chips) 
Seat 5: agonzalezelh ($1.47 in chips) 
Seat 6: Dorex2007 ($3.44 in chips) 
Seat 7: jgino14 ($2.03 in chips) 
Seat 8: AlekxSly ($0.85 in chips) 
agonzalezelh: posts small blind $0.01
Dorex2007: posts big blind $0.02
*** HOLE CARDS ***
Dealt to Dorex2007 [5h Jc]
jgino14: folds 
AlekxSly: folds 
TrancaRua2021: folds 
bofeca4321: folds 
Dr_Poliakov: folds 
agonzalezelh: calls $0.01
Dorex2007: checks 
*** FLOP *** [9c 9s As]
agonzalezelh: checks 
Dorex2007: checks 
*** TURN *** [9c 9s As] [Ad]
agonzalezelh: bets $0.04
Dorex2007: folds 
Uncalled bet ($0.04) returned to agonzalezelh
agonzalezelh collected $0.04 from pot
agonzalezelh: doesn't show hand 
*** SUMMARY ***
Total pot $0.04 | Rake $0 
Board [9c 9s As Ad]
Seat 1: TrancaRua2021 folded before Flop (didn't bet)
Seat 2: bofeca4321 folded before Flop (didn't bet)
Seat 4: Dr_Poliakov (button) folded before Flop (didn't bet)
Seat 5: agonzalezelh (small blind) collected ($0.04)
Seat 6: Dorex2007 (big blind) folded on the Turn
Seat 7: jgino14 folded before Flop (didn't bet)
Seat 8: AlekxSly folded before Flop (didn't bet)



PokerStars Hand #228336345759:  Hold'em No Limit ($0.01/$0.02 USD) - 2021/07/16 11:28:47 PT [2021/07/16 14:28:47 ET]
Table 'Sorga' 9-max Seat #5 is the button
Seat 1: TrancaRua2021 ($2 in chips) 
Seat 2: bofeca4321 ($1.97 in chips) 
Seat 3: djiga.1215 ($1 in chips) 
Seat 4: Dr_Poliakov ($2.67 in chips) 
Seat 5: agonzalezelh ($1.49 in chips) 
Seat 6: Dorex2007 ($3.42 in chips) 
Seat 7: jgino14 ($2.03 in chips) 
Seat 8: AlekxSly ($0.85 in chips) 
Dorex2007: posts small blind $0.01
jgino14: posts big blind $0.02
*** HOLE CARDS ***
Dealt to Dorex2007 [Td Jd]
AlekxSly: folds 
TrancaRua2021: folds 
bofeca4321: folds 
djiga.1215: raises $0.03 to $0.05
Dr_Poliakov: calls $0.05
agonzalezelh: folds 
Dorex2007: calls $0.04
jgino14: calls $0.03
*** FLOP *** [Js 3c 3d]
Dorex2007: bets $0.19
jgino14: folds 
djiga.1215: folds 
Dr_Poliakov: folds 
Uncalled bet ($0.19) returned to Dorex2007
Dorex2007 collected $0.19 from pot
Dorex2007: doesn't show hand 
*** SUMMARY ***
Total pot $0.20 | Rake $0.01 
Board [Js 3c 3d]
Seat 1: TrancaRua2021 folded before Flop (didn't bet)
Seat 2: bofeca4321 folded before Flop (didn't bet)
Seat 3: djiga.1215 folded on the Flop
Seat 4: Dr_Poliakov folded on the Flop
Seat 5: agonzalezelh (button) folded before Flop (didn't bet)
Seat 6: Dorex2007 (small blind) collected ($0.19)
Seat 7: jgino14 (big blind) folded on the Flop
Seat 8: AlekxSly folded before Flop (didn't bet)



PokerStars Hand #228336360177:  Hold'em No Limit ($0.01/$0.02 USD) - 2021/07/16 11:29:22 PT [2021/07/16 14:29:22 ET]
Table 'Sorga' 9-max Seat #6 is the button
Seat 1: TrancaRua2021 ($2 in chips) 
Seat 2: bofeca4321 ($1.97 in chips) 
Seat 3: djiga.1215 ($0.95 in chips) 
Seat 4: Dr_Poliakov ($2.62 in chips) 
Seat 5: agonzalezelh ($1.49 in chips) 
Seat 6: Dorex2007 ($3.56 in chips) 
Seat 7: jgino14 ($1.98 in chips) 
Seat 8: AlekxSly ($0.85 in chips) 
jgino14: posts small blind $0.01
AlekxSly: posts big blind $0.02
*** HOLE CARDS ***
Dealt to Dorex2007 [3d 6s]
TrancaRua2021: raises $0.03 to $0.05
bofeca4321: folds 
djiga.1215: calls $0.05
Dr_Poliakov: raises $0.18 to $0.23
agonzalezelh: folds 
Dorex2007: folds 
jgino14: folds 
AlekxSly: folds 
TrancaRua2021: folds 
djiga.1215: calls $0.18
*** FLOP *** [Tc 5d Qc]
djiga.1215: bets $0.72 and is all-in
Dr_Poliakov: calls $0.72
*** TURN *** [Tc 5d Qc] [9c]
*** RIVER *** [Tc 5d Qc 9c] [4s]
*** SHOW DOWN ***
djiga.1215: shows [Ks Jd] (a straight, Nine to King)
Dr_Poliakov: shows [Ac Kh] (high card Ace)
djiga.1215 collected $1.91 from pot
*** SUMMARY ***
Total pot $1.98 | Rake $0.07 
Board [Tc 5d Qc 9c 4s]
Seat 1: TrancaRua2021 folded before Flop
Seat 2: bofeca4321 folded before Flop (didn't bet)
Seat 3: djiga.1215 showed [Ks Jd] and won ($1.91) with a straight, Nine to King
Seat 4: Dr_Poliakov showed [Ac Kh] and lost with high card Ace
Seat 5: agonzalezelh folded before Flop (didn't bet)
Seat 6: Dorex2007 (button) folded before Flop (didn't bet)
Seat 7: jgino14 (small blind) folded before Flop
Seat 8: AlekxSly (big blind) folded before Flop



PokerStars Hand #228336375159:  Hold'em No Limit ($0.01/$0.02 USD) - 2021/07/16 11:29:59 PT [2021/07/16 14:29:59 ET]
Table 'Sorga' 9-max Seat #7 is the button
Seat 1: TrancaRua2021 ($2 in chips) 
Seat 2: bofeca4321 ($1.97 in chips) 
Seat 3: djiga.1215 ($1.91 in chips) 
Seat 4: Dr_Poliakov ($2 in chips) 
Seat 5: agonzalezelh ($1.49 in chips) 
Seat 6: Dorex2007 ($3.56 in chips) 
Seat 7: jgino14 ($1.97 in chips) 
Seat 8: AlekxSly ($0.83 in chips) 
Seat 9: LuisZeifer ($2.51 in chips) 
AlekxSly: posts small blind $0.01
LuisZeifer: posts big blind $0.02
*** HOLE CARDS ***
Dealt to Dorex2007 [3s Kc]
TrancaRua2021: folds 
bofeca4321: folds 
djiga.1215: folds 
Dr_Poliakov: folds 
agonzalezelh: folds 
Dorex2007: folds 
jgino14: raises $0.03 to $0.05
AlekxSly: folds 
LuisZeifer: calls $0.03
*** FLOP *** [9d 4d 6s]
LuisZeifer: checks 
jgino14: checks 
*** TURN *** [9d 4d 6s] [4s]
LuisZeifer: bets $0.11
jgino14: folds 
Uncalled bet ($0.11) returned to LuisZeifer
LuisZeifer collected $0.11 from pot
*** SUMMARY ***
Total pot $0.11 | Rake $0 
Board [9d 4d 6s 4s]
Seat 1: TrancaRua2021 folded before Flop (didn't bet)
Seat 2: bofeca4321 folded before Flop (didn't bet)
Seat 3: djiga.1215 folded before Flop (didn't bet)
Seat 4: Dr_Poliakov folded before Flop (didn't bet)
Seat 5: agonzalezelh folded before Flop (didn't bet)
Seat 6: Dorex2007 folded before Flop (didn't bet)
Seat 7: jgino14 (button) folded on the Turn
Seat 8: AlekxSly (small blind) folded before Flop
Seat 9: LuisZeifer (big blind) collected ($0.11)



PokerStars Hand #228336395951:  Hold'em No Limit ($0.01/$0.02 USD) - 2021/07/16 11:30:47 PT [2021/07/16 14:30:47 ET]
Table 'Sorga' 9-max Seat #8 is the button
Seat 1: TrancaRua2021 ($2 in chips) 
Seat 2: bofeca4321 ($1.97 in chips) 
Seat 3: djiga.1215 ($1.91 in chips) 
Seat 4: Dr_Poliakov ($2 in chips) 
Seat 5: agonzalezelh ($1.49 in chips) 
Seat 6: Dorex2007 ($3.56 in chips) 
Seat 7: jgino14 ($1.92 in chips) 
Seat 8: AlekxSly ($0.82 in chips) 
Seat 9: LuisZeifer ($2.57 in chips) 
LuisZeifer: posts small blind $0.01
TrancaRua2021: posts big blind $0.02
*** HOLE CARDS ***
Dealt to Dorex2007 [5s 8d]
bofeca4321: calls $0.02
djiga.1215: calls $0.02
Dr_Poliakov has timed out
Dr_Poliakov: folds 
agonzalezelh: folds 
Dorex2007: folds 
jgino14: folds 
AlekxSly: folds 
LuisZeifer: folds 
TrancaRua2021: checks 
*** FLOP *** [3s Ac Qs]
TrancaRua2021: checks 
bofeca4321: bets $0.02
djiga.1215: folds 
TrancaRua2021: folds 
Uncalled bet ($0.02) returned to bofeca4321
bofeca4321 collected $0.07 from pot
bofeca4321: doesn't show hand 
*** SUMMARY ***
Total pot $0.07 | Rake $0 
Board [3s Ac Qs]
Seat 1: TrancaRua2021 (big blind) folded on the Flop
Seat 2: bofeca4321 collected ($0.07)
Seat 3: djiga.1215 folded on the Flop
Seat 4: Dr_Poliakov folded before Flop (didn't bet)
Seat 5: agonzalezelh folded before Flop (didn't bet)
Seat 6: Dorex2007 folded before Flop (didn't bet)
Seat 7: jgino14 folded before Flop (didn't bet)
Seat 8: AlekxSly (button) folded before Flop (didn't bet)
Seat 9: LuisZeifer (small blind) folded before Flop



PokerStars Hand #228336408696:  Hold'em No Limit ($0.01/$0.02 USD) - 2021/07/16 11:31:18 PT [2021/07/16 14:31:18 ET]
Table 'Sorga' 9-max Seat #9 is the button
Seat 1: TrancaRua2021 ($2 in chips) 
Seat 2: bofeca4321 ($2.02 in chips) 
Seat 3: djiga.1215 ($1.89 in chips) 
Seat 4: Dr_Poliakov ($2 in chips) 
Seat 5: agonzalezelh ($1.49 in chips) 
Seat 6: Dorex2007 ($3.56 in chips) 
Seat 7: jgino14 ($1.92 in chips) 
Seat 8: AlekxSly ($0.82 in chips) 
Seat 9: LuisZeifer ($2.56 in chips) 
TrancaRua2021: posts small blind $0.01
bofeca4321: posts big blind $0.02
*** HOLE CARDS ***
Dealt to Dorex2007 [4d 8h]
djiga.1215: calls $0.02
Dr_Poliakov has timed out
Dr_Poliakov: folds 
agonzalezelh: folds 
Dorex2007: folds 
jgino14: folds 
AlekxSly: folds 
LuisZeifer: calls $0.02
TrancaRua2021: folds 
bofeca4321: checks 
*** FLOP *** [Td 6d 7s]
bofeca4321: bets $0.02
djiga.1215: raises $0.05 to $0.07
LuisZeifer: folds 
bofeca4321: folds 
Uncalled bet ($0.05) returned to djiga.1215
djiga.1215 collected $0.11 from pot
djiga.1215: doesn't show hand 
*** SUMMARY ***
Total pot $0.11 | Rake $0 
Board [Td 6d 7s]
Seat 1: TrancaRua2021 (small blind) folded before Flop
Seat 2: bofeca4321 (big blind) folded on the Flop
Seat 3: djiga.1215 collected ($0.11)
Seat 4: Dr_Poliakov folded before Flop (didn't bet)
Seat 5: agonzalezelh folded before Flop (didn't bet)
Seat 6: Dorex2007 folded before Flop (didn't bet)
Seat 7: jgino14 folded before Flop (didn't bet)
Seat 8: AlekxSly folded before Flop (didn't bet)
Seat 9: LuisZeifer (button) folded on the Flop



PokerStars Hand #228336431952:  Hold'em No Limit ($0.01/$0.02 USD) - 2021/07/16 11:32:14 PT [2021/07/16 14:32:14 ET]
Table 'Sorga' 9-max Seat #1 is the button
Seat 1: TrancaRua2021 ($2 in chips) 
Seat 2: bofeca4321 ($1.98 in chips) 
Seat 3: djiga.1215 ($1.96 in chips) 
Seat 4: Dr_Poliakov ($2 in chips) 
Seat 5: agonzalezelh ($1.49 in chips) 
Seat 6: Dorex2007 ($3.56 in chips) 
Seat 7: jgino14 ($1.92 in chips) 
Seat 8: AlekxSly ($0.82 in chips) 
Seat 9: LuisZeifer ($2.54 in chips) 
bofeca4321: posts small blind $0.01
djiga.1215: posts big blind $0.02
*** HOLE CARDS ***
Dealt to Dorex2007 [4c Js]
Dr_Poliakov has timed out
Dr_Poliakov: folds 
agonzalezelh: calls $0.02
Dorex2007: folds 
jgino14: folds 
AlekxSly: folds 
LuisZeifer: folds 
TrancaRua2021: folds 
bofeca4321: folds 
djiga.1215: checks 
*** FLOP *** [Ad 3s Jh]
djiga.1215: checks 
agonzalezelh: checks 
*** TURN *** [Ad 3s Jh] [7d]
djiga.1215: checks 
agonzalezelh: bets $0.05
djiga.1215: folds 
Uncalled bet ($0.05) returned to agonzalezelh
agonzalezelh collected $0.05 from pot
agonzalezelh: doesn't show hand 
*** SUMMARY ***
Total pot $0.05 | Rake $0 
Board [Ad 3s Jh 7d]
Seat 1: TrancaRua2021 (button) folded before Flop (didn't bet)
Seat 2: bofeca4321 (small blind) folded before Flop
Seat 3: djiga.1215 (big blind) folded on the Turn
Seat 4: Dr_Poliakov folded before Flop (didn't bet)
Seat 5: agonzalezelh collected ($0.05)
Seat 6: Dorex2007 folded before Flop (didn't bet)
Seat 7: jgino14 folded before Flop (didn't bet)
Seat 8: AlekxSly folded before Flop (didn't bet)
Seat 9: LuisZeifer folded before Flop (didn't bet)



PokerStars Hand #228336452365:  Hold'em No Limit ($0.01/$0.02 USD) - 2021/07/16 11:33:02 PT [2021/07/16 14:33:02 ET]
Table 'Sorga' 9-max Seat #2 is the button
Seat 1: TrancaRua2021 ($2 in chips) 
Seat 2: bofeca4321 ($1.97 in chips) 
Seat 3: djiga.1215 ($1.94 in chips) 
Seat 5: agonzalezelh ($1.52 in chips) 
Seat 6: Dorex2007 ($3.56 in chips) 
Seat 7: jgino14 ($1.92 in chips) 
Seat 8: AlekxSly ($0.82 in chips) 
Seat 9: LuisZeifer ($2.54 in chips) 
djiga.1215: posts small blind $0.01
agonzalezelh: posts big blind $0.02
*** HOLE CARDS ***
Dealt to Dorex2007 [Qc 8d]
Dorex2007: folds 
jgino14: folds 
AlekxSly: raises $0.02 to $0.04
LuisZeifer: folds 
TrancaRua2021: folds 
bofeca4321: folds 
djiga.1215: folds 
agonzalezelh: calls $0.02
*** FLOP *** [2c 8h 5h]
agonzalezelh: checks 
AlekxSly: checks 
*** TURN *** [2c 8h 5h] [Jh]
agonzalezelh: bets $0.09
AlekxSly: folds 
Uncalled bet ($0.09) returned to agonzalezelh
agonzalezelh collected $0.09 from pot
agonzalezelh: doesn't show hand 
*** SUMMARY ***
Total pot $0.09 | Rake $0 
Board [2c 8h 5h Jh]
Seat 1: TrancaRua2021 folded before Flop (didn't bet)
Seat 2: bofeca4321 (button) folded before Flop (didn't bet)
Seat 3: djiga.1215 (small blind) folded before Flop
Seat 5: agonzalezelh (big blind) collected ($0.09)
Seat 6: Dorex2007 folded before Flop (didn't bet)
Seat 7: jgino14 folded before Flop (didn't bet)
Seat 8: AlekxSly folded on the Turn
Seat 9: LuisZeifer folded before Flop (didn't bet)



PokerStars Hand #228336472474:  Hold'em No Limit ($0.01/$0.02 USD) - 2021/07/16 11:33:50 PT [2021/07/16 14:33:50 ET]
Table 'Sorga' 9-max Seat #3 is the button
Seat 2: bofeca4321 ($1.97 in chips) 
Seat 3: djiga.1215 ($1.93 in chips) 
Seat 5: agonzalezelh ($1.57 in chips) 
Seat 6: Dorex2007 ($3.56 in chips) 
Seat 7: jgino14 ($1.92 in chips) 
Seat 8: AlekxSly ($0.78 in chips) 
Seat 9: LuisZeifer ($2.54 in chips) 
agonzalezelh: posts small blind $0.01
Dorex2007: posts big blind $0.02
*** HOLE CARDS ***
Dealt to Dorex2007 [8h 9h]
jgino14: raises $0.04 to $0.06
AlekxSly: folds 
LuisZeifer: folds 
bofeca4321: folds 
djiga.1215: folds 
agonzalezelh: folds 
Dorex2007: calls $0.04
*** FLOP *** [Qc Ad 7s]
Dorex2007: checks 
jgino14: bets $0.06
Dorex2007: folds 
Uncalled bet ($0.06) returned to jgino14
jgino14 collected $0.13 from pot
jgino14: doesn't show hand 
*** SUMMARY ***
Total pot $0.13 | Rake $0 
Board [Qc Ad 7s]
Seat 2: bofeca4321 folded before Flop (didn't bet)
Seat 3: djiga.1215 (button) folded before Flop (didn't bet)
Seat 5: agonzalezelh (small blind) folded before Flop
Seat 6: Dorex2007 (big blind) folded on the Flop
Seat 7: jgino14 collected ($0.13)
Seat 8: AlekxSly folded before Flop (didn't bet)
Seat 9: LuisZeifer folded before Flop (didn't bet)



PokerStars Hand #228336487596:  Hold'em No Limit ($0.01/$0.02 USD) - 2021/07/16 11:34:25 PT [2021/07/16 14:34:25 ET]
Table 'Sorga' 9-max Seat #5 is the button
Seat 2: bofeca4321 ($1.97 in chips) 
Seat 3: djiga.1215 ($1.93 in chips) 
Seat 5: agonzalezelh ($1.56 in chips) 
Seat 6: Dorex2007 ($3.50 in chips) 
Seat 7: jgino14 ($1.99 in chips) 
Seat 8: AlekxSly ($0.78 in chips) 
Seat 9: LuisZeifer ($2.54 in chips) 
Dorex2007: posts small blind $0.01
jgino14: posts big blind $0.02
*** HOLE CARDS ***
Dealt to Dorex2007 [5c 6s]
AlekxSly: folds 
LuisZeifer has timed out
LuisZeifer: folds 
bofeca4321: folds 
djiga.1215: raises $0.08 to $0.10
agonzalezelh: folds 
Dorex2007: folds 
jgino14: folds 
Uncalled bet ($0.08) returned to djiga.1215
djiga.1215 collected $0.05 from pot
djiga.1215: doesn't show hand 
*** SUMMARY ***
Total pot $0.05 | Rake $0 
Seat 2: bofeca4321 folded before Flop (didn't bet)
Seat 3: djiga.1215 collected ($0.05)
Seat 5: agonzalezelh (button) folded before Flop (didn't bet)
Seat 6: Dorex2007 (small blind) folded before Flop
Seat 7: jgino14 (big blind) folded before Flop
Seat 8: AlekxSly folded before Flop (didn't bet)
Seat 9: LuisZeifer folded before Flop (didn't bet)



PokerStars Hand #228336498633:  Hold'em No Limit ($0.01/$0.02 USD) - 2021/07/16 11:34:52 PT [2021/07/16 14:34:52 ET]
Table 'Sorga' 9-max Seat #6 is the button
Seat 2: bofeca4321 ($1.97 in chips) 
Seat 3: djiga.1215 ($1.96 in chips) 
Seat 5: agonzalezelh ($1.56 in chips) 
Seat 6: Dorex2007 ($3.49 in chips) 
Seat 7: jgino14 ($1.97 in chips) 
Seat 8: AlekxSly ($0.78 in chips) 
Seat 9: LuisZeifer ($2.54 in chips) 
jgino14: posts small blind $0.01
AlekxSly: posts big blind $0.02
*** HOLE CARDS ***
Dealt to Dorex2007 [2d 6c]
LuisZeifer has timed out
LuisZeifer: folds 
bofeca4321: folds 
djiga.1215: folds 
agonzalezelh: folds 
Dorex2007: folds 
jgino14: folds 
Uncalled bet ($0.01) returned to AlekxSly
AlekxSly collected $0.02 from pot
AlekxSly: doesn't show hand 
*** SUMMARY ***
Total pot $0.02 | Rake $0 
Seat 2: bofeca4321 folded before Flop (didn't bet)
Seat 3: djiga.1215 folded before Flop (didn't bet)
Seat 5: agonzalezelh folded before Flop (didn't bet)
Seat 6: Dorex2007 (button) folded before Flop (didn't bet)
Seat 7: jgino14 (small blind) folded before Flop
Seat 8: AlekxSly (big blind) collected ($0.02)
Seat 9: LuisZeifer folded before Flop (didn't bet)



PokerStars Hand #228336507558:  Hold'em No Limit ($0.01/$0.02 USD) - 2021/07/16 11:35:12 PT [2021/07/16 14:35:12 ET]
Table 'Sorga' 9-max Seat #7 is the button
Seat 2: bofeca4321 ($1.97 in chips) 
Seat 3: djiga.1215 ($1.96 in chips) 
Seat 5: agonzalezelh ($1.56 in chips) 
Seat 6: Dorex2007 ($3.49 in chips) 
Seat 7: jgino14 ($1.96 in chips) 
Seat 8: AlekxSly ($0.79 in chips) 
AlekxSly: posts small blind $0.01
bofeca4321: posts big blind $0.02
*** HOLE CARDS ***
Dealt to Dorex2007 [4c 7h]
djiga.1215: calls $0.02
agonzalezelh: calls $0.02
Dorex2007: folds 
jgino14: folds 
AlekxSly: folds 
bofeca4321: checks 
*** FLOP *** [Jd 7s 5s]
bofeca4321: bets $0.02
djiga.1215: calls $0.02
agonzalezelh: calls $0.02
*** TURN *** [Jd 7s 5s] [6s]
bofeca4321: checks 
djiga.1215: checks 
agonzalezelh: checks 
*** RIVER *** [Jd 7s 5s 6s] [Jh]
bofeca4321: bets $0.02
djiga.1215: raises $0.10 to $0.12
agonzalezelh: folds 
bofeca4321: folds 
Uncalled bet ($0.10) returned to djiga.1215
djiga.1215 collected $0.16 from pot
djiga.1215: doesn't show hand 
*** SUMMARY ***
Total pot $0.17 | Rake $0.01 
Board [Jd 7s 5s 6s Jh]
Seat 2: bofeca4321 (big blind) folded on the River
Seat 3: djiga.1215 collected ($0.16)
Seat 5: agonzalezelh folded on the River
Seat 6: Dorex2007 folded before Flop (didn't bet)
Seat 7: jgino14 (button) folded before Flop (didn't bet)
Seat 8: AlekxSly (small blind) folded before Flop



PokerStars Hand #228336526752:  Hold'em No Limit ($0.01/$0.02 USD) - 2021/07/16 11:35:57 PT [2021/07/16 14:35:57 ET]
Table 'Sorga' 9-max Seat #8 is the button
Seat 2: bofeca4321 ($1.91 in chips) 
Seat 3: djiga.1215 ($2.06 in chips) 
Seat 5: agonzalezelh ($1.52 in chips) 
Seat 6: Dorex2007 ($3.49 in chips) 
Seat 7: jgino14 ($1.96 in chips) 
Seat 8: AlekxSly ($0.78 in chips) 
bofeca4321: posts small blind $0.01
djiga.1215: posts big blind $0.02
Dr_Poliakov: sits out 
*** HOLE CARDS ***
Dealt to Dorex2007 [Ts 7c]
agonzalezelh: raises $0.04 to $0.06
Dorex2007: folds 
jgino14: folds 
AlekxSly: folds 
bofeca4321: folds 
djiga.1215: folds 
Uncalled bet ($0.04) returned to agonzalezelh
agonzalezelh collected $0.05 from pot
agonzalezelh: doesn't show hand 
*** SUMMARY ***
Total pot $0.05 | Rake $0 
Seat 2: bofeca4321 (small blind) folded before Flop
Seat 3: djiga.1215 (big blind) folded before Flop
Seat 5: agonzalezelh collected ($0.05)
Seat 6: Dorex2007 folded before Flop (didn't bet)
Seat 7: jgino14 folded before Flop (didn't bet)
Seat 8: AlekxSly (button) folded before Flop (didn't bet)



PokerStars Hand #228336534077:  Hold'em No Limit ($0.01/$0.02 USD) - 2021/07/16 11:36:15 PT [2021/07/16 14:36:15 ET]
Table 'Sorga' 9-max Seat #2 is the button
Seat 2: bofeca4321 ($1.90 in chips) 
Seat 3: djiga.1215 ($2.04 in chips) 
Seat 4: Dr_Poliakov ($2 in chips) 
Seat 5: agonzalezelh ($1.55 in chips) 
Seat 6: Dorex2007 ($3.49 in chips) 
Seat 7: jgino14 ($1.96 in chips) 
Seat 8: AlekxSly ($0.78 in chips) 
djiga.1215: posts small blind $0.01
Dr_Poliakov: posts big blind $0.02
LuisZeifer: sits out 
*** HOLE CARDS ***
Dealt to Dorex2007 [6d Ts]
agonzalezelh: calls $0.02
Dorex2007: folds 
jgino14: folds 
AlekxSly: folds 
bofeca4321: folds 
djiga.1215: calls $0.01
Dr_Poliakov: checks 
*** FLOP *** [8c 2d 6c]
djiga.1215: checks 
Dr_Poliakov: checks 
agonzalezelh: bets $0.06
djiga.1215: folds 
Dr_Poliakov: calls $0.06
*** TURN *** [8c 2d 6c] [Ah]
Dr_Poliakov: checks 
agonzalezelh: checks 
*** RIVER *** [8c 2d 6c Ah] [3s]
Dr_Poliakov: checks 
agonzalezelh: bets $0.17
Dr_Poliakov: folds 
Uncalled bet ($0.17) returned to agonzalezelh
agonzalezelh collected $0.17 from pot
agonzalezelh: doesn't show hand 
*** SUMMARY ***
Total pot $0.18 | Rake $0.01 
Board [8c 2d 6c Ah 3s]
Seat 2: bofeca4321 (button) folded before Flop (didn't bet)
Seat 3: djiga.1215 (small blind) folded on the Flop
Seat 4: Dr_Poliakov (big blind) folded on the River
Seat 5: agonzalezelh collected ($0.17)
Seat 6: Dorex2007 folded before Flop (didn't bet)
Seat 7: jgino14 folded before Flop (didn't bet)
Seat 8: AlekxSly folded before Flop (didn't bet)



PokerStars Hand #228336561679:  Hold'em No Limit ($0.01/$0.02 USD) - 2021/07/16 11:37:19 PT [2021/07/16 14:37:19 ET]
Table 'Sorga' 9-max Seat #3 is the button
Seat 2: bofeca4321 ($1.90 in chips) 
Seat 3: djiga.1215 ($2.02 in chips) 
Seat 4: Dr_Poliakov ($2 in chips) 
Seat 5: agonzalezelh ($1.64 in chips) 
Seat 6: Dorex2007 ($3.49 in chips) 
Seat 7: jgino14 ($1.96 in chips) 
Seat 8: AlekxSly ($0.78 in chips) 
Dr_Poliakov: posts small blind $0.01
agonzalezelh: posts big blind $0.02
LuisZeifer: sits out 
*** HOLE CARDS ***
Dealt to Dorex2007 [9d 6s]
Dorex2007: folds 
jgino14: folds 
AlekxSly: folds 
bofeca4321: folds 
djiga.1215: folds 
Dr_Poliakov: folds 
Uncalled bet ($0.01) returned to agonzalezelh
agonzalezelh collected $0.02 from pot
agonzalezelh: doesn't show hand 
*** SUMMARY ***
Total pot $0.02 | Rake $0 
Seat 2: bofeca4321 folded before Flop (didn't bet)
Seat 3: djiga.1215 (button) folded before Flop (didn't bet)
Seat 4: Dr_Poliakov (small blind) folded before Flop
Seat 5: agonzalezelh (big blind) collected ($0.02)
Seat 6: Dorex2007 folded before Flop (didn't bet)
Seat 7: jgino14 folded before Flop (didn't bet)
Seat 8: AlekxSly folded before Flop (didn't bet)



PokerStars Hand #228336565975:  Hold'em No Limit ($0.01/$0.02 USD) - 2021/07/16 11:37:29 PT [2021/07/16 14:37:29 ET]
Table 'Sorga' 9-max Seat #4 is the button
Seat 2: bofeca4321 ($1.90 in chips) 
Seat 3: djiga.1215 ($2.02 in chips) 
Seat 4: Dr_Poliakov ($2 in chips) 
Seat 5: agonzalezelh ($1.65 in chips) 
Seat 6: Dorex2007 ($3.49 in chips) 
Seat 7: jgino14 ($1.96 in chips) 
Seat 8: AlekxSly ($0.78 in chips) 
agonzalezelh: posts small blind $0.01
Dorex2007: posts big blind $0.02
LuisZeifer: sits out 
*** HOLE CARDS ***
Dealt to Dorex2007 [2s 8h]
jgino14: folds 
AlekxSly: raises $0.02 to $0.04
bofeca4321: folds 
djiga.1215: folds 
Dr_Poliakov: folds 
agonzalezelh: calls $0.03
Dorex2007: folds 
*** FLOP *** [4h Th Ts]
agonzalezelh: checks 
AlekxSly: checks 
*** TURN *** [4h Th Ts] [7s]
agonzalezelh: bets $0.10
AlekxSly: calls $0.10
*** RIVER *** [4h Th Ts 7s] [Kd]
agonzalezelh: checks 
AlekxSly: bets $0.10
agonzalezelh: folds 
Uncalled bet ($0.10) returned to AlekxSly
AlekxSly collected $0.29 from pot
AlekxSly: doesn't show hand 
*** SUMMARY ***
Total pot $0.30 | Rake $0.01 
Board [4h Th Ts 7s Kd]
Seat 2: bofeca4321 folded before Flop (didn't bet)
Seat 3: djiga.1215 folded before Flop (didn't bet)
Seat 4: Dr_Poliakov (button) folded before Flop (didn't bet)
Seat 5: agonzalezelh (small blind) folded on the River
Seat 6: Dorex2007 (big blind) folded before Flop
Seat 7: jgino14 folded before Flop (didn't bet)
Seat 8: AlekxSly collected ($0.29)



PokerStars Hand #228336593536:  Hold'em No Limit ($0.01/$0.02 USD) - 2021/07/16 11:38:34 PT [2021/07/16 14:38:34 ET]
Table 'Sorga' 9-max Seat #5 is the button
Seat 1: TrancaRua2021 ($2 in chips) 
Seat 2: bofeca4321 ($1.90 in chips) 
Seat 3: djiga.1215 ($2.02 in chips) 
Seat 4: Dr_Poliakov ($2 in chips) 
Seat 5: agonzalezelh ($1.51 in chips) 
Seat 6: Dorex2007 ($3.47 in chips) 
Seat 7: jgino14 ($1.96 in chips) 
Seat 8: AlekxSly ($0.93 in chips) 
Dorex2007: posts small blind $0.01
jgino14: posts big blind $0.02
LuisZeifer: sits out 
TrancaRua2021: posts small & big blinds $0.03
*** HOLE CARDS ***
Dealt to Dorex2007 [5d Tc]
AlekxSly: folds 
TrancaRua2021: checks 
bofeca4321: folds 
djiga.1215: folds 
Dr_Poliakov has timed out
Dr_Poliakov: folds 
agonzalezelh: calls $0.02
Dorex2007: folds 
jgino14: checks 
*** FLOP *** [3d 8h 6c]
jgino14: checks 
TrancaRua2021: checks 
agonzalezelh: checks 
*** TURN *** [3d 8h 6c] [5s]
jgino14: bets $0.05
TrancaRua2021: folds 
agonzalezelh: calls $0.05
*** RIVER *** [3d 8h 6c 5s] [8c]
jgino14: checks 
agonzalezelh: bets $0.17
jgino14: calls $0.17
*** SHOW DOWN ***
agonzalezelh: shows [3c 7c] (two pair, Eights and Threes)
jgino14: shows [6s 7h] (two pair, Eights and Sixes)
jgino14 collected $0.50 from pot
*** SUMMARY ***
Total pot $0.52 | Rake $0.02 
Board [3d 8h 6c 5s 8c]
Seat 1: TrancaRua2021 folded on the Turn (didn't bet)
Seat 2: bofeca4321 folded before Flop (didn't bet)
Seat 3: djiga.1215 folded before Flop (didn't bet)
Seat 4: Dr_Poliakov folded before Flop (didn't bet)
Seat 5: agonzalezelh (button) showed [3c 7c] and lost with two pair, Eights and Threes
Seat 6: Dorex2007 (small blind) folded before Flop
Seat 7: jgino14 (big blind) showed [6s 7h] and won ($0.50) with two pair, Eights and Sixes
Seat 8: AlekxSly folded before Flop (didn't bet)



PokerStars Hand #228336628802:  Hold'em No Limit ($0.01/$0.02 USD) - 2021/07/16 11:39:38 PT [2021/07/16 14:39:38 ET]
Table 'Sorga' 9-max Seat #6 is the button
Seat 1: TrancaRua2021 ($2 in chips) 
Seat 2: bofeca4321 ($1.90 in chips) 
Seat 3: djiga.1215 ($2.02 in chips) 
Seat 4: Dr_Poliakov ($2 in chips) 
Seat 5: agonzalezelh ($1.27 in chips) 
Seat 6: Dorex2007 ($3.46 in chips) 
Seat 7: jgino14 ($2.22 in chips) 
Seat 9: LuisZeifer ($2.54 in chips) 
jgino14: posts small blind $0.01
AlekxSly: is sitting out 
LuisZeifer: posts big blind $0.02
*** HOLE CARDS ***
Dealt to Dorex2007 [4h 6h]
AlekxSly leaves the table
TrancaRua2021: folds 
bofeca4321: folds 
djiga.1215: raises $0.05 to $0.07
Dr_Poliakov has timed out
Dr_Poliakov: folds 
agonzalezelh: folds 
Dorex2007: folds 
jgino14: folds 
marjimgon joins the table at seat #8 
LuisZeifer: folds 
Uncalled bet ($0.05) returned to djiga.1215
djiga.1215 collected $0.05 from pot
djiga.1215: doesn't show hand 
*** SUMMARY ***
Total pot $0.05 | Rake $0 
Seat 1: TrancaRua2021 folded before Flop (didn't bet)
Seat 2: bofeca4321 folded before Flop (didn't bet)
Seat 3: djiga.1215 collected ($0.05)
Seat 4: Dr_Poliakov folded before Flop (didn't bet)
Seat 5: agonzalezelh folded before Flop (didn't bet)
Seat 6: Dorex2007 (button) folded before Flop (didn't bet)
Seat 7: jgino14 (small blind) folded before Flop
Seat 9: LuisZeifer (big blind) folded before Flop



PokerStars Hand #228336648836:  Hold'em No Limit ($0.01/$0.02 USD) - 2021/07/16 11:40:25 PT [2021/07/16 14:40:25 ET]
Table 'Sorga' 9-max Seat #7 is the button
Seat 1: TrancaRua2021 ($2 in chips) 
Seat 2: bofeca4321 ($1.90 in chips) 
Seat 3: djiga.1215 ($2.05 in chips) 
Seat 4: Dr_Poliakov ($2 in chips) 
Seat 5: agonzalezelh ($1.27 in chips) 
Seat 6: Dorex2007 ($3.46 in chips) 
Seat 7: jgino14 ($2.21 in chips) 
Seat 9: LuisZeifer ($2.52 in chips) 
LuisZeifer: posts small blind $0.01
TrancaRua2021: posts big blind $0.02
*** HOLE CARDS ***
Dealt to Dorex2007 [5h 3d]
bofeca4321: folds 
djiga.1215: folds 
Dr_Poliakov has timed out
Dr_Poliakov: folds 
agonzalezelh: raises $0.04 to $0.06
Dorex2007: folds 
jgino14: folds 
LuisZeifer: folds 
TrancaRua2021: folds 
Uncalled bet ($0.04) returned to agonzalezelh
agonzalezelh collected $0.05 from pot
agonzalezelh: doesn't show hand 
*** SUMMARY ***
Total pot $0.05 | Rake $0 
Seat 1: TrancaRua2021 (big blind) folded before Flop
Seat 2: bofeca4321 folded before Flop (didn't bet)
Seat 3: djiga.1215 folded before Flop (didn't bet)
Seat 4: Dr_Poliakov folded before Flop (didn't bet)
Seat 5: agonzalezelh collected ($0.05)
Seat 6: Dorex2007 folded before Flop (didn't bet)
Seat 7: jgino14 (button) folded before Flop (didn't bet)
Seat 9: LuisZeifer (small blind) folded before Flop



PokerStars Hand #228336660706:  Hold'em No Limit ($0.01/$0.02 USD) - 2021/07/16 11:40:53 PT [2021/07/16 14:40:53 ET]
Table 'Sorga' 9-max Seat #9 is the button
Seat 1: TrancaRua2021 ($2 in chips) 
Seat 2: bofeca4321 ($1.90 in chips) 
Seat 3: djiga.1215 ($2.05 in chips) 
Seat 5: agonzalezelh ($1.30 in chips) 
Seat 6: Dorex2007 ($3.46 in chips) 
Seat 7: jgino14 ($2.21 in chips) 
Seat 9: LuisZeifer ($2.51 in chips) 
TrancaRua2021: posts small blind $0.01
bofeca4321: posts big blind $0.02
marjimgon: sits out 
*** HOLE CARDS ***
Dealt to Dorex2007 [7h 9c]
djiga.1215: folds 
agonzalezelh: folds 
Dorex2007: folds 
jgino14: folds 
LuisZeifer has timed out
LuisZeifer: folds 
TrancaRua2021: folds 
Uncalled bet ($0.01) returned to bofeca4321
bofeca4321 collected $0.02 from pot
bofeca4321: doesn't show hand 
*** SUMMARY ***
Total pot $0.02 | Rake $0 
Seat 1: TrancaRua2021 (small blind) folded before Flop
Seat 2: bofeca4321 (big blind) collected ($0.02)
Seat 3: djiga.1215 folded before Flop (didn't bet)
Seat 5: agonzalezelh folded before Flop (didn't bet)
Seat 6: Dorex2007 folded before Flop (didn't bet)
Seat 7: jgino14 folded before Flop (didn't bet)
Seat 9: LuisZeifer (button) folded before Flop (didn't bet)



PokerStars Hand #228336669197:  Hold'em No Limit ($0.01/$0.02 USD) - 2021/07/16 11:41:13 PT [2021/07/16 14:41:13 ET]
Table 'Sorga' 9-max Seat #1 is the button
Seat 1: TrancaRua2021 ($2 in chips) 
Seat 2: bofeca4321 ($1.91 in chips) 
Seat 3: djiga.1215 ($2.05 in chips) 
Seat 5: agonzalezelh ($1.30 in chips) 
Seat 6: Dorex2007 ($3.46 in chips) 
Seat 7: jgino14 ($2.21 in chips) 
bofeca4321: posts small blind $0.01
djiga.1215: posts big blind $0.02
marjimgon: sits out 
*** HOLE CARDS ***
Dealt to Dorex2007 [Tc Jd]
agonzalezelh: calls $0.02
Dorex2007: folds 
jgino14: raises $0.06 to $0.08
TrancaRua2021: folds 
bofeca4321: folds 
djiga.1215: folds 
agonzalezelh: calls $0.06
*** FLOP *** [Jh 7s 2c]
agonzalezelh: bets $0.18
jgino14: calls $0.18
*** TURN *** [Jh 7s 2c] [Ah]
agonzalezelh: bets $1.04 and is all-in
jgino14: folds 
Uncalled bet ($1.04) returned to agonzalezelh
agonzalezelh collected $0.53 from pot
agonzalezelh: doesn't show hand 
*** SUMMARY ***
Total pot $0.55 | Rake $0.02 
Board [Jh 7s 2c Ah]
Seat 1: TrancaRua2021 (button) folded before Flop (didn't bet)
Seat 2: bofeca4321 (small blind) folded before Flop
Seat 3: djiga.1215 (big blind) folded before Flop
Seat 5: agonzalezelh collected ($0.53)
Seat 6: Dorex2007 folded before Flop (didn't bet)
Seat 7: jgino14 folded on the Turn



PokerStars Hand #228336684293:  Hold'em No Limit ($0.01/$0.02 USD) - 2021/07/16 11:41:48 PT [2021/07/16 14:41:48 ET]
Table 'Sorga' 9-max Seat #2 is the button
Seat 1: TrancaRua2021 ($2 in chips) 
Seat 2: bofeca4321 ($1.90 in chips) 
Seat 3: djiga.1215 ($2.03 in chips) 
Seat 5: agonzalezelh ($1.57 in chips) 
Seat 6: Dorex2007 ($3.46 in chips) 
Seat 7: jgino14 ($1.95 in chips) 
Seat 9: LuisZeifer ($2.51 in chips) 
djiga.1215: posts small blind $0.01
agonzalezelh: posts big blind $0.02
marjimgon: sits out 
*** HOLE CARDS ***
Dealt to Dorex2007 [Td 9h]
Dorex2007: folds 
jgino14: folds 
LuisZeifer: folds 
TrancaRua2021: raises $0.03 to $0.05
bofeca4321: folds 
djiga.1215: folds 
agonzalezelh: calls $0.03
*** FLOP *** [9s 7s 6c]
agonzalezelh: bets $0.11
TrancaRua2021: folds 
Uncalled bet ($0.11) returned to agonzalezelh
agonzalezelh collected $0.11 from pot
agonzalezelh: doesn't show hand 
*** SUMMARY ***
Total pot $0.11 | Rake $0 
Board [9s 7s 6c]
Seat 1: TrancaRua2021 folded on the Flop
Seat 2: bofeca4321 (button) folded before Flop (didn't bet)
Seat 3: djiga.1215 (small blind) folded before Flop
Seat 5: agonzalezelh (big blind) collected ($0.11)
Seat 6: Dorex2007 folded before Flop (didn't bet)
Seat 7: jgino14 folded before Flop (didn't bet)
Seat 9: LuisZeifer folded before Flop (didn't bet)



PokerStars Hand #228336696898:  Hold'em No Limit ($0.01/$0.02 USD) - 2021/07/16 11:42:18 PT [2021/07/16 14:42:18 ET]
Table 'Sorga' 9-max Seat #3 is the button
Seat 1: TrancaRua2021 ($2 in chips) 
Seat 2: bofeca4321 ($1.90 in chips) 
Seat 3: djiga.1215 ($2.02 in chips) 
Seat 5: agonzalezelh ($1.63 in chips) 
Seat 6: Dorex2007 ($3.46 in chips) 
Seat 7: jgino14 ($1.95 in chips) 
Seat 9: LuisZeifer ($2.51 in chips) 
agonzalezelh: posts small blind $0.01
Dorex2007: posts big blind $0.02
marjimgon: sits out 
*** HOLE CARDS ***
Dealt to Dorex2007 [9c 3h]
jgino14: folds 
jgino14 leaves the table
LuisZeifer has timed out
LuisZeifer: folds 
TrancaRua2021: folds 
bofeca4321: folds 
djiga.1215: raises $0.03 to $0.05
agonzalezelh: calls $0.04
JohnMcCarty94 joins the table at seat #7 
Dorex2007: folds 
*** FLOP *** [4s 2d Js]
agonzalezelh: checks 
djiga.1215: bets $0.12
agonzalezelh: folds 
Uncalled bet ($0.12) returned to djiga.1215
djiga.1215 collected $0.12 from pot
djiga.1215: doesn't show hand 
*** SUMMARY ***
Total pot $0.12 | Rake $0 
Board [4s 2d Js]
Seat 1: TrancaRua2021 folded before Flop (didn't bet)
Seat 2: bofeca4321 folded before Flop (didn't bet)
Seat 3: djiga.1215 (button) collected ($0.12)
Seat 5: agonzalezelh (small blind) folded on the Flop
Seat 6: Dorex2007 (big blind) folded before Flop
Seat 7: jgino14 folded before Flop (didn't bet)
Seat 9: LuisZeifer folded before Flop (didn't bet)



PokerStars Hand #228336715065:  Hold'em No Limit ($0.01/$0.02 USD) - 2021/07/16 11:43:00 PT [2021/07/16 14:43:00 ET]
Table 'Sorga' 9-max Seat #5 is the button
Seat 1: TrancaRua2021 ($2 in chips) 
Seat 2: bofeca4321 ($1.90 in chips) 
Seat 3: djiga.1215 ($2.09 in chips) 
Seat 5: agonzalezelh ($1.58 in chips) 
Seat 6: Dorex2007 ($3.44 in chips) 
Seat 7: JohnMcCarty94 ($1.30 in chips) 
Dorex2007: posts small blind $0.01
JohnMcCarty94: posts big blind $0.02
marjimgon: sits out 
*** HOLE CARDS ***
Dealt to Dorex2007 [6d 9s]
TrancaRua2021: folds 
bofeca4321: folds 
djiga.1215: folds 
agonzalezelh: folds 
Dorex2007: folds 
Uncalled bet ($0.01) returned to JohnMcCarty94
JohnMcCarty94 collected $0.02 from pot
JohnMcCarty94: doesn't show hand 
*** SUMMARY ***
Total pot $0.02 | Rake $0 
Seat 1: TrancaRua2021 folded before Flop (didn't bet)
Seat 2: bofeca4321 folded before Flop (didn't bet)
Seat 3: djiga.1215 folded before Flop (didn't bet)
Seat 5: agonzalezelh (button) folded before Flop (didn't bet)
Seat 6: Dorex2007 (small blind) folded before Flop
Seat 7: JohnMcCarty94 (big blind) collected ($0.02)



PokerStars Hand #228336719568:  Hold'em No Limit ($0.01/$0.02 USD) - 2021/07/16 11:43:11 PT [2021/07/16 14:43:11 ET]
Table 'Sorga' 9-max Seat #6 is the button
Seat 1: TrancaRua2021 ($2 in chips) 
Seat 2: bofeca4321 ($1.90 in chips) 
Seat 3: djiga.1215 ($2.09 in chips) 
Seat 5: agonzalezelh ($1.58 in chips) 
Seat 6: Dorex2007 ($3.43 in chips) 
Seat 7: JohnMcCarty94 ($1.31 in chips) 
Seat 8: marjimgon ($0.80 in chips) 
Seat 9: LuisZeifer ($2.51 in chips) 
JohnMcCarty94: posts small blind $0.01
marjimgon: posts big blind $0.02
*** HOLE CARDS ***
Dealt to Dorex2007 [6c Qd]
LuisZeifer has timed out
LuisZeifer: folds 
TrancaRua2021: folds 
bofeca4321: folds 
djiga.1215: raises $0.07 to $0.09
agonzalezelh: folds 
Dorex2007: folds 
JohnMcCarty94: folds 
marjimgon: folds 
Uncalled bet ($0.07) returned to djiga.1215
djiga.1215 collected $0.05 from pot
djiga.1215: doesn't show hand 
*** SUMMARY ***
Total pot $0.05 | Rake $0 
Seat 1: TrancaRua2021 folded before Flop (didn't bet)
Seat 2: bofeca4321 folded before Flop (didn't bet)
Seat 3: djiga.1215 collected ($0.05)
Seat 5: agonzalezelh folded before Flop (didn't bet)
Seat 6: Dorex2007 (button) folded before Flop (didn't bet)
Seat 7: JohnMcCarty94 (small blind) folded before Flop
Seat 8: marjimgon (big blind) folded before Flop
Seat 9: LuisZeifer folded before Flop (didn't bet)



PokerStars Hand #228336729715:  Hold'em No Limit ($0.01/$0.02 USD) - 2021/07/16 11:43:35 PT [2021/07/16 14:43:35 ET]
Table 'Sorga' 9-max Seat #7 is the button
Seat 1: TrancaRua2021 ($2 in chips) 
Seat 2: bofeca4321 ($1.90 in chips) 
Seat 3: djiga.1215 ($2.12 in chips) 
Seat 5: agonzalezelh ($1.58 in chips) 
Seat 6: Dorex2007 ($3.43 in chips) 
Seat 7: JohnMcCarty94 ($1.30 in chips) 
Seat 8: marjimgon ($0.78 in chips) 
marjimgon: posts small blind $0.01
TrancaRua2021: posts big blind $0.02
*** HOLE CARDS ***
Dealt to Dorex2007 [5h 6s]
bofeca4321: folds 
djiga.1215: folds 
agonzalezelh: calls $0.02
Dorex2007: folds 
JohnMcCarty94: calls $0.02
marjimgon: folds 
TrancaRua2021: checks 
*** FLOP *** [Ks 7h Qc]
TrancaRua2021: checks 
agonzalezelh: bets $0.07
JohnMcCarty94: folds 
TrancaRua2021: calls $0.07
*** TURN *** [Ks 7h Qc] [Jd]
TrancaRua2021: checks 
agonzalezelh: checks 
*** RIVER *** [Ks 7h Qc Jd] [Tc]
TrancaRua2021: checks 
agonzalezelh: bets $0.20
TrancaRua2021: folds 
Uncalled bet ($0.20) returned to agonzalezelh
agonzalezelh collected $0.20 from pot
agonzalezelh: doesn't show hand 
*** SUMMARY ***
Total pot $0.21 | Rake $0.01 
Board [Ks 7h Qc Jd Tc]
Seat 1: TrancaRua2021 (big blind) folded on the River
Seat 2: bofeca4321 folded before Flop (didn't bet)
Seat 3: djiga.1215 folded before Flop (didn't bet)
Seat 5: agonzalezelh collected ($0.20)
Seat 6: Dorex2007 folded before Flop (didn't bet)
Seat 7: JohnMcCarty94 (button) folded on the Flop
Seat 8: marjimgon (small blind) folded before Flop



PokerStars Hand #228336745276:  Hold'em No Limit ($0.01/$0.02 USD) - 2021/07/16 11:44:11 PT [2021/07/16 14:44:11 ET]
Table 'Sorga' 9-max Seat #8 is the button
Seat 1: TrancaRua2021 ($2 in chips) 
Seat 2: bofeca4321 ($1.90 in chips) 
Seat 3: djiga.1215 ($2.12 in chips) 
Seat 5: agonzalezelh ($1.69 in chips) 
Seat 6: Dorex2007 ($3.43 in chips) 
Seat 7: JohnMcCarty94 ($1.28 in chips) 
Seat 8: marjimgon ($0.77 in chips) 
TrancaRua2021: posts small blind $0.01
bofeca4321: posts big blind $0.02
*** HOLE CARDS ***
Dealt to Dorex2007 [Kd 5d]
djiga.1215: folds 
agonzalezelh: folds 
Dorex2007: folds 
JohnMcCarty94: calls $0.02
marjimgon: folds 
TrancaRua2021: folds 
bofeca4321: checks 
*** FLOP *** [Qd 2s 7d]
bofeca4321: checks 
JohnMcCarty94: checks 
*** TURN *** [Qd 2s 7d] [Jc]
bofeca4321: checks 
JohnMcCarty94: checks 
*** RIVER *** [Qd 2s 7d Jc] [As]
bofeca4321: checks 
JohnMcCarty94: checks 
*** SHOW DOWN ***
bofeca4321: shows [9s 8h] (high card Ace)
JohnMcCarty94: mucks hand 
bofeca4321 collected $0.05 from pot
*** SUMMARY ***
Total pot $0.05 | Rake $0 
Board [Qd 2s 7d Jc As]
Seat 1: TrancaRua2021 (small blind) folded before Flop
Seat 2: bofeca4321 (big blind) showed [9s 8h] and won ($0.05) with high card Ace
Seat 3: djiga.1215 folded before Flop (didn't bet)
Seat 5: agonzalezelh folded before Flop (didn't bet)
Seat 6: Dorex2007 folded before Flop (didn't bet)
Seat 7: JohnMcCarty94 mucked [3h 4s]
Seat 8: marjimgon (button) folded before Flop (didn't bet)



PokerStars Hand #228336759881:  Hold'em No Limit ($0.01/$0.02 USD) - 2021/07/16 11:44:45 PT [2021/07/16 14:44:45 ET]
Table 'Sorga' 9-max Seat #1 is the button
Seat 1: TrancaRua2021 ($2 in chips) 
Seat 2: bofeca4321 ($1.93 in chips) 
Seat 3: djiga.1215 ($2.12 in chips) 
Seat 5: agonzalezelh ($1.69 in chips) 
Seat 6: Dorex2007 ($3.43 in chips) 
Seat 7: JohnMcCarty94 ($1.26 in chips) 
Seat 8: marjimgon ($0.77 in chips) 
bofeca4321: posts small blind $0.01
djiga.1215: posts big blind $0.02
LuisZeifer: sits out 
*** HOLE CARDS ***
Dealt to Dorex2007 [Ks As]
agonzalezelh: raises $0.04 to $0.06
Dorex2007: calls $0.06
JohnMcCarty94: calls $0.06
marjimgon: folds 
TrancaRua2021: folds 
bofeca4321: folds 
djiga.1215: calls $0.04
*** FLOP *** [9h 4d Tc]
djiga.1215: checks 
agonzalezelh: checks 
Dorex2007: bets $0.12
JohnMcCarty94: folds 
djiga.1215: raises $0.24 to $0.36
agonzalezelh: folds 
Dorex2007: calls $0.24
*** TURN *** [9h 4d Tc] [Td]
djiga.1215: bets $0.47
Dorex2007: calls $0.47
*** RIVER *** [9h 4d Tc Td] [9c]
djiga.1215: bets $1.23 and is all-in
Dorex2007: folds 
Uncalled bet ($1.23) returned to djiga.1215
djiga.1215 collected $1.84 from pot
djiga.1215: doesn't show hand 
*** SUMMARY ***
Total pot $1.91 | Rake $0.07 
Board [9h 4d Tc Td 9c]
Seat 1: TrancaRua2021 (button) folded before Flop (didn't bet)
Seat 2: bofeca4321 (small blind) folded before Flop
Seat 3: djiga.1215 (big blind) collected ($1.84)
Seat 5: agonzalezelh folded on the Flop
Seat 6: Dorex2007 folded on the River
Seat 7: JohnMcCarty94 folded on the Flop
Seat 8: marjimgon folded before Flop (didn't bet)



PokerStars Hand #228336792277:  Hold'em No Limit ($0.01/$0.02 USD) - 2021/07/16 11:46:00 PT [2021/07/16 14:46:00 ET]
Table 'Sorga' 9-max Seat #2 is the button
Seat 1: TrancaRua2021 ($2 in chips) 
Seat 2: bofeca4321 ($1.92 in chips) 
Seat 3: djiga.1215 ($3.07 in chips) 
Seat 4: Dr_Poliakov ($2 in chips) 
Seat 5: agonzalezelh ($1.63 in chips) 
Seat 6: Dorex2007 ($2.54 in chips) 
Seat 7: JohnMcCarty94 ($1.20 in chips) 
Seat 8: marjimgon ($0.77 in chips) 
djiga.1215: posts small blind $0.01
Dr_Poliakov: posts big blind $0.02
LuisZeifer: sits out 
*** HOLE CARDS ***
Dealt to Dorex2007 [Qc 7d]
agonzalezelh: folds 
Dorex2007: folds 
JohnMcCarty94: calls $0.02
marjimgon: calls $0.02
TrancaRua2021: raises $0.03 to $0.05
bofeca4321: folds 
djiga.1215: folds 
Dr_Poliakov: calls $0.03
JohnMcCarty94: calls $0.03
djiga.1215 said, "sorry baby"
marjimgon: raises $0.72 to $0.77 and is all-in
TrancaRua2021: folds 
Dr_Poliakov: folds 
JohnMcCarty94: folds 
Uncalled bet ($0.72) returned to marjimgon
marjimgon collected $0.21 from pot
marjimgon: doesn't show hand 
*** SUMMARY ***
Total pot $0.21 | Rake $0 
Seat 1: TrancaRua2021 folded before Flop
Seat 2: bofeca4321 (button) folded before Flop (didn't bet)
Seat 3: djiga.1215 (small blind) folded before Flop
Seat 4: Dr_Poliakov (big blind) folded before Flop
Seat 5: agonzalezelh folded before Flop (didn't bet)
Seat 6: Dorex2007 folded before Flop (didn't bet)
Seat 7: JohnMcCarty94 folded before Flop
Seat 8: marjimgon collected ($0.21)



PokerStars Hand #228336809323:  Hold'em No Limit ($0.01/$0.02 USD) - 2021/07/16 11:46:40 PT [2021/07/16 14:46:40 ET]
Table 'Sorga' 9-max Seat #3 is the button
Seat 1: TrancaRua2021 ($2 in chips) 
Seat 2: bofeca4321 ($1.92 in chips) 
Seat 3: djiga.1215 ($3.06 in chips) 
Seat 4: Dr_Poliakov ($2 in chips) 
Seat 5: agonzalezelh ($1.63 in chips) 
Seat 6: Dorex2007 ($2.54 in chips) 
Seat 7: JohnMcCarty94 ($1.15 in chips) 
Seat 8: marjimgon ($0.93 in chips) 
Dr_Poliakov: posts small blind $0.01
agonzalezelh: posts big blind $0.02
LuisZeifer: sits out 
*** HOLE CARDS ***
Dealt to Dorex2007 [9c Ad]
Dorex2007: folds 
JohnMcCarty94: calls $0.02
marjimgon: folds 
TrancaRua2021: folds 
bofeca4321: folds 
djiga.1215: folds 
Dr_Poliakov: folds 
Dorex2007 said, "you bluff too  much"
agonzalezelh: checks 
*** FLOP *** [Qd 7c Ks]
djiga.1215 said, "blufff"
djiga.1215 said, "22"
agonzalezelh: checks 
JohnMcCarty94: bets $0.02
agonzalezelh: calls $0.02
*** TURN *** [Qd 7c Ks] [Kc]
agonzalezelh: checks 
JohnMcCarty94: bets $0.09
agonzalezelh: folds 
Uncalled bet ($0.09) returned to JohnMcCarty94
JohnMcCarty94 collected $0.09 from pot
JohnMcCarty94: doesn't show hand 
*** SUMMARY ***
Total pot $0.09 | Rake $0 
Board [Qd 7c Ks Kc]
Seat 1: TrancaRua2021 folded before Flop (didn't bet)
Seat 2: bofeca4321 folded before Flop (didn't bet)
Seat 3: djiga.1215 (button) folded before Flop (didn't bet)
Seat 4: Dr_Poliakov (small blind) folded before Flop
Seat 5: agonzalezelh (big blind) folded on the Turn
Seat 6: Dorex2007 folded before Flop (didn't bet)
Seat 7: JohnMcCarty94 collected ($0.09)
Seat 8: marjimgon folded before Flop (didn't bet)



PokerStars Hand #228336825303:  Hold'em No Limit ($0.01/$0.02 USD) - 2021/07/16 11:47:19 PT [2021/07/16 14:47:19 ET]
Table 'Sorga' 9-max Seat #4 is the button
Seat 1: TrancaRua2021 ($2 in chips) 
Seat 2: bofeca4321 ($1.92 in chips) 
Seat 3: djiga.1215 ($3.06 in chips) 
Seat 4: Dr_Poliakov ($2 in chips) 
Seat 5: agonzalezelh ($1.59 in chips) 
Seat 6: Dorex2007 ($2.54 in chips) 
Seat 7: JohnMcCarty94 ($1.20 in chips) 
Seat 8: marjimgon ($0.93 in chips) 
agonzalezelh: posts small blind $0.01
Dorex2007: posts big blind $0.02
LuisZeifer: sits out 
*** HOLE CARDS ***
Dealt to Dorex2007 [4d 8h]
JohnMcCarty94: calls $0.02
marjimgon: folds 
TrancaRua2021: folds 
bofeca4321: folds 
djiga.1215: folds 
Dr_Poliakov: folds 
agonzalezelh: calls $0.01
Dorex2007: checks 
*** FLOP *** [Td Ks 6c]
agonzalezelh: checks 
Dorex2007: checks 
JohnMcCarty94: checks 
*** TURN *** [Td Ks 6c] [Ah]
agonzalezelh: bets $0.06
Dorex2007: folds 
JohnMcCarty94: folds 
Uncalled bet ($0.06) returned to agonzalezelh
agonzalezelh collected $0.06 from pot
agonzalezelh: doesn't show hand 
*** SUMMARY ***
Total pot $0.06 | Rake $0 
Board [Td Ks 6c Ah]
Seat 1: TrancaRua2021 folded before Flop (didn't bet)
Seat 2: bofeca4321 folded before Flop (didn't bet)
Seat 3: djiga.1215 folded before Flop (didn't bet)
Seat 4: Dr_Poliakov (button) folded before Flop (didn't bet)
Seat 5: agonzalezelh (small blind) collected ($0.06)
Seat 6: Dorex2007 (big blind) folded on the Turn
Seat 7: JohnMcCarty94 folded on the Turn
Seat 8: marjimgon folded before Flop (didn't bet)



PokerStars Hand #228336837975:  Hold'em No Limit ($0.01/$0.02 USD) - 2021/07/16 11:47:48 PT [2021/07/16 14:47:48 ET]
Table 'Sorga' 9-max Seat #5 is the button
Seat 1: TrancaRua2021 ($2 in chips) 
Seat 2: bofeca4321 ($1.92 in chips) 
Seat 3: djiga.1215 ($3.06 in chips) 
Seat 4: Dr_Poliakov ($2 in chips) 
Seat 5: agonzalezelh ($1.63 in chips) 
Seat 6: Dorex2007 ($2.52 in chips) 
Seat 7: JohnMcCarty94 ($1.18 in chips) 
Seat 8: marjimgon ($0.93 in chips) 
Dorex2007: posts small blind $0.01
JohnMcCarty94: posts big blind $0.02
LuisZeifer: sits out 
*** HOLE CARDS ***
Dealt to Dorex2007 [Qc 3h]
marjimgon: folds 
TrancaRua2021: folds 
bofeca4321: folds 
djiga.1215: folds 
Dr_Poliakov: raises $0.03 to $0.05
agonzalezelh: folds 
Dorex2007: folds 
JohnMcCarty94: calls $0.03
*** FLOP *** [8d 9h 7h]
JohnMcCarty94: checks 
Dr_Poliakov: bets $0.08
JohnMcCarty94: folds 
Uncalled bet ($0.08) returned to Dr_Poliakov
Dr_Poliakov collected $0.11 from pot
Dr_Poliakov: doesn't show hand 
*** SUMMARY ***
Total pot $0.11 | Rake $0 
Board [8d 9h 7h]
Seat 1: TrancaRua2021 folded before Flop (didn't bet)
Seat 2: bofeca4321 folded before Flop (didn't bet)
Seat 3: djiga.1215 folded before Flop (didn't bet)
Seat 4: Dr_Poliakov collected ($0.11)
Seat 5: agonzalezelh (button) folded before Flop (didn't bet)
Seat 6: Dorex2007 (small blind) folded before Flop
Seat 7: JohnMcCarty94 (big blind) folded on the Flop
Seat 8: marjimgon folded before Flop (didn't bet)



PokerStars Hand #228336847634:  Hold'em No Limit ($0.01/$0.02 USD) - 2021/07/16 11:48:11 PT [2021/07/16 14:48:11 ET]
Table 'Sorga' 9-max Seat #6 is the button
Seat 1: TrancaRua2021 ($2 in chips) 
Seat 2: bofeca4321 ($1.92 in chips) 
Seat 3: djiga.1215 ($3.06 in chips) 
Seat 4: Dr_Poliakov ($2.06 in chips) 
Seat 5: agonzalezelh ($1.63 in chips) 
Seat 6: Dorex2007 ($2.51 in chips) 
Seat 7: JohnMcCarty94 ($1.13 in chips) 
Seat 8: marjimgon ($0.93 in chips) 
JohnMcCarty94: posts small blind $0.01
marjimgon: posts big blind $0.02
LuisZeifer: sits out 
*** HOLE CARDS ***
Dealt to Dorex2007 [4s As]
TrancaRua2021: folds 
bofeca4321: folds 
djiga.1215: folds 
Dr_Poliakov: folds 
agonzalezelh: calls $0.02
Dorex2007: calls $0.02
JohnMcCarty94: calls $0.01
marjimgon: raises $0.08 to $0.10
agonzalezelh: folds 
Dorex2007: calls $0.08
JohnMcCarty94: calls $0.08
*** FLOP *** [7h 9c 7c]
JohnMcCarty94: checks 
marjimgon: checks 
Dorex2007: checks 
*** TURN *** [7h 9c 7c] [9s]
JohnMcCarty94: checks 
marjimgon: bets $0.06
Dorex2007: raises $2.35 to $2.41 and is all-in
JohnMcCarty94: folds 
marjimgon: folds 
Uncalled bet ($2.35) returned to Dorex2007
Dorex2007 collected $0.42 from pot
Dorex2007: doesn't show hand 
*** SUMMARY ***
Total pot $0.44 | Rake $0.02 
Board [7h 9c 7c 9s]
Seat 1: TrancaRua2021 folded before Flop (didn't bet)
Seat 2: bofeca4321 folded before Flop (didn't bet)
Seat 3: djiga.1215 folded before Flop (didn't bet)
Seat 4: Dr_Poliakov folded before Flop (didn't bet)
Seat 5: agonzalezelh folded before Flop
Seat 6: Dorex2007 (button) collected ($0.42)
Seat 7: JohnMcCarty94 (small blind) folded on the Turn
Seat 8: marjimgon (big blind) folded on the Turn



PokerStars Hand #228336875508:  Hold'em No Limit ($0.01/$0.02 USD) - 2021/07/16 11:49:11 PT [2021/07/16 14:49:11 ET]
Table 'Sorga' 9-max Seat #7 is the button
Seat 1: TrancaRua2021 ($2 in chips) 
Seat 2: bofeca4321 ($1.92 in chips) 
Seat 3: djiga.1215 ($3.06 in chips) 
Seat 4: Dr_Poliakov ($2.06 in chips) 
Seat 5: agonzalezelh ($1.61 in chips) 
Seat 6: Dorex2007 ($2.77 in chips) 
Seat 7: JohnMcCarty94 ($1.03 in chips) 
Seat 8: marjimgon ($0.77 in chips) 
Seat 9: LuisZeifer ($2.51 in chips) 
marjimgon: posts small blind $0.01
LuisZeifer: posts big blind $0.02
*** HOLE CARDS ***
Dealt to Dorex2007 [4d 8c]
TrancaRua2021: folds 
bofeca4321: folds 
djiga.1215: folds 
Dr_Poliakov: folds 
agonzalezelh: folds 
Dorex2007: folds 
JohnMcCarty94: calls $0.02
marjimgon: folds 
LuisZeifer: checks 
*** FLOP *** [3h Jc Th]
LuisZeifer: checks 
JohnMcCarty94: checks 
*** TURN *** [3h Jc Th] [4h]
LuisZeifer: bets $0.05
JohnMcCarty94: folds 
Uncalled bet ($0.05) returned to LuisZeifer
LuisZeifer collected $0.05 from pot
*** SUMMARY ***
Total pot $0.05 | Rake $0 
Board [3h Jc Th 4h]
Seat 1: TrancaRua2021 folded before Flop (didn't bet)
Seat 2: bofeca4321 folded before Flop (didn't bet)
Seat 3: djiga.1215 folded before Flop (didn't bet)
Seat 4: Dr_Poliakov folded before Flop (didn't bet)
Seat 5: agonzalezelh folded before Flop (didn't bet)
Seat 6: Dorex2007 folded before Flop (didn't bet)
Seat 7: JohnMcCarty94 (button) folded on the Turn
Seat 8: marjimgon (small blind) folded before Flop
Seat 9: LuisZeifer (big blind) collected ($0.05)



PokerStars Hand #228336895795:  Hold'em No Limit ($0.01/$0.02 USD) - 2021/07/16 11:49:59 PT [2021/07/16 14:49:59 ET]
Table 'Sorga' 9-max Seat #8 is the button
Seat 1: TrancaRua2021 ($2 in chips) 
Seat 2: bofeca4321 ($1.92 in chips) 
Seat 3: djiga.1215 ($3.06 in chips) 
Seat 4: Dr_Poliakov ($2.06 in chips) 
Seat 5: agonzalezelh ($1.61 in chips) 
Seat 6: Dorex2007 ($2.77 in chips) 
Seat 7: JohnMcCarty94 ($1.01 in chips) 
Seat 8: marjimgon ($0.76 in chips) 
Seat 9: LuisZeifer ($2.54 in chips) 
LuisZeifer: posts small blind $0.01
TrancaRua2021: posts big blind $0.02
*** HOLE CARDS ***
Dealt to Dorex2007 [5c 9h]
bofeca4321: folds 
djiga.1215: folds 
Dr_Poliakov: folds 
agonzalezelh: raises $0.04 to $0.06
Dorex2007: folds 
JohnMcCarty94: calls $0.06
marjimgon: calls $0.06
LuisZeifer has timed out
LuisZeifer: folds 
TrancaRua2021: calls $0.04
*** FLOP *** [4c 3s 3d]
TrancaRua2021: checks 
agonzalezelh: bets $0.12
JohnMcCarty94: folds 
marjimgon: folds 
TrancaRua2021: folds 
Uncalled bet ($0.12) returned to agonzalezelh
agonzalezelh collected $0.24 from pot
agonzalezelh: doesn't show hand 
*** SUMMARY ***
Total pot $0.25 | Rake $0.01 
Board [4c 3s 3d]
Seat 1: TrancaRua2021 (big blind) folded on the Flop
Seat 2: bofeca4321 folded before Flop (didn't bet)
Seat 3: djiga.1215 folded before Flop (didn't bet)
Seat 4: Dr_Poliakov folded before Flop (didn't bet)
Seat 5: agonzalezelh collected ($0.24)
Seat 6: Dorex2007 folded before Flop (didn't bet)
Seat 7: JohnMcCarty94 folded on the Flop
Seat 8: marjimgon (button) folded on the Flop
Seat 9: LuisZeifer (small blind) folded before Flop



PokerStars Hand #228336918207:  Hold'em No Limit ($0.01/$0.02 USD) - 2021/07/16 11:50:54 PT [2021/07/16 14:50:54 ET]
Table 'Sorga' 9-max Seat #1 is the button
Seat 1: TrancaRua2021 ($2 in chips) 
Seat 2: bofeca4321 ($1.92 in chips) 
Seat 3: djiga.1215 ($3.06 in chips) 
Seat 4: Dr_Poliakov ($2.06 in chips) 
Seat 5: agonzalezelh ($1.79 in chips) 
Seat 6: Dorex2007 ($2.77 in chips) 
Seat 7: JohnMcCarty94 ($0.95 in chips) 
Seat 8: marjimgon ($0.70 in chips) 
bofeca4321: posts small blind $0.01
djiga.1215: posts big blind $0.02
*** HOLE CARDS ***
Dealt to Dorex2007 [4h 3s]
Dr_Poliakov: folds 
agonzalezelh: raises $0.04 to $0.06
Dorex2007: folds 
JohnMcCarty94: folds 
marjimgon: folds 
TrancaRua2021: folds 
bofeca4321: folds 
djiga.1215: folds 
Uncalled bet ($0.04) returned to agonzalezelh
agonzalezelh collected $0.05 from pot
agonzalezelh: doesn't show hand 
*** SUMMARY ***
Total pot $0.05 | Rake $0 
Seat 1: TrancaRua2021 (button) folded before Flop (didn't bet)
Seat 2: bofeca4321 (small blind) folded before Flop
Seat 3: djiga.1215 (big blind) folded before Flop
Seat 4: Dr_Poliakov folded before Flop (didn't bet)
Seat 5: agonzalezelh collected ($0.05)
Seat 6: Dorex2007 folded before Flop (didn't bet)
Seat 7: JohnMcCarty94 folded before Flop (didn't bet)
Seat 8: marjimgon folded before Flop (didn't bet)



PokerStars Hand #228336925726:  Hold'em No Limit ($0.01/$0.02 USD) - 2021/07/16 11:51:12 PT [2021/07/16 14:51:12 ET]
Table 'Sorga' 9-max Seat #2 is the button
Seat 1: TrancaRua2021 ($2 in chips) 
Seat 2: bofeca4321 ($1.91 in chips) 
Seat 3: djiga.1215 ($3.04 in chips) 
Seat 4: Dr_Poliakov ($2.06 in chips) 
Seat 5: agonzalezelh ($1.82 in chips) 
Seat 6: Dorex2007 ($2.77 in chips) 
Seat 7: JohnMcCarty94 ($0.95 in chips) 
Seat 8: marjimgon ($0.70 in chips) 
djiga.1215: posts small blind $0.01
Dr_Poliakov: posts big blind $0.02
*** HOLE CARDS ***
Dealt to Dorex2007 [3h 9h]
agonzalezelh: calls $0.02
Dorex2007: folds 
JohnMcCarty94: calls $0.02
marjimgon: folds 
TrancaRua2021: raises $0.03 to $0.05
bofeca4321: folds 
djiga.1215: folds 
Dr_Poliakov: folds 
agonzalezelh: calls $0.03
JohnMcCarty94: calls $0.03
*** FLOP *** [Qd Qs 5h]
agonzalezelh: checks 
JohnMcCarty94: checks 
TrancaRua2021: checks 
*** TURN *** [Qd Qs 5h] [5c]
agonzalezelh: bets $0.09
JohnMcCarty94: calls $0.09
TrancaRua2021: folds 
*** RIVER *** [Qd Qs 5h 5c] [2s]
agonzalezelh: bets $0.35
JohnMcCarty94: calls $0.35
*** SHOW DOWN ***
agonzalezelh: shows [9s Kh] (two pair, Queens and Fives)
JohnMcCarty94: shows [5s 3d] (a full house, Fives full of Queens)
JohnMcCarty94 collected $1.02 from pot
*** SUMMARY ***
Total pot $1.06 | Rake $0.04 
Board [Qd Qs 5h 5c 2s]
Seat 1: TrancaRua2021 folded on the Turn
Seat 2: bofeca4321 (button) folded before Flop (didn't bet)
Seat 3: djiga.1215 (small blind) folded before Flop
Seat 4: Dr_Poliakov (big blind) folded before Flop
Seat 5: agonzalezelh showed [9s Kh] and lost with two pair, Queens and Fives
Seat 6: Dorex2007 folded before Flop (didn't bet)
Seat 7: JohnMcCarty94 showed [5s 3d] and won ($1.02) with a full house, Fives full of Queens
Seat 8: marjimgon folded before Flop (didn't bet)



PokerStars Hand #228336944955:  Hold'em No Limit ($0.01/$0.02 USD) - 2021/07/16 11:51:56 PT [2021/07/16 14:51:56 ET]
Table 'Sorga' 9-max Seat #3 is the button
Seat 1: TrancaRua2021 ($2 in chips) 
Seat 2: bofeca4321 ($1.91 in chips) 
Seat 3: djiga.1215 ($3.03 in chips) 
Seat 4: Dr_Poliakov ($2.04 in chips) 
Seat 5: agonzalezelh ($1.33 in chips) 
Seat 6: Dorex2007 ($2.77 in chips) 
Seat 7: JohnMcCarty94 ($1.48 in chips) 
Seat 8: marjimgon ($0.70 in chips) 
Seat 9: LuisZeifer ($2.53 in chips) 
Dr_Poliakov: posts small blind $0.01
agonzalezelh: posts big blind $0.02
*** HOLE CARDS ***
Dealt to Dorex2007 [5c 8c]
Dorex2007: folds 
JohnMcCarty94: calls $0.02
marjimgon: folds 
LuisZeifer: folds 
TrancaRua2021: folds 
bofeca4321: calls $0.02
djiga.1215: calls $0.02
Dr_Poliakov: folds 
agonzalezelh: checks 
*** FLOP *** [Js 9s Ks]
agonzalezelh: checks 
JohnMcCarty94: checks 
bofeca4321: checks 
djiga.1215: checks 
*** TURN *** [Js 9s Ks] [Jd]
agonzalezelh: checks 
JohnMcCarty94: checks 
bofeca4321: bets $0.02
djiga.1215: folds 
agonzalezelh: calls $0.02
JohnMcCarty94: calls $0.02
*** RIVER *** [Js 9s Ks Jd] [4d]
agonzalezelh: checks 
JohnMcCarty94: checks 
bofeca4321: bets $0.04
agonzalezelh: folds 
JohnMcCarty94: folds 
Uncalled bet ($0.04) returned to bofeca4321
bofeca4321 collected $0.14 from pot
bofeca4321: doesn't show hand 
*** SUMMARY ***
Total pot $0.15 | Rake $0.01 
Board [Js 9s Ks Jd 4d]
Seat 1: TrancaRua2021 folded before Flop (didn't bet)
Seat 2: bofeca4321 collected ($0.14)
Seat 3: djiga.1215 (button) folded on the Turn
Seat 4: Dr_Poliakov (small blind) folded before Flop
Seat 5: agonzalezelh (big blind) folded on the River
Seat 6: Dorex2007 folded before Flop (didn't bet)
Seat 7: JohnMcCarty94 folded on the River
Seat 8: marjimgon folded before Flop (didn't bet)
Seat 9: LuisZeifer folded before Flop (didn't bet)



PokerStars Hand #228336972753:  Hold'em No Limit ($0.01/$0.02 USD) - 2021/07/16 11:53:00 PT [2021/07/16 14:53:00 ET]
Table 'Sorga' 9-max Seat #4 is the button
Seat 1: TrancaRua2021 ($2 in chips) 
Seat 2: bofeca4321 ($2.01 in chips) 
Seat 3: djiga.1215 ($3.01 in chips) 
Seat 4: Dr_Poliakov ($2.03 in chips) 
Seat 5: agonzalezelh ($1.29 in chips) 
Seat 6: Dorex2007 ($2.77 in chips) 
Seat 7: JohnMcCarty94 ($1.44 in chips) 
Seat 9: LuisZeifer ($2.53 in chips) 
agonzalezelh: posts small blind $0.01
Dorex2007: posts big blind $0.02
*** HOLE CARDS ***
Dealt to Dorex2007 [2c 9d]
JohnMcCarty94: calls $0.02
LuisZeifer has timed out
LuisZeifer: folds 
TrancaRua2021: raises $0.03 to $0.05
bofeca4321: folds 
djiga.1215: folds 
Dr_Poliakov has timed out
Dr_Poliakov: folds 
agonzalezelh: folds 
Dorex2007: folds 
JohnMcCarty94: calls $0.03
*** FLOP *** [3h Tc 5s]
agonzalezelh leaves the table
JohnMcCarty94: checks 
TrancaRua2021: checks 
*** TURN *** [3h Tc 5s] [Ac]
JohnMcCarty94: checks 
TrancaRua2021: bets $0.10
JohnMcCarty94: folds 
Uncalled bet ($0.10) returned to TrancaRua2021
TrancaRua2021 collected $0.13 from pot
TrancaRua2021: doesn't show hand 
*** SUMMARY ***
Total pot $0.13 | Rake $0 
Board [3h Tc 5s Ac]
Seat 1: TrancaRua2021 collected ($0.13)
Seat 2: bofeca4321 folded before Flop (didn't bet)
Seat 3: djiga.1215 folded before Flop (didn't bet)
Seat 4: Dr_Poliakov (button) folded before Flop (didn't bet)
Seat 5: agonzalezelh (small blind) folded before Flop
Seat 6: Dorex2007 (big blind) folded before Flop
Seat 7: JohnMcCarty94 folded on the Turn
Seat 9: LuisZeifer folded before Flop (didn't bet)



PokerStars Hand #228336993342:  Hold'em No Limit ($0.01/$0.02 USD) - 2021/07/16 11:53:48 PT [2021/07/16 14:53:48 ET]
Table 'Sorga' 9-max Seat #6 is the button
Seat 1: TrancaRua2021 ($2.08 in chips) 
Seat 2: bofeca4321 ($2.01 in chips) 
Seat 3: djiga.1215 ($3.01 in chips) 
Seat 4: Dr_Poliakov ($2.03 in chips) 
Seat 6: Dorex2007 ($2.75 in chips) 
Seat 7: JohnMcCarty94 ($1.39 in chips) 
Seat 9: LuisZeifer ($2.53 in chips) 
JohnMcCarty94: posts small blind $0.01
LuisZeifer: posts big blind $0.02
*** HOLE CARDS ***
Dealt to Dorex2007 [Kd Qc]
TrancaRua2021: folds 
bofeca4321: folds 
deka525 joins the table at seat #5 
djiga.1215: raises $0.03 to $0.05
Dr_Poliakov: folds 
Dorex2007: calls $0.05
JohnMcCarty94: calls $0.04
LuisZeifer: folds 
*** FLOP *** [4d 2c Ad]
JohnMcCarty94: checks 
djiga.1215: checks 
Dorex2007: checks 
*** TURN *** [4d 2c Ad] [7s]
JohnMcCarty94: bets $0.11
djiga.1215: calls $0.11
Dorex2007: folds 
*** RIVER *** [4d 2c Ad 7s] [Jh]
JohnMcCarty94: bets $0.24
djiga.1215: folds 
Uncalled bet ($0.24) returned to JohnMcCarty94
JohnMcCarty94 collected $0.38 from pot
JohnMcCarty94: doesn't show hand 
*** SUMMARY ***
Total pot $0.39 | Rake $0.01 
Board [4d 2c Ad 7s Jh]
Seat 1: TrancaRua2021 folded before Flop (didn't bet)
Seat 2: bofeca4321 folded before Flop (didn't bet)
Seat 3: djiga.1215 folded on the River
Seat 4: Dr_Poliakov folded before Flop (didn't bet)
Seat 6: Dorex2007 (button) folded on the Turn
Seat 7: JohnMcCarty94 (small blind) collected ($0.38)
Seat 9: LuisZeifer (big blind) folded before Flop



PokerStars Hand #228337021899:  Hold'em No Limit ($0.01/$0.02 USD) - 2021/07/16 11:54:55 PT [2021/07/16 14:54:55 ET]
Table 'Sorga' 9-max Seat #7 is the button
Seat 1: TrancaRua2021 ($2.08 in chips) 
Seat 2: bofeca4321 ($2.01 in chips) 
Seat 3: djiga.1215 ($2.85 in chips) 
Seat 4: Dr_Poliakov ($2.03 in chips) 
Seat 5: deka525 ($1.60 in chips) 
Seat 6: Dorex2007 ($2.70 in chips) 
Seat 7: JohnMcCarty94 ($1.61 in chips) 
Seat 9: LuisZeifer ($2.51 in chips) 
LuisZeifer: posts small blind $0.01
TrancaRua2021: posts big blind $0.02
deka525: posts big blind $0.02
*** HOLE CARDS ***
Dealt to Dorex2007 [6h Th]
bofeca4321: folds 
djiga.1215: folds 
Dr_Poliakov: folds 
deka525: checks 
Dorex2007: folds 
JohnMcCarty94: calls $0.02
LuisZeifer: calls $0.01
TrancaRua2021: checks 
*** FLOP *** [Ad As Qh]
LuisZeifer: checks 
TrancaRua2021: checks 
deka525: bets $0.12
JohnMcCarty94 has timed out
JohnMcCarty94: folds 
LuisZeifer: calls $0.12
TrancaRua2021: folds 
*** TURN *** [Ad As Qh] [3c]
LuisZeifer: bets $0.16
deka525: calls $0.16
*** RIVER *** [Ad As Qh 3c] [7d]
LuisZeifer: bets $0.31
deka525: calls $0.31
*** SHOW DOWN ***
LuisZeifer: shows [2s Ac] (three of a kind, Aces)
deka525: shows [Ah 8s] (three of a kind, Aces - Queen+Eight kicker)
deka525 collected $1.22 from pot
*** SUMMARY ***
Total pot $1.26 | Rake $0.04 
Board [Ad As Qh 3c 7d]
Seat 1: TrancaRua2021 (big blind) folded on the Flop
Seat 2: bofeca4321 folded before Flop (didn't bet)
Seat 3: djiga.1215 folded before Flop (didn't bet)
Seat 4: Dr_Poliakov folded before Flop (didn't bet)
Seat 5: deka525 showed [Ah 8s] and won ($1.22) with three of a kind, Aces
Seat 6: Dorex2007 folded before Flop (didn't bet)
Seat 7: JohnMcCarty94 (button) folded on the Flop
Seat 9: LuisZeifer (small blind) showed [2s Ac] and lost with three of a kind, Aces



PokerStars Hand #228337051530:  Hold'em No Limit ($0.01/$0.02 USD) - 2021/07/16 11:56:29 PT [2021/07/16 14:56:29 ET]
Table 'Sorga' 9-max Seat #9 is the button
Seat 1: TrancaRua2021 ($2.06 in chips) 
Seat 2: bofeca4321 ($2.01 in chips) 
Seat 3: djiga.1215 ($2.85 in chips) 
Seat 4: Dr_Poliakov ($2.03 in chips) 
Seat 5: deka525 ($2.21 in chips) 
Seat 6: Dorex2007 ($2.70 in chips) 
Seat 7: JohnMcCarty94 ($1.59 in chips) 
Seat 9: LuisZeifer ($1.90 in chips) 
TrancaRua2021: posts small blind $0.01
bofeca4321: posts big blind $0.02
*** HOLE CARDS ***
Dealt to Dorex2007 [5d Qs]
djiga.1215: folds 
Dr_Poliakov: raises $0.04 to $0.06
deka525: calls $0.06
Dorex2007: folds 
JohnMcCarty94 is disconnected 
JohnMcCarty94 has timed out while disconnected
JohnMcCarty94: folds 
LuisZeifer: folds 
TrancaRua2021: folds 
bofeca4321: folds 
*** FLOP *** [Js 5h 6c]
Dr_Poliakov: bets $0.11
deka525: calls $0.11
*** TURN *** [Js 5h 6c] [Jd]
Dr_Poliakov: checks 
deka525: checks 
*** RIVER *** [Js 5h 6c Jd] [7s]
Dr_Poliakov: checks 
deka525: checks 
*** SHOW DOWN ***
Dr_Poliakov: shows [Ts Ks] (a pair of Jacks)
deka525: shows [Kc 5c] (two pair, Jacks and Fives)
deka525 collected $0.36 from pot
*** SUMMARY ***
Total pot $0.37 | Rake $0.01 
Board [Js 5h 6c Jd 7s]
Seat 1: TrancaRua2021 (small blind) folded before Flop
Seat 2: bofeca4321 (big blind) folded before Flop
Seat 3: djiga.1215 folded before Flop (didn't bet)
Seat 4: Dr_Poliakov showed [Ts Ks] and lost with a pair of Jacks
Seat 5: deka525 showed [Kc 5c] and won ($0.36) with two pair, Jacks and Fives
Seat 6: Dorex2007 folded before Flop (didn't bet)
Seat 7: JohnMcCarty94 folded before Flop (didn't bet)
Seat 9: LuisZeifer (button) folded before Flop (didn't bet)



