PokerStars Hand #223627697661:  Hold'em No Limit ($0.01/$0.02 USD) - 2021/02/09 15:15:29 PT [2021/02/09 18:15:29 ET]
Table 'Fagnes IV' 9-max Seat #9 is the button
Seat 1: kano1313 ($1.32 in chips) 
Seat 2: englishmannn ($3.45 in chips) 
Seat 3: Unicus86 ($1.55 in chips) 
Seat 4: Hakunaaaa ($2.07 in chips) 
Seat 5: Amsterdam8383 ($1.48 in chips) 
Seat 6: Dorex2007 ($1.50 in chips) 
Seat 7: tinhabond ($0.80 in chips) 
Seat 9: QPokerOO7 ($7.67 in chips) 
kano1313: posts small blind $0.01
englishmannn: posts big blind $0.02
Dorex2007: posts big blind $0.02
*** HOLE CARDS ***
Dealt to Dorex2007 [6c Tc]
Unicus86: folds 
Hakunaaaa: folds 
Amsterdam8383: folds 
Dorex2007: checks 
tinhabond: folds 
QPokerOO7: folds 
kano1313 is disconnected 
kano1313 is connected 
kano1313 has timed out
kano1313: folds 
englishmannn: checks 
*** FLOP *** [Th Qh 5h]
englishmannn: checks 
Dorex2007: checks 
*** TURN *** [Th Qh 5h] [3s]
englishmannn: checks 
Dorex2007: checks 
*** RIVER *** [Th Qh 5h 3s] [Kd]
englishmannn: checks 
Dorex2007: bets $0.06
englishmannn: folds 
Uncalled bet ($0.06) returned to Dorex2007
Dorex2007 collected $0.05 from pot
Dorex2007: doesn't show hand 
*** SUMMARY ***
Total pot $0.05 | Rake $0 
Board [Th Qh 5h 3s Kd]
Seat 1: kano1313 (small blind) folded before Flop
Seat 2: englishmannn (big blind) folded on the River
Seat 3: Unicus86 folded before Flop (didn't bet)
Seat 4: Hakunaaaa folded before Flop (didn't bet)
Seat 5: Amsterdam8383 folded before Flop (didn't bet)
Seat 6: Dorex2007 collected ($0.05)
Seat 7: tinhabond folded before Flop (didn't bet)
Seat 9: QPokerOO7 (button) folded before Flop (didn't bet)



PokerStars Hand #223627772905:  Hold'em No Limit ($0.01/$0.02 USD) - 2021/02/09 15:17:38 PT [2021/02/09 18:17:38 ET]
Table 'Fagnes IV' 9-max Seat #1 is the button
Seat 1: kano1313 ($1.31 in chips) 
Seat 2: englishmannn ($3.43 in chips) 
Seat 3: Unicus86 ($1.55 in chips) 
Seat 4: Hakunaaaa ($2.07 in chips) 
Seat 5: Amsterdam8383 ($1.48 in chips) 
Seat 6: Dorex2007 ($1.53 in chips) 
Seat 7: tinhabond ($0.80 in chips) 
Seat 9: QPokerOO7 ($7.67 in chips) 
englishmannn: posts small blind $0.01
Unicus86: posts big blind $0.02
*** HOLE CARDS ***
Dealt to Dorex2007 [6s Tc]
Hakunaaaa: folds 
Amsterdam8383: calls $0.02
Dorex2007: folds 
tinhabond: calls $0.02
QPokerOO7: folds 
kano1313: calls $0.02
englishmannn: folds 
Unicus86: checks 
*** FLOP *** [9s 2d Td]
Unicus86: checks 
Amsterdam8383: bets $0.09
tinhabond: folds 
kano1313: folds 
Unicus86: folds 
Uncalled bet ($0.09) returned to Amsterdam8383
Amsterdam8383 collected $0.09 from pot
Amsterdam8383: doesn't show hand 
*** SUMMARY ***
Total pot $0.09 | Rake $0 
Board [9s 2d Td]
Seat 1: kano1313 (button) folded on the Flop
Seat 2: englishmannn (small blind) folded before Flop
Seat 3: Unicus86 (big blind) folded on the Flop
Seat 4: Hakunaaaa folded before Flop (didn't bet)
Seat 5: Amsterdam8383 collected ($0.09)
Seat 6: Dorex2007 folded before Flop (didn't bet)
Seat 7: tinhabond folded on the Flop
Seat 9: QPokerOO7 folded before Flop (didn't bet)



PokerStars Hand #223627802232:  Hold'em No Limit ($0.01/$0.02 USD) - 2021/02/09 15:18:32 PT [2021/02/09 18:18:32 ET]
Table 'Fagnes IV' 9-max Seat #2 is the button
Seat 1: kano1313 ($1.29 in chips) 
Seat 2: englishmannn ($3.42 in chips) 
Seat 3: Unicus86 ($1.53 in chips) 
Seat 4: Hakunaaaa ($2.07 in chips) 
Seat 5: Amsterdam8383 ($1.55 in chips) 
Seat 6: Dorex2007 ($1.53 in chips) 
Seat 7: tinhabond ($0.78 in chips) 
Seat 9: QPokerOO7 ($7.67 in chips) 
Unicus86: posts small blind $0.01
Hakunaaaa: posts big blind $0.02
*** HOLE CARDS ***
Dealt to Dorex2007 [4h Jh]
Amsterdam8383: calls $0.02
Dorex2007: folds 
tinhabond: calls $0.02
QPokerOO7: folds 
kano1313: folds 
englishmannn: folds 
Unicus86: folds 
Hakunaaaa: checks 
*** FLOP *** [Ac Js Td]
Hakunaaaa: checks 
Amsterdam8383: bets $0.07
tinhabond: calls $0.07
Hakunaaaa: folds 
*** TURN *** [Ac Js Td] [8h]
Amsterdam8383: checks 
tinhabond: checks 
*** RIVER *** [Ac Js Td 8h] [8d]
Amsterdam8383: bets $0.02
tinhabond: folds 
Uncalled bet ($0.02) returned to Amsterdam8383
Amsterdam8383 collected $0.20 from pot
Amsterdam8383: doesn't show hand 
*** SUMMARY ***
Total pot $0.21 | Rake $0.01 
Board [Ac Js Td 8h 8d]
Seat 1: kano1313 folded before Flop (didn't bet)
Seat 2: englishmannn (button) folded before Flop (didn't bet)
Seat 3: Unicus86 (small blind) folded before Flop
Seat 4: Hakunaaaa (big blind) folded on the Flop
Seat 5: Amsterdam8383 collected ($0.20)
Seat 6: Dorex2007 folded before Flop (didn't bet)
Seat 7: tinhabond folded on the River
Seat 9: QPokerOO7 folded before Flop (didn't bet)



PokerStars Hand #223627830553:  Hold'em No Limit ($0.01/$0.02 USD) - 2021/02/09 15:19:24 PT [2021/02/09 18:19:24 ET]
Table 'Fagnes IV' 9-max Seat #3 is the button
Seat 1: kano1313 ($1.29 in chips) 
Seat 2: englishmannn ($3.42 in chips) 
Seat 3: Unicus86 ($1.52 in chips) 
Seat 4: Hakunaaaa ($2.05 in chips) 
Seat 5: Amsterdam8383 ($1.66 in chips) 
Seat 6: Dorex2007 ($1.53 in chips) 
Seat 7: tinhabond ($0.69 in chips) 
Seat 9: QPokerOO7 ($7.67 in chips) 
Hakunaaaa: posts small blind $0.01
Amsterdam8383: posts big blind $0.02
*** HOLE CARDS ***
Dealt to Dorex2007 [5s 3d]
Dorex2007: folds 
tinhabond: folds 
tinhabond leaves the table
QPokerOO7: raises $0.08 to $0.10
kano1313: folds 
englishmannn: folds 
Unicus86: folds 
Hakunaaaa: folds 
Amsterdam8383: folds 
Uncalled bet ($0.08) returned to QPokerOO7
QPokerOO7 collected $0.05 from pot
QPokerOO7: doesn't show hand 
*** SUMMARY ***
Total pot $0.05 | Rake $0 
Seat 1: kano1313 folded before Flop (didn't bet)
Seat 2: englishmannn folded before Flop (didn't bet)
Seat 3: Unicus86 (button) folded before Flop (didn't bet)
Seat 4: Hakunaaaa (small blind) folded before Flop
Seat 5: Amsterdam8383 (big blind) folded before Flop
Seat 6: Dorex2007 folded before Flop (didn't bet)
Seat 7: tinhabond folded before Flop (didn't bet)
Seat 9: QPokerOO7 collected ($0.05)



PokerStars Hand #223627842698:  Hold'em No Limit ($0.01/$0.02 USD) - 2021/02/09 15:19:47 PT [2021/02/09 18:19:47 ET]
Table 'Fagnes IV' 9-max Seat #4 is the button
Seat 1: kano1313 ($1.29 in chips) 
Seat 2: englishmannn ($3.42 in chips) 
Seat 3: Unicus86 ($1.52 in chips) 
Seat 4: Hakunaaaa ($2.04 in chips) 
Seat 5: Amsterdam8383 ($1.64 in chips) 
Seat 6: Dorex2007 ($1.53 in chips) 
Seat 9: QPokerOO7 ($7.70 in chips) 
Amsterdam8383: posts small blind $0.01
Dorex2007: posts big blind $0.02
*** HOLE CARDS ***
Dealt to Dorex2007 [Ah Kd]
QPokerOO7: folds 
kano1313: folds 
englishmannn: folds 
Unicus86: folds 
Hakunaaaa: folds 
Amsterdam8383: calls $0.01
Dorex2007: raises $0.04 to $0.06
Amsterdam8383: calls $0.04
*** FLOP *** [Th Jh 3c]
Amsterdam8383: checks 
Dorex2007: bets $0.12
Amsterdam8383: folds 
Uncalled bet ($0.12) returned to Dorex2007
Dorex2007 collected $0.12 from pot
Dorex2007: doesn't show hand 
*** SUMMARY ***
Total pot $0.12 | Rake $0 
Board [Th Jh 3c]
Seat 1: kano1313 folded before Flop (didn't bet)
Seat 2: englishmannn folded before Flop (didn't bet)
Seat 3: Unicus86 folded before Flop (didn't bet)
Seat 4: Hakunaaaa (button) folded before Flop (didn't bet)
Seat 5: Amsterdam8383 (small blind) folded on the Flop
Seat 6: Dorex2007 (big blind) collected ($0.12)
Seat 9: QPokerOO7 folded before Flop (didn't bet)



PokerStars Hand #223627869518:  Hold'em No Limit ($0.01/$0.02 USD) - 2021/02/09 15:20:36 PT [2021/02/09 18:20:36 ET]
Table 'Fagnes IV' 9-max Seat #5 is the button
Seat 1: kano1313 ($1.29 in chips) 
Seat 2: englishmannn ($3.42 in chips) 
Seat 3: Unicus86 ($1.52 in chips) 
Seat 4: Hakunaaaa ($2.04 in chips) 
Seat 5: Amsterdam8383 ($1.58 in chips) 
Seat 6: Dorex2007 ($1.59 in chips) 
Seat 8: alevseev83 ($2.55 in chips) 
Seat 9: QPokerOO7 ($7.70 in chips) 
Dorex2007: posts small blind $0.01
alevseev83: posts big blind $0.02
*** HOLE CARDS ***
Dealt to Dorex2007 [5d 3s]
QPokerOO7: folds 
kano1313: folds 
Sören76 joins the table at seat #7 
englishmannn: folds 
Unicus86: folds 
Hakunaaaa: folds 
Amsterdam8383: calls $0.02
Dorex2007: folds 
alevseev83: checks 
*** FLOP *** [Ts 6c Qd]
alevseev83: checks 
Amsterdam8383: checks 
*** TURN *** [Ts 6c Qd] [Kh]
alevseev83: checks 
Amsterdam8383: checks 
*** RIVER *** [Ts 6c Qd Kh] [Jc]
alevseev83: checks 
Amsterdam8383: bets $0.05
alevseev83: folds 
Uncalled bet ($0.05) returned to Amsterdam8383
Amsterdam8383 collected $0.05 from pot
Amsterdam8383: doesn't show hand 
*** SUMMARY ***
Total pot $0.05 | Rake $0 
Board [Ts 6c Qd Kh Jc]
Seat 1: kano1313 folded before Flop (didn't bet)
Seat 2: englishmannn folded before Flop (didn't bet)
Seat 3: Unicus86 folded before Flop (didn't bet)
Seat 4: Hakunaaaa folded before Flop (didn't bet)
Seat 5: Amsterdam8383 (button) collected ($0.05)
Seat 6: Dorex2007 (small blind) folded before Flop
Seat 8: alevseev83 (big blind) folded on the River
Seat 9: QPokerOO7 folded before Flop (didn't bet)



PokerStars Hand #223627894593:  Hold'em No Limit ($0.01/$0.02 USD) - 2021/02/09 15:21:23 PT [2021/02/09 18:21:23 ET]
Table 'Fagnes IV' 9-max Seat #6 is the button
Seat 1: kano1313 ($1.29 in chips) 
Seat 2: englishmannn ($3.42 in chips) 
Seat 3: Unicus86 ($1.52 in chips) 
Seat 4: Hakunaaaa ($2.04 in chips) 
Seat 5: Amsterdam8383 ($1.61 in chips) 
Seat 6: Dorex2007 ($1.58 in chips) 
Seat 8: alevseev83 ($2.53 in chips) 
Seat 9: QPokerOO7 ($7.70 in chips) 
alevseev83: posts small blind $0.01
QPokerOO7: posts big blind $0.02
*** HOLE CARDS ***
Dealt to Dorex2007 [Qh Ks]
kano1313: folds 
englishmannn: folds 
Unicus86: folds 
Hakunaaaa: raises $0.04 to $0.06
Amsterdam8383: folds 
Dorex2007: calls $0.06
alevseev83: folds 
QPokerOO7: calls $0.04
*** FLOP *** [7s Ah Ac]
QPokerOO7: checks 
Hakunaaaa: bets $0.08
Dorex2007: calls $0.08
QPokerOO7: raises $7.56 to $7.64 and is all-in
Hakunaaaa: folds 
Dorex2007: folds 
Uncalled bet ($7.56) returned to QPokerOO7
QPokerOO7 collected $0.41 from pot
QPokerOO7: doesn't show hand 
*** SUMMARY ***
Total pot $0.43 | Rake $0.02 
Board [7s Ah Ac]
Seat 1: kano1313 folded before Flop (didn't bet)
Seat 2: englishmannn folded before Flop (didn't bet)
Seat 3: Unicus86 folded before Flop (didn't bet)
Seat 4: Hakunaaaa folded on the Flop
Seat 5: Amsterdam8383 folded before Flop (didn't bet)
Seat 6: Dorex2007 (button) folded on the Flop
Seat 8: alevseev83 (small blind) folded before Flop
Seat 9: QPokerOO7 (big blind) collected ($0.41)



PokerStars Hand #223627929137:  Hold'em No Limit ($0.01/$0.02 USD) - 2021/02/09 15:22:27 PT [2021/02/09 18:22:27 ET]
Table 'Fagnes IV' 9-max Seat #8 is the button
Seat 1: kano1313 ($1.29 in chips) 
Seat 2: englishmannn ($3.42 in chips) 
Seat 3: Unicus86 ($1.52 in chips) 
Seat 4: Hakunaaaa ($1.90 in chips) 
Seat 5: Amsterdam8383 ($1.61 in chips) 
Seat 6: Dorex2007 ($1.44 in chips) 
Seat 8: alevseev83 ($2.52 in chips) 
Seat 9: QPokerOO7 ($7.97 in chips) 
QPokerOO7: posts small blind $0.01
kano1313: posts big blind $0.02
Sören76: sits out 
*** HOLE CARDS ***
Dealt to Dorex2007 [Js 9c]
englishmannn: folds 
Unicus86: folds 
Hakunaaaa: folds 
Amsterdam8383: folds 
Dorex2007: folds 
alevseev83: raises $0.04 to $0.06
QPokerOO7: folds 
kano1313: folds 
Uncalled bet ($0.04) returned to alevseev83
alevseev83 collected $0.05 from pot
alevseev83: doesn't show hand 
*** SUMMARY ***
Total pot $0.05 | Rake $0 
Seat 1: kano1313 (big blind) folded before Flop
Seat 2: englishmannn folded before Flop (didn't bet)
Seat 3: Unicus86 folded before Flop (didn't bet)
Seat 4: Hakunaaaa folded before Flop (didn't bet)
Seat 5: Amsterdam8383 folded before Flop (didn't bet)
Seat 6: Dorex2007 folded before Flop (didn't bet)
Seat 8: alevseev83 (button) collected ($0.05)
Seat 9: QPokerOO7 (small blind) folded before Flop



PokerStars Hand #223627942602:  Hold'em No Limit ($0.01/$0.02 USD) - 2021/02/09 15:22:52 PT [2021/02/09 18:22:52 ET]
Table 'Fagnes IV' 9-max Seat #9 is the button
Seat 1: kano1313 ($1.37 in chips) 
Seat 2: englishmannn ($3.42 in chips) 
Seat 3: Unicus86 ($1.52 in chips) 
Seat 4: Hakunaaaa ($1.90 in chips) 
Seat 5: Amsterdam8383 ($1.61 in chips) 
Seat 6: Dorex2007 ($1.44 in chips) 
Seat 8: alevseev83 ($2.55 in chips) 
Seat 9: QPokerOO7 ($7.96 in chips) 
kano1313: posts small blind $0.01
englishmannn: posts big blind $0.02
Sören76: sits out 
*** HOLE CARDS ***
Dealt to Dorex2007 [5s Ac]
Unicus86: folds 
Hakunaaaa: folds 
Amsterdam8383: calls $0.02
Dorex2007: folds 
alevseev83: folds 
QPokerOO7: raises $0.10 to $0.12
kano1313: folds 
englishmannn: folds 
Amsterdam8383: folds 
Uncalled bet ($0.10) returned to QPokerOO7
QPokerOO7 collected $0.07 from pot
QPokerOO7: doesn't show hand 
*** SUMMARY ***
Total pot $0.07 | Rake $0 
Seat 1: kano1313 (small blind) folded before Flop
Seat 2: englishmannn (big blind) folded before Flop
Seat 3: Unicus86 folded before Flop (didn't bet)
Seat 4: Hakunaaaa folded before Flop (didn't bet)
Seat 5: Amsterdam8383 folded before Flop
Seat 6: Dorex2007 folded before Flop (didn't bet)
Seat 8: alevseev83 folded before Flop (didn't bet)
Seat 9: QPokerOO7 (button) collected ($0.07)



PokerStars Hand #223627968939:  Hold'em No Limit ($0.01/$0.02 USD) - 2021/02/09 15:23:40 PT [2021/02/09 18:23:40 ET]
Table 'Fagnes IV' 9-max Seat #1 is the button
Seat 1: kano1313 ($1.36 in chips) 
Seat 2: englishmannn ($3.40 in chips) 
Seat 3: Unicus86 ($1.52 in chips) 
Seat 4: Hakunaaaa ($1.90 in chips) 
Seat 5: Amsterdam8383 ($1.59 in chips) 
Seat 6: Dorex2007 ($1.44 in chips) 
Seat 8: alevseev83 ($2.55 in chips) 
Seat 9: QPokerOO7 ($8.01 in chips) 
englishmannn: posts small blind $0.01
Unicus86: posts big blind $0.02
Sören76: sits out 
*** HOLE CARDS ***
Dealt to Dorex2007 [Kc 8d]
Hakunaaaa: folds 
Amsterdam8383: calls $0.02
Dorex2007: folds 
alevseev83: folds 
QPokerOO7: raises $0.08 to $0.10
kano1313: folds 
englishmannn: folds 
Unicus86: folds 
Amsterdam8383: folds 
Uncalled bet ($0.08) returned to QPokerOO7
QPokerOO7 collected $0.07 from pot
QPokerOO7: doesn't show hand 
*** SUMMARY ***
Total pot $0.07 | Rake $0 
Seat 1: kano1313 (button) folded before Flop (didn't bet)
Seat 2: englishmannn (small blind) folded before Flop
Seat 3: Unicus86 (big blind) folded before Flop
Seat 4: Hakunaaaa folded before Flop (didn't bet)
Seat 5: Amsterdam8383 folded before Flop
Seat 6: Dorex2007 folded before Flop (didn't bet)
Seat 8: alevseev83 folded before Flop (didn't bet)
Seat 9: QPokerOO7 collected ($0.07)



PokerStars Hand #223627984604:  Hold'em No Limit ($0.01/$0.02 USD) - 2021/02/09 15:24:09 PT [2021/02/09 18:24:09 ET]
Table 'Fagnes IV' 9-max Seat #2 is the button
Seat 1: kano1313 ($1.36 in chips) 
Seat 2: englishmannn ($3.39 in chips) 
Seat 3: Unicus86 ($1.50 in chips) 
Seat 4: Hakunaaaa ($1.90 in chips) 
Seat 5: Amsterdam8383 ($1.57 in chips) 
Seat 6: Dorex2007 ($1.44 in chips) 
Seat 8: alevseev83 ($2.55 in chips) 
Seat 9: QPokerOO7 ($8.06 in chips) 
Unicus86: posts small blind $0.01
Hakunaaaa: posts big blind $0.02
Sören76: sits out 
*** HOLE CARDS ***
Dealt to Dorex2007 [2s 2c]
Amsterdam8383: folds 
Dorex2007: calls $0.02
alevseev83: folds 
QPokerOO7: folds 
kano1313: folds 
englishmannn: folds 
Unicus86: calls $0.01
Hakunaaaa: checks 
*** FLOP *** [Js 5d 4s]
Unicus86: checks 
Hakunaaaa: bets $0.06
Dorex2007: folds 
Unicus86: folds 
Uncalled bet ($0.06) returned to Hakunaaaa
Hakunaaaa collected $0.06 from pot
Hakunaaaa: doesn't show hand 
*** SUMMARY ***
Total pot $0.06 | Rake $0 
Board [Js 5d 4s]
Seat 1: kano1313 folded before Flop (didn't bet)
Seat 2: englishmannn (button) folded before Flop (didn't bet)
Seat 3: Unicus86 (small blind) folded on the Flop
Seat 4: Hakunaaaa (big blind) collected ($0.06)
Seat 5: Amsterdam8383 folded before Flop (didn't bet)
Seat 6: Dorex2007 folded on the Flop
Seat 8: alevseev83 folded before Flop (didn't bet)
Seat 9: QPokerOO7 folded before Flop (didn't bet)



PokerStars Hand #223628004808:  Hold'em No Limit ($0.01/$0.02 USD) - 2021/02/09 15:24:47 PT [2021/02/09 18:24:47 ET]
Table 'Fagnes IV' 9-max Seat #3 is the button
Seat 1: kano1313 ($1.36 in chips) 
Seat 2: englishmannn ($3.39 in chips) 
Seat 3: Unicus86 ($1.48 in chips) 
Seat 4: Hakunaaaa ($1.94 in chips) 
Seat 5: Amsterdam8383 ($1.57 in chips) 
Seat 6: Dorex2007 ($1.42 in chips) 
Seat 8: alevseev83 ($2.55 in chips) 
Seat 9: QPokerOO7 ($8.06 in chips) 
Hakunaaaa: posts small blind $0.01
Amsterdam8383: posts big blind $0.02
Sören76: sits out 
*** HOLE CARDS ***
Dealt to Dorex2007 [Qs Th]
Dorex2007: folds 
alevseev83: raises $0.04 to $0.06
QPokerOO7: calls $0.06
kano1313: folds 
englishmannn: folds 
Unicus86: folds 
Hakunaaaa: folds 
Amsterdam8383: folds 
*** FLOP *** [6d 3h 9c]
alevseev83: bets $0.07
QPokerOO7: folds 
Uncalled bet ($0.07) returned to alevseev83
alevseev83 collected $0.14 from pot
alevseev83: doesn't show hand 
*** SUMMARY ***
Total pot $0.15 | Rake $0.01 
Board [6d 3h 9c]
Seat 1: kano1313 folded before Flop (didn't bet)
Seat 2: englishmannn folded before Flop (didn't bet)
Seat 3: Unicus86 (button) folded before Flop (didn't bet)
Seat 4: Hakunaaaa (small blind) folded before Flop
Seat 5: Amsterdam8383 (big blind) folded before Flop
Seat 6: Dorex2007 folded before Flop (didn't bet)
Seat 8: alevseev83 collected ($0.14)
Seat 9: QPokerOO7 folded on the Flop



PokerStars Hand #223628030273:  Hold'em No Limit ($0.01/$0.02 USD) - 2021/02/09 15:25:35 PT [2021/02/09 18:25:35 ET]
Table 'Fagnes IV' 9-max Seat #4 is the button
Seat 1: kano1313 ($1.36 in chips) 
Seat 2: englishmannn ($3.39 in chips) 
Seat 3: Unicus86 ($1.48 in chips) 
Seat 4: Hakunaaaa ($1.93 in chips) 
Seat 5: Amsterdam8383 ($1.55 in chips) 
Seat 6: Dorex2007 ($1.42 in chips) 
Seat 8: alevseev83 ($2.63 in chips) 
Seat 9: QPokerOO7 ($8 in chips) 
Amsterdam8383: posts small blind $0.01
Dorex2007: posts big blind $0.02
Sören76: sits out 
*** HOLE CARDS ***
Dealt to Dorex2007 [7h Ad]
alevseev83: calls $0.02
QPokerOO7: folds 
kano1313: folds 
englishmannn: folds 
Unicus86: folds 
Hakunaaaa: folds 
Amsterdam8383: folds 
Dorex2007: checks 
*** FLOP *** [9h 4c 2d]
Dorex2007: bets $0.05
alevseev83: calls $0.05
*** TURN *** [9h 4c 2d] [Js]
Dorex2007: checks 
alevseev83: checks 
*** RIVER *** [9h 4c 2d Js] [4s]
Dorex2007: checks 
alevseev83: checks 
*** SHOW DOWN ***
Dorex2007: shows [7h Ad] (a pair of Fours)
alevseev83: shows [8c 8d] (two pair, Eights and Fours)
alevseev83 collected $0.14 from pot
*** SUMMARY ***
Total pot $0.15 | Rake $0.01 
Board [9h 4c 2d Js 4s]
Seat 1: kano1313 folded before Flop (didn't bet)
Seat 2: englishmannn folded before Flop (didn't bet)
Seat 3: Unicus86 folded before Flop (didn't bet)
Seat 4: Hakunaaaa (button) folded before Flop (didn't bet)
Seat 5: Amsterdam8383 (small blind) folded before Flop
Seat 6: Dorex2007 (big blind) showed [7h Ad] and lost with a pair of Fours
Seat 8: alevseev83 showed [8c 8d] and won ($0.14) with two pair, Eights and Fours
Seat 9: QPokerOO7 folded before Flop (didn't bet)



PokerStars Hand #223628053593:  Hold'em No Limit ($0.01/$0.02 USD) - 2021/02/09 15:26:19 PT [2021/02/09 18:26:19 ET]
Table 'Fagnes IV' 9-max Seat #5 is the button
Seat 1: kano1313 ($1.36 in chips) 
Seat 2: englishmannn ($3.39 in chips) 
Seat 3: Unicus86 ($1.48 in chips) 
Seat 4: Hakunaaaa ($1.93 in chips) 
Seat 5: Amsterdam8383 ($1.54 in chips) 
Seat 6: Dorex2007 ($1.35 in chips) 
Seat 7: Sören76 ($1.20 in chips) 
Seat 8: alevseev83 ($2.70 in chips) 
Seat 9: QPokerOO7 ($8 in chips) 
Dorex2007: posts small blind $0.01
Sören76: posts big blind $0.02
*** HOLE CARDS ***
Dealt to Dorex2007 [5c 7h]
alevseev83: folds 
QPokerOO7: raises $0.04 to $0.06
kano1313: folds 
englishmannn: folds 
Unicus86: calls $0.06
Hakunaaaa: folds 
Amsterdam8383: calls $0.06
Dorex2007: folds 
Sören76: folds 
*** FLOP *** [2s Js Tc]
QPokerOO7: checks 
Unicus86: checks 
Amsterdam8383: checks 
*** TURN *** [2s Js Tc] [Kc]
QPokerOO7: checks 
Unicus86: checks 
Amsterdam8383: checks 
*** RIVER *** [2s Js Tc Kc] [4c]
QPokerOO7: checks 
Unicus86: bets $0.20
Amsterdam8383: calls $0.20
QPokerOO7: folds 
*** SHOW DOWN ***
Unicus86: shows [Ac 3c] (a flush, Ace high)
Amsterdam8383: mucks hand 
Unicus86 collected $0.59 from pot
*** SUMMARY ***
Total pot $0.61 | Rake $0.02 
Board [2s Js Tc Kc 4c]
Seat 1: kano1313 folded before Flop (didn't bet)
Seat 2: englishmannn folded before Flop (didn't bet)
Seat 3: Unicus86 showed [Ac 3c] and won ($0.59) with a flush, Ace high
Seat 4: Hakunaaaa folded before Flop (didn't bet)
Seat 5: Amsterdam8383 (button) mucked [4h 4s]
Seat 6: Dorex2007 (small blind) folded before Flop
Seat 7: Sören76 (big blind) folded before Flop
Seat 8: alevseev83 folded before Flop (didn't bet)
Seat 9: QPokerOO7 folded on the River



PokerStars Hand #223628108939:  Hold'em No Limit ($0.01/$0.02 USD) - 2021/02/09 15:28:04 PT [2021/02/09 18:28:04 ET]
Table 'Fagnes IV' 9-max Seat #6 is the button
Seat 1: kano1313 ($1.36 in chips) 
Seat 2: englishmannn ($3.39 in chips) 
Seat 3: Unicus86 ($1.81 in chips) 
Seat 4: Hakunaaaa ($1.93 in chips) 
Seat 5: Amsterdam8383 ($1.28 in chips) 
Seat 6: Dorex2007 ($1.34 in chips) 
Seat 7: Sören76 ($1.18 in chips) 
Seat 8: alevseev83 ($2.70 in chips) 
Seat 9: QPokerOO7 ($7.94 in chips) 
Sören76: posts small blind $0.01
alevseev83: posts big blind $0.02
*** HOLE CARDS ***
Dealt to Dorex2007 [As Js]
QPokerOO7: folds 
kano1313: calls $0.02
englishmannn: folds 
Unicus86: folds 
Hakunaaaa: folds 
Amsterdam8383: folds 
Dorex2007: raises $0.06 to $0.08
Sören76: folds 
alevseev83: folds 
kano1313: raises $1.28 to $1.36 and is all-in
Dorex2007: calls $1.26 and is all-in
Uncalled bet ($0.02) returned to kano1313
*** FLOP *** [5s 9s 2c]
*** TURN *** [5s 9s 2c] [Kc]
*** RIVER *** [5s 9s 2c Kc] [Kh]
*** SHOW DOWN ***
kano1313: shows [Ah Kd] (three of a kind, Kings)
Dorex2007: shows [As Js] (a pair of Kings)
kano1313 collected $2.62 from pot
*** SUMMARY ***
Total pot $2.71 | Rake $0.09 
Board [5s 9s 2c Kc Kh]
Seat 1: kano1313 showed [Ah Kd] and won ($2.62) with three of a kind, Kings
Seat 2: englishmannn folded before Flop (didn't bet)
Seat 3: Unicus86 folded before Flop (didn't bet)
Seat 4: Hakunaaaa folded before Flop (didn't bet)
Seat 5: Amsterdam8383 folded before Flop (didn't bet)
Seat 6: Dorex2007 (button) showed [As Js] and lost with a pair of Kings
Seat 7: Sören76 (small blind) folded before Flop
Seat 8: alevseev83 (big blind) folded before Flop
Seat 9: QPokerOO7 folded before Flop (didn't bet)



PokerStars Hand #223628179537:  Hold'em No Limit ($0.01/$0.02 USD) - 2021/02/09 15:30:01 PT [2021/02/09 18:30:01 ET]
Table 'Fagnes IV' 9-max Seat #8 is the button
Seat 1: kano1313 ($2.64 in chips) 
Seat 2: englishmannn ($3.39 in chips) 
Seat 3: Unicus86 ($1.81 in chips) 
Seat 4: Hakunaaaa ($1.87 in chips) 
Seat 5: Amsterdam8383 ($1.13 in chips) 
Seat 6: Dorex2007 ($2 in chips) 
Seat 7: Sören76 ($1.17 in chips) 
Seat 8: alevseev83 ($2.67 in chips) 
Seat 9: QPokerOO7 ($8.15 in chips) 
QPokerOO7: posts small blind $0.01
kano1313: posts big blind $0.02
*** HOLE CARDS ***
Dealt to Dorex2007 [6d 8h]
englishmannn: folds 
Unicus86: folds 
Hakunaaaa: folds 
Amsterdam8383: folds 
Dorex2007: folds 
Sören76: folds 
alevseev83: folds 
QPokerOO7: raises $0.08 to $0.10
kano1313: folds 
Uncalled bet ($0.08) returned to QPokerOO7
QPokerOO7 collected $0.04 from pot
QPokerOO7: doesn't show hand 
*** SUMMARY ***
Total pot $0.04 | Rake $0 
Seat 1: kano1313 (big blind) folded before Flop
Seat 2: englishmannn folded before Flop (didn't bet)
Seat 3: Unicus86 folded before Flop (didn't bet)
Seat 4: Hakunaaaa folded before Flop (didn't bet)
Seat 5: Amsterdam8383 folded before Flop (didn't bet)
Seat 6: Dorex2007 folded before Flop (didn't bet)
Seat 7: Sören76 folded before Flop (didn't bet)
Seat 8: alevseev83 (button) folded before Flop (didn't bet)
Seat 9: QPokerOO7 (small blind) collected ($0.04)



PokerStars Hand #223628191232:  Hold'em No Limit ($0.01/$0.02 USD) - 2021/02/09 15:30:23 PT [2021/02/09 18:30:23 ET]
Table 'Fagnes IV' 9-max Seat #9 is the button
Seat 1: kano1313 ($2.62 in chips) 
Seat 2: englishmannn ($3.39 in chips) 
Seat 3: Unicus86 ($1.81 in chips) 
Seat 4: Hakunaaaa ($1.87 in chips) 
Seat 5: Amsterdam8383 ($1.13 in chips) 
Seat 6: Dorex2007 ($2 in chips) 
Seat 7: Sören76 ($1.17 in chips) 
Seat 8: alevseev83 ($2.67 in chips) 
Seat 9: QPokerOO7 ($8.17 in chips) 
kano1313: posts small blind $0.01
englishmannn: posts big blind $0.02
*** HOLE CARDS ***
Dealt to Dorex2007 [3c 6h]
Unicus86: folds 
Hakunaaaa: folds 
Amsterdam8383: folds 
Dorex2007: folds 
Sören76: raises $0.04 to $0.06
alevseev83: folds 
QPokerOO7: calls $0.06
kano1313: folds 
englishmannn: folds 
*** FLOP *** [2d 7h As]
Sören76: bets $0.04
QPokerOO7: folds 
Uncalled bet ($0.04) returned to Sören76
Sören76 collected $0.14 from pot
Sören76: doesn't show hand 
*** SUMMARY ***
Total pot $0.15 | Rake $0.01 
Board [2d 7h As]
Seat 1: kano1313 (small blind) folded before Flop
Seat 2: englishmannn (big blind) folded before Flop
Seat 3: Unicus86 folded before Flop (didn't bet)
Seat 4: Hakunaaaa folded before Flop (didn't bet)
Seat 5: Amsterdam8383 folded before Flop (didn't bet)
Seat 6: Dorex2007 folded before Flop (didn't bet)
Seat 7: Sören76 collected ($0.14)
Seat 8: alevseev83 folded before Flop (didn't bet)
Seat 9: QPokerOO7 (button) folded on the Flop



PokerStars Hand #223628207676:  Hold'em No Limit ($0.01/$0.02 USD) - 2021/02/09 15:30:54 PT [2021/02/09 18:30:54 ET]
Table 'Fagnes IV' 9-max Seat #1 is the button
Seat 1: kano1313 ($2.61 in chips) 
Seat 2: englishmannn ($3.37 in chips) 
Seat 3: Unicus86 ($1.81 in chips) 
Seat 4: Hakunaaaa ($1.87 in chips) 
Seat 5: Amsterdam8383 ($1.13 in chips) 
Seat 6: Dorex2007 ($2 in chips) 
Seat 7: Sören76 ($1.25 in chips) 
Seat 8: alevseev83 ($2.67 in chips) 
Seat 9: QPokerOO7 ($8.11 in chips) 
englishmannn: posts small blind $0.01
Unicus86: posts big blind $0.02
*** HOLE CARDS ***
Dealt to Dorex2007 [3d Qh]
Hakunaaaa: folds 
Amsterdam8383: folds 
Dorex2007: folds 
Sören76: folds 
alevseev83: folds 
QPokerOO7: folds 
kano1313: folds 
englishmannn: folds 
Uncalled bet ($0.01) returned to Unicus86
Unicus86 collected $0.02 from pot
Unicus86: doesn't show hand 
*** SUMMARY ***
Total pot $0.02 | Rake $0 
Seat 1: kano1313 (button) folded before Flop (didn't bet)
Seat 2: englishmannn (small blind) folded before Flop
Seat 3: Unicus86 (big blind) collected ($0.02)
Seat 4: Hakunaaaa folded before Flop (didn't bet)
Seat 5: Amsterdam8383 folded before Flop (didn't bet)
Seat 6: Dorex2007 folded before Flop (didn't bet)
Seat 7: Sören76 folded before Flop (didn't bet)
Seat 8: alevseev83 folded before Flop (didn't bet)
Seat 9: QPokerOO7 folded before Flop (didn't bet)



PokerStars Hand #223628220252:  Hold'em No Limit ($0.01/$0.02 USD) - 2021/02/09 15:31:17 PT [2021/02/09 18:31:17 ET]
Table 'Fagnes IV' 9-max Seat #2 is the button
Seat 1: kano1313 ($2.61 in chips) 
Seat 2: englishmannn ($3.36 in chips) 
Seat 3: Unicus86 ($1.82 in chips) 
Seat 4: Hakunaaaa ($1.87 in chips) 
Seat 5: Amsterdam8383 ($1.13 in chips) 
Seat 6: Dorex2007 ($2 in chips) 
Seat 7: Sören76 ($1.25 in chips) 
Seat 8: alevseev83 ($2.67 in chips) 
Seat 9: QPokerOO7 ($8.11 in chips) 
Unicus86: posts small blind $0.01
Hakunaaaa: posts big blind $0.02
*** HOLE CARDS ***
Dealt to Dorex2007 [Qh 9h]
Amsterdam8383: folds 
Dorex2007: folds 
Sören76: folds 
alevseev83: folds 
QPokerOO7: raises $0.08 to $0.10
kano1313: folds 
englishmannn: raises $0.23 to $0.33
Unicus86: folds 
Hakunaaaa: folds 
QPokerOO7: folds 
Uncalled bet ($0.23) returned to englishmannn
englishmannn collected $0.23 from pot
englishmannn: doesn't show hand 
*** SUMMARY ***
Total pot $0.23 | Rake $0 
Seat 1: kano1313 folded before Flop (didn't bet)
Seat 2: englishmannn (button) collected ($0.23)
Seat 3: Unicus86 (small blind) folded before Flop
Seat 4: Hakunaaaa (big blind) folded before Flop
Seat 5: Amsterdam8383 folded before Flop (didn't bet)
Seat 6: Dorex2007 folded before Flop (didn't bet)
Seat 7: Sören76 folded before Flop (didn't bet)
Seat 8: alevseev83 folded before Flop (didn't bet)
Seat 9: QPokerOO7 folded before Flop



PokerStars Hand #223628236701:  Hold'em No Limit ($0.01/$0.02 USD) - 2021/02/09 15:31:48 PT [2021/02/09 18:31:48 ET]
Table 'Fagnes IV' 9-max Seat #3 is the button
Seat 1: kano1313 ($2.61 in chips) 
Seat 2: englishmannn ($3.49 in chips) 
Seat 3: Unicus86 ($1.81 in chips) 
Seat 4: Hakunaaaa ($1.85 in chips) 
Seat 5: Amsterdam8383 ($1.13 in chips) 
Seat 6: Dorex2007 ($2 in chips) 
Seat 7: Sören76 ($1.25 in chips) 
Seat 8: alevseev83 ($2.67 in chips) 
Seat 9: QPokerOO7 ($8.01 in chips) 
Hakunaaaa: posts small blind $0.01
Amsterdam8383: posts big blind $0.02
*** HOLE CARDS ***
Dealt to Dorex2007 [5c 5s]
Dorex2007: calls $0.02
Sören76: folds 
alevseev83: folds 
QPokerOO7: folds 
kano1313: folds 
englishmannn: folds 
Unicus86: folds 
Hakunaaaa: calls $0.01
Amsterdam8383: checks 
*** FLOP *** [Kc 8d 8s]
Hakunaaaa: checks 
Amsterdam8383: checks 
Dorex2007: bets $0.06
Hakunaaaa: folds 
Amsterdam8383: calls $0.06
*** TURN *** [Kc 8d 8s] [6c]
Amsterdam8383: checks 
Dorex2007: checks 
*** RIVER *** [Kc 8d 8s 6c] [8h]
Amsterdam8383: checks 
Dorex2007: checks 
*** SHOW DOWN ***
Amsterdam8383: shows [2s Kh] (a full house, Eights full of Kings)
Dorex2007: mucks hand 
Amsterdam8383 collected $0.17 from pot
*** SUMMARY ***
Total pot $0.18 | Rake $0.01 
Board [Kc 8d 8s 6c 8h]
Seat 1: kano1313 folded before Flop (didn't bet)
Seat 2: englishmannn folded before Flop (didn't bet)
Seat 3: Unicus86 (button) folded before Flop (didn't bet)
Seat 4: Hakunaaaa (small blind) folded on the Flop
Seat 5: Amsterdam8383 (big blind) showed [2s Kh] and won ($0.17) with a full house, Eights full of Kings
Seat 6: Dorex2007 mucked [5c 5s]
Seat 7: Sören76 folded before Flop (didn't bet)
Seat 8: alevseev83 folded before Flop (didn't bet)
Seat 9: QPokerOO7 folded before Flop (didn't bet)



PokerStars Hand #223628263424:  Hold'em No Limit ($0.01/$0.02 USD) - 2021/02/09 15:32:38 PT [2021/02/09 18:32:38 ET]
Table 'Fagnes IV' 9-max Seat #4 is the button
Seat 1: kano1313 ($2.61 in chips) 
Seat 2: englishmannn ($3.49 in chips) 
Seat 3: Unicus86 ($1.81 in chips) 
Seat 4: Hakunaaaa ($1.83 in chips) 
Seat 5: Amsterdam8383 ($1.22 in chips) 
Seat 6: Dorex2007 ($1.92 in chips) 
Seat 7: Sören76 ($1.25 in chips) 
Seat 8: alevseev83 ($2.67 in chips) 
Seat 9: QPokerOO7 ($8.01 in chips) 
Amsterdam8383: posts small blind $0.01
Dorex2007: posts big blind $0.02
*** HOLE CARDS ***
Dealt to Dorex2007 [3s Jc]
Sören76: folds 
alevseev83: folds 
QPokerOO7: folds 
kano1313: raises $0.04 to $0.06
englishmannn: folds 
Unicus86: folds 
Hakunaaaa: folds 
Amsterdam8383: folds 
Dorex2007: folds 
Uncalled bet ($0.04) returned to kano1313
kano1313 collected $0.05 from pot
kano1313: doesn't show hand 
*** SUMMARY ***
Total pot $0.05 | Rake $0 
Seat 1: kano1313 collected ($0.05)
Seat 2: englishmannn folded before Flop (didn't bet)
Seat 3: Unicus86 folded before Flop (didn't bet)
Seat 4: Hakunaaaa (button) folded before Flop (didn't bet)
Seat 5: Amsterdam8383 (small blind) folded before Flop
Seat 6: Dorex2007 (big blind) folded before Flop
Seat 7: Sören76 folded before Flop (didn't bet)
Seat 8: alevseev83 folded before Flop (didn't bet)
Seat 9: QPokerOO7 folded before Flop (didn't bet)



PokerStars Hand #223628276746:  Hold'em No Limit ($0.01/$0.02 USD) - 2021/02/09 15:33:04 PT [2021/02/09 18:33:04 ET]
Table 'Fagnes IV' 9-max Seat #5 is the button
Seat 1: kano1313 ($2.64 in chips) 
Seat 2: englishmannn ($3.49 in chips) 
Seat 3: Unicus86 ($1.81 in chips) 
Seat 4: Hakunaaaa ($1.83 in chips) 
Seat 5: Amsterdam8383 ($1.21 in chips) 
Seat 6: Dorex2007 ($1.90 in chips) 
Seat 7: Sören76 ($1.25 in chips) 
Seat 8: alevseev83 ($2.67 in chips) 
Seat 9: QPokerOO7 ($8.01 in chips) 
Dorex2007: posts small blind $0.01
Sören76: posts big blind $0.02
*** HOLE CARDS ***
Dealt to Dorex2007 [4s Th]
alevseev83: folds 
QPokerOO7: folds 
kano1313: raises $0.04 to $0.06
englishmannn: folds 
Unicus86: folds 
Hakunaaaa: calls $0.06
Amsterdam8383: folds 
Dorex2007: folds 
Sören76: folds 
*** FLOP *** [Tc 7c 6c]
kano1313: bets $0.07
Hakunaaaa: folds 
Uncalled bet ($0.07) returned to kano1313
kano1313 collected $0.14 from pot
kano1313: doesn't show hand 
*** SUMMARY ***
Total pot $0.15 | Rake $0.01 
Board [Tc 7c 6c]
Seat 1: kano1313 collected ($0.14)
Seat 2: englishmannn folded before Flop (didn't bet)
Seat 3: Unicus86 folded before Flop (didn't bet)
Seat 4: Hakunaaaa folded on the Flop
Seat 5: Amsterdam8383 (button) folded before Flop (didn't bet)
Seat 6: Dorex2007 (small blind) folded before Flop
Seat 7: Sören76 (big blind) folded before Flop
Seat 8: alevseev83 folded before Flop (didn't bet)
Seat 9: QPokerOO7 folded before Flop (didn't bet)



PokerStars Hand #223628293956:  Hold'em No Limit ($0.01/$0.02 USD) - 2021/02/09 15:33:36 PT [2021/02/09 18:33:36 ET]
Table 'Fagnes IV' 9-max Seat #6 is the button
Seat 1: kano1313 ($2.72 in chips) 
Seat 2: englishmannn ($3.49 in chips) 
Seat 3: Unicus86 ($1.81 in chips) 
Seat 4: Hakunaaaa ($1.77 in chips) 
Seat 5: Amsterdam8383 ($1.21 in chips) 
Seat 6: Dorex2007 ($1.89 in chips) 
Seat 7: Sören76 ($1.23 in chips) 
Seat 8: alevseev83 ($2.67 in chips) 
Seat 9: QPokerOO7 ($8.01 in chips) 
Sören76: posts small blind $0.01
alevseev83: posts big blind $0.02
*** HOLE CARDS ***
Dealt to Dorex2007 [Jd 3c]
QPokerOO7: folds 
kano1313: folds 
englishmannn: folds 
Unicus86: calls $0.02
Hakunaaaa: raises $0.06 to $0.08
Amsterdam8383: folds 
Dorex2007: folds 
Sören76: folds 
alevseev83: calls $0.06
Unicus86: calls $0.06
*** FLOP *** [Jh Qh Qd]
alevseev83: bets $0.06
Unicus86: calls $0.06
Hakunaaaa: calls $0.06
*** TURN *** [Jh Qh Qd] [9s]
alevseev83: checks 
Unicus86: checks 
Hakunaaaa: bets $0.14
alevseev83: folds 
Unicus86: calls $0.14
*** RIVER *** [Jh Qh Qd 9s] [Js]
Unicus86: bets $0.69
Hakunaaaa: raises $0.80 to $1.49 and is all-in
Unicus86: calls $0.80
*** SHOW DOWN ***
Hakunaaaa: shows [Qs Ah] (a full house, Queens full of Jacks)
Unicus86: shows [Qc Tc] (a full house, Queens full of Jacks)
Unicus86 collected $1.78 from pot
Hakunaaaa collected $1.78 from pot
*** SUMMARY ***
Total pot $3.69 | Rake $0.13 
Board [Jh Qh Qd 9s Js]
Seat 1: kano1313 folded before Flop (didn't bet)
Seat 2: englishmannn folded before Flop (didn't bet)
Seat 3: Unicus86 showed [Qc Tc] and won ($1.78) with a full house, Queens full of Jacks
Seat 4: Hakunaaaa showed [Qs Ah] and won ($1.78) with a full house, Queens full of Jacks
Seat 5: Amsterdam8383 folded before Flop (didn't bet)
Seat 6: Dorex2007 (button) folded before Flop (didn't bet)
Seat 7: Sören76 (small blind) folded before Flop
Seat 8: alevseev83 (big blind) folded on the Turn
Seat 9: QPokerOO7 folded before Flop (didn't bet)



PokerStars Hand #223628337749:  Hold'em No Limit ($0.01/$0.02 USD) - 2021/02/09 15:34:59 PT [2021/02/09 18:34:59 ET]
Table 'Fagnes IV' 9-max Seat #7 is the button
Seat 1: kano1313 ($2.72 in chips) 
Seat 2: englishmannn ($3.49 in chips) 
Seat 3: Unicus86 ($1.82 in chips) 
Seat 4: Hakunaaaa ($1.78 in chips) 
Seat 5: Amsterdam8383 ($1.21 in chips) 
Seat 6: Dorex2007 ($1.89 in chips) 
Seat 7: Sören76 ($1.22 in chips) 
Seat 8: alevseev83 ($2.53 in chips) 
Seat 9: QPokerOO7 ($8.01 in chips) 
alevseev83: posts small blind $0.01
QPokerOO7: posts big blind $0.02
*** HOLE CARDS ***
Dealt to Dorex2007 [Ts Jc]
kano1313: folds 
englishmannn: folds 
Unicus86: folds 
Hakunaaaa: folds 
Amsterdam8383: folds 
Dorex2007: raises $0.02 to $0.04
Sören76: folds 
alevseev83: calls $0.03
QPokerOO7: calls $0.02
*** FLOP *** [Qd 3h 6s]
alevseev83: bets $0.10
QPokerOO7: folds 
Dorex2007: folds 
Uncalled bet ($0.10) returned to alevseev83
alevseev83 collected $0.12 from pot
alevseev83: doesn't show hand 
*** SUMMARY ***
Total pot $0.12 | Rake $0 
Board [Qd 3h 6s]
Seat 1: kano1313 folded before Flop (didn't bet)
Seat 2: englishmannn folded before Flop (didn't bet)
Seat 3: Unicus86 folded before Flop (didn't bet)
Seat 4: Hakunaaaa folded before Flop (didn't bet)
Seat 5: Amsterdam8383 folded before Flop (didn't bet)
Seat 6: Dorex2007 folded on the Flop
Seat 7: Sören76 (button) folded before Flop (didn't bet)
Seat 8: alevseev83 (small blind) collected ($0.12)
Seat 9: QPokerOO7 (big blind) folded on the Flop



PokerStars Hand #223628359731:  Hold'em No Limit ($0.01/$0.02 USD) - 2021/02/09 15:35:41 PT [2021/02/09 18:35:41 ET]
Table 'Fagnes IV' 9-max Seat #8 is the button
Seat 1: kano1313 ($2.72 in chips) 
Seat 2: englishmannn ($3.49 in chips) 
Seat 3: Unicus86 ($1.82 in chips) 
Seat 4: Hakunaaaa ($1.78 in chips) 
Seat 5: Amsterdam8383 ($1.21 in chips) 
Seat 6: Dorex2007 ($1.85 in chips) 
Seat 7: Sören76 ($1.22 in chips) 
Seat 8: alevseev83 ($2.61 in chips) 
Seat 9: QPokerOO7 ($7.97 in chips) 
QPokerOO7: posts small blind $0.01
kano1313: posts big blind $0.02
*** HOLE CARDS ***
Dealt to Dorex2007 [8c 9h]
englishmannn: folds 
Unicus86 has timed out
Unicus86: folds 
Hakunaaaa: folds 
Amsterdam8383: calls $0.02
Dorex2007: folds 
Sören76: folds 
alevseev83: folds 
QPokerOO7: raises $0.06 to $0.08
kano1313: calls $0.06
Amsterdam8383: folds 
*** FLOP *** [8h 8d Js]
QPokerOO7: checks 
kano1313: checks 
*** TURN *** [8h 8d Js] [4c]
QPokerOO7: bets $0.09
kano1313: folds 
Uncalled bet ($0.09) returned to QPokerOO7
QPokerOO7 collected $0.17 from pot
QPokerOO7: doesn't show hand 
*** SUMMARY ***
Total pot $0.18 | Rake $0.01 
Board [8h 8d Js 4c]
Seat 1: kano1313 (big blind) folded on the Turn
Seat 2: englishmannn folded before Flop (didn't bet)
Seat 3: Unicus86 folded before Flop (didn't bet)
Seat 4: Hakunaaaa folded before Flop (didn't bet)
Seat 5: Amsterdam8383 folded before Flop
Seat 6: Dorex2007 folded before Flop (didn't bet)
Seat 7: Sören76 folded before Flop (didn't bet)
Seat 8: alevseev83 (button) folded before Flop (didn't bet)
Seat 9: QPokerOO7 (small blind) collected ($0.17)



PokerStars Hand #223628389667:  Hold'em No Limit ($0.01/$0.02 USD) - 2021/02/09 15:36:37 PT [2021/02/09 18:36:37 ET]
Table 'Fagnes IV' 9-max Seat #9 is the button
Seat 1: kano1313 ($2.64 in chips) 
Seat 2: englishmannn ($3.49 in chips) 
Seat 3: Unicus86 ($1.82 in chips) 
Seat 4: Hakunaaaa ($1.78 in chips) 
Seat 5: Amsterdam8383 ($1.19 in chips) 
Seat 6: Dorex2007 ($1.85 in chips) 
Seat 7: Sören76 ($1.22 in chips) 
Seat 8: alevseev83 ($2.61 in chips) 
Seat 9: QPokerOO7 ($8.06 in chips) 
kano1313: posts small blind $0.01
englishmannn: posts big blind $0.02
*** HOLE CARDS ***
Dealt to Dorex2007 [2d Qd]
Unicus86: calls $0.02
Hakunaaaa: folds 
Amsterdam8383: folds 
Dorex2007: folds 
Sören76: folds 
alevseev83: raises $0.04 to $0.06
QPokerOO7: folds 
kano1313: calls $0.05
englishmannn: folds 
Unicus86: calls $0.04
*** FLOP *** [9c Jh Kd]
kano1313: checks 
Unicus86: checks 
alevseev83: checks 
*** TURN *** [9c Jh Kd] [9h]
kano1313: checks 
Unicus86: checks 
alevseev83: bets $0.06
kano1313: folds 
Unicus86: folds 
Uncalled bet ($0.06) returned to alevseev83
alevseev83 collected $0.19 from pot
alevseev83: doesn't show hand 
*** SUMMARY ***
Total pot $0.20 | Rake $0.01 
Board [9c Jh Kd 9h]
Seat 1: kano1313 (small blind) folded on the Turn
Seat 2: englishmannn (big blind) folded before Flop
Seat 3: Unicus86 folded on the Turn
Seat 4: Hakunaaaa folded before Flop (didn't bet)
Seat 5: Amsterdam8383 folded before Flop (didn't bet)
Seat 6: Dorex2007 folded before Flop (didn't bet)
Seat 7: Sören76 folded before Flop (didn't bet)
Seat 8: alevseev83 collected ($0.19)
Seat 9: QPokerOO7 (button) folded before Flop (didn't bet)



PokerStars Hand #223628425210:  Hold'em No Limit ($0.01/$0.02 USD) - 2021/02/09 15:37:45 PT [2021/02/09 18:37:45 ET]
Table 'Fagnes IV' 9-max Seat #1 is the button
Seat 1: kano1313 ($2.58 in chips) 
Seat 2: englishmannn ($3.47 in chips) 
Seat 3: Unicus86 ($1.76 in chips) 
Seat 4: Hakunaaaa ($1.78 in chips) 
Seat 5: Amsterdam8383 ($1.19 in chips) 
Seat 6: Dorex2007 ($1.85 in chips) 
Seat 7: Sören76 ($1.22 in chips) 
Seat 8: alevseev83 ($2.74 in chips) 
Seat 9: QPokerOO7 ($8.06 in chips) 
englishmannn: posts small blind $0.01
Unicus86: posts big blind $0.02
*** HOLE CARDS ***
Dealt to Dorex2007 [9d 9h]
Hakunaaaa: folds 
Amsterdam8383: folds 
Dorex2007: calls $0.02
Sören76: folds 
alevseev83: folds 
QPokerOO7 has timed out
QPokerOO7: folds 
kano1313: raises $0.04 to $0.06
englishmannn: folds 
Unicus86: folds 
Dorex2007: calls $0.04
*** FLOP *** [3d 5h 8s]
Dorex2007: bets $0.14
kano1313: folds 
Uncalled bet ($0.14) returned to Dorex2007
Dorex2007 collected $0.14 from pot
Dorex2007: doesn't show hand 
*** SUMMARY ***
Total pot $0.15 | Rake $0.01 
Board [3d 5h 8s]
Seat 1: kano1313 (button) folded on the Flop
Seat 2: englishmannn (small blind) folded before Flop
Seat 3: Unicus86 (big blind) folded before Flop
Seat 4: Hakunaaaa folded before Flop (didn't bet)
Seat 5: Amsterdam8383 folded before Flop (didn't bet)
Seat 6: Dorex2007 collected ($0.14)
Seat 7: Sören76 folded before Flop (didn't bet)
Seat 8: alevseev83 folded before Flop (didn't bet)
Seat 9: QPokerOO7 folded before Flop (didn't bet)



PokerStars Hand #223628447779:  Hold'em No Limit ($0.01/$0.02 USD) - 2021/02/09 15:38:28 PT [2021/02/09 18:38:28 ET]
Table 'Fagnes IV' 9-max Seat #2 is the button
Seat 1: kano1313 ($2.52 in chips) 
Seat 2: englishmannn ($3.46 in chips) 
Seat 3: Unicus86 ($1.74 in chips) 
Seat 5: Amsterdam8383 ($1.19 in chips) 
Seat 6: Dorex2007 ($1.93 in chips) 
Seat 7: Sören76 ($1.22 in chips) 
Seat 8: alevseev83 ($2.74 in chips) 
Seat 9: QPokerOO7 ($8.06 in chips) 
Unicus86: posts small blind $0.01
Amsterdam8383: posts big blind $0.02
*** HOLE CARDS ***
Dealt to Dorex2007 [As 4h]
Dorex2007: folds 
Sören76: raises $0.04 to $0.06
alevseev83: calls $0.06
QPokerOO7: calls $0.06
kano1313: raises $0.16 to $0.22
englishmannn: folds 
Unicus86: folds 
Amsterdam8383: folds 
Sören76: folds 
alevseev83: calls $0.16
QPokerOO7: calls $0.16
*** FLOP *** [Js 8c 5c]
alevseev83: checks 
QPokerOO7: checks 
kano1313: checks 
*** TURN *** [Js 8c 5c] [4c]
alevseev83: bets $0.10
QPokerOO7: raises $0.52 to $0.62
kano1313: folds 
alevseev83: raises $1.90 to $2.52 and is all-in
QPokerOO7: calls $1.90
*** RIVER *** [Js 8c 5c 4c] [Qs]
*** SHOW DOWN ***
alevseev83: shows [9h 8h] (a pair of Eights)
QPokerOO7: shows [Ad Jd] (a pair of Jacks)
QPokerOO7 collected $5.59 from pot
*** SUMMARY ***
Total pot $5.79 | Rake $0.20 
Board [Js 8c 5c 4c Qs]
Seat 1: kano1313 folded on the Turn
Seat 2: englishmannn (button) folded before Flop (didn't bet)
Seat 3: Unicus86 (small blind) folded before Flop
Seat 5: Amsterdam8383 (big blind) folded before Flop
Seat 6: Dorex2007 folded before Flop (didn't bet)
Seat 7: Sören76 folded before Flop
Seat 8: alevseev83 showed [9h 8h] and lost with a pair of Eights
Seat 9: QPokerOO7 showed [Ad Jd] and won ($5.59) with a pair of Jacks



PokerStars Hand #223628499182:  Hold'em No Limit ($0.01/$0.02 USD) - 2021/02/09 15:40:08 PT [2021/02/09 18:40:08 ET]
Table 'Fagnes IV' 9-max Seat #3 is the button
Seat 1: kano1313 ($2.30 in chips) 
Seat 2: englishmannn ($3.46 in chips) 
Seat 3: Unicus86 ($1.73 in chips) 
Seat 5: Amsterdam8383 ($1.17 in chips) 
Seat 6: Dorex2007 ($1.93 in chips) 
Seat 7: Sören76 ($1.16 in chips) 
Seat 9: QPokerOO7 ($10.91 in chips) 
Amsterdam8383: posts small blind $0.01
Dorex2007: posts big blind $0.02
*** HOLE CARDS ***
Dealt to Dorex2007 [As 8c]
Sören76: folds 
QPokerOO7: folds 
alevseev83 leaves the table
kano1313: folds 
englishmannn: folds 
Unicus86: folds 
Amsterdam8383: calls $0.01
sizeofachair joins the table at seat #8 
Dorex2007: checks 
*** FLOP *** [6s Kd 9c]
Amsterdam8383: checks 
Dorex2007: checks 
*** TURN *** [6s Kd 9c] [Ah]
Amsterdam8383: bets $0.04
Dorex2007: calls $0.04
*** RIVER *** [6s Kd 9c Ah] [5c]
Amsterdam8383: bets $0.12
Dorex2007: folds 
Uncalled bet ($0.12) returned to Amsterdam8383
Amsterdam8383 collected $0.12 from pot
Amsterdam8383: doesn't show hand 
*** SUMMARY ***
Total pot $0.12 | Rake $0 
Board [6s Kd 9c Ah 5c]
Seat 1: kano1313 folded before Flop (didn't bet)
Seat 2: englishmannn folded before Flop (didn't bet)
Seat 3: Unicus86 (button) folded before Flop (didn't bet)
Seat 5: Amsterdam8383 (small blind) collected ($0.12)
Seat 6: Dorex2007 (big blind) folded on the River
Seat 7: Sören76 folded before Flop (didn't bet)
Seat 9: QPokerOO7 folded before Flop (didn't bet)



