PokerStars Hand #225159893101:  Hold'em No Limit ($0.01/$0.02 USD) - 2021/03/24 22:48:01 PT [2021/03/25 1:48:01 ET]
Table 'Belopolskya VI' 9-max Seat #5 is the button
Seat 2: Marrcceell ($1.42 in chips) 
Seat 3: showder10 ($2.41 in chips) 
Seat 4: dmcrbr ($2 in chips) 
Seat 5: hgpperez ($2.29 in chips) 
Seat 6: takano1337 ($0.59 in chips) 
Seat 7: Dorex2007 ($1.50 in chips) 
Seat 8: kiling1 ($1.78 in chips) 
Seat 9: 88Tanatos88 ($2 in chips) 
takano1337: posts small blind $0.01
Dorex2007: posts big blind $0.02
88Tanatos88: posts big blind $0.02
*** HOLE CARDS ***
Dealt to Dorex2007 [Kh Th]
kiling1: folds 
88Tanatos88: checks 
Marrcceell: calls $0.02
showder10: folds 
dmcrbr: folds 
hgpperez: folds 
takano1337: calls $0.01
Dorex2007: checks 
*** FLOP *** [9s Ts Qd]
takano1337: checks 
Dorex2007: checks 
88Tanatos88: checks 
Marrcceell: checks 
*** TURN *** [9s Ts Qd] [Ac]
takano1337: checks 
Dorex2007: checks 
88Tanatos88: checks 
Marrcceell: checks 
*** RIVER *** [9s Ts Qd Ac] [Tc]
takano1337: bets $0.06
Dorex2007: raises $0.08 to $0.14
88Tanatos88: folds 
Marrcceell: folds 
takano1337: calls $0.08
*** SHOW DOWN ***
Dorex2007: shows [Kh Th] (three of a kind, Tens)
takano1337: mucks hand 
Dorex2007 collected $0.35 from pot
*** SUMMARY ***
Total pot $0.36 | Rake $0.01 
Board [9s Ts Qd Ac Tc]
Seat 2: Marrcceell folded on the River
Seat 3: showder10 folded before Flop (didn't bet)
Seat 4: dmcrbr folded before Flop (didn't bet)
Seat 5: hgpperez (button) folded before Flop (didn't bet)
Seat 6: takano1337 (small blind) mucked [As 6c]
Seat 7: Dorex2007 (big blind) showed [Kh Th] and won ($0.35) with three of a kind, Tens
Seat 8: kiling1 folded before Flop (didn't bet)
Seat 9: 88Tanatos88 folded on the River (didn't bet)



PokerStars Hand #225159905939:  Hold'em No Limit ($0.01/$0.02 USD) - 2021/03/24 22:49:02 PT [2021/03/25 1:49:02 ET]
Table 'Belopolskya VI' 9-max Seat #6 is the button
Seat 2: Marrcceell ($1.40 in chips) 
Seat 3: showder10 ($2.41 in chips) 
Seat 4: dmcrbr ($2 in chips) 
Seat 5: hgpperez ($2.29 in chips) 
Seat 6: takano1337 ($0.43 in chips) 
Seat 7: Dorex2007 ($1.69 in chips) 
Seat 8: kiling1 ($1.78 in chips) 
Seat 9: 88Tanatos88 ($2 in chips) 
Dorex2007: posts small blind $0.01
kiling1: posts big blind $0.02
*** HOLE CARDS ***
Dealt to Dorex2007 [8c 2c]
88Tanatos88: folds 
Marrcceell: folds 
showder10: folds 
dmcrbr: folds 
hgpperez: folds 
takano1337: calls $0.02
Dorex2007: folds 
kiling1: checks 
*** FLOP *** [Th Jd 4d]
kiling1: checks 
takano1337: checks 
*** TURN *** [Th Jd 4d] [Ac]
kiling1: checks 
takano1337: checks 
*** RIVER *** [Th Jd 4d Ac] [8h]
kiling1: checks 
takano1337: checks 
*** SHOW DOWN ***
kiling1: shows [Kh 3h] (high card Ace)
takano1337: mucks hand 
kiling1 collected $0.05 from pot
*** SUMMARY ***
Total pot $0.05 | Rake $0 
Board [Th Jd 4d Ac 8h]
Seat 2: Marrcceell folded before Flop (didn't bet)
Seat 3: showder10 folded before Flop (didn't bet)
Seat 4: dmcrbr folded before Flop (didn't bet)
Seat 5: hgpperez folded before Flop (didn't bet)
Seat 6: takano1337 (button) mucked [6s 9d]
Seat 7: Dorex2007 (small blind) folded before Flop
Seat 8: kiling1 (big blind) showed [Kh 3h] and won ($0.05) with high card Ace
Seat 9: 88Tanatos88 folded before Flop (didn't bet)



PokerStars Hand #225159911769:  Hold'em No Limit ($0.01/$0.02 USD) - 2021/03/24 22:49:40 PT [2021/03/25 1:49:40 ET]
Table 'Belopolskya VI' 9-max Seat #7 is the button
Seat 2: Marrcceell ($1.40 in chips) 
Seat 3: showder10 ($2.41 in chips) 
Seat 4: dmcrbr ($2 in chips) 
Seat 5: hgpperez ($2.29 in chips) 
Seat 6: takano1337 ($0.41 in chips) 
Seat 7: Dorex2007 ($1.68 in chips) 
Seat 8: kiling1 ($1.81 in chips) 
Seat 9: 88Tanatos88 ($2 in chips) 
kiling1: posts small blind $0.01
88Tanatos88: posts big blind $0.02
*** HOLE CARDS ***
Dealt to Dorex2007 [6d Ah]
Marrcceell: folds 
showder10: folds 
dmcrbr: folds 
hgpperez: folds 
takano1337: calls $0.02
Dorex2007: calls $0.02
kiling1: folds 
88Tanatos88: checks 
*** FLOP *** [8s 4c 2c]
88Tanatos88: checks 
takano1337: checks 
Dorex2007: checks 
*** TURN *** [8s 4c 2c] [3d]
88Tanatos88: checks 
takano1337: checks 
Dorex2007: bets $0.07
88Tanatos88: folds 
takano1337: folds 
Uncalled bet ($0.07) returned to Dorex2007
Dorex2007 collected $0.07 from pot
Dorex2007: doesn't show hand 
*** SUMMARY ***
Total pot $0.07 | Rake $0 
Board [8s 4c 2c 3d]
Seat 2: Marrcceell folded before Flop (didn't bet)
Seat 3: showder10 folded before Flop (didn't bet)
Seat 4: dmcrbr folded before Flop (didn't bet)
Seat 5: hgpperez folded before Flop (didn't bet)
Seat 6: takano1337 folded on the Turn
Seat 7: Dorex2007 (button) collected ($0.07)
Seat 8: kiling1 (small blind) folded before Flop
Seat 9: 88Tanatos88 (big blind) folded on the Turn



PokerStars Hand #225159918324:  Hold'em No Limit ($0.01/$0.02 USD) - 2021/03/24 22:50:22 PT [2021/03/25 1:50:22 ET]
Table 'Belopolskya VI' 9-max Seat #8 is the button
Seat 2: Marrcceell ($1.40 in chips) 
Seat 3: showder10 ($2.41 in chips) 
Seat 4: dmcrbr ($2 in chips) 
Seat 5: hgpperez ($2.29 in chips) 
Seat 6: takano1337 ($0.39 in chips) 
Seat 7: Dorex2007 ($1.73 in chips) 
Seat 8: kiling1 ($1.80 in chips) 
Seat 9: 88Tanatos88 ($2 in chips) 
88Tanatos88: posts small blind $0.01
Marrcceell: posts big blind $0.02
*** HOLE CARDS ***
Dealt to Dorex2007 [Js 2h]
showder10: folds 
dmcrbr: folds 
hgpperez: folds 
takano1337: calls $0.02
Dorex2007: folds 
kiling1: calls $0.02
88Tanatos88: calls $0.01
Marrcceell: raises $0.08 to $0.10
takano1337: calls $0.08
kiling1: folds 
88Tanatos88: folds 
*** FLOP *** [7h 6d Ts]
Marrcceell: bets $0.15
takano1337: raises $0.14 to $0.29 and is all-in
Marrcceell: calls $0.14
*** TURN *** [7h 6d Ts] [9c]
*** RIVER *** [7h 6d Ts 9c] [Ac]
*** SHOW DOWN ***
Marrcceell: shows [Ah Ad] (three of a kind, Aces)
takano1337: shows [8h 8c] (a straight, Six to Ten)
takano1337 collected $0.79 from pot
*** SUMMARY ***
Total pot $0.82 | Rake $0.03 
Board [7h 6d Ts 9c Ac]
Seat 2: Marrcceell (big blind) showed [Ah Ad] and lost with three of a kind, Aces
Seat 3: showder10 folded before Flop (didn't bet)
Seat 4: dmcrbr folded before Flop (didn't bet)
Seat 5: hgpperez folded before Flop (didn't bet)
Seat 6: takano1337 showed [8h 8c] and won ($0.79) with a straight, Six to Ten
Seat 7: Dorex2007 folded before Flop (didn't bet)
Seat 8: kiling1 (button) folded before Flop
Seat 9: 88Tanatos88 (small blind) folded before Flop



PokerStars Hand #225159926548:  Hold'em No Limit ($0.01/$0.02 USD) - 2021/03/24 22:51:16 PT [2021/03/25 1:51:16 ET]
Table 'Belopolskya VI' 9-max Seat #9 is the button
Seat 2: Marrcceell ($1.01 in chips) 
Seat 3: showder10 ($2.41 in chips) 
Seat 4: dmcrbr ($2 in chips) 
Seat 5: hgpperez ($2.29 in chips) 
Seat 6: takano1337 ($0.79 in chips) 
Seat 7: Dorex2007 ($1.73 in chips) 
Seat 8: kiling1 ($1.78 in chips) 
Seat 9: 88Tanatos88 ($2 in chips) 
Marrcceell: posts small blind $0.01
showder10: posts big blind $0.02
*** HOLE CARDS ***
Dealt to Dorex2007 [6d Jc]
dmcrbr: folds 
hgpperez: folds 
takano1337: calls $0.02
Dorex2007: folds 
kiling1: raises $0.07 to $0.09
88Tanatos88: calls $0.09
Marrcceell: folds 
showder10: calls $0.07
takano1337: folds 
*** FLOP *** [8h 3h 3d]
showder10: checks 
kiling1: bets $0.14
88Tanatos88: raises $0.42 to $0.56
showder10: folds 
kiling1: folds 
Uncalled bet ($0.42) returned to 88Tanatos88
88Tanatos88 collected $0.56 from pot
88Tanatos88: doesn't show hand 
*** SUMMARY ***
Total pot $0.58 | Rake $0.02 
Board [8h 3h 3d]
Seat 2: Marrcceell (small blind) folded before Flop
Seat 3: showder10 (big blind) folded on the Flop
Seat 4: dmcrbr folded before Flop (didn't bet)
Seat 5: hgpperez folded before Flop (didn't bet)
Seat 6: takano1337 folded before Flop
Seat 7: Dorex2007 folded before Flop (didn't bet)
Seat 8: kiling1 folded on the Flop
Seat 9: 88Tanatos88 (button) collected ($0.56)



PokerStars Hand #225159935129:  Hold'em No Limit ($0.01/$0.02 USD) - 2021/03/24 22:52:12 PT [2021/03/25 1:52:12 ET]
Table 'Belopolskya VI' 9-max Seat #2 is the button
Seat 2: Marrcceell ($1 in chips) 
Seat 3: showder10 ($2.32 in chips) 
Seat 4: dmcrbr ($2 in chips) 
Seat 5: hgpperez ($2.29 in chips) 
Seat 6: takano1337 ($0.77 in chips) 
Seat 7: Dorex2007 ($1.73 in chips) 
Seat 8: kiling1 ($1.55 in chips) 
Seat 9: 88Tanatos88 ($2.33 in chips) 
showder10: posts small blind $0.01
dmcrbr: posts big blind $0.02
*** HOLE CARDS ***
Dealt to Dorex2007 [9c Jh]
hgpperez: folds 
takano1337: folds 
Dorex2007: folds 
kiling1: folds 
88Tanatos88: calls $0.02
Marrcceell: calls $0.02
showder10: folds 
dmcrbr: checks 
*** FLOP *** [6c 7s 2c]
dmcrbr: checks 
88Tanatos88: bets $0.02
Marrcceell: calls $0.02
dmcrbr: folds 
*** TURN *** [6c 7s 2c] [Qc]
88Tanatos88: checks 
Marrcceell: checks 
*** RIVER *** [6c 7s 2c Qc] [7c]
88Tanatos88: bets $0.12
Marrcceell: folds 
Uncalled bet ($0.12) returned to 88Tanatos88
88Tanatos88 collected $0.11 from pot
88Tanatos88: doesn't show hand 
*** SUMMARY ***
Total pot $0.11 | Rake $0 
Board [6c 7s 2c Qc 7c]
Seat 2: Marrcceell (button) folded on the River
Seat 3: showder10 (small blind) folded before Flop
Seat 4: dmcrbr (big blind) folded on the Flop
Seat 5: hgpperez folded before Flop (didn't bet)
Seat 6: takano1337 folded before Flop (didn't bet)
Seat 7: Dorex2007 folded before Flop (didn't bet)
Seat 8: kiling1 folded before Flop (didn't bet)
Seat 9: 88Tanatos88 collected ($0.11)



PokerStars Hand #225159942317:  Hold'em No Limit ($0.01/$0.02 USD) - 2021/03/24 22:53:00 PT [2021/03/25 1:53:00 ET]
Table 'Belopolskya VI' 9-max Seat #3 is the button
Seat 2: Marrcceell ($0.96 in chips) 
Seat 3: showder10 ($2.31 in chips) 
Seat 4: dmcrbr ($2 in chips) 
Seat 5: hgpperez ($2.29 in chips) 
Seat 6: takano1337 ($0.77 in chips) 
Seat 7: Dorex2007 ($1.73 in chips) 
Seat 8: kiling1 ($1.55 in chips) 
Seat 9: 88Tanatos88 ($2.40 in chips) 
dmcrbr: posts small blind $0.01
hgpperez: posts big blind $0.02
Seregaa1998: sits out 
*** HOLE CARDS ***
Dealt to Dorex2007 [9c Js]
takano1337: folds 
Dorex2007: folds 
kiling1: calls $0.02
88Tanatos88: folds 
Marrcceell: calls $0.02
showder10: folds 
dmcrbr: folds 
hgpperez: checks 
*** FLOP *** [7c 9h 2s]
88Tanatos88 leaves the table
hgpperez: checks 
kiling1: checks 
Marrcceell: checks 
*** TURN *** [7c 9h 2s] [2d]
hgpperez: bets $0.07
kiling1: folds 
Marrcceell: calls $0.07
*** RIVER *** [7c 9h 2s 2d] [Qd]
hgpperez: bets $0.20
Marrcceell: folds 
Uncalled bet ($0.20) returned to hgpperez
hgpperez collected $0.20 from pot
hgpperez: doesn't show hand 
*** SUMMARY ***
Total pot $0.21 | Rake $0.01 
Board [7c 9h 2s 2d Qd]
Seat 2: Marrcceell folded on the River
Seat 3: showder10 (button) folded before Flop (didn't bet)
Seat 4: dmcrbr (small blind) folded before Flop
Seat 5: hgpperez (big blind) collected ($0.20)
Seat 6: takano1337 folded before Flop (didn't bet)
Seat 7: Dorex2007 folded before Flop (didn't bet)
Seat 8: kiling1 folded on the Turn
Seat 9: 88Tanatos88 folded before Flop (didn't bet)



PokerStars Hand #225159952983:  Hold'em No Limit ($0.01/$0.02 USD) - 2021/03/24 22:54:11 PT [2021/03/25 1:54:11 ET]
Table 'Belopolskya VI' 9-max Seat #4 is the button
Seat 2: Marrcceell ($0.87 in chips) 
Seat 3: showder10 ($2.31 in chips) 
Seat 4: dmcrbr ($2 in chips) 
Seat 5: hgpperez ($2.40 in chips) 
Seat 6: takano1337 ($0.77 in chips) 
Seat 7: Dorex2007 ($1.73 in chips) 
Seat 8: kiling1 ($1.53 in chips) 
hgpperez: posts small blind $0.01
takano1337: posts big blind $0.02
Seregaa1998: sits out 
*** HOLE CARDS ***
Dealt to Dorex2007 [7s As]
Dorex2007: raises $0.04 to $0.06
kiling1: folds 
Marrcceell: calls $0.06
showder10: folds 
dmcrbr: folds 
hgpperez: folds 
takano1337: calls $0.04
*** FLOP *** [6d Th Jd]
takano1337: bets $0.04
Dorex2007: folds 
Marrcceell: calls $0.04
*** TURN *** [6d Th Jd] [Qh]
takano1337: bets $0.10
Marrcceell: raises $0.67 to $0.77 and is all-in
takano1337: calls $0.57 and is all-in
Uncalled bet ($0.10) returned to Marrcceell
*** RIVER *** [6d Th Jd Qh] [4s]
*** SHOW DOWN ***
takano1337: shows [Qs Ks] (a pair of Queens)
Marrcceell: shows [Ad Kc] (a straight, Ten to Ace)
Marrcceell collected $1.55 from pot
takano1337 cashed out the hand for $0.06
*** SUMMARY ***
Total pot $1.61 | Rake $0.06 
Board [6d Th Jd Qh 4s]
Seat 2: Marrcceell showed [Ad Kc] and won ($1.55) with a straight, Ten to Ace
Seat 3: showder10 folded before Flop (didn't bet)
Seat 4: dmcrbr (button) folded before Flop (didn't bet)
Seat 5: hgpperez (small blind) folded before Flop
Seat 6: takano1337 (big blind) showed [Qs Ks] and lost with a pair of Queens (cashed out).
Seat 7: Dorex2007 folded on the Flop
Seat 8: kiling1 folded before Flop (didn't bet)



PokerStars Hand #225159961944:  Hold'em No Limit ($0.01/$0.02 USD) - 2021/03/24 22:55:12 PT [2021/03/25 1:55:12 ET]
Table 'Belopolskya VI' 9-max Seat #5 is the button
Seat 2: Marrcceell ($1.65 in chips) 
Seat 3: showder10 ($2.31 in chips) 
Seat 4: dmcrbr ($2 in chips) 
Seat 5: hgpperez ($2.39 in chips) 
Seat 6: takano1337 ($0.06 in chips) 
Seat 7: Dorex2007 ($1.67 in chips) 
Seat 8: kiling1 ($1.53 in chips) 
takano1337: posts small blind $0.01
Dorex2007: posts big blind $0.02
Seregaa1998: sits out 
*** HOLE CARDS ***
Dealt to Dorex2007 [Qd 5d]
kiling1 has timed out
kiling1: folds 
Marrcceell: calls $0.02
showder10: calls $0.02
dmcrbr: folds 
hgpperez: calls $0.02
takano1337: calls $0.01
Dorex2007: checks 
*** FLOP *** [Jc As 3c]
takano1337: bets $0.04 and is all-in
Dorex2007: folds 
Marrcceell: calls $0.04
showder10: folds 
hgpperez: calls $0.04
*** TURN *** [Jc As 3c] [8h]
Marrcceell: bets $0.08
hgpperez: folds 
Uncalled bet ($0.08) returned to Marrcceell
baligo666 joins the table at seat #9 
*** RIVER *** [Jc As 3c 8h] [Tc]
*** SHOW DOWN ***
takano1337: shows [Js 4h] (a pair of Jacks)
Marrcceell: shows [Kc Qh] (a straight, Ten to Ace)
Marrcceell collected $0.21 from pot
*** SUMMARY ***
Total pot $0.22 | Rake $0.01 
Board [Jc As 3c 8h Tc]
Seat 2: Marrcceell showed [Kc Qh] and won ($0.21) with a straight, Ten to Ace
Seat 3: showder10 folded on the Flop
Seat 4: dmcrbr folded before Flop (didn't bet)
Seat 5: hgpperez (button) folded on the Turn
Seat 6: takano1337 (small blind) showed [Js 4h] and lost with a pair of Jacks
Seat 7: Dorex2007 (big blind) folded on the Flop
Seat 8: kiling1 folded before Flop (didn't bet)



PokerStars Hand #225159969376:  Hold'em No Limit ($0.01/$0.02 USD) - 2021/03/24 22:56:10 PT [2021/03/25 1:56:10 ET]
Table 'Belopolskya VI' 9-max Seat #7 is the button
Seat 2: Marrcceell ($1.80 in chips) 
Seat 3: showder10 ($2.29 in chips) 
Seat 4: dmcrbr ($2 in chips) 
Seat 5: hgpperez ($2.33 in chips) 
Seat 7: Dorex2007 ($1.65 in chips) 
Marrcceell: posts small blind $0.01
showder10: posts big blind $0.02
*** HOLE CARDS ***
Dealt to Dorex2007 [7s Ac]
dmcrbr: folds 
hgpperez: folds 
takano1337 leaves the table
Dorex2007: raises $0.04 to $0.06
Marrcceell: folds 
showder10: calls $0.04
*** FLOP *** [3s 8d 2c]
showder10: checks 
Dorex2007: bets $0.13
showder10: folds 
Uncalled bet ($0.13) returned to Dorex2007
Dorex2007 collected $0.13 from pot
Dorex2007: doesn't show hand 
*** SUMMARY ***
Total pot $0.13 | Rake $0 
Board [3s 8d 2c]
Seat 2: Marrcceell (small blind) folded before Flop
Seat 3: showder10 (big blind) folded on the Flop
Seat 4: dmcrbr folded before Flop (didn't bet)
Seat 5: hgpperez folded before Flop (didn't bet)
Seat 7: Dorex2007 (button) collected ($0.13)



PokerStars Hand #225159973270:  Hold'em No Limit ($0.01/$0.02 USD) - 2021/03/24 22:56:40 PT [2021/03/25 1:56:40 ET]
Table 'Belopolskya VI' 9-max Seat #2 is the button
Seat 2: Marrcceell ($1.79 in chips) 
Seat 3: showder10 ($2.23 in chips) 
Seat 4: dmcrbr ($2 in chips) 
Seat 5: hgpperez ($2.33 in chips) 
Seat 7: Dorex2007 ($1.72 in chips) 
showder10: posts small blind $0.01
dmcrbr: posts big blind $0.02
baligo666: sits out 
Seregaa1998: sits out 
*** HOLE CARDS ***
Dealt to Dorex2007 [4h Kh]
KiDraybeon joins the table at seat #6 
hgpperez: folds 
Dorex2007: folds 
Marrcceell: folds 
Marrcceell leaves the table
showder10: raises $0.04 to $0.06
dmcrbr: folds 
Uncalled bet ($0.04) returned to showder10
showder10 collected $0.04 from pot
showder10: doesn't show hand 
*** SUMMARY ***
Total pot $0.04 | Rake $0 
Seat 2: Marrcceell (button) folded before Flop (didn't bet)
Seat 3: showder10 (small blind) collected ($0.04)
Seat 4: dmcrbr (big blind) folded before Flop
Seat 5: hgpperez folded before Flop (didn't bet)
Seat 7: Dorex2007 folded before Flop (didn't bet)



PokerStars Hand #225159975199:  Hold'em No Limit ($0.01/$0.02 USD) - 2021/03/24 22:56:55 PT [2021/03/25 1:56:55 ET]
Table 'Belopolskya VI' 9-max Seat #3 is the button
Seat 3: showder10 ($2.25 in chips) 
Seat 4: dmcrbr ($2 in chips) 
Seat 5: hgpperez ($2.33 in chips) 
Seat 7: Dorex2007 ($1.72 in chips) 
dmcrbr: posts small blind $0.01
hgpperez: posts big blind $0.02
KiDraybeon: sits out 
baligo666: sits out 
Seregaa1998: sits out 
*** HOLE CARDS ***
Dealt to Dorex2007 [Tc Ks]
Dorex2007: raises $0.04 to $0.06
showder10: calls $0.06
dmcrbr: folds 
hgpperez: folds 
*** FLOP *** [Ah 4c 8h]
Dorex2007: bets $0.09
showder10: calls $0.09
*** TURN *** [Ah 4c 8h] [8s]
Dorex2007: checks 
showder10: checks 
*** RIVER *** [Ah 4c 8h 8s] [4s]
Dorex2007: bets $0.32
showder10: raises $0.54 to $0.86
bojnice21 joins the table at seat #2 
Dorex2007: folds 
Uncalled bet ($0.54) returned to showder10
showder10 collected $0.94 from pot
showder10: doesn't show hand 
*** SUMMARY ***
Total pot $0.97 | Rake $0.03 
Board [Ah 4c 8h 8s 4s]
Seat 3: showder10 (button) collected ($0.94)
Seat 4: dmcrbr (small blind) folded before Flop
Seat 5: hgpperez (big blind) folded before Flop
Seat 7: Dorex2007 folded on the River



PokerStars Hand #225159982425:  Hold'em No Limit ($0.01/$0.02 USD) - 2021/03/24 22:57:52 PT [2021/03/25 1:57:52 ET]
Table 'Belopolskya VI' 9-max Seat #4 is the button
Seat 3: showder10 ($2.72 in chips) 
Seat 4: dmcrbr ($2 in chips) 
Seat 5: hgpperez ($2.31 in chips) 
Seat 6: KiDraybeon ($2 in chips) 
Seat 7: Dorex2007 ($1.25 in chips) 
hgpperez: posts small blind $0.01
KiDraybeon: posts big blind $0.02
kiling1: sits out 
baligo666: sits out 
Seregaa1998: sits out 
bojnice21: sits out 
*** HOLE CARDS ***
Dealt to Dorex2007 [Jd Kh]
Dorex2007: raises $0.04 to $0.06
showder10: folds 
dmcrbr: folds 
hgpperez: folds 
KiDraybeon: folds 
Uncalled bet ($0.04) returned to Dorex2007
Dorex2007 collected $0.05 from pot
Dorex2007: doesn't show hand 
*** SUMMARY ***
Total pot $0.05 | Rake $0 
Seat 3: showder10 folded before Flop (didn't bet)
Seat 4: dmcrbr (button) folded before Flop (didn't bet)
Seat 5: hgpperez (small blind) folded before Flop
Seat 6: KiDraybeon (big blind) folded before Flop
Seat 7: Dorex2007 collected ($0.05)



PokerStars Hand #225159984727:  Hold'em No Limit ($0.01/$0.02 USD) - 2021/03/24 22:58:10 PT [2021/03/25 1:58:10 ET]
Table 'Belopolskya VI' 9-max Seat #5 is the button
Seat 3: showder10 ($2.72 in chips) 
Seat 4: dmcrbr ($2 in chips) 
Seat 5: hgpperez ($2.30 in chips) 
Seat 6: KiDraybeon ($2 in chips) 
Seat 7: Dorex2007 ($2 in chips) 
KiDraybeon: posts small blind $0.01
Dorex2007: posts big blind $0.02
kiling1: sits out 
baligo666: sits out 
Seregaa1998: sits out 
bojnice21: sits out 
*** HOLE CARDS ***
Dealt to Dorex2007 [2h Js]
showder10: folds 
dmcrbr: folds 
hgpperez: folds 
KiDraybeon has timed out
KiDraybeon: folds 
Uncalled bet ($0.01) returned to Dorex2007
Dorex2007 collected $0.02 from pot
Dorex2007: doesn't show hand 
*** SUMMARY ***
Total pot $0.02 | Rake $0 
Seat 3: showder10 folded before Flop (didn't bet)
Seat 4: dmcrbr folded before Flop (didn't bet)
Seat 5: hgpperez (button) folded before Flop (didn't bet)
Seat 6: KiDraybeon (small blind) folded before Flop
Seat 7: Dorex2007 (big blind) collected ($0.02)



PokerStars Hand #225159989352:  Hold'em No Limit ($0.01/$0.02 USD) - 2021/03/24 22:58:45 PT [2021/03/25 1:58:45 ET]
Table 'Belopolskya VI' 9-max Seat #7 is the button
Seat 3: showder10 ($2.72 in chips) 
Seat 4: dmcrbr ($2 in chips) 
Seat 5: hgpperez ($2.30 in chips) 
Seat 7: Dorex2007 ($2.01 in chips) 
showder10: posts small blind $0.01
dmcrbr: posts big blind $0.02
*** HOLE CARDS ***
Dealt to Dorex2007 [Js Jd]
hgpperez: folds 
Dorex2007: raises $0.04 to $0.06
showder10: folds 
dmcrbr: folds 
Uncalled bet ($0.04) returned to Dorex2007
Dorex2007 collected $0.05 from pot
Dorex2007: doesn't show hand 
*** SUMMARY ***
Total pot $0.05 | Rake $0 
Seat 3: showder10 (small blind) folded before Flop
Seat 4: dmcrbr (big blind) folded before Flop
Seat 5: hgpperez folded before Flop (didn't bet)
Seat 7: Dorex2007 (button) collected ($0.05)



PokerStars Hand #225159990976:  Hold'em No Limit ($0.01/$0.02 USD) - 2021/03/24 22:58:57 PT [2021/03/25 1:58:57 ET]
Table 'Belopolskya VI' 9-max Seat #3 is the button
Seat 3: showder10 ($2.71 in chips) 
Seat 4: dmcrbr ($2 in chips) 
Seat 5: hgpperez ($2.30 in chips) 
Seat 6: KiDraybeon ($2 in chips) 
Seat 7: Dorex2007 ($2.04 in chips) 
dmcrbr: posts small blind $0.01
hgpperez: posts big blind $0.02
kiling1: sits out 
baligo666: sits out 
Seregaa1998: sits out 
bojnice21: sits out 
*** HOLE CARDS ***
Dealt to Dorex2007 [9s Jd]
KiDraybeon: folds 
Dorex2007: folds 
showder10: folds 
dmcrbr: folds 
Uncalled bet ($0.01) returned to hgpperez
hgpperez collected $0.02 from pot
hgpperez: doesn't show hand 
*** SUMMARY ***
Total pot $0.02 | Rake $0 
Seat 3: showder10 (button) folded before Flop (didn't bet)
Seat 4: dmcrbr (small blind) folded before Flop
Seat 5: hgpperez (big blind) collected ($0.02)
Seat 6: KiDraybeon folded before Flop (didn't bet)
Seat 7: Dorex2007 folded before Flop (didn't bet)



PokerStars Hand #225159992412:  Hold'em No Limit ($0.01/$0.02 USD) - 2021/03/24 22:59:08 PT [2021/03/25 1:59:08 ET]
Table 'Belopolskya VI' 9-max Seat #4 is the button
Seat 3: showder10 ($2.71 in chips) 
Seat 4: dmcrbr ($2 in chips) 
Seat 5: hgpperez ($2.31 in chips) 
Seat 6: KiDraybeon ($2 in chips) 
Seat 7: Dorex2007 ($2.04 in chips) 
hgpperez: posts small blind $0.01
KiDraybeon: posts big blind $0.02
kiling1: sits out 
baligo666: sits out 
Seregaa1998: sits out 
bojnice21: sits out 
*** HOLE CARDS ***
Dealt to Dorex2007 [4s 3c]
Dorex2007: folds 
showder10: folds 
dmcrbr: folds 
hgpperez: raises $0.04 to $0.06
KiDraybeon: calls $0.04
*** FLOP *** [Jd 7h 2h]
hgpperez: bets $0.08
KiDraybeon: calls $0.08
*** TURN *** [Jd 7h 2h] [7d]
hgpperez: bets $0.18
KiDraybeon: calls $0.18
*** RIVER *** [Jd 7h 2h 7d] [4h]
hgpperez: bets $0.30
KiDraybeon: calls $0.30
*** SHOW DOWN ***
hgpperez: shows [8h Ks] (a pair of Sevens)
KiDraybeon: shows [Qc Jc] (two pair, Jacks and Sevens)
KiDraybeon collected $1.20 from pot
*** SUMMARY ***
Total pot $1.24 | Rake $0.04 
Board [Jd 7h 2h 7d 4h]
Seat 3: showder10 folded before Flop (didn't bet)
Seat 4: dmcrbr (button) folded before Flop (didn't bet)
Seat 5: hgpperez (small blind) showed [8h Ks] and lost with a pair of Sevens
Seat 6: KiDraybeon (big blind) showed [Qc Jc] and won ($1.20) with two pair, Jacks and Sevens
Seat 7: Dorex2007 folded before Flop (didn't bet)



PokerStars Hand #225160000288:  Hold'em No Limit ($0.01/$0.02 USD) - 2021/03/24 23:00:09 PT [2021/03/25 2:00:09 ET]
Table 'Belopolskya VI' 9-max Seat #5 is the button
Seat 3: showder10 ($2.71 in chips) 
Seat 4: dmcrbr ($2 in chips) 
Seat 5: hgpperez ($1.69 in chips) 
Seat 6: KiDraybeon ($2.58 in chips) 
Seat 7: Dorex2007 ($2.04 in chips) 
KiDraybeon: posts small blind $0.01
Dorex2007: posts big blind $0.02
kiling1: sits out 
baligo666: sits out 
Seregaa1998: sits out 
bojnice21: sits out 
*** HOLE CARDS ***
Dealt to Dorex2007 [Js 6h]
showder10: folds 
dmcrbr: folds 
hgpperez: folds 
KiDraybeon: raises $0.05 to $0.07
Dorex2007: folds 
Uncalled bet ($0.05) returned to KiDraybeon
KiDraybeon collected $0.04 from pot
KiDraybeon: doesn't show hand 
*** SUMMARY ***
Total pot $0.04 | Rake $0 
Seat 3: showder10 folded before Flop (didn't bet)
Seat 4: dmcrbr folded before Flop (didn't bet)
Seat 5: hgpperez (button) folded before Flop (didn't bet)
Seat 6: KiDraybeon (small blind) collected ($0.04)
Seat 7: Dorex2007 (big blind) folded before Flop



PokerStars Hand #225160002642:  Hold'em No Limit ($0.01/$0.02 USD) - 2021/03/24 23:00:26 PT [2021/03/25 2:00:26 ET]
Table 'Belopolskya VI' 9-max Seat #6 is the button
Seat 3: showder10 ($2.71 in chips) 
Seat 4: dmcrbr ($2 in chips) 
Seat 5: hgpperez ($1.69 in chips) 
Seat 6: KiDraybeon ($2.60 in chips) 
Seat 7: Dorex2007 ($2.02 in chips) 
Seat 8: kiling1 ($1.53 in chips) 
Dorex2007: posts small blind $0.01
kiling1: posts big blind $0.02
baligo666: sits out 
Seregaa1998: sits out 
bojnice21: sits out 
*** HOLE CARDS ***
Dealt to Dorex2007 [7d 2c]
showder10: folds 
dmcrbr: folds 
hgpperez: folds 
KiDraybeon: folds 
Dorex2007: folds 
Uncalled bet ($0.01) returned to kiling1
kiling1 collected $0.02 from pot
kiling1: doesn't show hand 
*** SUMMARY ***
Total pot $0.02 | Rake $0 
Seat 3: showder10 folded before Flop (didn't bet)
Seat 4: dmcrbr folded before Flop (didn't bet)
Seat 5: hgpperez folded before Flop (didn't bet)
Seat 6: KiDraybeon (button) folded before Flop (didn't bet)
Seat 7: Dorex2007 (small blind) folded before Flop
Seat 8: kiling1 (big blind) collected ($0.02)



PokerStars Hand #225160004292:  Hold'em No Limit ($0.01/$0.02 USD) - 2021/03/24 23:00:38 PT [2021/03/25 2:00:38 ET]
Table 'Belopolskya VI' 9-max Seat #7 is the button
Seat 3: showder10 ($2.71 in chips) 
Seat 4: dmcrbr ($2 in chips) 
Seat 5: hgpperez ($1.69 in chips) 
Seat 6: KiDraybeon ($2.60 in chips) 
Seat 7: Dorex2007 ($2.01 in chips) 
Seat 8: kiling1 ($1.54 in chips) 
Seat 9: baligo666 ($2 in chips) 
kiling1: posts small blind $0.01
baligo666: posts big blind $0.02
Seregaa1998: sits out 
bojnice21: sits out 
*** HOLE CARDS ***
Dealt to Dorex2007 [Kh 9h]
showder10: folds 
dmcrbr: folds 
hgpperez: calls $0.02
KiDraybeon: folds 
Dorex2007: calls $0.02
kiling1: folds 
baligo666: checks 
*** FLOP *** [Tc Js 9s]
baligo666: checks 
hgpperez: bets $0.02
Dorex2007: raises $0.04 to $0.06
baligo666: folds 
hgpperez: calls $0.04
*** TURN *** [Tc Js 9s] [7s]
hgpperez: checks 
Dorex2007: bets $0.09
hgpperez: folds 
Uncalled bet ($0.09) returned to Dorex2007
Dorex2007 collected $0.18 from pot
Dorex2007: doesn't show hand 
*** SUMMARY ***
Total pot $0.19 | Rake $0.01 
Board [Tc Js 9s 7s]
Seat 3: showder10 folded before Flop (didn't bet)
Seat 4: dmcrbr folded before Flop (didn't bet)
Seat 5: hgpperez folded on the Turn
Seat 6: KiDraybeon folded before Flop (didn't bet)
Seat 7: Dorex2007 (button) collected ($0.18)
Seat 8: kiling1 (small blind) folded before Flop
Seat 9: baligo666 (big blind) folded on the Flop



PokerStars Hand #225160012254:  Hold'em No Limit ($0.01/$0.02 USD) - 2021/03/24 23:01:32 PT [2021/03/25 2:01:32 ET]
Table 'Belopolskya VI' 9-max Seat #8 is the button
Seat 1: Seregaa1998 ($2 in chips) 
Seat 3: showder10 ($2.71 in chips) 
Seat 4: dmcrbr ($2 in chips) 
Seat 5: hgpperez ($1.61 in chips) 
Seat 6: KiDraybeon ($2.60 in chips) 
Seat 7: Dorex2007 ($2.11 in chips) 
Seat 8: kiling1 ($1.53 in chips) 
Seat 9: baligo666 ($1.98 in chips) 
baligo666: posts small blind $0.01
Seregaa1998: posts big blind $0.02
bojnice21: sits out 
*** HOLE CARDS ***
Dealt to Dorex2007 [Qs Ts]
showder10: folds 
dmcrbr: folds 
hgpperez: folds 
KiDraybeon: folds 
Dorex2007: raises $0.04 to $0.06
kiling1: folds 
baligo666: folds 
Seregaa1998: folds 
Uncalled bet ($0.04) returned to Dorex2007
Dorex2007 collected $0.05 from pot
Dorex2007: doesn't show hand 
*** SUMMARY ***
Total pot $0.05 | Rake $0 
Seat 1: Seregaa1998 (big blind) folded before Flop
Seat 3: showder10 folded before Flop (didn't bet)
Seat 4: dmcrbr folded before Flop (didn't bet)
Seat 5: hgpperez folded before Flop (didn't bet)
Seat 6: KiDraybeon folded before Flop (didn't bet)
Seat 7: Dorex2007 collected ($0.05)
Seat 8: kiling1 (button) folded before Flop (didn't bet)
Seat 9: baligo666 (small blind) folded before Flop



PokerStars Hand #225160015766:  Hold'em No Limit ($0.01/$0.02 USD) - 2021/03/24 23:01:56 PT [2021/03/25 2:01:56 ET]
Table 'Belopolskya VI' 9-max Seat #9 is the button
Seat 1: Seregaa1998 ($1.98 in chips) 
Seat 2: bojnice21 ($2 in chips) 
Seat 3: showder10 ($2.71 in chips) 
Seat 4: dmcrbr ($2 in chips) 
Seat 5: hgpperez ($1.61 in chips) 
Seat 6: KiDraybeon ($2.60 in chips) 
Seat 7: Dorex2007 ($2.14 in chips) 
Seat 8: kiling1 ($1.53 in chips) 
Seat 9: baligo666 ($1.97 in chips) 
Seregaa1998: posts small blind $0.01
bojnice21: posts big blind $0.02
*** HOLE CARDS ***
Dealt to Dorex2007 [2s 3d]
showder10: folds 
dmcrbr: folds 
hgpperez: raises $0.04 to $0.06
KiDraybeon: folds 
Dorex2007: folds 
kiling1: folds 
baligo666: folds 
Seregaa1998: raises $0.14 to $0.20
bojnice21: folds 
hgpperez: folds 
Uncalled bet ($0.14) returned to Seregaa1998
Seregaa1998 collected $0.14 from pot
Seregaa1998: doesn't show hand 
*** SUMMARY ***
Total pot $0.14 | Rake $0 
Seat 1: Seregaa1998 (small blind) collected ($0.14)
Seat 2: bojnice21 (big blind) folded before Flop
Seat 3: showder10 folded before Flop (didn't bet)
Seat 4: dmcrbr folded before Flop (didn't bet)
Seat 5: hgpperez folded before Flop
Seat 6: KiDraybeon folded before Flop (didn't bet)
Seat 7: Dorex2007 folded before Flop (didn't bet)
Seat 8: kiling1 folded before Flop (didn't bet)
Seat 9: baligo666 (button) folded before Flop (didn't bet)



PokerStars Hand #225160021562:  Hold'em No Limit ($0.01/$0.02 USD) - 2021/03/24 23:02:35 PT [2021/03/25 2:02:35 ET]
Table 'Belopolskya VI' 9-max Seat #1 is the button
Seat 1: Seregaa1998 ($2.06 in chips) 
Seat 2: bojnice21 ($1.98 in chips) 
Seat 3: showder10 ($2.71 in chips) 
Seat 4: dmcrbr ($2 in chips) 
Seat 5: hgpperez ($1.55 in chips) 
Seat 6: KiDraybeon ($2.60 in chips) 
Seat 7: Dorex2007 ($2.14 in chips) 
Seat 8: kiling1 ($1.53 in chips) 
Seat 9: baligo666 ($1.97 in chips) 
bojnice21: posts small blind $0.01
showder10: posts big blind $0.02
*** HOLE CARDS ***
Dealt to Dorex2007 [7s 3h]
dmcrbr: folds 
hgpperez: folds 
KiDraybeon: folds 
Dorex2007: folds 
kiling1: folds 
baligo666: folds 
Seregaa1998: folds 
bojnice21: raises $0.04 to $0.06
showder10: calls $0.04
*** FLOP *** [4h Jc 2d]
bojnice21: checks 
showder10: checks 
*** TURN *** [4h Jc 2d] [Js]
bojnice21: checks 
showder10: bets $0.06
bojnice21: folds 
Uncalled bet ($0.06) returned to showder10
showder10 collected $0.12 from pot
showder10: doesn't show hand 
*** SUMMARY ***
Total pot $0.12 | Rake $0 
Board [4h Jc 2d Js]
Seat 1: Seregaa1998 (button) folded before Flop (didn't bet)
Seat 2: bojnice21 (small blind) folded on the Turn
Seat 3: showder10 (big blind) collected ($0.12)
Seat 4: dmcrbr folded before Flop (didn't bet)
Seat 5: hgpperez folded before Flop (didn't bet)
Seat 6: KiDraybeon folded before Flop (didn't bet)
Seat 7: Dorex2007 folded before Flop (didn't bet)
Seat 8: kiling1 folded before Flop (didn't bet)
Seat 9: baligo666 folded before Flop (didn't bet)



PokerStars Hand #225160037866:  Hold'em No Limit ($0.01/$0.02 USD) - 2021/03/24 23:03:36 PT [2021/03/25 2:03:36 ET]
Table 'Belopolskya VI' 9-max Seat #2 is the button
Seat 1: Seregaa1998 ($2.06 in chips) 
Seat 2: bojnice21 ($1.92 in chips) 
Seat 3: showder10 ($2.77 in chips) 
Seat 4: dmcrbr ($2 in chips) 
Seat 5: hgpperez ($1.55 in chips) 
Seat 6: KiDraybeon ($2.60 in chips) 
Seat 7: Dorex2007 ($2.14 in chips) 
Seat 8: kiling1 ($1.53 in chips) 
Seat 9: baligo666 ($1.97 in chips) 
showder10: posts small blind $0.01
dmcrbr: posts big blind $0.02
*** HOLE CARDS ***
Dealt to Dorex2007 [As 5s]
hgpperez: raises $0.04 to $0.06
KiDraybeon: folds 
Dorex2007: folds 
kiling1: folds 
baligo666: folds 
Seregaa1998: folds 
bojnice21: folds 
showder10: folds 
dmcrbr: folds 
Uncalled bet ($0.04) returned to hgpperez
hgpperez collected $0.05 from pot
hgpperez: doesn't show hand 
*** SUMMARY ***
Total pot $0.05 | Rake $0 
Seat 1: Seregaa1998 folded before Flop (didn't bet)
Seat 2: bojnice21 (button) folded before Flop (didn't bet)
Seat 3: showder10 (small blind) folded before Flop
Seat 4: dmcrbr (big blind) folded before Flop
Seat 5: hgpperez collected ($0.05)
Seat 6: KiDraybeon folded before Flop (didn't bet)
Seat 7: Dorex2007 folded before Flop (didn't bet)
Seat 8: kiling1 folded before Flop (didn't bet)
Seat 9: baligo666 folded before Flop (didn't bet)



PokerStars Hand #225160041926:  Hold'em No Limit ($0.01/$0.02 USD) - 2021/03/24 23:04:04 PT [2021/03/25 2:04:04 ET]
Table 'Belopolskya VI' 9-max Seat #3 is the button
Seat 1: Seregaa1998 ($2.06 in chips) 
Seat 2: bojnice21 ($1.92 in chips) 
Seat 3: showder10 ($2.76 in chips) 
Seat 4: dmcrbr ($2 in chips) 
Seat 5: hgpperez ($1.58 in chips) 
Seat 6: KiDraybeon ($2.60 in chips) 
Seat 7: Dorex2007 ($2.14 in chips) 
Seat 8: kiling1 ($1.53 in chips) 
Seat 9: baligo666 ($1.97 in chips) 
dmcrbr: posts small blind $0.01
hgpperez: posts big blind $0.02
*** HOLE CARDS ***
Dealt to Dorex2007 [3c 6d]
KiDraybeon: raises $0.03 to $0.05
Dorex2007: folds 
kiling1: folds 
baligo666: folds 
Seregaa1998: folds 
bojnice21: folds 
showder10: folds 
dmcrbr: folds 
hgpperez: folds 
Uncalled bet ($0.03) returned to KiDraybeon
KiDraybeon collected $0.05 from pot
KiDraybeon: doesn't show hand 
*** SUMMARY ***
Total pot $0.05 | Rake $0 
Seat 1: Seregaa1998 folded before Flop (didn't bet)
Seat 2: bojnice21 folded before Flop (didn't bet)
Seat 3: showder10 (button) folded before Flop (didn't bet)
Seat 4: dmcrbr (small blind) folded before Flop
Seat 5: hgpperez (big blind) folded before Flop
Seat 6: KiDraybeon collected ($0.05)
Seat 7: Dorex2007 folded before Flop (didn't bet)
Seat 8: kiling1 folded before Flop (didn't bet)
Seat 9: baligo666 folded before Flop (didn't bet)



PokerStars Hand #225160045040:  Hold'em No Limit ($0.01/$0.02 USD) - 2021/03/24 23:04:25 PT [2021/03/25 2:04:25 ET]
Table 'Belopolskya VI' 9-max Seat #4 is the button
Seat 1: Seregaa1998 ($2.06 in chips) 
Seat 2: bojnice21 ($1.92 in chips) 
Seat 3: showder10 ($2.76 in chips) 
Seat 4: dmcrbr ($2 in chips) 
Seat 5: hgpperez ($1.56 in chips) 
Seat 6: KiDraybeon ($2.63 in chips) 
Seat 7: Dorex2007 ($2.14 in chips) 
Seat 8: kiling1 ($1.53 in chips) 
Seat 9: baligo666 ($1.97 in chips) 
hgpperez: posts small blind $0.01
KiDraybeon: posts big blind $0.02
*** HOLE CARDS ***
Dealt to Dorex2007 [Ah As]
Dorex2007: raises $0.04 to $0.06
kiling1: folds 
baligo666: folds 
Seregaa1998: folds 
bojnice21: folds 
showder10: calls $0.06
dmcrbr: folds 
hgpperez: folds 
KiDraybeon: folds 
*** FLOP *** [5s Kh 9d]
Dorex2007: bets $0.14
showder10: folds 
Uncalled bet ($0.14) returned to Dorex2007
Dorex2007 collected $0.14 from pot
Dorex2007: doesn't show hand 
*** SUMMARY ***
Total pot $0.15 | Rake $0.01 
Board [5s Kh 9d]
Seat 1: Seregaa1998 folded before Flop (didn't bet)
Seat 2: bojnice21 folded before Flop (didn't bet)
Seat 3: showder10 folded on the Flop
Seat 4: dmcrbr (button) folded before Flop (didn't bet)
Seat 5: hgpperez (small blind) folded before Flop
Seat 6: KiDraybeon (big blind) folded before Flop
Seat 7: Dorex2007 collected ($0.14)
Seat 8: kiling1 folded before Flop (didn't bet)
Seat 9: baligo666 folded before Flop (didn't bet)



PokerStars Hand #225160051779:  Hold'em No Limit ($0.01/$0.02 USD) - 2021/03/24 23:05:10 PT [2021/03/25 2:05:10 ET]
Table 'Belopolskya VI' 9-max Seat #5 is the button
Seat 1: Seregaa1998 ($2.06 in chips) 
Seat 2: bojnice21 ($1.92 in chips) 
Seat 3: showder10 ($2.70 in chips) 
Seat 4: dmcrbr ($2 in chips) 
Seat 5: hgpperez ($1.55 in chips) 
Seat 6: KiDraybeon ($2.61 in chips) 
Seat 7: Dorex2007 ($2.22 in chips) 
Seat 8: kiling1 ($1.53 in chips) 
Seat 9: baligo666 ($1.97 in chips) 
KiDraybeon: posts small blind $0.01
Dorex2007: posts big blind $0.02
*** HOLE CARDS ***
Dealt to Dorex2007 [4c 8s]
kiling1: folds 
baligo666: folds 
Seregaa1998: folds 
bojnice21: folds 
showder10: folds 
dmcrbr: folds 
hgpperez: folds 
KiDraybeon: raises $0.05 to $0.07
Dorex2007: folds 
Uncalled bet ($0.05) returned to KiDraybeon
KiDraybeon collected $0.04 from pot
KiDraybeon: doesn't show hand 
*** SUMMARY ***
Total pot $0.04 | Rake $0 
Seat 1: Seregaa1998 folded before Flop (didn't bet)
Seat 2: bojnice21 folded before Flop (didn't bet)
Seat 3: showder10 folded before Flop (didn't bet)
Seat 4: dmcrbr folded before Flop (didn't bet)
Seat 5: hgpperez (button) folded before Flop (didn't bet)
Seat 6: KiDraybeon (small blind) collected ($0.04)
Seat 7: Dorex2007 (big blind) folded before Flop
Seat 8: kiling1 folded before Flop (didn't bet)
Seat 9: baligo666 folded before Flop (didn't bet)



PokerStars Hand #225160055590:  Hold'em No Limit ($0.01/$0.02 USD) - 2021/03/24 23:05:36 PT [2021/03/25 2:05:36 ET]
Table 'Belopolskya VI' 9-max Seat #6 is the button
Seat 1: Seregaa1998 ($2.06 in chips) 
Seat 2: bojnice21 ($1.92 in chips) 
Seat 3: showder10 ($2.70 in chips) 
Seat 4: dmcrbr ($2 in chips) 
Seat 5: hgpperez ($1.55 in chips) 
Seat 6: KiDraybeon ($2.63 in chips) 
Seat 7: Dorex2007 ($2.20 in chips) 
Seat 8: kiling1 ($1.53 in chips) 
Seat 9: baligo666 ($1.97 in chips) 
Dorex2007: posts small blind $0.01
kiling1: posts big blind $0.02
*** HOLE CARDS ***
Dealt to Dorex2007 [7h 4c]
baligo666: folds 
Seregaa1998: folds 
bojnice21: folds 
showder10: calls $0.02
dmcrbr: folds 
hgpperez: calls $0.02
KiDraybeon: folds 
Dorex2007: folds 
kiling1: checks 
*** FLOP *** [Ac Qs Qc]
kiling1: checks 
showder10: bets $0.02
hgpperez: raises $0.06 to $0.08
kiling1: folds 
showder10: calls $0.06
*** TURN *** [Ac Qs Qc] [Qd]
showder10: checks 
hgpperez: bets $0.10
showder10: calls $0.10
*** RIVER *** [Ac Qs Qc Qd] [Tc]
showder10: checks 
hgpperez: bets $0.20
showder10: calls $0.20
*** SHOW DOWN ***
hgpperez: shows [Th Qh] (four of a kind, Queens)
showder10: mucks hand 
hgpperez collected $0.80 from pot
*** SUMMARY ***
Total pot $0.83 | Rake $0.03 
Board [Ac Qs Qc Qd Tc]
Seat 1: Seregaa1998 folded before Flop (didn't bet)
Seat 2: bojnice21 folded before Flop (didn't bet)
Seat 3: showder10 mucked [Ad 3d]
Seat 4: dmcrbr folded before Flop (didn't bet)
Seat 5: hgpperez showed [Th Qh] and won ($0.80) with four of a kind, Queens
Seat 6: KiDraybeon (button) folded before Flop (didn't bet)
Seat 7: Dorex2007 (small blind) folded before Flop
Seat 8: kiling1 (big blind) folded on the Flop
Seat 9: baligo666 folded before Flop (didn't bet)



PokerStars Hand #225160066716:  Hold'em No Limit ($0.01/$0.02 USD) - 2021/03/24 23:06:50 PT [2021/03/25 2:06:50 ET]
Table 'Belopolskya VI' 9-max Seat #7 is the button
Seat 1: Seregaa1998 ($2.06 in chips) 
Seat 2: bojnice21 ($1.92 in chips) 
Seat 3: showder10 ($2.30 in chips) 
Seat 4: dmcrbr ($2 in chips) 
Seat 5: hgpperez ($1.95 in chips) 
Seat 6: KiDraybeon ($2.63 in chips) 
Seat 7: Dorex2007 ($2.19 in chips) 
Seat 8: kiling1 ($1.51 in chips) 
Seat 9: baligo666 ($1.97 in chips) 
kiling1: posts small blind $0.01
baligo666: posts big blind $0.02
*** HOLE CARDS ***
Dealt to Dorex2007 [Qd 8s]
Seregaa1998: raises $0.04 to $0.06
bojnice21: folds 
showder10: folds 
dmcrbr: folds 
hgpperez: folds 
KiDraybeon: folds 
Dorex2007: folds 
kiling1: calls $0.05
baligo666: folds 
*** FLOP *** [Tc 3c 4d]
kiling1: checks 
Seregaa1998: checks 
*** TURN *** [Tc 3c 4d] [6c]
kiling1: checks 
Seregaa1998: bets $0.09
kiling1: calls $0.09
*** RIVER *** [Tc 3c 4d 6c] [As]
kiling1: checks 
Seregaa1998: bets $0.21
kiling1: folds 
Uncalled bet ($0.21) returned to Seregaa1998
Seregaa1998 collected $0.31 from pot
Seregaa1998: doesn't show hand 
*** SUMMARY ***
Total pot $0.32 | Rake $0.01 
Board [Tc 3c 4d 6c As]
Seat 1: Seregaa1998 collected ($0.31)
Seat 2: bojnice21 folded before Flop (didn't bet)
Seat 3: showder10 folded before Flop (didn't bet)
Seat 4: dmcrbr folded before Flop (didn't bet)
Seat 5: hgpperez folded before Flop (didn't bet)
Seat 6: KiDraybeon folded before Flop (didn't bet)
Seat 7: Dorex2007 (button) folded before Flop (didn't bet)
Seat 8: kiling1 (small blind) folded on the River
Seat 9: baligo666 (big blind) folded before Flop



PokerStars Hand #225160080824:  Hold'em No Limit ($0.01/$0.02 USD) - 2021/03/24 23:08:23 PT [2021/03/25 2:08:23 ET]
Table 'Belopolskya VI' 9-max Seat #8 is the button
Seat 1: Seregaa1998 ($2.22 in chips) 
Seat 2: bojnice21 ($1.92 in chips) 
Seat 3: showder10 ($2.30 in chips) 
Seat 4: dmcrbr ($2 in chips) 
Seat 5: hgpperez ($1.95 in chips) 
Seat 6: KiDraybeon ($2.63 in chips) 
Seat 7: Dorex2007 ($2.19 in chips) 
Seat 8: kiling1 ($1.36 in chips) 
Seat 9: baligo666 ($1.95 in chips) 
baligo666: posts small blind $0.01
Seregaa1998: posts big blind $0.02
*** HOLE CARDS ***
Dealt to Dorex2007 [Td 8c]
bojnice21: folds 
showder10: raises $0.04 to $0.06
dmcrbr: folds 
hgpperez: folds 
KiDraybeon: raises $0.13 to $0.19
Dorex2007: folds 
kiling1: folds 
baligo666: folds 
Seregaa1998: folds 
showder10: folds 
Uncalled bet ($0.13) returned to KiDraybeon
KiDraybeon collected $0.15 from pot
KiDraybeon: doesn't show hand 
*** SUMMARY ***
Total pot $0.15 | Rake $0 
Seat 1: Seregaa1998 (big blind) folded before Flop
Seat 2: bojnice21 folded before Flop (didn't bet)
Seat 3: showder10 folded before Flop
Seat 4: dmcrbr folded before Flop (didn't bet)
Seat 5: hgpperez folded before Flop (didn't bet)
Seat 6: KiDraybeon collected ($0.15)
Seat 7: Dorex2007 folded before Flop (didn't bet)
Seat 8: kiling1 (button) folded before Flop (didn't bet)
Seat 9: baligo666 (small blind) folded before Flop



PokerStars Hand #225160085250:  Hold'em No Limit ($0.01/$0.02 USD) - 2021/03/24 23:08:53 PT [2021/03/25 2:08:53 ET]
Table 'Belopolskya VI' 9-max Seat #9 is the button
Seat 1: Seregaa1998 ($2.20 in chips) 
Seat 2: bojnice21 ($1.92 in chips) 
Seat 3: showder10 ($2.24 in chips) 
Seat 4: dmcrbr ($2 in chips) 
Seat 5: hgpperez ($1.95 in chips) 
Seat 6: KiDraybeon ($2.72 in chips) 
Seat 7: Dorex2007 ($2.19 in chips) 
Seat 8: kiling1 ($1.36 in chips) 
Seat 9: baligo666 ($1.94 in chips) 
Seregaa1998: posts small blind $0.01
bojnice21: posts big blind $0.02
*** HOLE CARDS ***
Dealt to Dorex2007 [9s 4d]
showder10: folds 
dmcrbr: folds 
hgpperez: folds 
KiDraybeon: folds 
Dorex2007: folds 
kiling1: folds 
baligo666: folds 
Seregaa1998: raises $0.04 to $0.06
bojnice21: folds 
Uncalled bet ($0.04) returned to Seregaa1998
Seregaa1998 collected $0.04 from pot
Seregaa1998: doesn't show hand 
*** SUMMARY ***
Total pot $0.04 | Rake $0 
Seat 1: Seregaa1998 (small blind) collected ($0.04)
Seat 2: bojnice21 (big blind) folded before Flop
Seat 3: showder10 folded before Flop (didn't bet)
Seat 4: dmcrbr folded before Flop (didn't bet)
Seat 5: hgpperez folded before Flop (didn't bet)
Seat 6: KiDraybeon folded before Flop (didn't bet)
Seat 7: Dorex2007 folded before Flop (didn't bet)
Seat 8: kiling1 folded before Flop (didn't bet)
Seat 9: baligo666 (button) folded before Flop (didn't bet)



PokerStars Hand #225160088501:  Hold'em No Limit ($0.01/$0.02 USD) - 2021/03/24 23:09:14 PT [2021/03/25 2:09:14 ET]
Table 'Belopolskya VI' 9-max Seat #1 is the button
Seat 1: Seregaa1998 ($2.22 in chips) 
Seat 2: bojnice21 ($1.90 in chips) 
Seat 3: showder10 ($2.24 in chips) 
Seat 4: dmcrbr ($2 in chips) 
Seat 5: hgpperez ($1.95 in chips) 
Seat 6: KiDraybeon ($2.72 in chips) 
Seat 7: Dorex2007 ($2.19 in chips) 
Seat 8: kiling1 ($1.36 in chips) 
Seat 9: baligo666 ($1.94 in chips) 
bojnice21: posts small blind $0.01
showder10: posts big blind $0.02
*** HOLE CARDS ***
Dealt to Dorex2007 [Kh 4c]
dmcrbr: folds 
hgpperez: folds 
KiDraybeon: folds 
Dorex2007: folds 
kiling1: folds 
baligo666: folds 
Seregaa1998: folds 
bojnice21: folds 
Uncalled bet ($0.01) returned to showder10
showder10 collected $0.02 from pot
*** SUMMARY ***
Total pot $0.02 | Rake $0 
Seat 1: Seregaa1998 (button) folded before Flop (didn't bet)
Seat 2: bojnice21 (small blind) folded before Flop
Seat 3: showder10 (big blind) collected ($0.02)
Seat 4: dmcrbr folded before Flop (didn't bet)
Seat 5: hgpperez folded before Flop (didn't bet)
Seat 6: KiDraybeon folded before Flop (didn't bet)
Seat 7: Dorex2007 folded before Flop (didn't bet)
Seat 8: kiling1 folded before Flop (didn't bet)
Seat 9: baligo666 folded before Flop (didn't bet)



PokerStars Hand #225160091823:  Hold'em No Limit ($0.01/$0.02 USD) - 2021/03/24 23:09:36 PT [2021/03/25 2:09:36 ET]
Table 'Belopolskya VI' 9-max Seat #2 is the button
Seat 1: Seregaa1998 ($2.22 in chips) 
Seat 2: bojnice21 ($1.89 in chips) 
Seat 3: showder10 ($2.25 in chips) 
Seat 4: dmcrbr ($2 in chips) 
Seat 5: hgpperez ($1.95 in chips) 
Seat 6: KiDraybeon ($2.72 in chips) 
Seat 7: Dorex2007 ($2.19 in chips) 
Seat 8: kiling1 ($1.36 in chips) 
Seat 9: baligo666 ($1.94 in chips) 
showder10: posts small blind $0.01
dmcrbr: posts big blind $0.02
*** HOLE CARDS ***
Dealt to Dorex2007 [9c 7s]
hgpperez: raises $0.02 to $0.04
KiDraybeon: folds 
Dorex2007: folds 
kiling1: folds 
baligo666: folds 
Seregaa1998: folds 
bojnice21: folds 
showder10: folds 
dmcrbr: folds 
Uncalled bet ($0.02) returned to hgpperez
hgpperez collected $0.05 from pot
hgpperez: doesn't show hand 
*** SUMMARY ***
Total pot $0.05 | Rake $0 
Seat 1: Seregaa1998 folded before Flop (didn't bet)
Seat 2: bojnice21 (button) folded before Flop (didn't bet)
Seat 3: showder10 (small blind) folded before Flop
Seat 4: dmcrbr (big blind) folded before Flop
Seat 5: hgpperez collected ($0.05)
Seat 6: KiDraybeon folded before Flop (didn't bet)
Seat 7: Dorex2007 folded before Flop (didn't bet)
Seat 8: kiling1 folded before Flop (didn't bet)
Seat 9: baligo666 folded before Flop (didn't bet)



PokerStars Hand #225160096814:  Hold'em No Limit ($0.01/$0.02 USD) - 2021/03/24 23:10:09 PT [2021/03/25 2:10:09 ET]
Table 'Belopolskya VI' 9-max Seat #3 is the button
Seat 1: Seregaa1998 ($2.22 in chips) 
Seat 2: bojnice21 ($1.89 in chips) 
Seat 3: showder10 ($2.24 in chips) 
Seat 4: dmcrbr ($2 in chips) 
Seat 5: hgpperez ($1.98 in chips) 
Seat 6: KiDraybeon ($2.72 in chips) 
Seat 7: Dorex2007 ($2.19 in chips) 
Seat 8: kiling1 ($1.36 in chips) 
Seat 9: baligo666 ($1.94 in chips) 
dmcrbr: posts small blind $0.01
hgpperez: posts big blind $0.02
*** HOLE CARDS ***
Dealt to Dorex2007 [8h Qc]
KiDraybeon: folds 
Dorex2007: folds 
kiling1: folds 
baligo666: folds 
Seregaa1998: folds 
bojnice21: folds 
showder10: calls $0.02
dmcrbr: folds 
hgpperez: checks 
*** FLOP *** [3c As Kd]
hgpperez: checks 
showder10: bets $0.04
hgpperez: calls $0.04
*** TURN *** [3c As Kd] [5d]
hgpperez: checks 
showder10: bets $0.07
hgpperez: calls $0.07
*** RIVER *** [3c As Kd 5d] [9s]
hgpperez: checks 
showder10: bets $0.12
hgpperez: calls $0.12
*** SHOW DOWN ***
showder10: shows [Qs Tc] (high card Ace)
hgpperez: shows [7c Ad] (a pair of Aces)
hgpperez collected $0.49 from pot
*** SUMMARY ***
Total pot $0.51 | Rake $0.02 
Board [3c As Kd 5d 9s]
Seat 1: Seregaa1998 folded before Flop (didn't bet)
Seat 2: bojnice21 folded before Flop (didn't bet)
Seat 3: showder10 (button) showed [Qs Tc] and lost with high card Ace
Seat 4: dmcrbr (small blind) folded before Flop
Seat 5: hgpperez (big blind) showed [7c Ad] and won ($0.49) with a pair of Aces
Seat 6: KiDraybeon folded before Flop (didn't bet)
Seat 7: Dorex2007 folded before Flop (didn't bet)
Seat 8: kiling1 folded before Flop (didn't bet)
Seat 9: baligo666 folded before Flop (didn't bet)



PokerStars Hand #225160107997:  Hold'em No Limit ($0.01/$0.02 USD) - 2021/03/24 23:11:23 PT [2021/03/25 2:11:23 ET]
Table 'Belopolskya VI' 9-max Seat #4 is the button
Seat 1: Seregaa1998 ($2.22 in chips) 
Seat 2: bojnice21 ($1.89 in chips) 
Seat 3: showder10 ($1.99 in chips) 
Seat 4: dmcrbr ($2 in chips) 
Seat 5: hgpperez ($2.22 in chips) 
Seat 6: KiDraybeon ($2.72 in chips) 
Seat 7: Dorex2007 ($2.19 in chips) 
Seat 8: kiling1 ($1.36 in chips) 
Seat 9: baligo666 ($1.94 in chips) 
hgpperez: posts small blind $0.01
KiDraybeon: posts big blind $0.02
*** HOLE CARDS ***
Dealt to Dorex2007 [7h Ts]
Dorex2007: folds 
kiling1: folds 
baligo666: folds 
Seregaa1998: folds 
bojnice21: folds 
showder10: folds 
dmcrbr: folds 
hgpperez: calls $0.01
KiDraybeon: checks 
*** FLOP *** [Qh 8c Qc]
hgpperez: checks 
KiDraybeon: bets $0.03
hgpperez: calls $0.03
*** TURN *** [Qh 8c Qc] [Kc]
hgpperez: checks 
KiDraybeon: checks 
*** RIVER *** [Qh 8c Qc Kc] [3c]
hgpperez: bets $0.02
KiDraybeon: folds 
Uncalled bet ($0.02) returned to hgpperez
hgpperez collected $0.10 from pot
hgpperez: doesn't show hand 
*** SUMMARY ***
Total pot $0.10 | Rake $0 
Board [Qh 8c Qc Kc 3c]
Seat 1: Seregaa1998 folded before Flop (didn't bet)
Seat 2: bojnice21 folded before Flop (didn't bet)
Seat 3: showder10 folded before Flop (didn't bet)
Seat 4: dmcrbr (button) folded before Flop (didn't bet)
Seat 5: hgpperez (small blind) collected ($0.10)
Seat 6: KiDraybeon (big blind) folded on the River
Seat 7: Dorex2007 folded before Flop (didn't bet)
Seat 8: kiling1 folded before Flop (didn't bet)
Seat 9: baligo666 folded before Flop (didn't bet)



PokerStars Hand #225160113419:  Hold'em No Limit ($0.01/$0.02 USD) - 2021/03/24 23:11:59 PT [2021/03/25 2:11:59 ET]
Table 'Belopolskya VI' 9-max Seat #5 is the button
Seat 1: Seregaa1998 ($2.22 in chips) 
Seat 2: bojnice21 ($1.89 in chips) 
Seat 3: showder10 ($1.99 in chips) 
Seat 4: dmcrbr ($2 in chips) 
Seat 5: hgpperez ($2.27 in chips) 
Seat 6: KiDraybeon ($2.67 in chips) 
Seat 7: Dorex2007 ($2.19 in chips) 
Seat 8: kiling1 ($1.36 in chips) 
Seat 9: baligo666 ($1.94 in chips) 
KiDraybeon: posts small blind $0.01
Dorex2007: posts big blind $0.02
*** HOLE CARDS ***
Dealt to Dorex2007 [4d 7c]
kiling1: folds 
baligo666: raises $0.03 to $0.05
Seregaa1998: folds 
bojnice21: folds 
showder10: folds 
dmcrbr: folds 
hgpperez: raises $0.03 to $0.08
KiDraybeon: calls $0.07
Dorex2007: folds 
baligo666: raises $0.03 to $0.11
hgpperez: calls $0.03
showder10 leaves the table
KiDraybeon: calls $0.03
*** FLOP *** [Th Kh 9d]
KiDraybeon: checks 
baligo666: bets $0.34
hgpperez: calls $0.34
KiDraybeon: raises $2.22 to $2.56 and is all-in
Jimpenter joins the table at seat #3 
baligo666: calls $1.49 and is all-in
hgpperez: calls $1.82 and is all-in
Uncalled bet ($0.40) returned to KiDraybeon
*** TURN *** [Th Kh 9d] [2c]
*** RIVER *** [Th Kh 9d 2c] [Ts]
*** SHOW DOWN ***
KiDraybeon: shows [6h Ah] (a pair of Tens)
hgpperez: shows [Kd Ac] (two pair, Kings and Tens)
baligo666: shows [Kc Jd] (two pair, Kings and Tens - lower kicker)
hgpperez cashed out the hand for $2.83 | Cash Out Fee $0.03
*** SUMMARY ***
Total pot $6.50 Main pot $5.64. Side pot $0.63. | Rake $0.23 
Board [Th Kh 9d 2c Ts]
Seat 1: Seregaa1998 folded before Flop (didn't bet)
Seat 2: bojnice21 folded before Flop (didn't bet)
Seat 3: showder10 folded before Flop (didn't bet)
Seat 4: dmcrbr folded before Flop (didn't bet)
Seat 5: hgpperez (button) showed [Kd Ac] and won ($6.27) with two pair, Kings and Tens (pot not awarded as player cashed out)
Seat 6: KiDraybeon (small blind) showed [6h Ah] and lost with a pair of Tens
Seat 7: Dorex2007 (big blind) folded before Flop
Seat 8: kiling1 folded before Flop (didn't bet)
Seat 9: baligo666 showed [Kc Jd] and lost with two pair, Kings and Tens



PokerStars Hand #225160123528:  Hold'em No Limit ($0.01/$0.02 USD) - 2021/03/24 23:13:06 PT [2021/03/25 2:13:06 ET]
Table 'Belopolskya VI' 9-max Seat #6 is the button
Seat 1: Seregaa1998 ($2.22 in chips) 
Seat 2: bojnice21 ($1.89 in chips) 
Seat 4: dmcrbr ($2 in chips) 
Seat 5: hgpperez ($2.83 in chips) 
Seat 6: KiDraybeon ($2 in chips) 
Seat 7: Dorex2007 ($2.17 in chips) 
Seat 8: kiling1 ($1.36 in chips) 
Dorex2007: posts small blind $0.01
kiling1: posts big blind $0.02
Jimpenter: sits out 
*** HOLE CARDS ***
Dealt to Dorex2007 [Qd Kd]
Seregaa1998: folds 
bojnice21: calls $0.02
baligo666 leaves the table
dmcrbr: folds 
BrykmiD joins the table at seat #9 
hgpperez: folds 
KiDraybeon: folds 
Dorex2007: raises $0.06 to $0.08
kiling1: folds 
bojnice21: calls $0.06
*** FLOP *** [Ah Th 6c]
Dorex2007: bets $0.09
Jimpenter leaves the table
bojnice21: calls $0.09
*** TURN *** [Ah Th 6c] [Ks]
Dorex2007: checks 
bojnice21: checks 
*** RIVER *** [Ah Th 6c Ks] [8s]
Dorex2007: bets $0.18
bojnice21: folds 
Uncalled bet ($0.18) returned to Dorex2007
Dorex2007 collected $0.35 from pot
Dorex2007: doesn't show hand 
*** SUMMARY ***
Total pot $0.36 | Rake $0.01 
Board [Ah Th 6c Ks 8s]
Seat 1: Seregaa1998 folded before Flop (didn't bet)
Seat 2: bojnice21 folded on the River
Seat 4: dmcrbr folded before Flop (didn't bet)
Seat 5: hgpperez folded before Flop (didn't bet)
Seat 6: KiDraybeon (button) folded before Flop (didn't bet)
Seat 7: Dorex2007 (small blind) collected ($0.35)
Seat 8: kiling1 (big blind) folded before Flop



PokerStars Hand #225160133042:  Hold'em No Limit ($0.01/$0.02 USD) - 2021/03/24 23:14:09 PT [2021/03/25 2:14:09 ET]
Table 'Belopolskya VI' 9-max Seat #7 is the button
Seat 1: Seregaa1998 ($2.22 in chips) 
Seat 2: bojnice21 ($1.72 in chips) 
Seat 5: hgpperez ($2.83 in chips) 
Seat 6: KiDraybeon ($2 in chips) 
Seat 7: Dorex2007 ($2.35 in chips) 
Seat 8: kiling1 ($1.34 in chips) 
Seat 9: BrykmiD ($2 in chips) 
kiling1: posts small blind $0.01
BrykmiD: posts big blind $0.02
*** HOLE CARDS ***
Dealt to Dorex2007 [5s Ks]
Seregaa1998: raises $0.04 to $0.06
bojnice21: folds 
hgpperez: calls $0.06
Mr_Zh.Evgeniy joins the table at seat #3 
KiDraybeon: folds 
Dorex2007: folds 
kiling1: calls $0.05
BrykmiD: folds 
*** FLOP *** [Ah 7h 3h]
kiling1: checks 
Seregaa1998: checks 
hgpperez: checks 
*** TURN *** [Ah 7h 3h] [9s]
kiling1: checks 
Seregaa1998: checks 
dmcrbr leaves the table
hgpperez: checks 
*** RIVER *** [Ah 7h 3h 9s] [Jc]
kiling1: checks 
Seregaa1998: checks 
hgpperez: checks 
*** SHOW DOWN ***
kiling1: shows [Js Td] (a pair of Jacks)
Seregaa1998: mucks hand 
hgpperez: mucks hand 
kiling1 collected $0.19 from pot
*** SUMMARY ***
Total pot $0.20 | Rake $0.01 
Board [Ah 7h 3h 9s Jc]
Seat 1: Seregaa1998 mucked [5d 5h]
Seat 2: bojnice21 folded before Flop (didn't bet)
Seat 5: hgpperez mucked [4d 4h]
Seat 6: KiDraybeon folded before Flop (didn't bet)
Seat 7: Dorex2007 (button) folded before Flop (didn't bet)
Seat 8: kiling1 (small blind) showed [Js Td] and won ($0.19) with a pair of Jacks
Seat 9: BrykmiD (big blind) folded before Flop



PokerStars Hand #225160151347:  Hold'em No Limit ($0.01/$0.02 USD) - 2021/03/24 23:15:22 PT [2021/03/25 2:15:22 ET]
Table 'Belopolskya VI' 9-max Seat #8 is the button
Seat 1: Seregaa1998 ($2.16 in chips) 
Seat 2: bojnice21 ($2 in chips) 
Seat 5: hgpperez ($2.77 in chips) 
Seat 6: KiDraybeon ($2 in chips) 
Seat 7: Dorex2007 ($2.35 in chips) 
Seat 8: kiling1 ($1.47 in chips) 
Seat 9: BrykmiD ($1.98 in chips) 
BrykmiD: posts small blind $0.01
Seregaa1998: posts big blind $0.02
Mr_Zh.Evgeniy: sits out 
*** HOLE CARDS ***
Dealt to Dorex2007 [5s 2h]
bojnice21: folds 
hgpperez: folds 
NortheastIron joins the table at seat #4 
KiDraybeon: raises $0.03 to $0.05
Dorex2007: folds 
kiling1: folds 
BrykmiD: folds 
Seregaa1998: folds 
Uncalled bet ($0.03) returned to KiDraybeon
KiDraybeon collected $0.05 from pot
KiDraybeon: doesn't show hand 
*** SUMMARY ***
Total pot $0.05 | Rake $0 
Seat 1: Seregaa1998 (big blind) folded before Flop
Seat 2: bojnice21 folded before Flop (didn't bet)
Seat 5: hgpperez folded before Flop (didn't bet)
Seat 6: KiDraybeon collected ($0.05)
Seat 7: Dorex2007 folded before Flop (didn't bet)
Seat 8: kiling1 (button) folded before Flop (didn't bet)
Seat 9: BrykmiD (small blind) folded before Flop



PokerStars Hand #225160155839:  Hold'em No Limit ($0.01/$0.02 USD) - 2021/03/24 23:15:53 PT [2021/03/25 2:15:53 ET]
Table 'Belopolskya VI' 9-max Seat #9 is the button
Seat 1: Seregaa1998 ($2.14 in chips) 
Seat 2: bojnice21 ($2 in chips) 
Seat 4: NortheastIron ($0.80 in chips) 
Seat 5: hgpperez ($2.77 in chips) 
Seat 6: KiDraybeon ($2.03 in chips) 
Seat 7: Dorex2007 ($2.35 in chips) 
Seat 8: kiling1 ($1.47 in chips) 
Seat 9: BrykmiD ($1.97 in chips) 
Seregaa1998: posts small blind $0.01
bojnice21: posts big blind $0.02
Mr_Zh.Evgeniy: sits out 
NortheastIron: posts big blind $0.02
*** HOLE CARDS ***
Dealt to Dorex2007 [Ah Kc]
NortheastIron: checks 
hgpperez: folds 
KiDraybeon: folds 
Dorex2007: raises $0.04 to $0.06
kiling1: raises $0.17 to $0.23
BrykmiD: folds 
Seregaa1998: folds 
bojnice21: folds 
NortheastIron: folds 
Dorex2007: raises $0.17 to $0.40
kiling1: calls $0.17
*** FLOP *** [6h As 6s]
Dorex2007: bets $0.82
kiling1: folds 
Uncalled bet ($0.82) returned to Dorex2007
Dorex2007 collected $0.82 from pot
Dorex2007: doesn't show hand 
*** SUMMARY ***
Total pot $0.85 | Rake $0.03 
Board [6h As 6s]
Seat 1: Seregaa1998 (small blind) folded before Flop
Seat 2: bojnice21 (big blind) folded before Flop
Seat 4: NortheastIron folded before Flop (didn't bet)
Seat 5: hgpperez folded before Flop (didn't bet)
Seat 6: KiDraybeon folded before Flop (didn't bet)
Seat 7: Dorex2007 collected ($0.82)
Seat 8: kiling1 folded on the Flop
Seat 9: BrykmiD (button) folded before Flop (didn't bet)



PokerStars Hand #225160167336:  Hold'em No Limit ($0.01/$0.02 USD) - 2021/03/24 23:17:10 PT [2021/03/25 2:17:10 ET]
Table 'Belopolskya VI' 9-max Seat #1 is the button
Seat 1: Seregaa1998 ($2.13 in chips) 
Seat 2: bojnice21 ($1.98 in chips) 
Seat 3: Mr_Zh.Evgeniy ($1 in chips) 
Seat 4: NortheastIron ($0.78 in chips) 
Seat 5: hgpperez ($2.77 in chips) 
Seat 6: KiDraybeon ($2.03 in chips) 
Seat 7: Dorex2007 ($2.77 in chips) 
Seat 8: kiling1 ($1.07 in chips) 
Seat 9: BrykmiD ($1.97 in chips) 
bojnice21: posts small blind $0.01
Mr_Zh.Evgeniy: posts big blind $0.02
*** HOLE CARDS ***
Dealt to Dorex2007 [Jh 9h]
NortheastIron: folds 
hgpperez: folds 
KiDraybeon: folds 
Dorex2007: raises $0.04 to $0.06
kiling1: folds 
BrykmiD: folds 
Seregaa1998: folds 
bojnice21: folds 
Mr_Zh.Evgeniy: folds 
Uncalled bet ($0.04) returned to Dorex2007
Dorex2007 collected $0.05 from pot
Dorex2007: doesn't show hand 
*** SUMMARY ***
Total pot $0.05 | Rake $0 
Seat 1: Seregaa1998 (button) folded before Flop (didn't bet)
Seat 2: bojnice21 (small blind) folded before Flop
Seat 3: Mr_Zh.Evgeniy (big blind) folded before Flop
Seat 4: NortheastIron folded before Flop (didn't bet)
Seat 5: hgpperez folded before Flop (didn't bet)
Seat 6: KiDraybeon folded before Flop (didn't bet)
Seat 7: Dorex2007 collected ($0.05)
Seat 8: kiling1 folded before Flop (didn't bet)
Seat 9: BrykmiD folded before Flop (didn't bet)



PokerStars Hand #225160173457:  Hold'em No Limit ($0.01/$0.02 USD) - 2021/03/24 23:17:51 PT [2021/03/25 2:17:51 ET]
Table 'Belopolskya VI' 9-max Seat #2 is the button
Seat 1: Seregaa1998 ($2.13 in chips) 
Seat 2: bojnice21 ($1.97 in chips) 
Seat 3: Mr_Zh.Evgeniy ($0.98 in chips) 
Seat 4: NortheastIron ($0.78 in chips) 
Seat 5: hgpperez ($2.77 in chips) 
Seat 6: KiDraybeon ($2.03 in chips) 
Seat 7: Dorex2007 ($2.80 in chips) 
Seat 8: kiling1 ($1.07 in chips) 
Seat 9: BrykmiD ($1.97 in chips) 
Mr_Zh.Evgeniy: posts small blind $0.01
NortheastIron: posts big blind $0.02
*** HOLE CARDS ***
Dealt to Dorex2007 [3c Js]
hgpperez: folds 
KiDraybeon: folds 
Dorex2007: folds 
kiling1: folds 
BrykmiD: folds 
Seregaa1998: folds 
bojnice21: folds 
Mr_Zh.Evgeniy: calls $0.01
NortheastIron: checks 
*** FLOP *** [9c Jc 9s]
Mr_Zh.Evgeniy: checks 
NortheastIron: bets $0.02
Mr_Zh.Evgeniy: folds 
Uncalled bet ($0.02) returned to NortheastIron
NortheastIron collected $0.04 from pot
NortheastIron: doesn't show hand 
*** SUMMARY ***
Total pot $0.04 | Rake $0 
Board [9c Jc 9s]
Seat 1: Seregaa1998 folded before Flop (didn't bet)
Seat 2: bojnice21 (button) folded before Flop (didn't bet)
Seat 3: Mr_Zh.Evgeniy (small blind) folded on the Flop
Seat 4: NortheastIron (big blind) collected ($0.04)
Seat 5: hgpperez folded before Flop (didn't bet)
Seat 6: KiDraybeon folded before Flop (didn't bet)
Seat 7: Dorex2007 folded before Flop (didn't bet)
Seat 8: kiling1 folded before Flop (didn't bet)
Seat 9: BrykmiD folded before Flop (didn't bet)



PokerStars Hand #225160178601:  Hold'em No Limit ($0.01/$0.02 USD) - 2021/03/24 23:18:25 PT [2021/03/25 2:18:25 ET]
Table 'Belopolskya VI' 9-max Seat #3 is the button
Seat 1: Seregaa1998 ($2.13 in chips) 
Seat 2: bojnice21 ($1.97 in chips) 
Seat 3: Mr_Zh.Evgeniy ($0.96 in chips) 
Seat 4: NortheastIron ($0.80 in chips) 
Seat 5: hgpperez ($2.77 in chips) 
Seat 6: KiDraybeon ($2.03 in chips) 
Seat 7: Dorex2007 ($2.80 in chips) 
Seat 8: kiling1 ($1.07 in chips) 
Seat 9: BrykmiD ($1.97 in chips) 
NortheastIron: posts small blind $0.01
hgpperez: posts big blind $0.02
*** HOLE CARDS ***
Dealt to Dorex2007 [5s 4d]
KiDraybeon: folds 
Dorex2007: folds 
kiling1: calls $0.02
BrykmiD: folds 
Seregaa1998: folds 
bojnice21: folds 
Mr_Zh.Evgeniy: folds 
NortheastIron: calls $0.01
hgpperez: checks 
*** FLOP *** [2h 6s 2s]
NortheastIron: checks 
hgpperez: checks 
kiling1: checks 
*** TURN *** [2h 6s 2s] [Qs]
NortheastIron: bets $0.02
hgpperez: folds 
kiling1: calls $0.02
*** RIVER *** [2h 6s 2s Qs] [3s]
NortheastIron: bets $0.04
kiling1: calls $0.04
*** SHOW DOWN ***
NortheastIron: shows [8s Th] (a flush, Queen high)
kiling1: shows [Ts Qc] (a flush, Queen high - Ten higher)
kiling1 collected $0.17 from pot
*** SUMMARY ***
Total pot $0.18 | Rake $0.01 
Board [2h 6s 2s Qs 3s]
Seat 1: Seregaa1998 folded before Flop (didn't bet)
Seat 2: bojnice21 folded before Flop (didn't bet)
Seat 3: Mr_Zh.Evgeniy (button) folded before Flop (didn't bet)
Seat 4: NortheastIron (small blind) showed [8s Th] and lost with a flush, Queen high
Seat 5: hgpperez (big blind) folded on the Turn
Seat 6: KiDraybeon folded before Flop (didn't bet)
Seat 7: Dorex2007 folded before Flop (didn't bet)
Seat 8: kiling1 showed [Ts Qc] and won ($0.17) with a flush, Queen high
Seat 9: BrykmiD folded before Flop (didn't bet)



PokerStars Hand #225160193053:  Hold'em No Limit ($0.01/$0.02 USD) - 2021/03/24 23:20:02 PT [2021/03/25 2:20:02 ET]
Table 'Belopolskya VI' 9-max Seat #4 is the button
Seat 1: Seregaa1998 ($2.13 in chips) 
Seat 2: bojnice21 ($1.97 in chips) 
Seat 3: Mr_Zh.Evgeniy ($0.96 in chips) 
Seat 4: NortheastIron ($0.72 in chips) 
Seat 5: hgpperez ($2.75 in chips) 
Seat 6: KiDraybeon ($2.03 in chips) 
Seat 7: Dorex2007 ($2.80 in chips) 
Seat 8: kiling1 ($1.16 in chips) 
Seat 9: BrykmiD ($1.97 in chips) 
hgpperez: posts small blind $0.01
KiDraybeon: posts big blind $0.02
*** HOLE CARDS ***
Dealt to Dorex2007 [2c Tc]
Dorex2007: folds 
kiling1: raises $0.05 to $0.07
BrykmiD: folds 
Seregaa1998: folds 
bojnice21: folds 
Mr_Zh.Evgeniy: folds 
NortheastIron: folds 
hgpperez: folds 
KiDraybeon: folds 
Uncalled bet ($0.05) returned to kiling1
kiling1 collected $0.05 from pot
kiling1: doesn't show hand 
*** SUMMARY ***
Total pot $0.05 | Rake $0 
Seat 1: Seregaa1998 folded before Flop (didn't bet)
Seat 2: bojnice21 folded before Flop (didn't bet)
Seat 3: Mr_Zh.Evgeniy folded before Flop (didn't bet)
Seat 4: NortheastIron (button) folded before Flop (didn't bet)
Seat 5: hgpperez (small blind) folded before Flop
Seat 6: KiDraybeon (big blind) folded before Flop
Seat 7: Dorex2007 folded before Flop (didn't bet)
Seat 8: kiling1 collected ($0.05)
Seat 9: BrykmiD folded before Flop (didn't bet)



PokerStars Hand #225160197194:  Hold'em No Limit ($0.01/$0.02 USD) - 2021/03/24 23:20:30 PT [2021/03/25 2:20:30 ET]
Table 'Belopolskya VI' 9-max Seat #5 is the button
Seat 1: Seregaa1998 ($2.13 in chips) 
Seat 2: bojnice21 ($1.97 in chips) 
Seat 3: Mr_Zh.Evgeniy ($0.96 in chips) 
Seat 4: NortheastIron ($0.72 in chips) 
Seat 5: hgpperez ($2.74 in chips) 
Seat 6: KiDraybeon ($2.01 in chips) 
Seat 7: Dorex2007 ($2.80 in chips) 
Seat 8: kiling1 ($1.19 in chips) 
Seat 9: BrykmiD ($1.97 in chips) 
KiDraybeon: posts small blind $0.01
Dorex2007: posts big blind $0.02
*** HOLE CARDS ***
Dealt to Dorex2007 [7h 5h]
kiling1: folds 
BrykmiD: folds 
Seregaa1998: folds 
bojnice21: calls $0.02
Mr_Zh.Evgeniy: folds 
NortheastIron: raises $0.04 to $0.06
hgpperez: folds 
KiDraybeon: folds 
Dorex2007: folds 
bojnice21: calls $0.04
*** FLOP *** [8c 6c Kh]
bojnice21: bets $0.07
NortheastIron: folds 
Uncalled bet ($0.07) returned to bojnice21
bojnice21 collected $0.14 from pot
bojnice21: doesn't show hand 
*** SUMMARY ***
Total pot $0.15 | Rake $0.01 
Board [8c 6c Kh]
Seat 1: Seregaa1998 folded before Flop (didn't bet)
Seat 2: bojnice21 collected ($0.14)
Seat 3: Mr_Zh.Evgeniy folded before Flop (didn't bet)
Seat 4: NortheastIron folded on the Flop
Seat 5: hgpperez (button) folded before Flop (didn't bet)
Seat 6: KiDraybeon (small blind) folded before Flop
Seat 7: Dorex2007 (big blind) folded before Flop
Seat 8: kiling1 folded before Flop (didn't bet)
Seat 9: BrykmiD folded before Flop (didn't bet)



PokerStars Hand #225160204138:  Hold'em No Limit ($0.01/$0.02 USD) - 2021/03/24 23:21:18 PT [2021/03/25 2:21:18 ET]
Table 'Belopolskya VI' 9-max Seat #6 is the button
Seat 1: Seregaa1998 ($2.13 in chips) 
Seat 2: bojnice21 ($2.05 in chips) 
Seat 3: Mr_Zh.Evgeniy ($1 in chips) 
Seat 4: NortheastIron ($0.66 in chips) 
Seat 5: hgpperez ($2.74 in chips) 
Seat 6: KiDraybeon ($2 in chips) 
Seat 7: Dorex2007 ($2.78 in chips) 
Seat 8: kiling1 ($1.19 in chips) 
Seat 9: BrykmiD ($1.97 in chips) 
Dorex2007: posts small blind $0.01
kiling1: posts big blind $0.02
*** HOLE CARDS ***
Dealt to Dorex2007 [4d 8c]
BrykmiD: folds 
Seregaa1998: folds 
bojnice21: folds 
Mr_Zh.Evgeniy: folds 
NortheastIron: raises $0.04 to $0.06
hgpperez: folds 
KiDraybeon: folds 
Dorex2007: folds 
kiling1: folds 
Uncalled bet ($0.04) returned to NortheastIron
NortheastIron collected $0.05 from pot
NortheastIron: doesn't show hand 
*** SUMMARY ***
Total pot $0.05 | Rake $0 
Seat 1: Seregaa1998 folded before Flop (didn't bet)
Seat 2: bojnice21 folded before Flop (didn't bet)
Seat 3: Mr_Zh.Evgeniy folded before Flop (didn't bet)
Seat 4: NortheastIron collected ($0.05)
Seat 5: hgpperez folded before Flop (didn't bet)
Seat 6: KiDraybeon (button) folded before Flop (didn't bet)
Seat 7: Dorex2007 (small blind) folded before Flop
Seat 8: kiling1 (big blind) folded before Flop
Seat 9: BrykmiD folded before Flop (didn't bet)



PokerStars Hand #225160206953:  Hold'em No Limit ($0.01/$0.02 USD) - 2021/03/24 23:21:38 PT [2021/03/25 2:21:38 ET]
Table 'Belopolskya VI' 9-max Seat #7 is the button
Seat 1: Seregaa1998 ($2.13 in chips) 
Seat 2: bojnice21 ($2.05 in chips) 
Seat 3: Mr_Zh.Evgeniy ($1 in chips) 
Seat 4: NortheastIron ($0.69 in chips) 
Seat 5: hgpperez ($2.74 in chips) 
Seat 6: KiDraybeon ($2 in chips) 
Seat 7: Dorex2007 ($2.77 in chips) 
Seat 8: kiling1 ($1.17 in chips) 
Seat 9: BrykmiD ($1.97 in chips) 
kiling1: posts small blind $0.01
BrykmiD: posts big blind $0.02
*** HOLE CARDS ***
Dealt to Dorex2007 [Qd As]
Seregaa1998: folds 
bojnice21: calls $0.02
Mr_Zh.Evgeniy: raises $0.02 to $0.04
NortheastIron: folds 
hgpperez: folds 
KiDraybeon: calls $0.04
Dorex2007: raises $0.12 to $0.16
kiling1: folds 
BrykmiD: folds 
bojnice21: folds 
Mr_Zh.Evgeniy: folds 
KiDraybeon: calls $0.12
*** FLOP *** [4c 2s 3s]
KiDraybeon: checks 
Dorex2007: bets $0.40
KiDraybeon: calls $0.40
*** TURN *** [4c 2s 3s] [Kd]
KiDraybeon: checks 
Dorex2007: bets $2.21 and is all-in
KiDraybeon: folds 
Uncalled bet ($2.21) returned to Dorex2007
Dorex2007 collected $1.17 from pot
Dorex2007: doesn't show hand 
*** SUMMARY ***
Total pot $1.21 | Rake $0.04 
Board [4c 2s 3s Kd]
Seat 1: Seregaa1998 folded before Flop (didn't bet)
Seat 2: bojnice21 folded before Flop
Seat 3: Mr_Zh.Evgeniy folded before Flop
Seat 4: NortheastIron folded before Flop (didn't bet)
Seat 5: hgpperez folded before Flop (didn't bet)
Seat 6: KiDraybeon folded on the Turn
Seat 7: Dorex2007 (button) collected ($1.17)
Seat 8: kiling1 (small blind) folded before Flop
Seat 9: BrykmiD (big blind) folded before Flop



PokerStars Hand #225160217379:  Hold'em No Limit ($0.01/$0.02 USD) - 2021/03/24 23:22:49 PT [2021/03/25 2:22:49 ET]
Table 'Belopolskya VI' 9-max Seat #8 is the button
Seat 1: Seregaa1998 ($2.13 in chips) 
Seat 2: bojnice21 ($2.03 in chips) 
Seat 3: Mr_Zh.Evgeniy ($0.96 in chips) 
Seat 4: NortheastIron ($0.69 in chips) 
Seat 5: hgpperez ($2.74 in chips) 
Seat 6: KiDraybeon ($2 in chips) 
Seat 7: Dorex2007 ($3.38 in chips) 
Seat 8: kiling1 ($1.16 in chips) 
Seat 9: BrykmiD ($1.95 in chips) 
BrykmiD: posts small blind $0.01
Seregaa1998: posts big blind $0.02
*** HOLE CARDS ***
Dealt to Dorex2007 [4s 9d]
bojnice21: calls $0.02
Mr_Zh.Evgeniy: folds 
NortheastIron: folds 
hgpperez: folds 
KiDraybeon: folds 
Dorex2007: folds 
kiling1: folds 
BrykmiD: raises $0.04 to $0.06
Seregaa1998: folds 
bojnice21: calls $0.04
*** FLOP *** [8s Tc Ts]
BrykmiD: bets $0.08
bojnice21: folds 
Uncalled bet ($0.08) returned to BrykmiD
BrykmiD collected $0.14 from pot
*** SUMMARY ***
Total pot $0.14 | Rake $0 
Board [8s Tc Ts]
Seat 1: Seregaa1998 (big blind) folded before Flop
Seat 2: bojnice21 folded on the Flop
Seat 3: Mr_Zh.Evgeniy folded before Flop (didn't bet)
Seat 4: NortheastIron folded before Flop (didn't bet)
Seat 5: hgpperez folded before Flop (didn't bet)
Seat 6: KiDraybeon folded before Flop (didn't bet)
Seat 7: Dorex2007 folded before Flop (didn't bet)
Seat 8: kiling1 (button) folded before Flop (didn't bet)
Seat 9: BrykmiD (small blind) collected ($0.14)



PokerStars Hand #225160230233:  Hold'em No Limit ($0.01/$0.02 USD) - 2021/03/24 23:23:30 PT [2021/03/25 2:23:30 ET]
Table 'Belopolskya VI' 9-max Seat #9 is the button
Seat 1: Seregaa1998 ($2.11 in chips) 
Seat 2: bojnice21 ($1.97 in chips) 
Seat 3: Mr_Zh.Evgeniy ($0.96 in chips) 
Seat 4: NortheastIron ($0.69 in chips) 
Seat 5: hgpperez ($2.74 in chips) 
Seat 6: KiDraybeon ($2 in chips) 
Seat 7: Dorex2007 ($3.38 in chips) 
Seat 8: kiling1 ($1.16 in chips) 
Seat 9: BrykmiD ($2.03 in chips) 
Seregaa1998: posts small blind $0.01
bojnice21: posts big blind $0.02
*** HOLE CARDS ***
Dealt to Dorex2007 [3s Td]
Mr_Zh.Evgeniy: raises $0.04 to $0.06
NortheastIron: folds 
hgpperez: raises $0.04 to $0.10
KiDraybeon: folds 
Dorex2007: folds 
kiling1: folds 
BrykmiD: folds 
Seregaa1998: folds 
bojnice21: calls $0.08
Mr_Zh.Evgeniy is disconnected 
Mr_Zh.Evgeniy is connected 
Mr_Zh.Evgeniy: calls $0.04
*** FLOP *** [7s 7c 3c]
bojnice21: checks 
Mr_Zh.Evgeniy: checks 
hgpperez: bets $0.30
bojnice21: folds 
Mr_Zh.Evgeniy: folds 
Uncalled bet ($0.30) returned to hgpperez
hgpperez collected $0.30 from pot
hgpperez: doesn't show hand 
*** SUMMARY ***
Total pot $0.31 | Rake $0.01 
Board [7s 7c 3c]
Seat 1: Seregaa1998 (small blind) folded before Flop
Seat 2: bojnice21 (big blind) folded on the Flop
Seat 3: Mr_Zh.Evgeniy folded on the Flop
Seat 4: NortheastIron folded before Flop (didn't bet)
Seat 5: hgpperez collected ($0.30)
Seat 6: KiDraybeon folded before Flop (didn't bet)
Seat 7: Dorex2007 folded before Flop (didn't bet)
Seat 8: kiling1 folded before Flop (didn't bet)
Seat 9: BrykmiD (button) folded before Flop (didn't bet)



PokerStars Hand #225160244589:  Hold'em No Limit ($0.01/$0.02 USD) - 2021/03/24 23:25:08 PT [2021/03/25 2:25:08 ET]
Table 'Belopolskya VI' 9-max Seat #1 is the button
Seat 1: Seregaa1998 ($2.10 in chips) 
Seat 2: bojnice21 ($1.87 in chips) 
Seat 3: Mr_Zh.Evgeniy ($0.86 in chips) 
Seat 4: NortheastIron ($0.69 in chips) 
Seat 5: hgpperez ($2.94 in chips) 
Seat 6: KiDraybeon ($2 in chips) 
Seat 7: Dorex2007 ($3.38 in chips) 
Seat 8: kiling1 ($1.16 in chips) 
Seat 9: BrykmiD ($2.03 in chips) 
bojnice21: posts small blind $0.01
Mr_Zh.Evgeniy: posts big blind $0.02
*** HOLE CARDS ***
Dealt to Dorex2007 [4s 9h]
NortheastIron has timed out
NortheastIron: folds 
hgpperez: folds 
KiDraybeon: folds 
Dorex2007: folds 
kiling1: folds 
BrykmiD: raises $0.06 to $0.08
Seregaa1998: folds 
bojnice21: folds 
Mr_Zh.Evgeniy: folds 
Uncalled bet ($0.06) returned to BrykmiD
BrykmiD collected $0.05 from pot
*** SUMMARY ***
Total pot $0.05 | Rake $0 
Seat 1: Seregaa1998 (button) folded before Flop (didn't bet)
Seat 2: bojnice21 (small blind) folded before Flop
Seat 3: Mr_Zh.Evgeniy (big blind) folded before Flop
Seat 4: NortheastIron folded before Flop (didn't bet)
Seat 5: hgpperez folded before Flop (didn't bet)
Seat 6: KiDraybeon folded before Flop (didn't bet)
Seat 7: Dorex2007 folded before Flop (didn't bet)
Seat 8: kiling1 folded before Flop (didn't bet)
Seat 9: BrykmiD collected ($0.05)



PokerStars Hand #225160252640:  Hold'em No Limit ($0.01/$0.02 USD) - 2021/03/24 23:26:02 PT [2021/03/25 2:26:02 ET]
Table 'Belopolskya VI' 9-max Seat #2 is the button
Seat 1: Seregaa1998 ($2.10 in chips) 
Seat 2: bojnice21 ($1.86 in chips) 
Seat 3: Mr_Zh.Evgeniy ($0.84 in chips) 
Seat 4: NortheastIron ($0.69 in chips) 
Seat 5: hgpperez ($2.94 in chips) 
Seat 6: KiDraybeon ($2 in chips) 
Seat 7: Dorex2007 ($3.38 in chips) 
Seat 8: kiling1 ($1.16 in chips) 
Seat 9: BrykmiD ($2.06 in chips) 
Mr_Zh.Evgeniy: posts small blind $0.01
NortheastIron: posts big blind $0.02
*** HOLE CARDS ***
Dealt to Dorex2007 [7s 7c]
hgpperez: raises $0.04 to $0.06
KiDraybeon: folds 
Dorex2007: folds 
kiling1: folds 
BrykmiD: folds 
Seregaa1998: folds 
bojnice21: folds 
Mr_Zh.Evgeniy: folds 
NortheastIron: folds 
Uncalled bet ($0.04) returned to hgpperez
hgpperez collected $0.05 from pot
hgpperez: doesn't show hand 
*** SUMMARY ***
Total pot $0.05 | Rake $0 
Seat 1: Seregaa1998 folded before Flop (didn't bet)
Seat 2: bojnice21 (button) folded before Flop (didn't bet)
Seat 3: Mr_Zh.Evgeniy (small blind) folded before Flop
Seat 4: NortheastIron (big blind) folded before Flop
Seat 5: hgpperez collected ($0.05)
Seat 6: KiDraybeon folded before Flop (didn't bet)
Seat 7: Dorex2007 folded before Flop (didn't bet)
Seat 8: kiling1 folded before Flop (didn't bet)
Seat 9: BrykmiD folded before Flop (didn't bet)



PokerStars Hand #225160257456:  Hold'em No Limit ($0.01/$0.02 USD) - 2021/03/24 23:26:35 PT [2021/03/25 2:26:35 ET]
Table 'Belopolskya VI' 9-max Seat #3 is the button
Seat 1: Seregaa1998 ($2.10 in chips) 
Seat 2: bojnice21 ($1.86 in chips) 
Seat 3: Mr_Zh.Evgeniy ($0.83 in chips) 
Seat 4: NortheastIron ($0.67 in chips) 
Seat 6: KiDraybeon ($2 in chips) 
Seat 7: Dorex2007 ($3.38 in chips) 
Seat 8: kiling1 ($1.16 in chips) 
Seat 9: BrykmiD ($2.06 in chips) 
NortheastIron: posts small blind $0.01
hgpperez: is sitting out 
KiDraybeon: posts big blind $0.02
*** HOLE CARDS ***
Dealt to Dorex2007 [2h 9s]
hgpperez leaves the table
Dorex2007: folds 
kiling1: folds 
BrykmiD: folds 
Seregaa1998: folds 
bojnice21: folds 
Mr_Zh.Evgeniy: folds 
NortheastIron: raises $0.02 to $0.04
KiDraybeon: calls $0.02
*** FLOP *** [5s Jh Ac]
NortheastIron: bets $0.02
KiDraybeon: folds 
Uncalled bet ($0.02) returned to NortheastIron
NortheastIron collected $0.08 from pot
NortheastIron: doesn't show hand 
*** SUMMARY ***
Total pot $0.08 | Rake $0 
Board [5s Jh Ac]
Seat 1: Seregaa1998 folded before Flop (didn't bet)
Seat 2: bojnice21 folded before Flop (didn't bet)
Seat 3: Mr_Zh.Evgeniy (button) folded before Flop (didn't bet)
Seat 4: NortheastIron (small blind) collected ($0.08)
Seat 6: KiDraybeon (big blind) folded on the Flop
Seat 7: Dorex2007 folded before Flop (didn't bet)
Seat 8: kiling1 folded before Flop (didn't bet)
Seat 9: BrykmiD folded before Flop (didn't bet)



PokerStars Hand #225160261623:  Hold'em No Limit ($0.01/$0.02 USD) - 2021/03/24 23:27:04 PT [2021/03/25 2:27:04 ET]
Table 'Belopolskya VI' 9-max Seat #4 is the button
Seat 1: Seregaa1998 ($2.10 in chips) 
Seat 2: bojnice21 ($1.86 in chips) 
Seat 3: Mr_Zh.Evgeniy ($0.83 in chips) 
Seat 4: NortheastIron ($0.71 in chips) 
Seat 6: KiDraybeon ($2 in chips) 
Seat 7: Dorex2007 ($3.38 in chips) 
Seat 8: kiling1 ($1.16 in chips) 
Seat 9: BrykmiD ($2.06 in chips) 
KiDraybeon: posts small blind $0.01
Dorex2007: posts big blind $0.02
*** HOLE CARDS ***
Dealt to Dorex2007 [3s 6d]
kiling1: folds 
BrykmiD: folds 
Seregaa1998: raises $0.04 to $0.06
bojnice21: folds 
Mr_Zh.Evgeniy: folds 
NortheastIron: folds 
KiDraybeon: folds 
Dorex2007: folds 
Uncalled bet ($0.04) returned to Seregaa1998
Seregaa1998 collected $0.05 from pot
Seregaa1998: doesn't show hand 
*** SUMMARY ***
Total pot $0.05 | Rake $0 
Seat 1: Seregaa1998 collected ($0.05)
Seat 2: bojnice21 folded before Flop (didn't bet)
Seat 3: Mr_Zh.Evgeniy folded before Flop (didn't bet)
Seat 4: NortheastIron (button) folded before Flop (didn't bet)
Seat 6: KiDraybeon (small blind) folded before Flop
Seat 7: Dorex2007 (big blind) folded before Flop
Seat 8: kiling1 folded before Flop (didn't bet)
Seat 9: BrykmiD folded before Flop (didn't bet)



PokerStars Hand #225160269438:  Hold'em No Limit ($0.01/$0.02 USD) - 2021/03/24 23:27:56 PT [2021/03/25 2:27:56 ET]
Table 'Belopolskya VI' 9-max Seat #6 is the button
Seat 1: Seregaa1998 ($2.13 in chips) 
Seat 2: bojnice21 ($1.86 in chips) 
Seat 3: Mr_Zh.Evgeniy ($0.83 in chips) 
Seat 4: NortheastIron ($0.71 in chips) 
Seat 6: KiDraybeon ($2 in chips) 
Seat 7: Dorex2007 ($3.36 in chips) 
Seat 8: kiling1 ($1.16 in chips) 
Seat 9: BrykmiD ($2.06 in chips) 
Dorex2007: posts small blind $0.01
kiling1: posts big blind $0.02
*** HOLE CARDS ***
Dealt to Dorex2007 [7h Ah]
BrykmiD: folds 
Seregaa1998: folds 
neude joins the table at seat #5 
bojnice21: folds 
Mr_Zh.Evgeniy: calls $0.02
NortheastIron: raises $0.02 to $0.04
KiDraybeon: folds 
Dorex2007: calls $0.03
kiling1: folds 
Mr_Zh.Evgeniy: calls $0.02
*** FLOP *** [Ts 7c 4c]
Dorex2007: bets $0.14
Mr_Zh.Evgeniy: folds 
NortheastIron: folds 
Uncalled bet ($0.14) returned to Dorex2007
Dorex2007 collected $0.14 from pot
Dorex2007: doesn't show hand 
*** SUMMARY ***
Total pot $0.14 | Rake $0 
Board [Ts 7c 4c]
Seat 1: Seregaa1998 folded before Flop (didn't bet)
Seat 2: bojnice21 folded before Flop (didn't bet)
Seat 3: Mr_Zh.Evgeniy folded on the Flop
Seat 4: NortheastIron folded on the Flop
Seat 6: KiDraybeon (button) folded before Flop (didn't bet)
Seat 7: Dorex2007 (small blind) collected ($0.14)
Seat 8: kiling1 (big blind) folded before Flop
Seat 9: BrykmiD folded before Flop (didn't bet)



PokerStars Hand #225160276186:  Hold'em No Limit ($0.01/$0.02 USD) - 2021/03/24 23:28:42 PT [2021/03/25 2:28:42 ET]
Table 'Belopolskya VI' 9-max Seat #7 is the button
Seat 1: Seregaa1998 ($2.13 in chips) 
Seat 2: bojnice21 ($1.86 in chips) 
Seat 3: Mr_Zh.Evgeniy ($0.79 in chips) 
Seat 4: NortheastIron ($0.67 in chips) 
Seat 5: neude ($1.60 in chips) 
Seat 6: KiDraybeon ($2 in chips) 
Seat 7: Dorex2007 ($3.46 in chips) 
Seat 8: kiling1 ($1.14 in chips) 
Seat 9: BrykmiD ($2.06 in chips) 
kiling1: posts small blind $0.01
BrykmiD: posts big blind $0.02
neude: posts big blind $0.02
*** HOLE CARDS ***
Dealt to Dorex2007 [8h 6d]
Seregaa1998: folds 
bojnice21: folds 
Mr_Zh.Evgeniy: folds 
NortheastIron has timed out
NortheastIron: folds 
neude: raises $0.02 to $0.04
KiDraybeon: folds 
Dorex2007: folds 
kiling1: folds 
BrykmiD: folds 
Uncalled bet ($0.02) returned to neude
neude collected $0.05 from pot
*** SUMMARY ***
Total pot $0.05 | Rake $0 
Seat 1: Seregaa1998 folded before Flop (didn't bet)
Seat 2: bojnice21 folded before Flop (didn't bet)
Seat 3: Mr_Zh.Evgeniy folded before Flop (didn't bet)
Seat 4: NortheastIron folded before Flop (didn't bet)
Seat 5: neude collected ($0.05)
Seat 6: KiDraybeon folded before Flop (didn't bet)
Seat 7: Dorex2007 (button) folded before Flop (didn't bet)
Seat 8: kiling1 (small blind) folded before Flop
Seat 9: BrykmiD (big blind) folded before Flop



PokerStars Hand #225160284611:  Hold'em No Limit ($0.01/$0.02 USD) - 2021/03/24 23:29:40 PT [2021/03/25 2:29:40 ET]
Table 'Belopolskya VI' 9-max Seat #8 is the button
Seat 1: Seregaa1998 ($2.13 in chips) 
Seat 2: bojnice21 ($1.86 in chips) 
Seat 3: Mr_Zh.Evgeniy ($0.79 in chips) 
Seat 4: NortheastIron ($0.67 in chips) 
Seat 5: neude ($1.63 in chips) 
Seat 6: KiDraybeon ($2 in chips) 
Seat 7: Dorex2007 ($3.46 in chips) 
Seat 8: kiling1 ($1.13 in chips) 
Seat 9: BrykmiD ($2.04 in chips) 
BrykmiD: posts small blind $0.01
Seregaa1998: posts big blind $0.02
*** HOLE CARDS ***
Dealt to Dorex2007 [5h 8s]
bojnice21: folds 
Mr_Zh.Evgeniy: folds 
NortheastIron: folds 
neude: folds 
KiDraybeon: raises $0.03 to $0.05
Dorex2007: folds 
kiling1 has timed out
kiling1: folds 
BrykmiD: folds 
Seregaa1998: folds 
Uncalled bet ($0.03) returned to KiDraybeon
KiDraybeon collected $0.05 from pot
KiDraybeon: doesn't show hand 
*** SUMMARY ***
Total pot $0.05 | Rake $0 
Seat 1: Seregaa1998 (big blind) folded before Flop
Seat 2: bojnice21 folded before Flop (didn't bet)
Seat 3: Mr_Zh.Evgeniy folded before Flop (didn't bet)
Seat 4: NortheastIron folded before Flop (didn't bet)
Seat 5: neude folded before Flop (didn't bet)
Seat 6: KiDraybeon collected ($0.05)
Seat 7: Dorex2007 folded before Flop (didn't bet)
Seat 8: kiling1 (button) folded before Flop (didn't bet)
Seat 9: BrykmiD (small blind) folded before Flop



PokerStars Hand #225160290969:  Hold'em No Limit ($0.01/$0.02 USD) - 2021/03/24 23:30:23 PT [2021/03/25 2:30:23 ET]
Table 'Belopolskya VI' 9-max Seat #9 is the button
Seat 1: Seregaa1998 ($2.11 in chips) 
Seat 2: bojnice21 ($1.86 in chips) 
Seat 3: Mr_Zh.Evgeniy ($0.79 in chips) 
Seat 4: NortheastIron ($0.67 in chips) 
Seat 5: neude ($1.63 in chips) 
Seat 6: KiDraybeon ($2.03 in chips) 
Seat 7: Dorex2007 ($3.46 in chips) 
Seat 9: BrykmiD ($2.03 in chips) 
Seregaa1998: posts small blind $0.01
bojnice21: posts big blind $0.02
*** HOLE CARDS ***
Dealt to Dorex2007 [4c 9h]
Mr_Zh.Evgeniy: folds 
NortheastIron: folds 
neude: raises $0.16 to $0.18
KiDraybeon: folds 
Dorex2007: folds 
BrykmiD: folds 
Seregaa1998: folds 
bojnice21: folds 
Uncalled bet ($0.16) returned to neude
neude collected $0.05 from pot
*** SUMMARY ***
Total pot $0.05 | Rake $0 
Seat 1: Seregaa1998 (small blind) folded before Flop
Seat 2: bojnice21 (big blind) folded before Flop
Seat 3: Mr_Zh.Evgeniy folded before Flop (didn't bet)
Seat 4: NortheastIron folded before Flop (didn't bet)
Seat 5: neude collected ($0.05)
Seat 6: KiDraybeon folded before Flop (didn't bet)
Seat 7: Dorex2007 folded before Flop (didn't bet)
Seat 9: BrykmiD (button) folded before Flop (didn't bet)



PokerStars Hand #225160294662:  Hold'em No Limit ($0.01/$0.02 USD) - 2021/03/24 23:30:48 PT [2021/03/25 2:30:48 ET]
Table 'Belopolskya VI' 9-max Seat #1 is the button
Seat 1: Seregaa1998 ($2.10 in chips) 
Seat 2: bojnice21 ($1.84 in chips) 
Seat 3: Mr_Zh.Evgeniy ($0.79 in chips) 
Seat 4: NortheastIron ($0.67 in chips) 
Seat 5: neude ($1.66 in chips) 
Seat 6: KiDraybeon ($2.03 in chips) 
Seat 7: Dorex2007 ($3.46 in chips) 
Seat 9: BrykmiD ($2.03 in chips) 
bojnice21: posts small blind $0.01
Mr_Zh.Evgeniy: posts big blind $0.02
*** HOLE CARDS ***
Dealt to Dorex2007 [Qc Qs]
NortheastIron: folds 
neude: calls $0.02
KiDraybeon: folds 
Dorex2007: raises $0.04 to $0.06
BrykmiD: folds 
Seregaa1998: folds 
bojnice21: folds 
Mr_Zh.Evgeniy: folds 
neude: calls $0.04
*** FLOP *** [Kh 6s Kd]
neude: checks 
Dorex2007: bets $0.14
neude: raises $0.42 to $0.56
Dorex2007: calls $0.42
*** TURN *** [Kh 6s Kd] [3h]
neude: bets $1.04 and is all-in
Dorex2007: calls $1.04
*** RIVER *** [Kh 6s Kd 3h] [9d]
*** SHOW DOWN ***
neude: shows [Ac Ks] (three of a kind, Kings)
Dorex2007: shows [Qc Qs] (two pair, Kings and Queens)
neude collected $3.23 from pot
*** SUMMARY ***
Total pot $3.35 | Rake $0.12 
Board [Kh 6s Kd 3h 9d]
Seat 1: Seregaa1998 (button) folded before Flop (didn't bet)
Seat 2: bojnice21 (small blind) folded before Flop
Seat 3: Mr_Zh.Evgeniy (big blind) folded before Flop
Seat 4: NortheastIron folded before Flop (didn't bet)
Seat 5: neude showed [Ac Ks] and won ($3.23) with three of a kind, Kings
Seat 6: KiDraybeon folded before Flop (didn't bet)
Seat 7: Dorex2007 showed [Qc Qs] and lost with two pair, Kings and Queens
Seat 9: BrykmiD folded before Flop (didn't bet)



PokerStars Hand #225160308784:  Hold'em No Limit ($0.01/$0.02 USD) - 2021/03/24 23:32:26 PT [2021/03/25 2:32:26 ET]
Table 'Belopolskya VI' 9-max Seat #2 is the button
Seat 1: Seregaa1998 ($2.10 in chips) 
Seat 2: bojnice21 ($1.83 in chips) 
Seat 3: Mr_Zh.Evgeniy ($0.77 in chips) 
Seat 4: NortheastIron ($0.67 in chips) 
Seat 5: neude ($3.23 in chips) 
Seat 6: KiDraybeon ($2.03 in chips) 
Seat 7: Dorex2007 ($1.80 in chips) 
Seat 9: BrykmiD ($2.03 in chips) 
Mr_Zh.Evgeniy: posts small blind $0.01
NortheastIron: posts big blind $0.02
*** HOLE CARDS ***
Dealt to Dorex2007 [4h Tc]
neude: folds 
KiDraybeon: folds 
Dorex2007: folds 
BrykmiD: folds 
Seregaa1998: folds 
bojnice21: folds 
Mr_Zh.Evgeniy: calls $0.01
neude leaves the table
NortheastIron: raises $0.02 to $0.04
Mr_Zh.Evgeniy: calls $0.02
*** FLOP *** [Js 7c 9s]
Mr_Zh.Evgeniy: checks 
NortheastIron: bets $0.04
Mr_Zh.Evgeniy: calls $0.04
*** TURN *** [Js 7c 9s] [Td]
Mr_Zh.Evgeniy: checks 
NortheastIron: checks 
*** RIVER *** [Js 7c 9s Td] [9d]
Mr_Zh.Evgeniy: bets $0.10
NortheastIron: folds 
Uncalled bet ($0.10) returned to Mr_Zh.Evgeniy
Mr_Zh.Evgeniy collected $0.15 from pot
Mr_Zh.Evgeniy: doesn't show hand 
*** SUMMARY ***
Total pot $0.16 | Rake $0.01 
Board [Js 7c 9s Td 9d]
Seat 1: Seregaa1998 folded before Flop (didn't bet)
Seat 2: bojnice21 (button) folded before Flop (didn't bet)
Seat 3: Mr_Zh.Evgeniy (small blind) collected ($0.15)
Seat 4: NortheastIron (big blind) folded on the River
Seat 5: neude folded before Flop (didn't bet)
Seat 6: KiDraybeon folded before Flop (didn't bet)
Seat 7: Dorex2007 folded before Flop (didn't bet)
Seat 9: BrykmiD folded before Flop (didn't bet)



PokerStars Hand #225160315506:  Hold'em No Limit ($0.01/$0.02 USD) - 2021/03/24 23:33:13 PT [2021/03/25 2:33:13 ET]
Table 'Belopolskya VI' 9-max Seat #3 is the button
Seat 1: Seregaa1998 ($2.10 in chips) 
Seat 2: bojnice21 ($1.83 in chips) 
Seat 3: Mr_Zh.Evgeniy ($0.84 in chips) 
Seat 4: NortheastIron ($0.59 in chips) 
Seat 6: KiDraybeon ($2.03 in chips) 
Seat 7: Dorex2007 ($1.80 in chips) 
Seat 8: kiling1 ($1.13 in chips) 
Seat 9: BrykmiD ($2.03 in chips) 
caroteen joins the table at seat #5 
NortheastIron: posts small blind $0.01
KiDraybeon: posts big blind $0.02
*** HOLE CARDS ***
Dealt to Dorex2007 [Kd Ks]
Dorex2007 has timed out
Dorex2007: folds 
kiling1: folds 
BrykmiD: folds 
Seregaa1998: folds 
bojnice21: folds 
Mr_Zh.Evgeniy: folds 
NortheastIron: raises $0.04 to $0.06
KiDraybeon: calls $0.04
*** FLOP *** [4h 7h 3h]
NortheastIron: bets $0.04
KiDraybeon: folds 
Uncalled bet ($0.04) returned to NortheastIron
NortheastIron collected $0.12 from pot
NortheastIron: doesn't show hand 
*** SUMMARY ***
Total pot $0.12 | Rake $0 
Board [4h 7h 3h]
Seat 1: Seregaa1998 folded before Flop (didn't bet)
Seat 2: bojnice21 folded before Flop (didn't bet)
Seat 3: Mr_Zh.Evgeniy (button) folded before Flop (didn't bet)
Seat 4: NortheastIron (small blind) collected ($0.12)
Seat 6: KiDraybeon (big blind) folded on the Flop
Seat 7: Dorex2007 folded before Flop (didn't bet)
Seat 8: kiling1 folded before Flop (didn't bet)
Seat 9: BrykmiD folded before Flop (didn't bet)



PokerStars Hand #225160325681:  Hold'em No Limit ($0.01/$0.02 USD) - 2021/03/24 23:34:22 PT [2021/03/25 2:34:22 ET]
Table 'Belopolskya VI' 9-max Seat #4 is the button
Seat 1: Seregaa1998 ($2.10 in chips) 
Seat 2: bojnice21 ($2 in chips) 
Seat 3: Mr_Zh.Evgeniy ($0.84 in chips) 
Seat 4: NortheastIron ($0.65 in chips) 
Seat 6: KiDraybeon ($2 in chips) 
Seat 7: Dorex2007 ($1.80 in chips) 
Seat 8: kiling1 ($1.13 in chips) 
Seat 9: BrykmiD ($2.03 in chips) 
KiDraybeon: posts small blind $0.01
Dorex2007: posts big blind $0.02
*** HOLE CARDS ***
Dealt to Dorex2007 [8d 5s]
kiling1: folds 
BrykmiD: folds 
Seregaa1998: raises $0.04 to $0.06
bojnice21: folds 
Mr_Zh.Evgeniy: folds 
NortheastIron: folds 
KiDraybeon: folds 
Dorex2007: folds 
Uncalled bet ($0.04) returned to Seregaa1998
Seregaa1998 collected $0.05 from pot
Seregaa1998: doesn't show hand 
*** SUMMARY ***
Total pot $0.05 | Rake $0 
Seat 1: Seregaa1998 collected ($0.05)
Seat 2: bojnice21 folded before Flop (didn't bet)
Seat 3: Mr_Zh.Evgeniy folded before Flop (didn't bet)
Seat 4: NortheastIron (button) folded before Flop (didn't bet)
Seat 6: KiDraybeon (small blind) folded before Flop
Seat 7: Dorex2007 (big blind) folded before Flop
Seat 8: kiling1 folded before Flop (didn't bet)
Seat 9: BrykmiD folded before Flop (didn't bet)



PokerStars Hand #225160329454:  Hold'em No Limit ($0.01/$0.02 USD) - 2021/03/24 23:34:48 PT [2021/03/25 2:34:48 ET]
Table 'Belopolskya VI' 9-max Seat #6 is the button
Seat 1: Seregaa1998 ($2.13 in chips) 
Seat 2: bojnice21 ($2 in chips) 
Seat 3: Mr_Zh.Evgeniy ($0.84 in chips) 
Seat 4: NortheastIron ($0.65 in chips) 
Seat 5: caroteen ($0.80 in chips) 
Seat 6: KiDraybeon ($2 in chips) 
Seat 7: Dorex2007 ($1.78 in chips) 
Seat 8: kiling1 ($1.13 in chips) 
Seat 9: BrykmiD ($2.03 in chips) 
Dorex2007: posts small blind $0.01
kiling1: posts big blind $0.02
caroteen: posts big blind $0.02
*** HOLE CARDS ***
Dealt to Dorex2007 [9h 5s]
BrykmiD: folds 
Seregaa1998: folds 
bojnice21: calls $0.02
Mr_Zh.Evgeniy: folds 
NortheastIron: folds 
caroteen: checks 
KiDraybeon: raises $0.05 to $0.07
Dorex2007: folds 
kiling1: calls $0.05
bojnice21: calls $0.05
caroteen: calls $0.05
*** FLOP *** [3d 3c 5h]
kiling1: checks 
bojnice21: checks 
caroteen: bets $0.04
KiDraybeon: calls $0.04
kiling1: folds 
bojnice21: folds 
*** TURN *** [3d 3c 5h] [6c]
caroteen: bets $0.04
KiDraybeon: raises $0.22 to $0.26
caroteen: folds 
Uncalled bet ($0.22) returned to KiDraybeon
KiDraybeon collected $0.43 from pot
KiDraybeon: doesn't show hand 
*** SUMMARY ***
Total pot $0.45 | Rake $0.02 
Board [3d 3c 5h 6c]
Seat 1: Seregaa1998 folded before Flop (didn't bet)
Seat 2: bojnice21 folded on the Flop
Seat 3: Mr_Zh.Evgeniy folded before Flop (didn't bet)
Seat 4: NortheastIron folded before Flop (didn't bet)
Seat 5: caroteen folded on the Turn
Seat 6: KiDraybeon (button) collected ($0.43)
Seat 7: Dorex2007 (small blind) folded before Flop
Seat 8: kiling1 (big blind) folded on the Flop
Seat 9: BrykmiD folded before Flop (didn't bet)



PokerStars Hand #225160346231:  Hold'em No Limit ($0.01/$0.02 USD) - 2021/03/24 23:36:41 PT [2021/03/25 2:36:41 ET]
Table 'Belopolskya VI' 9-max Seat #7 is the button
Seat 1: Seregaa1998 ($2.13 in chips) 
Seat 2: bojnice21 ($1.93 in chips) 
Seat 3: Mr_Zh.Evgeniy ($0.84 in chips) 
Seat 4: NortheastIron ($0.65 in chips) 
Seat 5: caroteen ($0.65 in chips) 
Seat 6: KiDraybeon ($2.28 in chips) 
Seat 7: Dorex2007 ($1.77 in chips) 
Seat 8: kiling1 ($1.06 in chips) 
Seat 9: BrykmiD ($2.03 in chips) 
kiling1: posts small blind $0.01
BrykmiD: posts big blind $0.02
*** HOLE CARDS ***
Dealt to Dorex2007 [2h 8h]
Seregaa1998: folds 
bojnice21: folds 
Mr_Zh.Evgeniy: folds 
NortheastIron: folds 
caroteen: folds 
KiDraybeon: folds 
Dorex2007: folds 
kiling1: raises $0.04 to $0.06
BrykmiD: folds 
Uncalled bet ($0.04) returned to kiling1
kiling1 collected $0.04 from pot
kiling1: doesn't show hand 
*** SUMMARY ***
Total pot $0.04 | Rake $0 
Seat 1: Seregaa1998 folded before Flop (didn't bet)
Seat 2: bojnice21 folded before Flop (didn't bet)
Seat 3: Mr_Zh.Evgeniy folded before Flop (didn't bet)
Seat 4: NortheastIron folded before Flop (didn't bet)
Seat 5: caroteen folded before Flop (didn't bet)
Seat 6: KiDraybeon folded before Flop (didn't bet)
Seat 7: Dorex2007 (button) folded before Flop (didn't bet)
Seat 8: kiling1 (small blind) collected ($0.04)
Seat 9: BrykmiD (big blind) folded before Flop



PokerStars Hand #225160348736:  Hold'em No Limit ($0.01/$0.02 USD) - 2021/03/24 23:36:58 PT [2021/03/25 2:36:58 ET]
Table 'Belopolskya VI' 9-max Seat #8 is the button
Seat 1: Seregaa1998 ($2.13 in chips) 
Seat 2: bojnice21 ($1.93 in chips) 
Seat 3: Mr_Zh.Evgeniy ($0.84 in chips) 
Seat 4: NortheastIron ($0.65 in chips) 
Seat 5: caroteen ($0.65 in chips) 
Seat 6: KiDraybeon ($2.28 in chips) 
Seat 7: Dorex2007 ($1.77 in chips) 
Seat 8: kiling1 ($1.08 in chips) 
Seat 9: BrykmiD ($2.01 in chips) 
BrykmiD: posts small blind $0.01
Seregaa1998: posts big blind $0.02
*** HOLE CARDS ***
Dealt to Dorex2007 [8d Ac]
bojnice21: folds 
Mr_Zh.Evgeniy: calls $0.02
NortheastIron: folds 
caroteen: folds 
KiDraybeon: folds 
Dorex2007: folds 
kiling1: folds 
BrykmiD: raises $0.04 to $0.06
Seregaa1998: folds 
Mr_Zh.Evgeniy: calls $0.04
*** FLOP *** [7s Ah 8h]
BrykmiD: checks 
Mr_Zh.Evgeniy: checks 
*** TURN *** [7s Ah 8h] [3d]
BrykmiD: checks 
Mr_Zh.Evgeniy: checks 
*** RIVER *** [7s Ah 8h 3d] [Ts]
BrykmiD: bets $0.10
Mr_Zh.Evgeniy: folds 
Uncalled bet ($0.10) returned to BrykmiD
BrykmiD collected $0.14 from pot
*** SUMMARY ***
Total pot $0.14 | Rake $0 
Board [7s Ah 8h 3d Ts]
Seat 1: Seregaa1998 (big blind) folded before Flop
Seat 2: bojnice21 folded before Flop (didn't bet)
Seat 3: Mr_Zh.Evgeniy folded on the River
Seat 4: NortheastIron folded before Flop (didn't bet)
Seat 5: caroteen folded before Flop (didn't bet)
Seat 6: KiDraybeon folded before Flop (didn't bet)
Seat 7: Dorex2007 folded before Flop (didn't bet)
Seat 8: kiling1 (button) folded before Flop (didn't bet)
Seat 9: BrykmiD (small blind) collected ($0.14)



PokerStars Hand #225160360835:  Hold'em No Limit ($0.01/$0.02 USD) - 2021/03/24 23:38:20 PT [2021/03/25 2:38:20 ET]
Table 'Belopolskya VI' 9-max Seat #9 is the button
Seat 1: Seregaa1998 ($2.11 in chips) 
Seat 2: bojnice21 ($1.93 in chips) 
Seat 3: Mr_Zh.Evgeniy ($0.78 in chips) 
Seat 4: NortheastIron ($0.65 in chips) 
Seat 5: caroteen ($0.65 in chips) 
Seat 6: KiDraybeon ($2.28 in chips) 
Seat 7: Dorex2007 ($1.77 in chips) 
Seat 8: kiling1 ($1.08 in chips) 
Seat 9: BrykmiD ($2.09 in chips) 
Seregaa1998: posts small blind $0.01
bojnice21: posts big blind $0.02
*** HOLE CARDS ***
Dealt to Dorex2007 [4h Jh]
Mr_Zh.Evgeniy: calls $0.02
NortheastIron: folds 
caroteen: calls $0.02
KiDraybeon: folds 
Dorex2007: folds 
kiling1 has timed out
kiling1: folds 
BrykmiD: folds 
Seregaa1998: calls $0.01
bojnice21: checks 
*** FLOP *** [Th As 4c]
Seregaa1998: checks 
bojnice21: checks 
Mr_Zh.Evgeniy: checks 
caroteen: bets $0.04
Seregaa1998: calls $0.04
bojnice21: calls $0.04
Mr_Zh.Evgeniy: folds 
*** TURN *** [Th As 4c] [Kc]
Seregaa1998: checks 
bojnice21: checks 
caroteen: bets $0.06
Seregaa1998: calls $0.06
bojnice21: calls $0.06
*** RIVER *** [Th As 4c Kc] [5s]
Seregaa1998: checks 
bojnice21: checks 
caroteen: bets $0.10
Seregaa1998: folds 
bojnice21: calls $0.10
*** SHOW DOWN ***
caroteen: shows [Kh Ks] (three of a kind, Kings)
bojnice21: shows [3c 2c] (a straight, Ace to Five)
bojnice21 collected $0.56 from pot
*** SUMMARY ***
Total pot $0.58 | Rake $0.02 
Board [Th As 4c Kc 5s]
Seat 1: Seregaa1998 (small blind) folded on the River
Seat 2: bojnice21 (big blind) showed [3c 2c] and won ($0.56) with a straight, Ace to Five
Seat 3: Mr_Zh.Evgeniy folded on the Flop
Seat 4: NortheastIron folded before Flop (didn't bet)
Seat 5: caroteen showed [Kh Ks] and lost with three of a kind, Kings
Seat 6: KiDraybeon folded before Flop (didn't bet)
Seat 7: Dorex2007 folded before Flop (didn't bet)
Seat 8: kiling1 folded before Flop (didn't bet)
Seat 9: BrykmiD (button) folded before Flop (didn't bet)



PokerStars Hand #225160375581:  Hold'em No Limit ($0.01/$0.02 USD) - 2021/03/24 23:39:58 PT [2021/03/25 2:39:58 ET]
Table 'Belopolskya VI' 9-max Seat #1 is the button
Seat 1: Seregaa1998 ($2 in chips) 
Seat 2: bojnice21 ($2.27 in chips) 
Seat 3: Mr_Zh.Evgeniy ($0.76 in chips) 
Seat 4: NortheastIron ($0.65 in chips) 
Seat 5: caroteen ($0.43 in chips) 
Seat 6: KiDraybeon ($2.28 in chips) 
Seat 7: Dorex2007 ($1.77 in chips) 
Seat 9: BrykmiD ($2.09 in chips) 
bojnice21: posts small blind $0.01
Mr_Zh.Evgeniy: posts big blind $0.02
*** HOLE CARDS ***
Dealt to Dorex2007 [Qs 8s]
NortheastIron: folds 
caroteen: calls $0.02
NortheastIron leaves the table
KiDraybeon: folds 
Dorex2007: folds 
BrykmiD: folds 
Seregaa1998: folds 
bojnice21: folds 
Mr_Zh.Evgeniy: checks 
*** FLOP *** [Kd 7d Jc]
Mr_Zh.Evgeniy: checks 
caroteen: checks 
*** TURN *** [Kd 7d Jc] [Qd]
Mr_Zh.Evgeniy: checks 
caroteen: checks 
*** RIVER *** [Kd 7d Jc Qd] [7h]
Mr_Zh.Evgeniy: bets $0.02
vagoneta16 joins the table at seat #4 
caroteen: raises $0.08 to $0.10
Mr_Zh.Evgeniy: calls $0.08
*** SHOW DOWN ***
caroteen: shows [As 7c] (three of a kind, Sevens)
Mr_Zh.Evgeniy: mucks hand 
caroteen collected $0.24 from pot
*** SUMMARY ***
Total pot $0.25 | Rake $0.01 
Board [Kd 7d Jc Qd 7h]
Seat 1: Seregaa1998 (button) folded before Flop (didn't bet)
Seat 2: bojnice21 (small blind) folded before Flop
Seat 3: Mr_Zh.Evgeniy (big blind) mucked [Ks 9h]
Seat 4: NortheastIron folded before Flop (didn't bet)
Seat 5: caroteen showed [As 7c] and won ($0.24) with three of a kind, Sevens
Seat 6: KiDraybeon folded before Flop (didn't bet)
Seat 7: Dorex2007 folded before Flop (didn't bet)
Seat 9: BrykmiD folded before Flop (didn't bet)



PokerStars Hand #225160383102:  Hold'em No Limit ($0.01/$0.02 USD) - 2021/03/24 23:40:48 PT [2021/03/25 2:40:48 ET]
Table 'Belopolskya VI' 9-max Seat #2 is the button
Seat 1: Seregaa1998 ($2 in chips) 
Seat 2: bojnice21 ($2.26 in chips) 
Seat 3: Mr_Zh.Evgeniy ($0.64 in chips) 
Seat 4: vagoneta16 ($2 in chips) 
Seat 5: caroteen ($0.55 in chips) 
Seat 6: KiDraybeon ($2.28 in chips) 
Seat 7: Dorex2007 ($1.77 in chips) 
Seat 8: kiling1 ($1.08 in chips) 
Seat 9: BrykmiD ($2.09 in chips) 
Mr_Zh.Evgeniy: posts small blind $0.01
vagoneta16: posts big blind $0.02
*** HOLE CARDS ***
Dealt to Dorex2007 [8c Kh]
caroteen: folds 
KiDraybeon: folds 
Dorex2007: folds 
kiling1: folds 
BrykmiD: folds 
Seregaa1998: folds 
bojnice21: folds 
Mr_Zh.Evgeniy: raises $0.04 to $0.06
vagoneta16: folds 
Uncalled bet ($0.04) returned to Mr_Zh.Evgeniy
Mr_Zh.Evgeniy collected $0.04 from pot
Mr_Zh.Evgeniy: doesn't show hand 
*** SUMMARY ***
Total pot $0.04 | Rake $0 
Seat 1: Seregaa1998 folded before Flop (didn't bet)
Seat 2: bojnice21 (button) folded before Flop (didn't bet)
Seat 3: Mr_Zh.Evgeniy (small blind) collected ($0.04)
Seat 4: vagoneta16 (big blind) folded before Flop
Seat 5: caroteen folded before Flop (didn't bet)
Seat 6: KiDraybeon folded before Flop (didn't bet)
Seat 7: Dorex2007 folded before Flop (didn't bet)
Seat 8: kiling1 folded before Flop (didn't bet)
Seat 9: BrykmiD folded before Flop (didn't bet)



PokerStars Hand #225160388838:  Hold'em No Limit ($0.01/$0.02 USD) - 2021/03/24 23:41:26 PT [2021/03/25 2:41:26 ET]
Table 'Belopolskya VI' 9-max Seat #3 is the button
Seat 1: Seregaa1998 ($2 in chips) 
Seat 2: bojnice21 ($2.26 in chips) 
Seat 3: Mr_Zh.Evgeniy ($0.66 in chips) 
Seat 4: vagoneta16 ($1.98 in chips) 
Seat 5: caroteen ($0.55 in chips) 
Seat 6: KiDraybeon ($2.28 in chips) 
Seat 7: Dorex2007 ($1.77 in chips) 
Seat 8: kiling1 ($1.08 in chips) 
Seat 9: BrykmiD ($2.09 in chips) 
vagoneta16: posts small blind $0.01
caroteen: posts big blind $0.02
*** HOLE CARDS ***
Dealt to Dorex2007 [4d 2c]
KiDraybeon: folds 
Dorex2007: folds 
kiling1: folds 
BrykmiD: folds 
Seregaa1998: folds 
bojnice21: folds 
Mr_Zh.Evgeniy: raises $0.04 to $0.06
vagoneta16: folds 
caroteen: folds 
Uncalled bet ($0.04) returned to Mr_Zh.Evgeniy
Mr_Zh.Evgeniy collected $0.05 from pot
Mr_Zh.Evgeniy: doesn't show hand 
*** SUMMARY ***
Total pot $0.05 | Rake $0 
Seat 1: Seregaa1998 folded before Flop (didn't bet)
Seat 2: bojnice21 folded before Flop (didn't bet)
Seat 3: Mr_Zh.Evgeniy (button) collected ($0.05)
Seat 4: vagoneta16 (small blind) folded before Flop
Seat 5: caroteen (big blind) folded before Flop
Seat 6: KiDraybeon folded before Flop (didn't bet)
Seat 7: Dorex2007 folded before Flop (didn't bet)
Seat 8: kiling1 folded before Flop (didn't bet)
Seat 9: BrykmiD folded before Flop (didn't bet)



PokerStars Hand #225160395410:  Hold'em No Limit ($0.01/$0.02 USD) - 2021/03/24 23:42:10 PT [2021/03/25 2:42:10 ET]
Table 'Belopolskya VI' 9-max Seat #4 is the button
Seat 1: Seregaa1998 ($2 in chips) 
Seat 2: bojnice21 ($2.26 in chips) 
Seat 3: Mr_Zh.Evgeniy ($0.69 in chips) 
Seat 4: vagoneta16 ($1.97 in chips) 
Seat 5: caroteen ($0.53 in chips) 
Seat 6: KiDraybeon ($2.28 in chips) 
Seat 7: Dorex2007 ($1.77 in chips) 
Seat 8: kiling1 ($1.08 in chips) 
Seat 9: BrykmiD ($2.09 in chips) 
caroteen: posts small blind $0.01
KiDraybeon: posts big blind $0.02
*** HOLE CARDS ***
Dealt to Dorex2007 [Ks 2d]
Dorex2007: folds 
kiling1: folds 
BrykmiD: folds 
Seregaa1998: folds 
bojnice21: folds 
Mr_Zh.Evgeniy has timed out
Mr_Zh.Evgeniy: folds 
vagoneta16: raises $0.04 to $0.06
caroteen: folds 
KiDraybeon: folds 
Uncalled bet ($0.04) returned to vagoneta16
vagoneta16 collected $0.05 from pot
vagoneta16: doesn't show hand 
*** SUMMARY ***
Total pot $0.05 | Rake $0 
Seat 1: Seregaa1998 folded before Flop (didn't bet)
Seat 2: bojnice21 folded before Flop (didn't bet)
Seat 3: Mr_Zh.Evgeniy folded before Flop (didn't bet)
Seat 4: vagoneta16 (button) collected ($0.05)
Seat 5: caroteen (small blind) folded before Flop
Seat 6: KiDraybeon (big blind) folded before Flop
Seat 7: Dorex2007 folded before Flop (didn't bet)
Seat 8: kiling1 folded before Flop (didn't bet)
Seat 9: BrykmiD folded before Flop (didn't bet)



PokerStars Hand #225160400887:  Hold'em No Limit ($0.01/$0.02 USD) - 2021/03/24 23:42:47 PT [2021/03/25 2:42:47 ET]
Table 'Belopolskya VI' 9-max Seat #5 is the button
Seat 1: Seregaa1998 ($2 in chips) 
Seat 2: bojnice21 ($2.26 in chips) 
Seat 4: vagoneta16 ($2 in chips) 
Seat 5: caroteen ($0.52 in chips) 
Seat 6: KiDraybeon ($2.26 in chips) 
Seat 7: Dorex2007 ($1.77 in chips) 
Seat 8: kiling1 ($1.08 in chips) 
Seat 9: BrykmiD ($2.09 in chips) 
KiDraybeon: posts small blind $0.01
Dorex2007: posts big blind $0.02
*** HOLE CARDS ***
Dealt to Dorex2007 [4s Th]
kiling1: folds 
BrykmiD: folds 
Seregaa1998: folds 
bojnice21: folds 
vagoneta16: folds 
caroteen: folds 
KiDraybeon: raises $0.05 to $0.07
Dorex2007: folds 
Uncalled bet ($0.05) returned to KiDraybeon
KiDraybeon collected $0.04 from pot
KiDraybeon: doesn't show hand 
*** SUMMARY ***
Total pot $0.04 | Rake $0 
Seat 1: Seregaa1998 folded before Flop (didn't bet)
Seat 2: bojnice21 folded before Flop (didn't bet)
Seat 4: vagoneta16 folded before Flop (didn't bet)
Seat 5: caroteen (button) folded before Flop (didn't bet)
Seat 6: KiDraybeon (small blind) collected ($0.04)
Seat 7: Dorex2007 (big blind) folded before Flop
Seat 8: kiling1 folded before Flop (didn't bet)
Seat 9: BrykmiD folded before Flop (didn't bet)



PokerStars Hand #225160404437:  Hold'em No Limit ($0.01/$0.02 USD) - 2021/03/24 23:43:10 PT [2021/03/25 2:43:10 ET]
Table 'Belopolskya VI' 9-max Seat #6 is the button
Seat 1: Seregaa1998 ($2 in chips) 
Seat 2: bojnice21 ($2.26 in chips) 
Seat 4: vagoneta16 ($2 in chips) 
Seat 5: caroteen ($0.52 in chips) 
Seat 6: KiDraybeon ($2.28 in chips) 
Seat 7: Dorex2007 ($1.75 in chips) 
Seat 8: kiling1 ($1.08 in chips) 
Seat 9: BrykmiD ($2.09 in chips) 
Dorex2007: posts small blind $0.01
kiling1: posts big blind $0.02
*** HOLE CARDS ***
Dealt to Dorex2007 [2c 8h]
BrykmiD: folds 
Seregaa1998: raises $0.04 to $0.06
bojnice21: calls $0.06
vagoneta16: folds 
caroteen: folds 
KiDraybeon: folds 
Dorex2007: folds 
kiling1: calls $0.04
*** FLOP *** [9d 6s Qs]
kiling1: checks 
Seregaa1998: checks 
bojnice21: checks 
*** TURN *** [9d 6s Qs] [Ad]
kiling1: checks 
Seregaa1998: checks 
bojnice21: checks 
*** RIVER *** [9d 6s Qs Ad] [Kd]
kiling1: checks 
Seregaa1998: checks 
bojnice21: checks 
*** SHOW DOWN ***
kiling1: shows [5s 5d] (a pair of Fives)
Seregaa1998: shows [7s 7d] (a pair of Sevens)
bojnice21: shows [Ah 2h] (a pair of Aces)
bojnice21 collected $0.18 from pot
*** SUMMARY ***
Total pot $0.19 | Rake $0.01 
Board [9d 6s Qs Ad Kd]
Seat 1: Seregaa1998 showed [7s 7d] and lost with a pair of Sevens
Seat 2: bojnice21 showed [Ah 2h] and won ($0.18) with a pair of Aces
Seat 4: vagoneta16 folded before Flop (didn't bet)
Seat 5: caroteen folded before Flop (didn't bet)
Seat 6: KiDraybeon (button) folded before Flop (didn't bet)
Seat 7: Dorex2007 (small blind) folded before Flop
Seat 8: kiling1 (big blind) showed [5s 5d] and lost with a pair of Fives
Seat 9: BrykmiD folded before Flop (didn't bet)



PokerStars Hand #225160417752:  Hold'em No Limit ($0.01/$0.02 USD) - 2021/03/24 23:44:39 PT [2021/03/25 2:44:39 ET]
Table 'Belopolskya VI' 9-max Seat #7 is the button
Seat 1: Seregaa1998 ($2 in chips) 
Seat 2: bojnice21 ($2.38 in chips) 
Seat 3: Mr_Zh.Evgeniy ($0.69 in chips) 
Seat 4: vagoneta16 ($2 in chips) 
Seat 5: caroteen ($0.52 in chips) 
Seat 6: KiDraybeon ($2.28 in chips) 
Seat 7: Dorex2007 ($1.74 in chips) 
Seat 8: kiling1 ($1.02 in chips) 
Seat 9: BrykmiD ($2.09 in chips) 
kiling1: posts small blind $0.01
BrykmiD: posts big blind $0.02
*** HOLE CARDS ***
Dealt to Dorex2007 [8d 7s]
Seregaa1998: raises $0.04 to $0.06
bojnice21: folds 
Mr_Zh.Evgeniy: calls $0.06
vagoneta16: folds 
caroteen: folds 
KiDraybeon: folds 
Dorex2007: folds 
kiling1: calls $0.05
BrykmiD: folds 
*** FLOP *** [3h Ks 3c]
kiling1: checks 
Seregaa1998: bets $0.08
Mr_Zh.Evgeniy: calls $0.08
kiling1: calls $0.08
*** TURN *** [3h Ks 3c] [Ts]
kiling1: checks 
Seregaa1998: checks 
Mr_Zh.Evgeniy: bets $0.12
kiling1: folds 
Seregaa1998: folds 
Uncalled bet ($0.12) returned to Mr_Zh.Evgeniy
Mr_Zh.Evgeniy collected $0.42 from pot
Mr_Zh.Evgeniy: doesn't show hand 
*** SUMMARY ***
Total pot $0.44 | Rake $0.02 
Board [3h Ks 3c Ts]
Seat 1: Seregaa1998 folded on the Turn
Seat 2: bojnice21 folded before Flop (didn't bet)
Seat 3: Mr_Zh.Evgeniy collected ($0.42)
Seat 4: vagoneta16 folded before Flop (didn't bet)
Seat 5: caroteen folded before Flop (didn't bet)
Seat 6: KiDraybeon folded before Flop (didn't bet)
Seat 7: Dorex2007 (button) folded before Flop (didn't bet)
Seat 8: kiling1 (small blind) folded on the Turn
Seat 9: BrykmiD (big blind) folded before Flop



PokerStars Hand #225160430155:  Hold'em No Limit ($0.01/$0.02 USD) - 2021/03/24 23:46:00 PT [2021/03/25 2:46:00 ET]
Table 'Belopolskya VI' 9-max Seat #8 is the button
Seat 1: Seregaa1998 ($2 in chips) 
Seat 2: bojnice21 ($2.38 in chips) 
Seat 3: Mr_Zh.Evgeniy ($0.97 in chips) 
Seat 4: vagoneta16 ($2 in chips) 
Seat 5: caroteen ($0.52 in chips) 
Seat 6: KiDraybeon ($2.28 in chips) 
Seat 7: Dorex2007 ($1.74 in chips) 
Seat 8: kiling1 ($0.88 in chips) 
Seat 9: BrykmiD ($2.07 in chips) 
BrykmiD: posts small blind $0.01
Seregaa1998: posts big blind $0.02
*** HOLE CARDS ***
Dealt to Dorex2007 [6d 4d]
bojnice21: folds 
Mr_Zh.Evgeniy: folds 
vagoneta16: folds 
caroteen: folds 
KiDraybeon: folds 
Dorex2007: folds 
kiling1 has timed out
kiling1: folds 
BrykmiD: folds 
Uncalled bet ($0.01) returned to Seregaa1998
Seregaa1998 collected $0.02 from pot
Seregaa1998: doesn't show hand 
*** SUMMARY ***
Total pot $0.02 | Rake $0 
Seat 1: Seregaa1998 (big blind) collected ($0.02)
Seat 2: bojnice21 folded before Flop (didn't bet)
Seat 3: Mr_Zh.Evgeniy folded before Flop (didn't bet)
Seat 4: vagoneta16 folded before Flop (didn't bet)
Seat 5: caroteen folded before Flop (didn't bet)
Seat 6: KiDraybeon folded before Flop (didn't bet)
Seat 7: Dorex2007 folded before Flop (didn't bet)
Seat 8: kiling1 (button) folded before Flop (didn't bet)
Seat 9: BrykmiD (small blind) folded before Flop



PokerStars Hand #225160435561:  Hold'em No Limit ($0.01/$0.02 USD) - 2021/03/24 23:46:36 PT [2021/03/25 2:46:36 ET]
Table 'Belopolskya VI' 9-max Seat #9 is the button
Seat 1: Seregaa1998 ($2.01 in chips) 
Seat 2: bojnice21 ($2.38 in chips) 
Seat 3: Mr_Zh.Evgeniy ($0.97 in chips) 
Seat 4: vagoneta16 ($2 in chips) 
Seat 5: caroteen ($0.52 in chips) 
Seat 6: KiDraybeon ($2.28 in chips) 
Seat 7: Dorex2007 ($1.74 in chips) 
Seat 9: BrykmiD ($2.06 in chips) 
Seregaa1998: posts small blind $0.01
bojnice21: posts big blind $0.02
*** HOLE CARDS ***
Dealt to Dorex2007 [Ac 4h]
Mr_Zh.Evgeniy: folds 
vagoneta16: folds 
caroteen: calls $0.02
KiDraybeon: raises $0.05 to $0.07
Dorex2007: folds 
BrykmiD: folds 
Seregaa1998: calls $0.06
bojnice21: folds 
caroteen: calls $0.05
*** FLOP *** [4s 6s 2h]
Seregaa1998: checks 
caroteen: checks 
KiDraybeon: checks 
*** TURN *** [4s 6s 2h] [3h]
Seregaa1998: checks 
caroteen: checks 
KiDraybeon: checks 
*** RIVER *** [4s 6s 2h 3h] [3c]
Seregaa1998: bets $0.12
caroteen: folds 
KiDraybeon: folds 
Uncalled bet ($0.12) returned to Seregaa1998
Seregaa1998 collected $0.22 from pot
Seregaa1998: doesn't show hand 
*** SUMMARY ***
Total pot $0.23 | Rake $0.01 
Board [4s 6s 2h 3h 3c]
Seat 1: Seregaa1998 (small blind) collected ($0.22)
Seat 2: bojnice21 (big blind) folded before Flop
Seat 3: Mr_Zh.Evgeniy folded before Flop (didn't bet)
Seat 4: vagoneta16 folded before Flop (didn't bet)
Seat 5: caroteen folded on the River
Seat 6: KiDraybeon folded on the River
Seat 7: Dorex2007 folded before Flop (didn't bet)
Seat 9: BrykmiD (button) folded before Flop (didn't bet)



PokerStars Hand #225160442299:  Hold'em No Limit ($0.01/$0.02 USD) - 2021/03/24 23:47:20 PT [2021/03/25 2:47:20 ET]
Table 'Belopolskya VI' 9-max Seat #1 is the button
Seat 1: Seregaa1998 ($2.16 in chips) 
Seat 2: bojnice21 ($2.36 in chips) 
Seat 3: Mr_Zh.Evgeniy ($0.97 in chips) 
Seat 4: vagoneta16 ($2 in chips) 
Seat 5: caroteen ($0.45 in chips) 
Seat 6: KiDraybeon ($2.21 in chips) 
Seat 7: Dorex2007 ($1.74 in chips) 
Seat 9: BrykmiD ($2.06 in chips) 
bojnice21: posts small blind $0.01
Mr_Zh.Evgeniy: posts big blind $0.02
*** HOLE CARDS ***
Dealt to Dorex2007 [3c 3h]
vagoneta16: raises $0.04 to $0.06
caroteen: folds 
KiDraybeon: folds 
Dorex2007: folds 
BrykmiD: folds 
Seregaa1998: folds 
bojnice21: folds 
Mr_Zh.Evgeniy: calls $0.04
*** FLOP *** [8d Ts Td]
Mr_Zh.Evgeniy: checks 
vagoneta16: checks 
*** TURN *** [8d Ts Td] [8h]
Mr_Zh.Evgeniy: checks 
vagoneta16: bets $0.07
Mr_Zh.Evgeniy: folds 
Uncalled bet ($0.07) returned to vagoneta16
vagoneta16 collected $0.13 from pot
vagoneta16: doesn't show hand 
*** SUMMARY ***
Total pot $0.13 | Rake $0 
Board [8d Ts Td 8h]
Seat 1: Seregaa1998 (button) folded before Flop (didn't bet)
Seat 2: bojnice21 (small blind) folded before Flop
Seat 3: Mr_Zh.Evgeniy (big blind) folded on the Turn
Seat 4: vagoneta16 collected ($0.13)
Seat 5: caroteen folded before Flop (didn't bet)
Seat 6: KiDraybeon folded before Flop (didn't bet)
Seat 7: Dorex2007 folded before Flop (didn't bet)
Seat 9: BrykmiD folded before Flop (didn't bet)



PokerStars Hand #225160452268:  Hold'em No Limit ($0.01/$0.02 USD) - 2021/03/24 23:48:26 PT [2021/03/25 2:48:26 ET]
Table 'Belopolskya VI' 9-max Seat #2 is the button
Seat 1: Seregaa1998 ($2.16 in chips) 
Seat 2: bojnice21 ($2.35 in chips) 
Seat 3: Mr_Zh.Evgeniy ($0.91 in chips) 
Seat 4: vagoneta16 ($2.07 in chips) 
Seat 5: caroteen ($0.45 in chips) 
Seat 6: KiDraybeon ($2.21 in chips) 
Seat 7: Dorex2007 ($1.74 in chips) 
Seat 8: kiling1 ($0.88 in chips) 
Seat 9: BrykmiD ($2.06 in chips) 
Mr_Zh.Evgeniy: posts small blind $0.01
vagoneta16: posts big blind $0.02
*** HOLE CARDS ***
Dealt to Dorex2007 [3s 6h]
caroteen: folds 
KiDraybeon: folds 
Dorex2007: folds 
kiling1: folds 
BrykmiD: folds 
Seregaa1998: folds 
bojnice21: folds 
Mr_Zh.Evgeniy: folds 
Uncalled bet ($0.01) returned to vagoneta16
vagoneta16 collected $0.02 from pot
vagoneta16: doesn't show hand 
*** SUMMARY ***
Total pot $0.02 | Rake $0 
Seat 1: Seregaa1998 folded before Flop (didn't bet)
Seat 2: bojnice21 (button) folded before Flop (didn't bet)
Seat 3: Mr_Zh.Evgeniy (small blind) folded before Flop
Seat 4: vagoneta16 (big blind) collected ($0.02)
Seat 5: caroteen folded before Flop (didn't bet)
Seat 6: KiDraybeon folded before Flop (didn't bet)
Seat 7: Dorex2007 folded before Flop (didn't bet)
Seat 8: kiling1 folded before Flop (didn't bet)
Seat 9: BrykmiD folded before Flop (didn't bet)



PokerStars Hand #225160455604:  Hold'em No Limit ($0.01/$0.02 USD) - 2021/03/24 23:48:47 PT [2021/03/25 2:48:47 ET]
Table 'Belopolskya VI' 9-max Seat #3 is the button
Seat 1: Seregaa1998 ($2.16 in chips) 
Seat 2: bojnice21 ($2.35 in chips) 
Seat 3: Mr_Zh.Evgeniy ($0.90 in chips) 
Seat 4: vagoneta16 ($2.08 in chips) 
Seat 5: caroteen ($0.45 in chips) 
Seat 6: KiDraybeon ($2.21 in chips) 
Seat 7: Dorex2007 ($1.74 in chips) 
Seat 8: kiling1 ($0.88 in chips) 
Seat 9: BrykmiD ($2.06 in chips) 
vagoneta16: posts small blind $0.01
caroteen: posts big blind $0.02
*** HOLE CARDS ***
Dealt to Dorex2007 [Th 4d]
KiDraybeon: folds 
Dorex2007: calls $0.02
kiling1: folds 
BrykmiD: folds 
Seregaa1998: folds 
bojnice21: folds 
Mr_Zh.Evgeniy: calls $0.02
vagoneta16: calls $0.01
caroteen: checks 
*** FLOP *** [9s 3s 2c]
vagoneta16: checks 
caroteen: checks 
Dorex2007: checks 
Mr_Zh.Evgeniy: bets $0.06
vagoneta16: folds 
caroteen: raises $0.37 to $0.43 and is all-in
Dorex2007: folds 
Mr_Zh.Evgeniy: calls $0.37
*** TURN *** [9s 3s 2c] [Kh]
*** RIVER *** [9s 3s 2c Kh] [Qd]
*** SHOW DOWN ***
caroteen: shows [9c Js] (a pair of Nines)
Mr_Zh.Evgeniy: shows [Jh 9d] (a pair of Nines)
caroteen collected $0.46 from pot
Mr_Zh.Evgeniy collected $0.45 from pot
*** SUMMARY ***
Total pot $0.94 | Rake $0.03 
Board [9s 3s 2c Kh Qd]
Seat 1: Seregaa1998 folded before Flop (didn't bet)
Seat 2: bojnice21 folded before Flop (didn't bet)
Seat 3: Mr_Zh.Evgeniy (button) showed [Jh 9d] and won ($0.45) with a pair of Nines
Seat 4: vagoneta16 (small blind) folded on the Flop
Seat 5: caroteen (big blind) showed [9c Js] and won ($0.46) with a pair of Nines
Seat 6: KiDraybeon folded before Flop (didn't bet)
Seat 7: Dorex2007 folded on the Flop
Seat 8: kiling1 folded before Flop (didn't bet)
Seat 9: BrykmiD folded before Flop (didn't bet)



PokerStars Hand #225160467129:  Hold'em No Limit ($0.01/$0.02 USD) - 2021/03/24 23:50:03 PT [2021/03/25 2:50:03 ET]
Table 'Belopolskya VI' 9-max Seat #4 is the button
Seat 1: Seregaa1998 ($2.16 in chips) 
Seat 2: bojnice21 ($2.35 in chips) 
Seat 3: Mr_Zh.Evgeniy ($0.90 in chips) 
Seat 4: vagoneta16 ($2.06 in chips) 
Seat 5: caroteen ($0.46 in chips) 
Seat 6: KiDraybeon ($2.21 in chips) 
Seat 7: Dorex2007 ($1.72 in chips) 
Seat 8: kiling1 ($0.88 in chips) 
Seat 9: BrykmiD ($2.06 in chips) 
caroteen: posts small blind $0.01
KiDraybeon: posts big blind $0.02
*** HOLE CARDS ***
Dealt to Dorex2007 [7c 6s]
Dorex2007: folds 
kiling1: folds 
BrykmiD: raises $0.06 to $0.08
Seregaa1998: folds 
bojnice21: folds 
Mr_Zh.Evgeniy: folds 
vagoneta16: folds 
caroteen: folds 
KiDraybeon: folds 
Uncalled bet ($0.06) returned to BrykmiD
BrykmiD collected $0.05 from pot
*** SUMMARY ***
Total pot $0.05 | Rake $0 
Seat 1: Seregaa1998 folded before Flop (didn't bet)
Seat 2: bojnice21 folded before Flop (didn't bet)
Seat 3: Mr_Zh.Evgeniy folded before Flop (didn't bet)
Seat 4: vagoneta16 (button) folded before Flop (didn't bet)
Seat 5: caroteen (small blind) folded before Flop
Seat 6: KiDraybeon (big blind) folded before Flop
Seat 7: Dorex2007 folded before Flop (didn't bet)
Seat 8: kiling1 folded before Flop (didn't bet)
Seat 9: BrykmiD collected ($0.05)



PokerStars Hand #225160470571:  Hold'em No Limit ($0.01/$0.02 USD) - 2021/03/24 23:50:25 PT [2021/03/25 2:50:25 ET]
Table 'Belopolskya VI' 9-max Seat #5 is the button
Seat 1: Seregaa1998 ($2.16 in chips) 
Seat 2: bojnice21 ($2.35 in chips) 
Seat 3: Mr_Zh.Evgeniy ($0.90 in chips) 
Seat 4: vagoneta16 ($2.06 in chips) 
Seat 5: caroteen ($0.45 in chips) 
Seat 6: KiDraybeon ($2.19 in chips) 
Seat 7: Dorex2007 ($1.72 in chips) 
Seat 8: kiling1 ($0.88 in chips) 
Seat 9: BrykmiD ($2.09 in chips) 
KiDraybeon: posts small blind $0.01
Dorex2007: posts big blind $0.02
*** HOLE CARDS ***
Dealt to Dorex2007 [Td 9s]
kiling1: folds 
BrykmiD: folds 
Seregaa1998: folds 
bojnice21: folds 
Mr_Zh.Evgeniy has timed out
Mr_Zh.Evgeniy: folds 
vagoneta16: folds 
caroteen: calls $0.02
KiDraybeon: folds 
Dorex2007: checks 
*** FLOP *** [Jd 7c Kh]
Dorex2007: checks 
caroteen: bets $0.04
Dorex2007: folds 
Uncalled bet ($0.04) returned to caroteen
caroteen collected $0.05 from pot
caroteen: doesn't show hand 
*** SUMMARY ***
Total pot $0.05 | Rake $0 
Board [Jd 7c Kh]
Seat 1: Seregaa1998 folded before Flop (didn't bet)
Seat 2: bojnice21 folded before Flop (didn't bet)
Seat 3: Mr_Zh.Evgeniy folded before Flop (didn't bet)
Seat 4: vagoneta16 folded before Flop (didn't bet)
Seat 5: caroteen (button) collected ($0.05)
Seat 6: KiDraybeon (small blind) folded before Flop
Seat 7: Dorex2007 (big blind) folded on the Flop
Seat 8: kiling1 folded before Flop (didn't bet)
Seat 9: BrykmiD folded before Flop (didn't bet)



PokerStars Hand #225160478235:  Hold'em No Limit ($0.01/$0.02 USD) - 2021/03/24 23:51:14 PT [2021/03/25 2:51:14 ET]
Table 'Belopolskya VI' 9-max Seat #6 is the button
Seat 1: Seregaa1998 ($2.16 in chips) 
Seat 2: bojnice21 ($2.35 in chips) 
Seat 3: Mr_Zh.Evgeniy ($0.90 in chips) 
Seat 4: vagoneta16 ($2.06 in chips) 
Seat 5: caroteen ($0.48 in chips) 
Seat 6: KiDraybeon ($2.18 in chips) 
Seat 7: Dorex2007 ($1.70 in chips) 
Seat 8: kiling1 ($0.88 in chips) 
Seat 9: BrykmiD ($2.09 in chips) 
Dorex2007: posts small blind $0.01
kiling1: posts big blind $0.02
*** HOLE CARDS ***
Dealt to Dorex2007 [Kh 9d]
BrykmiD: folds 
Seregaa1998: folds 
bojnice21: folds 
Mr_Zh.Evgeniy: folds 
vagoneta16: folds 
caroteen: calls $0.02
KiDraybeon: folds 
Dorex2007: calls $0.01
kiling1: checks 
*** FLOP *** [2d Qd Jh]
Dorex2007: checks 
kiling1: checks 
caroteen: checks 
*** TURN *** [2d Qd Jh] [Qs]
Dorex2007: checks 
kiling1: checks 
caroteen: checks 
*** RIVER *** [2d Qd Jh Qs] [8h]
Dorex2007: checks 
kiling1: checks 
caroteen: checks 
*** SHOW DOWN ***
Dorex2007: shows [Kh 9d] (a pair of Queens)
kiling1: mucks hand 
caroteen: shows [As 9h] (a pair of Queens - Ace kicker)
caroteen collected $0.06 from pot
*** SUMMARY ***
Total pot $0.06 | Rake $0 
Board [2d Qd Jh Qs 8h]
Seat 1: Seregaa1998 folded before Flop (didn't bet)
Seat 2: bojnice21 folded before Flop (didn't bet)
Seat 3: Mr_Zh.Evgeniy folded before Flop (didn't bet)
Seat 4: vagoneta16 folded before Flop (didn't bet)
Seat 5: caroteen showed [As 9h] and won ($0.06) with a pair of Queens
Seat 6: KiDraybeon (button) folded before Flop (didn't bet)
Seat 7: Dorex2007 (small blind) showed [Kh 9d] and lost with a pair of Queens
Seat 8: kiling1 (big blind) mucked [3s 5h]
Seat 9: BrykmiD folded before Flop (didn't bet)



PokerStars Hand #225160487224:  Hold'em No Limit ($0.01/$0.02 USD) - 2021/03/24 23:52:13 PT [2021/03/25 2:52:13 ET]
Table 'Belopolskya VI' 9-max Seat #7 is the button
Seat 1: Seregaa1998 ($2.16 in chips) 
Seat 2: bojnice21 ($2.35 in chips) 
Seat 3: Mr_Zh.Evgeniy ($0.90 in chips) 
Seat 4: vagoneta16 ($2.06 in chips) 
Seat 5: caroteen ($0.52 in chips) 
Seat 6: KiDraybeon ($2.18 in chips) 
Seat 7: Dorex2007 ($1.68 in chips) 
Seat 8: kiling1 ($1.98 in chips) 
Seat 9: BrykmiD ($2.09 in chips) 
kiling1: posts small blind $0.01
BrykmiD: posts big blind $0.02
*** HOLE CARDS ***
Dealt to Dorex2007 [3c Qd]
Seregaa1998: folds 
bojnice21: folds 
Mr_Zh.Evgeniy: folds 
vagoneta16: calls $0.02
caroteen: folds 
KiDraybeon: folds 
Dorex2007: folds 
kiling1: calls $0.01
BrykmiD: checks 
*** FLOP *** [4c 5h Ts]
kiling1: checks 
BrykmiD: checks 
vagoneta16: bets $0.03
kiling1: raises $0.06 to $0.09
BrykmiD: folds 
vagoneta16: calls $0.06
*** TURN *** [4c 5h Ts] [5s]
kiling1: bets $0.13
vagoneta16: calls $0.13
*** RIVER *** [4c 5h Ts 5s] [6h]
kiling1: bets $0.20
vagoneta16: folds 
Uncalled bet ($0.20) returned to kiling1
kiling1 collected $0.48 from pot
kiling1: doesn't show hand 
*** SUMMARY ***
Total pot $0.50 | Rake $0.02 
Board [4c 5h Ts 5s 6h]
Seat 1: Seregaa1998 folded before Flop (didn't bet)
Seat 2: bojnice21 folded before Flop (didn't bet)
Seat 3: Mr_Zh.Evgeniy folded before Flop (didn't bet)
Seat 4: vagoneta16 folded on the River
Seat 5: caroteen folded before Flop (didn't bet)
Seat 6: KiDraybeon folded before Flop (didn't bet)
Seat 7: Dorex2007 (button) folded before Flop (didn't bet)
Seat 8: kiling1 (small blind) collected ($0.48)
Seat 9: BrykmiD (big blind) folded on the Flop



PokerStars Hand #225160501050:  Hold'em No Limit ($0.01/$0.02 USD) - 2021/03/24 23:53:43 PT [2021/03/25 2:53:43 ET]
Table 'Belopolskya VI' 9-max Seat #8 is the button
Seat 1: Seregaa1998 ($2.16 in chips) 
Seat 2: bojnice21 ($2.35 in chips) 
Seat 3: Mr_Zh.Evgeniy ($0.90 in chips) 
Seat 4: vagoneta16 ($1.82 in chips) 
Seat 5: caroteen ($0.52 in chips) 
Seat 6: KiDraybeon ($2.18 in chips) 
Seat 7: Dorex2007 ($1.68 in chips) 
Seat 8: kiling1 ($2.22 in chips) 
Seat 9: BrykmiD ($2.07 in chips) 
BrykmiD: posts small blind $0.01
Seregaa1998: posts big blind $0.02
*** HOLE CARDS ***
Dealt to Dorex2007 [9c 2c]
bojnice21: folds 
Mr_Zh.Evgeniy: folds 
vagoneta16: raises $0.04 to $0.06
caroteen: folds 
KiDraybeon: folds 
Dorex2007: folds 
kiling1: folds 
BrykmiD: folds 
Seregaa1998: calls $0.04
*** FLOP *** [7s 8s Ad]
Seregaa1998: checks 
vagoneta16: bets $0.09
Seregaa1998: folds 
Uncalled bet ($0.09) returned to vagoneta16
vagoneta16 collected $0.13 from pot
vagoneta16: doesn't show hand 
*** SUMMARY ***
Total pot $0.13 | Rake $0 
Board [7s 8s Ad]
Seat 1: Seregaa1998 (big blind) folded on the Flop
Seat 2: bojnice21 folded before Flop (didn't bet)
Seat 3: Mr_Zh.Evgeniy folded before Flop (didn't bet)
Seat 4: vagoneta16 collected ($0.13)
Seat 5: caroteen folded before Flop (didn't bet)
Seat 6: KiDraybeon folded before Flop (didn't bet)
Seat 7: Dorex2007 folded before Flop (didn't bet)
Seat 8: kiling1 (button) folded before Flop (didn't bet)
Seat 9: BrykmiD (small blind) folded before Flop



PokerStars Hand #225160508948:  Hold'em No Limit ($0.01/$0.02 USD) - 2021/03/24 23:54:35 PT [2021/03/25 2:54:35 ET]
Table 'Belopolskya VI' 9-max Seat #9 is the button
Seat 1: Seregaa1998 ($2.10 in chips) 
Seat 2: bojnice21 ($2.35 in chips) 
Seat 3: Mr_Zh.Evgeniy ($0.90 in chips) 
Seat 4: vagoneta16 ($1.89 in chips) 
Seat 5: caroteen ($0.52 in chips) 
Seat 6: KiDraybeon ($2.18 in chips) 
Seat 7: Dorex2007 ($1.68 in chips) 
Seat 8: kiling1 ($2.22 in chips) 
Seat 9: BrykmiD ($2.06 in chips) 
Seregaa1998: posts small blind $0.01
bojnice21: posts big blind $0.02
*** HOLE CARDS ***
Dealt to Dorex2007 [3h Kh]
Mr_Zh.Evgeniy has timed out
Mr_Zh.Evgeniy: folds 
vagoneta16: raises $0.04 to $0.06
caroteen: folds 
KiDraybeon: folds 
Dorex2007: folds 
kiling1: calls $0.06
BrykmiD: folds 
Seregaa1998: folds 
bojnice21: folds 
*** FLOP *** [5h 4h 7c]
vagoneta16: checks 
kiling1: bets $0.07
vagoneta16: folds 
Uncalled bet ($0.07) returned to kiling1
kiling1 collected $0.14 from pot
kiling1: doesn't show hand 
*** SUMMARY ***
Total pot $0.15 | Rake $0.01 
Board [5h 4h 7c]
Seat 1: Seregaa1998 (small blind) folded before Flop
Seat 2: bojnice21 (big blind) folded before Flop
Seat 3: Mr_Zh.Evgeniy folded before Flop (didn't bet)
Seat 4: vagoneta16 folded on the Flop
Seat 5: caroteen folded before Flop (didn't bet)
Seat 6: KiDraybeon folded before Flop (didn't bet)
Seat 7: Dorex2007 folded before Flop (didn't bet)
Seat 8: kiling1 collected ($0.14)
Seat 9: BrykmiD (button) folded before Flop (didn't bet)



PokerStars Hand #225160520631:  Hold'em No Limit ($0.01/$0.02 USD) - 2021/03/24 23:55:58 PT [2021/03/25 2:55:58 ET]
Table 'Belopolskya VI' 9-max Seat #1 is the button
Seat 1: Seregaa1998 ($2.09 in chips) 
Seat 2: bojnice21 ($2.33 in chips) 
Seat 3: Mr_Zh.Evgeniy ($0.90 in chips) 
Seat 4: vagoneta16 ($1.83 in chips) 
Seat 5: caroteen ($0.52 in chips) 
Seat 6: KiDraybeon ($2.18 in chips) 
Seat 7: Dorex2007 ($1.68 in chips) 
Seat 8: kiling1 ($2.30 in chips) 
Seat 9: BrykmiD ($2.06 in chips) 
bojnice21: posts small blind $0.01
Mr_Zh.Evgeniy: posts big blind $0.02
*** HOLE CARDS ***
Dealt to Dorex2007 [2h Jc]
vagoneta16 has timed out
vagoneta16: folds 
caroteen: calls $0.02
KiDraybeon: folds 
Dorex2007: folds 
kiling1: folds 
BrykmiD: folds 
Seregaa1998: raises $0.04 to $0.06
bojnice21: folds 
Mr_Zh.Evgeniy: calls $0.04
caroteen: calls $0.04
*** FLOP *** [Kd Td 3s]
Mr_Zh.Evgeniy: checks 
caroteen: bets $0.02
Seregaa1998: calls $0.02
Mr_Zh.Evgeniy: folds 
*** TURN *** [Kd Td 3s] [7s]
caroteen: checks 
Seregaa1998: bets $0.15
caroteen: calls $0.15
*** RIVER *** [Kd Td 3s 7s] [7d]
caroteen: bets $0.29 and is all-in
Seregaa1998: folds 
Uncalled bet ($0.29) returned to caroteen
caroteen collected $0.51 from pot
caroteen: doesn't show hand 
*** SUMMARY ***
Total pot $0.53 | Rake $0.02 
Board [Kd Td 3s 7s 7d]
Seat 1: Seregaa1998 (button) folded on the River
Seat 2: bojnice21 (small blind) folded before Flop
Seat 3: Mr_Zh.Evgeniy (big blind) folded on the Flop
Seat 4: vagoneta16 folded before Flop (didn't bet)
Seat 5: caroteen collected ($0.51)
Seat 6: KiDraybeon folded before Flop (didn't bet)
Seat 7: Dorex2007 folded before Flop (didn't bet)
Seat 8: kiling1 folded before Flop (didn't bet)
Seat 9: BrykmiD folded before Flop (didn't bet)



PokerStars Hand #225160532539:  Hold'em No Limit ($0.01/$0.02 USD) - 2021/03/24 23:57:27 PT [2021/03/25 2:57:27 ET]
Table 'Belopolskya VI' 9-max Seat #2 is the button
Seat 1: Seregaa1998 ($2 in chips) 
Seat 2: bojnice21 ($2.32 in chips) 
Seat 3: Mr_Zh.Evgeniy ($0.84 in chips) 
Seat 4: vagoneta16 ($1.83 in chips) 
Seat 5: caroteen ($0.80 in chips) 
Seat 6: KiDraybeon ($2.18 in chips) 
Seat 7: Dorex2007 ($1.68 in chips) 
Seat 8: kiling1 ($2.30 in chips) 
Seat 9: BrykmiD ($2.06 in chips) 
Mr_Zh.Evgeniy: posts small blind $0.01
vagoneta16: posts big blind $0.02
*** HOLE CARDS ***
Dealt to Dorex2007 [Jc Ac]
caroteen: folds 
KiDraybeon: folds 
Dorex2007: raises $0.04 to $0.06
kiling1: folds 
kiling1 leaves the table
BrykmiD: folds 
Seregaa1998: folds 
bojnice21: folds 
Mr_Zh.Evgeniy: folds 
vagoneta16: folds 
Uncalled bet ($0.04) returned to Dorex2007
Dorex2007 collected $0.05 from pot
Dorex2007: doesn't show hand 
*** SUMMARY ***
Total pot $0.05 | Rake $0 
Seat 1: Seregaa1998 folded before Flop (didn't bet)
Seat 2: bojnice21 (button) folded before Flop (didn't bet)
Seat 3: Mr_Zh.Evgeniy (small blind) folded before Flop
Seat 4: vagoneta16 (big blind) folded before Flop
Seat 5: caroteen folded before Flop (didn't bet)
Seat 6: KiDraybeon folded before Flop (didn't bet)
Seat 7: Dorex2007 collected ($0.05)
Seat 8: kiling1 folded before Flop (didn't bet)
Seat 9: BrykmiD folded before Flop (didn't bet)



PokerStars Hand #225160536530:  Hold'em No Limit ($0.01/$0.02 USD) - 2021/03/24 23:57:57 PT [2021/03/25 2:57:57 ET]
Table 'Belopolskya VI' 9-max Seat #3 is the button
Seat 1: Seregaa1998 ($2 in chips) 
Seat 2: bojnice21 ($2.32 in chips) 
Seat 3: Mr_Zh.Evgeniy ($0.83 in chips) 
Seat 4: vagoneta16 ($1.81 in chips) 
Seat 5: caroteen ($0.80 in chips) 
Seat 6: KiDraybeon ($2.18 in chips) 
Seat 7: Dorex2007 ($1.71 in chips) 
Seat 9: BrykmiD ($2.06 in chips) 
vagoneta16: posts small blind $0.01
caroteen: posts big blind $0.02
*** HOLE CARDS ***
Dealt to Dorex2007 [6h Qc]
KiDraybeon: folds 
Dorex2007: folds 
KiDraybeon said, "sorry just for fun;;;"
BrykmiD: folds 
Seregaa1998: folds 
KiDraybeon leaves the table
bojnice21: folds 
Mr_Zh.Evgeniy: folds 
Sharan628 joins the table at seat #6 
vagoneta16: raises $0.04 to $0.06
caroteen: folds 
Uncalled bet ($0.04) returned to vagoneta16
vagoneta16 collected $0.04 from pot
vagoneta16: doesn't show hand 
*** SUMMARY ***
Total pot $0.04 | Rake $0 
Seat 1: Seregaa1998 folded before Flop (didn't bet)
Seat 2: bojnice21 folded before Flop (didn't bet)
Seat 3: Mr_Zh.Evgeniy (button) folded before Flop (didn't bet)
Seat 4: vagoneta16 (small blind) collected ($0.04)
Seat 5: caroteen (big blind) folded before Flop
Seat 6: KiDraybeon folded before Flop (didn't bet)
Seat 7: Dorex2007 folded before Flop (didn't bet)
Seat 9: BrykmiD folded before Flop (didn't bet)



PokerStars Hand #225160540314:  Hold'em No Limit ($0.01/$0.02 USD) - 2021/03/24 23:58:25 PT [2021/03/25 2:58:25 ET]
Table 'Belopolskya VI' 9-max Seat #4 is the button
Seat 1: Seregaa1998 ($2 in chips) 
Seat 2: bojnice21 ($2.32 in chips) 
Seat 3: Mr_Zh.Evgeniy ($0.83 in chips) 
Seat 4: vagoneta16 ($1.83 in chips) 
Seat 5: caroteen ($0.78 in chips) 
Seat 6: Sharan628 ($2 in chips) 
Seat 7: Dorex2007 ($1.71 in chips) 
Seat 9: BrykmiD ($2.06 in chips) 
caroteen: posts small blind $0.01
Sharan628: posts big blind $0.02
*** HOLE CARDS ***
Dealt to Dorex2007 [9h 3c]
Dorex2007: folds 
BrykmiD: folds 
Seregaa1998: folds 
bojnice21: folds 
Mr_Zh.Evgeniy: raises $0.04 to $0.06
bojnice21 leaves the table
vagoneta16: folds 
caroteen: raises $0.72 to $0.78 and is all-in
Sharan628: folds 
Mr_Zh.Evgeniy: calls $0.72
*** FLOP *** [5s Jc 4h]
*** TURN *** [5s Jc 4h] [7c]
*** RIVER *** [5s Jc 4h 7c] [3s]
*** SHOW DOWN ***
caroteen: shows [5d 5h] (three of a kind, Fives)
Mr_Zh.Evgeniy: shows [Qs Ah] (high card Ace)
caroteen cashed out the hand for $0.82 | Cash Out Fee $0.01
*** SUMMARY ***
Total pot $1.58 | Rake $0.06 
Board [5s Jc 4h 7c 3s]
Seat 1: Seregaa1998 folded before Flop (didn't bet)
Seat 2: bojnice21 folded before Flop (didn't bet)
Seat 3: Mr_Zh.Evgeniy showed [Qs Ah] and lost with high card Ace
Seat 4: vagoneta16 (button) folded before Flop (didn't bet)
Seat 5: caroteen (small blind) showed [5d 5h] and won ($1.52) with three of a kind, Fives (pot not awarded as player cashed out)
Seat 6: Sharan628 (big blind) folded before Flop
Seat 7: Dorex2007 folded before Flop (didn't bet)
Seat 9: BrykmiD folded before Flop (didn't bet)



PokerStars Hand #225160545591:  Hold'em No Limit ($0.01/$0.02 USD) - 2021/03/24 23:59:05 PT [2021/03/25 2:59:05 ET]
Table 'Belopolskya VI' 9-max Seat #5 is the button
Seat 1: Seregaa1998 ($2 in chips) 
Seat 4: vagoneta16 ($1.83 in chips) 
Seat 5: caroteen ($0.82 in chips) 
Seat 6: Sharan628 ($1.98 in chips) 
Seat 7: Dorex2007 ($1.71 in chips) 
Seat 9: BrykmiD ($2.06 in chips) 
Sharan628: posts small blind $0.01
Dorex2007: posts big blind $0.02
*** HOLE CARDS ***
Dealt to Dorex2007 [Ah 9s]
Mr_Zh.Evgeniy leaves the table
BrykmiD: folds 
Seregaa1998: folds 
vagoneta16: folds 
caroteen: folds 
caroteen leaves the table
Sharan628: folds 
Uncalled bet ($0.01) returned to Dorex2007
Dorex2007 collected $0.02 from pot
Dorex2007: doesn't show hand 
*** SUMMARY ***
Total pot $0.02 | Rake $0 
Seat 1: Seregaa1998 folded before Flop (didn't bet)
Seat 4: vagoneta16 folded before Flop (didn't bet)
Seat 5: caroteen (button) folded before Flop (didn't bet)
Seat 6: Sharan628 (small blind) folded before Flop
Seat 7: Dorex2007 (big blind) collected ($0.02)
Seat 9: BrykmiD folded before Flop (didn't bet)



PokerStars Hand #225160547847:  Hold'em No Limit ($0.01/$0.02 USD) - 2021/03/24 23:59:22 PT [2021/03/25 2:59:22 ET]
Table 'Belopolskya VI' 9-max Seat #6 is the button
Seat 1: Seregaa1998 ($2 in chips) 
Seat 4: vagoneta16 ($1.83 in chips) 
Seat 6: Sharan628 ($1.97 in chips) 
Seat 7: Dorex2007 ($1.72 in chips) 
Seat 9: BrykmiD ($2.06 in chips) 
Dorex2007: posts small blind $0.01
BrykmiD: posts big blind $0.02
*** HOLE CARDS ***
Dealt to Dorex2007 [7d 5c]
Seregaa1998: folds 
npcqaz joins the table at seat #2 
vagoneta16: folds 
Sharan628: folds 
Dorex2007: folds 
Uncalled bet ($0.01) returned to BrykmiD
BrykmiD collected $0.02 from pot
*** SUMMARY ***
Total pot $0.02 | Rake $0 
Seat 1: Seregaa1998 folded before Flop (didn't bet)
Seat 4: vagoneta16 folded before Flop (didn't bet)
Seat 6: Sharan628 (button) folded before Flop (didn't bet)
Seat 7: Dorex2007 (small blind) folded before Flop
Seat 9: BrykmiD (big blind) collected ($0.02)



PokerStars Hand #225160550423:  Hold'em No Limit ($0.01/$0.02 USD) - 2021/03/24 23:59:41 PT [2021/03/25 2:59:41 ET]
Table 'Belopolskya VI' 9-max Seat #7 is the button
Seat 1: Seregaa1998 ($2 in chips) 
Seat 4: vagoneta16 ($1.83 in chips) 
Seat 6: Sharan628 ($1.97 in chips) 
Seat 7: Dorex2007 ($1.71 in chips) 
Seat 9: BrykmiD ($2.07 in chips) 
BrykmiD: posts small blind $0.01
Seregaa1998: posts big blind $0.02
npcqaz: sits out 
*** HOLE CARDS ***
Dealt to Dorex2007 [5h 7s]
vagoneta16: folds 
Sharan628: folds 
Dorex2007: folds 
BrykmiD: raises $0.06 to $0.08
Seregaa1998: folds 
Uncalled bet ($0.06) returned to BrykmiD
BrykmiD collected $0.04 from pot
*** SUMMARY ***
Total pot $0.04 | Rake $0 
Seat 1: Seregaa1998 (big blind) folded before Flop
Seat 4: vagoneta16 folded before Flop (didn't bet)
Seat 6: Sharan628 folded before Flop (didn't bet)
Seat 7: Dorex2007 (button) folded before Flop (didn't bet)
Seat 9: BrykmiD (small blind) collected ($0.04)



PokerStars Hand #225160553264:  Hold'em No Limit ($0.01/$0.02 USD) - 2021/03/25 0:00:02 PT [2021/03/25 3:00:02 ET]
Table 'Belopolskya VI' 9-max Seat #9 is the button
Seat 1: Seregaa1998 ($2 in chips) 
Seat 2: npcqaz ($1.60 in chips) 
Seat 4: vagoneta16 ($1.83 in chips) 
Seat 6: Sharan628 ($1.97 in chips) 
Seat 7: Dorex2007 ($1.71 in chips) 
Seat 9: BrykmiD ($2.09 in chips) 
Seregaa1998: posts small blind $0.01
npcqaz: posts big blind $0.02
*** HOLE CARDS ***
Dealt to Dorex2007 [6s 6d]
vagoneta16: folds 
ALelesin joins the table at seat #3 
Sharan628: folds 
Dorex2007: raises $0.04 to $0.06
BrykmiD: folds 
Seregaa1998: folds 
npcqaz: folds 
Uncalled bet ($0.04) returned to Dorex2007
Dorex2007 collected $0.05 from pot
Dorex2007: doesn't show hand 
*** SUMMARY ***
Total pot $0.05 | Rake $0 
Seat 1: Seregaa1998 (small blind) folded before Flop
Seat 2: npcqaz (big blind) folded before Flop
Seat 4: vagoneta16 folded before Flop (didn't bet)
Seat 6: Sharan628 folded before Flop (didn't bet)
Seat 7: Dorex2007 collected ($0.05)
Seat 9: BrykmiD (button) folded before Flop (didn't bet)



PokerStars Hand #225160556752:  Hold'em No Limit ($0.01/$0.02 USD) - 2021/03/25 0:00:27 PT [2021/03/25 3:00:27 ET]
Table 'Belopolskya VI' 9-max Seat #1 is the button
Seat 1: Seregaa1998 ($2 in chips) 
Seat 2: npcqaz ($1.58 in chips) 
Seat 3: ALelesin ($2 in chips) 
Seat 4: vagoneta16 ($1.83 in chips) 
Seat 6: Sharan628 ($1.97 in chips) 
Seat 7: Dorex2007 ($1.74 in chips) 
Seat 9: BrykmiD ($2.09 in chips) 
npcqaz: posts small blind $0.01
ALelesin: posts big blind $0.02
*** HOLE CARDS ***
Dealt to Dorex2007 [2h 5d]
dimitriusDZ joins the table at seat #5 
vagoneta16: folds 
Sharan628: folds 
Dorex2007: folds 
BrykmiD: folds 
Seregaa1998: folds 
npcqaz: raises $0.02 to $0.04
ALelesin: folds 
Uncalled bet ($0.02) returned to npcqaz
npcqaz collected $0.04 from pot
npcqaz: doesn't show hand 
*** SUMMARY ***
Total pot $0.04 | Rake $0 
Seat 1: Seregaa1998 (button) folded before Flop (didn't bet)
Seat 2: npcqaz (small blind) collected ($0.04)
Seat 3: ALelesin (big blind) folded before Flop
Seat 4: vagoneta16 folded before Flop (didn't bet)
Seat 6: Sharan628 folded before Flop (didn't bet)
Seat 7: Dorex2007 folded before Flop (didn't bet)
Seat 9: BrykmiD folded before Flop (didn't bet)



PokerStars Hand #225160558957:  Hold'em No Limit ($0.01/$0.02 USD) - 2021/03/25 0:00:42 PT [2021/03/25 3:00:42 ET]
Table 'Belopolskya VI' 9-max Seat #2 is the button
Seat 1: Seregaa1998 ($2 in chips) 
Seat 2: npcqaz ($1.60 in chips) 
Seat 3: ALelesin ($1.98 in chips) 
Seat 5: dimitriusDZ ($2 in chips) 
Seat 6: Sharan628 ($1.97 in chips) 
Seat 7: Dorex2007 ($1.74 in chips) 
Seat 9: BrykmiD ($2.09 in chips) 
ALelesin: posts small blind $0.01
vagoneta16: is sitting out 
dimitriusDZ: posts big blind $0.02
*** HOLE CARDS ***
Dealt to Dorex2007 [Kc 4c]
Sharan628: folds 
Dorex2007: folds 
BrykmiD: folds 
Seregaa1998: folds 
npcqaz: folds 
ALelesin: folds 
Uncalled bet ($0.01) returned to dimitriusDZ
dimitriusDZ collected $0.02 from pot
dimitriusDZ: doesn't show hand 
*** SUMMARY ***
Total pot $0.02 | Rake $0 
Seat 1: Seregaa1998 folded before Flop (didn't bet)
Seat 2: npcqaz (button) folded before Flop (didn't bet)
Seat 3: ALelesin (small blind) folded before Flop
Seat 5: dimitriusDZ (big blind) collected ($0.02)
Seat 6: Sharan628 folded before Flop (didn't bet)
Seat 7: Dorex2007 folded before Flop (didn't bet)
Seat 9: BrykmiD folded before Flop (didn't bet)



PokerStars Hand #225160561057:  Hold'em No Limit ($0.01/$0.02 USD) - 2021/03/25 0:00:56 PT [2021/03/25 3:00:56 ET]
Table 'Belopolskya VI' 9-max Seat #3 is the button
Seat 1: Seregaa1998 ($2 in chips) 
Seat 2: npcqaz ($1.60 in chips) 
Seat 3: ALelesin ($1.97 in chips) 
Seat 5: dimitriusDZ ($2.01 in chips) 
Seat 6: Sharan628 ($1.97 in chips) 
Seat 7: Dorex2007 ($1.74 in chips) 
Seat 9: BrykmiD ($2.09 in chips) 
dimitriusDZ: posts small blind $0.01
Sharan628: posts big blind $0.02
*** HOLE CARDS ***
Dealt to Dorex2007 [8s Tc]
Dorex2007: folds 
BrykmiD: raises $0.06 to $0.08
Seregaa1998: folds 
npcqaz: calls $0.08
ALelesin: folds 
Artuzo127 joins the table at seat #8 
dimitriusDZ: folds 
Sharan628: folds 
*** FLOP *** [6d 4d 7s]
BrykmiD: checks 
npcqaz: bets $0.18
BrykmiD: folds 
Uncalled bet ($0.18) returned to npcqaz
npcqaz collected $0.18 from pot
npcqaz: doesn't show hand 
*** SUMMARY ***
Total pot $0.19 | Rake $0.01 
Board [6d 4d 7s]
Seat 1: Seregaa1998 folded before Flop (didn't bet)
Seat 2: npcqaz collected ($0.18)
Seat 3: ALelesin (button) folded before Flop (didn't bet)
Seat 5: dimitriusDZ (small blind) folded before Flop
Seat 6: Sharan628 (big blind) folded before Flop
Seat 7: Dorex2007 folded before Flop (didn't bet)
Seat 9: BrykmiD folded on the Flop



PokerStars Hand #225160568077:  Hold'em No Limit ($0.01/$0.02 USD) - 2021/03/25 0:01:42 PT [2021/03/25 3:01:42 ET]
Table 'Belopolskya VI' 9-max Seat #5 is the button
Seat 1: Seregaa1998 ($2 in chips) 
Seat 2: npcqaz ($1.70 in chips) 
Seat 3: ALelesin ($1.97 in chips) 
Seat 5: dimitriusDZ ($2 in chips) 
Seat 6: Sharan628 ($1.95 in chips) 
Seat 7: Dorex2007 ($1.74 in chips) 
Seat 8: Artuzo127 ($2 in chips) 
Seat 9: BrykmiD ($2.01 in chips) 
Sharan628: posts small blind $0.01
Dorex2007: posts big blind $0.02
Artuzo127: posts big blind $0.02
*** HOLE CARDS ***
Dealt to Dorex2007 [Tc Ah]
Artuzo127: checks 
BrykmiD: folds 
Seregaa1998: folds 
npcqaz: folds 
ALelesin: raises $0.04 to $0.06
dimitriusDZ: raises $0.17 to $0.23
Sharan628: folds 
Dorex2007: folds 
Artuzo127: folds 
ALelesin: folds 
Uncalled bet ($0.17) returned to dimitriusDZ
dimitriusDZ collected $0.17 from pot
dimitriusDZ: doesn't show hand 
*** SUMMARY ***
Total pot $0.17 | Rake $0 
Seat 1: Seregaa1998 folded before Flop (didn't bet)
Seat 2: npcqaz folded before Flop (didn't bet)
Seat 3: ALelesin folded before Flop
Seat 5: dimitriusDZ (button) collected ($0.17)
Seat 6: Sharan628 (small blind) folded before Flop
Seat 7: Dorex2007 (big blind) folded before Flop
Seat 8: Artuzo127 folded before Flop (didn't bet)
Seat 9: BrykmiD folded before Flop (didn't bet)



PokerStars Hand #225160572781:  Hold'em No Limit ($0.01/$0.02 USD) - 2021/03/25 0:02:14 PT [2021/03/25 3:02:14 ET]
Table 'Belopolskya VI' 9-max Seat #6 is the button
Seat 1: Seregaa1998 ($2 in chips) 
Seat 2: npcqaz ($1.70 in chips) 
Seat 3: ALelesin ($1.91 in chips) 
Seat 5: dimitriusDZ ($2.11 in chips) 
Seat 6: Sharan628 ($1.94 in chips) 
Seat 7: Dorex2007 ($1.72 in chips) 
Seat 8: Artuzo127 ($1.98 in chips) 
Seat 9: BrykmiD ($2.01 in chips) 
Dorex2007: posts small blind $0.01
Artuzo127: posts big blind $0.02
*** HOLE CARDS ***
Dealt to Dorex2007 [Td Qh]
BrykmiD: folds 
Seregaa1998: folds 
npcqaz: folds 
ALelesin: folds 
dimitriusDZ: folds 
Sharan628: folds 
Dorex2007: calls $0.01
vagoneta16 leaves the table
Artuzo127: raises $0.04 to $0.06
Dorex2007: calls $0.04
*** FLOP *** [9s 5d Tc]
Dorex2007: bets $0.12
Artuzo127: calls $0.12
*** TURN *** [9s 5d Tc] [4c]
Dorex2007: bets $0.35
Artuzo127: calls $0.35
*** RIVER *** [9s 5d Tc 4c] [Jh]
Dorex2007: checks 
Artuzo127: bets $1.02
fektivno joins the table at seat #4 
Dorex2007: calls $1.02
*** SHOW DOWN ***
Artuzo127: shows [Kh Qs] (a straight, Nine to King)
Dorex2007: mucks hand 
Artuzo127 collected $2.99 from pot
*** SUMMARY ***
Total pot $3.10 | Rake $0.11 
Board [9s 5d Tc 4c Jh]
Seat 1: Seregaa1998 folded before Flop (didn't bet)
Seat 2: npcqaz folded before Flop (didn't bet)
Seat 3: ALelesin folded before Flop (didn't bet)
Seat 5: dimitriusDZ folded before Flop (didn't bet)
Seat 6: Sharan628 (button) folded before Flop (didn't bet)
Seat 7: Dorex2007 (small blind) mucked [Td Qh]
Seat 8: Artuzo127 (big blind) showed [Kh Qs] and won ($2.99) with a straight, Nine to King
Seat 9: BrykmiD folded before Flop (didn't bet)



PokerStars Hand #225160581011:  Hold'em No Limit ($0.01/$0.02 USD) - 2021/03/25 0:03:08 PT [2021/03/25 3:03:08 ET]
Table 'Belopolskya VI' 9-max Seat #7 is the button
Seat 1: Seregaa1998 ($2 in chips) 
Seat 2: npcqaz ($1.70 in chips) 
Seat 3: ALelesin ($1.91 in chips) 
Seat 5: dimitriusDZ ($2.11 in chips) 
Seat 6: Sharan628 ($1.94 in chips) 
Seat 7: Dorex2007 ($0.17 in chips) 
Seat 8: Artuzo127 ($3.42 in chips) 
Seat 9: BrykmiD ($2.01 in chips) 
Artuzo127: posts small blind $0.01
BrykmiD: posts big blind $0.02
fektivno: sits out 
*** HOLE CARDS ***
Dealt to Dorex2007 [Th 6d]
Seregaa1998: folds 
npcqaz: raises $0.08 to $0.10
ALelesin: calls $0.10
dimitriusDZ: folds 
Sharan628: folds 
Dorex2007: folds 
Artuzo127: calls $0.09
BrykmiD: folds 
*** FLOP *** [5d 9c Qh]
Artuzo127: checks 
npcqaz: checks 
ALelesin: bets $0.16
Artuzo127: folds 
npcqaz: calls $0.16
*** TURN *** [5d 9c Qh] [Jd]
npcqaz: checks 
ALelesin: checks 
*** RIVER *** [5d 9c Qh Jd] [7s]
npcqaz: checks 
ALelesin: checks 
*** SHOW DOWN ***
npcqaz: shows [Js Ts] (a pair of Jacks)
ALelesin: mucks hand 
npcqaz collected $0.62 from pot
*** SUMMARY ***
Total pot $0.64 | Rake $0.02 
Board [5d 9c Qh Jd 7s]
Seat 1: Seregaa1998 folded before Flop (didn't bet)
Seat 2: npcqaz showed [Js Ts] and won ($0.62) with a pair of Jacks
Seat 3: ALelesin mucked [8s 8d]
Seat 5: dimitriusDZ folded before Flop (didn't bet)
Seat 6: Sharan628 folded before Flop (didn't bet)
Seat 7: Dorex2007 (button) folded before Flop (didn't bet)
Seat 8: Artuzo127 (small blind) folded on the Flop
Seat 9: BrykmiD (big blind) folded before Flop



PokerStars Hand #225160587782:  Hold'em No Limit ($0.01/$0.02 USD) - 2021/03/25 0:03:51 PT [2021/03/25 3:03:51 ET]
Table 'Belopolskya VI' 9-max Seat #8 is the button
Seat 1: Seregaa1998 ($2 in chips) 
Seat 2: npcqaz ($2.06 in chips) 
Seat 3: ALelesin ($1.65 in chips) 
Seat 5: dimitriusDZ ($2.11 in chips) 
Seat 6: Sharan628 ($1.94 in chips) 
Seat 7: Dorex2007 ($2 in chips) 
Seat 8: Artuzo127 ($3.32 in chips) 
Seat 9: BrykmiD ($1.99 in chips) 
BrykmiD: posts small blind $0.01
Seregaa1998: posts big blind $0.02
fektivno: sits out 
*** HOLE CARDS ***
Dealt to Dorex2007 [Js Tc]
npcqaz: folds 
ALelesin: folds 
dimitriusDZ: raises $0.03 to $0.05
Sharan628: folds 
Dorex2007: folds 
Artuzo127: calls $0.05
BrykmiD: folds 
Seregaa1998: folds 
*** FLOP *** [9c 3s 2s]
dimitriusDZ: bets $0.06
Artuzo127: folds 
Uncalled bet ($0.06) returned to dimitriusDZ
dimitriusDZ collected $0.13 from pot
dimitriusDZ: doesn't show hand 
*** SUMMARY ***
Total pot $0.13 | Rake $0 
Board [9c 3s 2s]
Seat 1: Seregaa1998 (big blind) folded before Flop
Seat 2: npcqaz folded before Flop (didn't bet)
Seat 3: ALelesin folded before Flop (didn't bet)
Seat 5: dimitriusDZ collected ($0.13)
Seat 6: Sharan628 folded before Flop (didn't bet)
Seat 7: Dorex2007 folded before Flop (didn't bet)
Seat 8: Artuzo127 (button) folded on the Flop
Seat 9: BrykmiD (small blind) folded before Flop



PokerStars Hand #225160591932:  Hold'em No Limit ($0.01/$0.02 USD) - 2021/03/25 0:04:18 PT [2021/03/25 3:04:18 ET]
Table 'Belopolskya VI' 9-max Seat #9 is the button
Seat 1: Seregaa1998 ($2 in chips) 
Seat 2: npcqaz ($2.06 in chips) 
Seat 3: ALelesin ($1.65 in chips) 
Seat 5: dimitriusDZ ($2.19 in chips) 
Seat 6: Sharan628 ($1.94 in chips) 
Seat 7: Dorex2007 ($2 in chips) 
Seat 8: Artuzo127 ($3.27 in chips) 
Seat 9: BrykmiD ($1.98 in chips) 
Seregaa1998: posts small blind $0.01
npcqaz: posts big blind $0.02
fektivno: sits out 
*** HOLE CARDS ***
Dealt to Dorex2007 [7s 2c]
ALelesin: folds 
dimitriusDZ: folds 
Sharan628: folds 
Dorex2007: folds 
Artuzo127: raises $0.02 to $0.04
BrykmiD: folds 
Seregaa1998: folds 
npcqaz: raises $0.06 to $0.10
Artuzo127: calls $0.06
*** FLOP *** [Kd Th 9d]
npcqaz: bets $0.10
Artuzo127: folds 
Uncalled bet ($0.10) returned to npcqaz
npcqaz collected $0.20 from pot
npcqaz: doesn't show hand 
*** SUMMARY ***
Total pot $0.21 | Rake $0.01 
Board [Kd Th 9d]
Seat 1: Seregaa1998 (small blind) folded before Flop
Seat 2: npcqaz (big blind) collected ($0.20)
Seat 3: ALelesin folded before Flop (didn't bet)
Seat 5: dimitriusDZ folded before Flop (didn't bet)
Seat 6: Sharan628 folded before Flop (didn't bet)
Seat 7: Dorex2007 folded before Flop (didn't bet)
Seat 8: Artuzo127 folded on the Flop
Seat 9: BrykmiD (button) folded before Flop (didn't bet)



PokerStars Hand #225160598509:  Hold'em No Limit ($0.01/$0.02 USD) - 2021/03/25 0:05:01 PT [2021/03/25 3:05:01 ET]
Table 'Belopolskya VI' 9-max Seat #1 is the button
Seat 1: Seregaa1998 ($2 in chips) 
Seat 2: npcqaz ($2.16 in chips) 
Seat 3: ALelesin ($1.65 in chips) 
Seat 5: dimitriusDZ ($2.19 in chips) 
Seat 6: Sharan628 ($1.94 in chips) 
Seat 7: Dorex2007 ($2 in chips) 
Seat 8: Artuzo127 ($3.17 in chips) 
Seat 9: BrykmiD ($1.98 in chips) 
npcqaz: posts small blind $0.01
ALelesin: posts big blind $0.02
fektivno: sits out 
*** HOLE CARDS ***
Dealt to Dorex2007 [5h 2c]
dimitriusDZ has timed out
dimitriusDZ: folds 
Sharan628: folds 
Dorex2007: folds 
Artuzo127: calls $0.02
BrykmiD: calls $0.02
Seregaa1998: folds 
npcqaz: calls $0.01
ALelesin: checks 
*** FLOP *** [4c Tc Jd]
npcqaz: checks 
ALelesin: checks 
Artuzo127: checks 
BrykmiD: bets $0.05
npcqaz: calls $0.05
ALelesin: folds 
Artuzo127: folds 
*** TURN *** [4c Tc Jd] [5s]
npcqaz: checks 
BrykmiD: bets $0.08
npcqaz: calls $0.08
*** RIVER *** [4c Tc Jd 5s] [3c]
npcqaz: bets $0.33
BrykmiD: calls $0.33
*** SHOW DOWN ***
npcqaz: shows [Qd 9c] (high card Queen)
BrykmiD: shows [Th Jh] (two pair, Jacks and Tens)
BrykmiD collected $0.96 from pot
*** SUMMARY ***
Total pot $1 | Rake $0.04 
Board [4c Tc Jd 5s 3c]
Seat 1: Seregaa1998 (button) folded before Flop (didn't bet)
Seat 2: npcqaz (small blind) showed [Qd 9c] and lost with high card Queen
Seat 3: ALelesin (big blind) folded on the Flop
Seat 5: dimitriusDZ folded before Flop (didn't bet)
Seat 6: Sharan628 folded before Flop (didn't bet)
Seat 7: Dorex2007 folded before Flop (didn't bet)
Seat 8: Artuzo127 folded on the Flop
Seat 9: BrykmiD showed [Th Jh] and won ($0.96) with two pair, Jacks and Tens



PokerStars Hand #225160612033:  Hold'em No Limit ($0.01/$0.02 USD) - 2021/03/25 0:05:51 PT [2021/03/25 3:05:51 ET]
Table 'Belopolskya VI' 9-max Seat #2 is the button
Seat 1: Seregaa1998 ($2 in chips) 
Seat 2: npcqaz ($1.68 in chips) 
Seat 3: ALelesin ($2 in chips) 
Seat 4: fektivno ($2 in chips) 
Seat 5: dimitriusDZ ($2.19 in chips) 
Seat 6: Sharan628 ($1.94 in chips) 
Seat 7: Dorex2007 ($2 in chips) 
Seat 8: Artuzo127 ($3.15 in chips) 
Seat 9: BrykmiD ($2.46 in chips) 
ALelesin: posts small blind $0.01
fektivno: posts big blind $0.02
*** HOLE CARDS ***
Dealt to Dorex2007 [5s 3s]
dimitriusDZ has timed out
dimitriusDZ: folds 
Sharan628: folds 
Dorex2007: folds 
Artuzo127: folds 
BrykmiD: folds 
Seregaa1998: folds 
npcqaz: folds 
ALelesin: calls $0.01
fektivno: checks 
*** FLOP *** [Jc As Js]
ALelesin: checks 
fektivno: checks 
*** TURN *** [Jc As Js] [9s]
ALelesin: checks 
fektivno: bets $0.03
ALelesin: folds 
Uncalled bet ($0.03) returned to fektivno
fektivno collected $0.04 from pot
fektivno: doesn't show hand 
*** SUMMARY ***
Total pot $0.04 | Rake $0 
Board [Jc As Js 9s]
Seat 1: Seregaa1998 folded before Flop (didn't bet)
Seat 2: npcqaz (button) folded before Flop (didn't bet)
Seat 3: ALelesin (small blind) folded on the Turn
Seat 4: fektivno (big blind) collected ($0.04)
Seat 5: dimitriusDZ folded before Flop (didn't bet)
Seat 6: Sharan628 folded before Flop (didn't bet)
Seat 7: Dorex2007 folded before Flop (didn't bet)
Seat 8: Artuzo127 folded before Flop (didn't bet)
Seat 9: BrykmiD folded before Flop (didn't bet)



PokerStars Hand #225160617559:  Hold'em No Limit ($0.01/$0.02 USD) - 2021/03/25 0:06:27 PT [2021/03/25 3:06:27 ET]
Table 'Belopolskya VI' 9-max Seat #3 is the button
Seat 1: Seregaa1998 ($2 in chips) 
Seat 2: npcqaz ($1.68 in chips) 
Seat 3: ALelesin ($1.98 in chips) 
Seat 4: fektivno ($2.02 in chips) 
Seat 6: Sharan628 ($1.94 in chips) 
Seat 7: Dorex2007 ($2 in chips) 
Seat 8: Artuzo127 ($3.15 in chips) 
Seat 9: BrykmiD ($2.46 in chips) 
fektivno: posts small blind $0.01
Sharan628: posts big blind $0.02
*** HOLE CARDS ***
Dealt to Dorex2007 [8d Td]
Dorex2007: folds 
Artuzo127: calls $0.02
BrykmiD: folds 
Seregaa1998: raises $0.04 to $0.06
npcqaz: folds 
ALelesin: folds 
fektivno: folds 
Sharan628: raises $0.21 to $0.27
Artuzo127: calls $0.25
Seregaa1998: calls $0.21
*** FLOP *** [9c 3c 5h]
Sharan628: bets $1.67 and is all-in
Artuzo127: folds 
Seregaa1998: calls $1.67
*** TURN *** [9c 3c 5h] [7s]
*** RIVER *** [9c 3c 5h 7s] [Ah]
*** SHOW DOWN ***
Sharan628: shows [As Ad] (three of a kind, Aces)
Seregaa1998: shows [Ac 4c] (a pair of Aces)
Sharan628 collected $4.01 from pot
*** SUMMARY ***
Total pot $4.16 | Rake $0.15 
Board [9c 3c 5h 7s Ah]
Seat 1: Seregaa1998 showed [Ac 4c] and lost with a pair of Aces
Seat 2: npcqaz folded before Flop (didn't bet)
Seat 3: ALelesin (button) folded before Flop (didn't bet)
Seat 4: fektivno (small blind) folded before Flop
Seat 6: Sharan628 (big blind) showed [As Ad] and won ($4.01) with three of a kind, Aces
Seat 7: Dorex2007 folded before Flop (didn't bet)
Seat 8: Artuzo127 folded on the Flop
Seat 9: BrykmiD folded before Flop (didn't bet)



PokerStars Hand #225160627277:  Hold'em No Limit ($0.01/$0.02 USD) - 2021/03/25 0:07:30 PT [2021/03/25 3:07:30 ET]
Table 'Belopolskya VI' 9-max Seat #4 is the button
Seat 1: Seregaa1998 ($2 in chips) 
Seat 2: npcqaz ($1.68 in chips) 
Seat 3: ALelesin ($1.98 in chips) 
Seat 4: fektivno ($2.01 in chips) 
Seat 6: Sharan628 ($4.01 in chips) 
Seat 7: Dorex2007 ($2 in chips) 
Seat 8: Artuzo127 ($2.88 in chips) 
Seat 9: BrykmiD ($2.46 in chips) 
Sharan628: posts small blind $0.01
Dorex2007: posts big blind $0.02
*** HOLE CARDS ***
Dealt to Dorex2007 [7c Qh]
Artuzo127: folds 
BrykmiD: raises $0.06 to $0.08
Seregaa1998: folds 
npcqaz has timed out
npcqaz: folds 
ALelesin: folds 
ALelesin leaves the table
fektivno: folds 
Sharan628: folds 
Dorex2007: folds 
Uncalled bet ($0.06) returned to BrykmiD
BrykmiD collected $0.05 from pot
*** SUMMARY ***
Total pot $0.05 | Rake $0 
Seat 1: Seregaa1998 folded before Flop (didn't bet)
Seat 2: npcqaz folded before Flop (didn't bet)
Seat 3: ALelesin folded before Flop (didn't bet)
Seat 4: fektivno (button) folded before Flop (didn't bet)
Seat 6: Sharan628 (small blind) folded before Flop
Seat 7: Dorex2007 (big blind) folded before Flop
Seat 8: Artuzo127 folded before Flop (didn't bet)
Seat 9: BrykmiD collected ($0.05)



PokerStars Hand #225160632973:  Hold'em No Limit ($0.01/$0.02 USD) - 2021/03/25 0:08:07 PT [2021/03/25 3:08:07 ET]
Table 'Belopolskya VI' 9-max Seat #6 is the button
Seat 1: Seregaa1998 ($2 in chips) 
Seat 4: fektivno ($2.01 in chips) 
Seat 6: Sharan628 ($4 in chips) 
Seat 7: Dorex2007 ($1.98 in chips) 
Seat 8: Artuzo127 ($2.88 in chips) 
Seat 9: BrykmiD ($2.49 in chips) 
Dorex2007: posts small blind $0.01
Artuzo127: posts big blind $0.02
dimitriusDZ: sits out 
*** HOLE CARDS ***
Dealt to Dorex2007 [9h 8c]
fakeaces27 joins the table at seat #3 
BrykmiD: folds 
Seregaa1998: folds 
fektivno: folds 
Sharan628: folds 
Dorex2007: calls $0.01
Artuzo127: checks 
*** FLOP *** [6h 7d 2h]
Dorex2007: checks 
Artuzo127: bets $0.02
Dorex2007: calls $0.02
*** TURN *** [6h 7d 2h] [9d]
Dorex2007: bets $0.08
Artuzo127: folds 
Uncalled bet ($0.08) returned to Dorex2007
Dorex2007 collected $0.08 from pot
Dorex2007: doesn't show hand 
*** SUMMARY ***
Total pot $0.08 | Rake $0 
Board [6h 7d 2h 9d]
Seat 1: Seregaa1998 folded before Flop (didn't bet)
Seat 4: fektivno folded before Flop (didn't bet)
Seat 6: Sharan628 (button) folded before Flop (didn't bet)
Seat 7: Dorex2007 (small blind) collected ($0.08)
Seat 8: Artuzo127 (big blind) folded on the Turn
Seat 9: BrykmiD folded before Flop (didn't bet)



PokerStars Hand #225160637287:  Hold'em No Limit ($0.01/$0.02 USD) - 2021/03/25 0:08:36 PT [2021/03/25 3:08:36 ET]
Table 'Belopolskya VI' 9-max Seat #7 is the button
Seat 1: Seregaa1998 ($2 in chips) 
Seat 4: fektivno ($2.01 in chips) 
Seat 5: dimitriusDZ ($2.19 in chips) 
Seat 6: Sharan628 ($4 in chips) 
Seat 7: Dorex2007 ($2.02 in chips) 
Seat 8: Artuzo127 ($2.84 in chips) 
Seat 9: BrykmiD ($2.49 in chips) 
Artuzo127: posts small blind $0.01
BrykmiD: posts big blind $0.02
fakeaces27: sits out 
dimitriusDZ: posts small & big blinds $0.03
*** HOLE CARDS ***
Dealt to Dorex2007 [2s Jh]
Seregaa1998: raises $0.04 to $0.06
fektivno: folds 
dimitriusDZ: folds 
Sharan628: folds 
Dorex2007: folds 
Artuzo127: calls $0.05
BrykmiD: folds 
*** FLOP *** [Qh Kd Ts]
Artuzo127: checks 
Seregaa1998: bets $0.06
Artuzo127: folds 
Uncalled bet ($0.06) returned to Seregaa1998
Seregaa1998 collected $0.16 from pot
Seregaa1998: doesn't show hand 
*** SUMMARY ***
Total pot $0.17 | Rake $0.01 
Board [Qh Kd Ts]
Seat 1: Seregaa1998 collected ($0.16)
Seat 4: fektivno folded before Flop (didn't bet)
Seat 5: dimitriusDZ folded before Flop (didn't bet)
Seat 6: Sharan628 folded before Flop (didn't bet)
Seat 7: Dorex2007 (button) folded before Flop (didn't bet)
Seat 8: Artuzo127 (small blind) folded on the Flop
Seat 9: BrykmiD (big blind) folded before Flop



PokerStars Hand #225160641690:  Hold'em No Limit ($0.01/$0.02 USD) - 2021/03/25 0:09:04 PT [2021/03/25 3:09:04 ET]
Table 'Belopolskya VI' 9-max Seat #8 is the button
Seat 1: Seregaa1998 ($2.10 in chips) 
Seat 4: fektivno ($2.01 in chips) 
Seat 5: dimitriusDZ ($2.16 in chips) 
Seat 6: Sharan628 ($4 in chips) 
Seat 7: Dorex2007 ($2.02 in chips) 
Seat 8: Artuzo127 ($2.78 in chips) 
Seat 9: BrykmiD ($2.47 in chips) 
BrykmiD: posts small blind $0.01
Seregaa1998: posts big blind $0.02
fakeaces27: sits out 
*** HOLE CARDS ***
Dealt to Dorex2007 [Tc 9s]
fektivno: folds 
dimitriusDZ: raises $0.03 to $0.05
Sharan628: folds 
Dorex2007: folds 
Artuzo127: folds 
BrykmiD: folds 
Seregaa1998: folds 
Uncalled bet ($0.03) returned to dimitriusDZ
dimitriusDZ collected $0.05 from pot
dimitriusDZ: doesn't show hand 
*** SUMMARY ***
Total pot $0.05 | Rake $0 
Seat 1: Seregaa1998 (big blind) folded before Flop
Seat 4: fektivno folded before Flop (didn't bet)
Seat 5: dimitriusDZ collected ($0.05)
Seat 6: Sharan628 folded before Flop (didn't bet)
Seat 7: Dorex2007 folded before Flop (didn't bet)
Seat 8: Artuzo127 (button) folded before Flop (didn't bet)
Seat 9: BrykmiD (small blind) folded before Flop



PokerStars Hand #225160645408:  Hold'em No Limit ($0.01/$0.02 USD) - 2021/03/25 0:09:29 PT [2021/03/25 3:09:29 ET]
Table 'Belopolskya VI' 9-max Seat #9 is the button
Seat 1: Seregaa1998 ($2.08 in chips) 
Seat 3: fakeaces27 ($2 in chips) 
Seat 4: fektivno ($2.01 in chips) 
Seat 5: dimitriusDZ ($2.19 in chips) 
Seat 6: Sharan628 ($4 in chips) 
Seat 7: Dorex2007 ($2.02 in chips) 
Seat 8: Artuzo127 ($2.78 in chips) 
Seat 9: BrykmiD ($2.46 in chips) 
Seregaa1998: posts small blind $0.01
fakeaces27: posts big blind $0.02
*** HOLE CARDS ***
Dealt to Dorex2007 [Qd 5d]
fektivno: folds 
dimitriusDZ: folds 
Sharan628: folds 
Dorex2007: folds 
Artuzo127: raises $0.05 to $0.07
BrykmiD: folds 
Seregaa1998: folds 
fakeaces27: calls $0.05
*** FLOP *** [9s Qc Ac]
fakeaces27: checks 
Artuzo127: bets $0.14
fakeaces27: folds 
Uncalled bet ($0.14) returned to Artuzo127
Artuzo127 collected $0.14 from pot
Artuzo127: doesn't show hand 
*** SUMMARY ***
Total pot $0.15 | Rake $0.01 
Board [9s Qc Ac]
Seat 1: Seregaa1998 (small blind) folded before Flop
Seat 3: fakeaces27 (big blind) folded on the Flop
Seat 4: fektivno folded before Flop (didn't bet)
Seat 5: dimitriusDZ folded before Flop (didn't bet)
Seat 6: Sharan628 folded before Flop (didn't bet)
Seat 7: Dorex2007 folded before Flop (didn't bet)
Seat 8: Artuzo127 collected ($0.14)
Seat 9: BrykmiD (button) folded before Flop (didn't bet)



PokerStars Hand #225160650141:  Hold'em No Limit ($0.01/$0.02 USD) - 2021/03/25 0:09:59 PT [2021/03/25 3:09:59 ET]
Table 'Belopolskya VI' 9-max Seat #1 is the button
Seat 1: Seregaa1998 ($2.07 in chips) 
Seat 3: fakeaces27 ($1.93 in chips) 
Seat 4: fektivno ($2.01 in chips) 
Seat 5: dimitriusDZ ($2.19 in chips) 
Seat 6: Sharan628 ($4 in chips) 
Seat 7: Dorex2007 ($2.02 in chips) 
Seat 8: Artuzo127 ($2.85 in chips) 
Seat 9: BrykmiD ($2.46 in chips) 
fakeaces27: posts small blind $0.01
fektivno: posts big blind $0.02
*** HOLE CARDS ***
Dealt to Dorex2007 [3c As]
dimitriusDZ: folds 
Sharan628: folds 
Dorex2007: folds 
Artuzo127: calls $0.02
BrykmiD: folds 
Seregaa1998: raises $0.08 to $0.10
fakeaces27: folds 
fektivno: folds 
Artuzo127: calls $0.08
*** FLOP *** [Ks 9d 4d]
Artuzo127: bets $0.22
Seregaa1998: folds 
Uncalled bet ($0.22) returned to Artuzo127
Artuzo127 collected $0.22 from pot
Artuzo127: doesn't show hand 
*** SUMMARY ***
Total pot $0.23 | Rake $0.01 
Board [Ks 9d 4d]
Seat 1: Seregaa1998 (button) folded on the Flop
Seat 3: fakeaces27 (small blind) folded before Flop
Seat 4: fektivno (big blind) folded before Flop
Seat 5: dimitriusDZ folded before Flop (didn't bet)
Seat 6: Sharan628 folded before Flop (didn't bet)
Seat 7: Dorex2007 folded before Flop (didn't bet)
Seat 8: Artuzo127 collected ($0.22)
Seat 9: BrykmiD folded before Flop (didn't bet)



PokerStars Hand #225160655543:  Hold'em No Limit ($0.01/$0.02 USD) - 2021/03/25 0:10:35 PT [2021/03/25 3:10:35 ET]
Table 'Belopolskya VI' 9-max Seat #3 is the button
Seat 1: Seregaa1998 ($2 in chips) 
Seat 2: npcqaz ($1.68 in chips) 
Seat 3: fakeaces27 ($1.92 in chips) 
Seat 4: fektivno ($2 in chips) 
Seat 5: dimitriusDZ ($2.19 in chips) 
Seat 6: Sharan628 ($4 in chips) 
Seat 7: Dorex2007 ($2.02 in chips) 
Seat 8: Artuzo127 ($2.97 in chips) 
Seat 9: BrykmiD ($2.46 in chips) 
fektivno: posts small blind $0.01
dimitriusDZ: posts big blind $0.02
npcqaz: posts small & big blinds $0.03
*** HOLE CARDS ***
Dealt to Dorex2007 [8s Qc]
Sharan628: folds 
Dorex2007: folds 
Artuzo127: calls $0.02
BrykmiD: folds 
Seregaa1998: raises $0.08 to $0.10
npcqaz: folds 
fakeaces27: folds 
fektivno: folds 
dimitriusDZ: folds 
Artuzo127: calls $0.08
*** FLOP *** [Ac Tc 2s]
Artuzo127: checks 
Seregaa1998: bets $0.10
Artuzo127: folds 
Uncalled bet ($0.10) returned to Seregaa1998
Seregaa1998 collected $0.25 from pot
Seregaa1998: doesn't show hand 
*** SUMMARY ***
Total pot $0.26 | Rake $0.01 
Board [Ac Tc 2s]
Seat 1: Seregaa1998 collected ($0.25)
Seat 2: npcqaz folded before Flop (didn't bet)
Seat 3: fakeaces27 (button) folded before Flop (didn't bet)
Seat 4: fektivno (small blind) folded before Flop
Seat 5: dimitriusDZ (big blind) folded before Flop
Seat 6: Sharan628 folded before Flop (didn't bet)
Seat 7: Dorex2007 folded before Flop (didn't bet)
Seat 8: Artuzo127 folded on the Flop
Seat 9: BrykmiD folded before Flop (didn't bet)



PokerStars Hand #225160661799:  Hold'em No Limit ($0.01/$0.02 USD) - 2021/03/25 0:11:16 PT [2021/03/25 3:11:16 ET]
Table 'Belopolskya VI' 9-max Seat #4 is the button
Seat 1: Seregaa1998 ($2.15 in chips) 
Seat 2: npcqaz ($1.65 in chips) 
Seat 3: fakeaces27 ($1.92 in chips) 
Seat 4: fektivno ($2 in chips) 
Seat 5: dimitriusDZ ($2.17 in chips) 
Seat 6: Sharan628 ($4 in chips) 
Seat 7: Dorex2007 ($2.02 in chips) 
Seat 8: Artuzo127 ($2.87 in chips) 
Seat 9: BrykmiD ($2.46 in chips) 
dimitriusDZ: posts small blind $0.01
Sharan628: posts big blind $0.02
*** HOLE CARDS ***
Dealt to Dorex2007 [Tc Ks]
Dorex2007: folds 
Artuzo127: calls $0.02
BrykmiD: folds 
Seregaa1998: folds 
npcqaz: folds 
fakeaces27: folds 
fektivno: folds 
dimitriusDZ: folds 
Sharan628: checks 
*** FLOP *** [5s 3h 8c]
Sharan628: checks 
Artuzo127: checks 
*** TURN *** [5s 3h 8c] [Ts]
Sharan628: checks 
Artuzo127: bets $0.05
Sharan628: folds 
Uncalled bet ($0.05) returned to Artuzo127
Artuzo127 collected $0.05 from pot
Artuzo127: doesn't show hand 
*** SUMMARY ***
Total pot $0.05 | Rake $0 
Board [5s 3h 8c Ts]
Seat 1: Seregaa1998 folded before Flop (didn't bet)
Seat 2: npcqaz folded before Flop (didn't bet)
Seat 3: fakeaces27 folded before Flop (didn't bet)
Seat 4: fektivno (button) folded before Flop (didn't bet)
Seat 5: dimitriusDZ (small blind) folded before Flop
Seat 6: Sharan628 (big blind) folded on the Turn
Seat 7: Dorex2007 folded before Flop (didn't bet)
Seat 8: Artuzo127 collected ($0.05)
Seat 9: BrykmiD folded before Flop (didn't bet)



PokerStars Hand #225160669807:  Hold'em No Limit ($0.01/$0.02 USD) - 2021/03/25 0:12:09 PT [2021/03/25 3:12:09 ET]
Table 'Belopolskya VI' 9-max Seat #5 is the button
Seat 1: Seregaa1998 ($2.15 in chips) 
Seat 2: npcqaz ($1.65 in chips) 
Seat 3: fakeaces27 ($1.92 in chips) 
Seat 4: fektivno ($2 in chips) 
Seat 5: dimitriusDZ ($2.16 in chips) 
Seat 6: Sharan628 ($3.98 in chips) 
Seat 7: Dorex2007 ($2.02 in chips) 
Seat 8: Artuzo127 ($2.90 in chips) 
Seat 9: BrykmiD ($2.46 in chips) 
Sharan628: posts small blind $0.01
Dorex2007: posts big blind $0.02
*** HOLE CARDS ***
Dealt to Dorex2007 [5s 9d]
Artuzo127: folds 
BrykmiD: folds 
Seregaa1998: folds 
npcqaz: folds 
fakeaces27: folds 
fektivno: folds 
dimitriusDZ: folds 
Sharan628: folds 
Uncalled bet ($0.01) returned to Dorex2007
Dorex2007 collected $0.02 from pot
Dorex2007: doesn't show hand 
*** SUMMARY ***
Total pot $0.02 | Rake $0 
Seat 1: Seregaa1998 folded before Flop (didn't bet)
Seat 2: npcqaz folded before Flop (didn't bet)
Seat 3: fakeaces27 folded before Flop (didn't bet)
Seat 4: fektivno folded before Flop (didn't bet)
Seat 5: dimitriusDZ (button) folded before Flop (didn't bet)
Seat 6: Sharan628 (small blind) folded before Flop
Seat 7: Dorex2007 (big blind) collected ($0.02)
Seat 8: Artuzo127 folded before Flop (didn't bet)
Seat 9: BrykmiD folded before Flop (didn't bet)



PokerStars Hand #225160673257:  Hold'em No Limit ($0.01/$0.02 USD) - 2021/03/25 0:12:30 PT [2021/03/25 3:12:30 ET]
Table 'Belopolskya VI' 9-max Seat #6 is the button
Seat 1: Seregaa1998 ($2.15 in chips) 
Seat 2: npcqaz ($1.65 in chips) 
Seat 3: fakeaces27 ($1.92 in chips) 
Seat 4: fektivno ($2 in chips) 
Seat 5: dimitriusDZ ($2.16 in chips) 
Seat 6: Sharan628 ($3.97 in chips) 
Seat 7: Dorex2007 ($2.03 in chips) 
Seat 8: Artuzo127 ($2.90 in chips) 
Seat 9: BrykmiD ($2.46 in chips) 
Dorex2007: posts small blind $0.01
Artuzo127: posts big blind $0.02
*** HOLE CARDS ***
Dealt to Dorex2007 [Qc Ac]
BrykmiD: raises $0.06 to $0.08
Seregaa1998: folds 
npcqaz: folds 
fakeaces27: folds 
fektivno: folds 
dimitriusDZ: calls $0.08
Sharan628: folds 
Dorex2007: calls $0.07
Artuzo127: folds 
*** FLOP *** [Jc Jh Td]
Dorex2007: bets $0.25
BrykmiD: folds 
dimitriusDZ: folds 
Uncalled bet ($0.25) returned to Dorex2007
Dorex2007 collected $0.25 from pot
Dorex2007: doesn't show hand 
*** SUMMARY ***
Total pot $0.26 | Rake $0.01 
Board [Jc Jh Td]
Seat 1: Seregaa1998 folded before Flop (didn't bet)
Seat 2: npcqaz folded before Flop (didn't bet)
Seat 3: fakeaces27 folded before Flop (didn't bet)
Seat 4: fektivno folded before Flop (didn't bet)
Seat 5: dimitriusDZ folded on the Flop
Seat 6: Sharan628 (button) folded before Flop (didn't bet)
Seat 7: Dorex2007 (small blind) collected ($0.25)
Seat 8: Artuzo127 (big blind) folded before Flop
Seat 9: BrykmiD folded on the Flop



PokerStars Hand #225160679829:  Hold'em No Limit ($0.01/$0.02 USD) - 2021/03/25 0:13:13 PT [2021/03/25 3:13:13 ET]
Table 'Belopolskya VI' 9-max Seat #7 is the button
Seat 1: Seregaa1998 ($2.15 in chips) 
Seat 2: npcqaz ($1.65 in chips) 
Seat 3: fakeaces27 ($1.92 in chips) 
Seat 4: fektivno ($2 in chips) 
Seat 5: dimitriusDZ ($2.08 in chips) 
Seat 6: Sharan628 ($3.97 in chips) 
Seat 7: Dorex2007 ($2.20 in chips) 
Seat 8: Artuzo127 ($2.88 in chips) 
Seat 9: BrykmiD ($2.38 in chips) 
Artuzo127: posts small blind $0.01
BrykmiD: posts big blind $0.02
*** HOLE CARDS ***
Dealt to Dorex2007 [9c 8h]
Seregaa1998: folds 
npcqaz: folds 
fakeaces27: folds 
fektivno: folds 
dimitriusDZ: raises $0.03 to $0.05
Sharan628: folds 
Dorex2007: folds 
Artuzo127: folds 
BrykmiD: folds 
Uncalled bet ($0.03) returned to dimitriusDZ
dimitriusDZ collected $0.05 from pot
dimitriusDZ: doesn't show hand 
*** SUMMARY ***
Total pot $0.05 | Rake $0 
Seat 1: Seregaa1998 folded before Flop (didn't bet)
Seat 2: npcqaz folded before Flop (didn't bet)
Seat 3: fakeaces27 folded before Flop (didn't bet)
Seat 4: fektivno folded before Flop (didn't bet)
Seat 5: dimitriusDZ collected ($0.05)
Seat 6: Sharan628 folded before Flop (didn't bet)
Seat 7: Dorex2007 (button) folded before Flop (didn't bet)
Seat 8: Artuzo127 (small blind) folded before Flop
Seat 9: BrykmiD (big blind) folded before Flop



PokerStars Hand #225160683342:  Hold'em No Limit ($0.01/$0.02 USD) - 2021/03/25 0:13:35 PT [2021/03/25 3:13:35 ET]
Table 'Belopolskya VI' 9-max Seat #8 is the button
Seat 1: Seregaa1998 ($2.15 in chips) 
Seat 2: npcqaz ($1.65 in chips) 
Seat 3: fakeaces27 ($1.92 in chips) 
Seat 4: fektivno ($2 in chips) 
Seat 5: dimitriusDZ ($2.11 in chips) 
Seat 6: Sharan628 ($3.97 in chips) 
Seat 7: Dorex2007 ($2.20 in chips) 
Seat 8: Artuzo127 ($2.87 in chips) 
Seat 9: BrykmiD ($2.36 in chips) 
BrykmiD: posts small blind $0.01
Seregaa1998: posts big blind $0.02
*** HOLE CARDS ***
Dealt to Dorex2007 [6h 2h]
npcqaz: calls $0.02
fakeaces27: folds 
fektivno: folds 
dimitriusDZ: folds 
Sharan628: folds 
Dorex2007: folds 
Artuzo127: calls $0.02
BrykmiD: folds 
Seregaa1998: checks 
*** FLOP *** [8h 5s 9h]
Seregaa1998: checks 
npcqaz: bets $0.02
Artuzo127: raises $0.46 to $0.48
Seregaa1998: folds 
npcqaz: calls $0.46
*** TURN *** [8h 5s 9h] [Qd]
npcqaz: bets $1.15 and is all-in
Artuzo127: calls $1.15
*** RIVER *** [8h 5s 9h Qd] [6s]
*** SHOW DOWN ***
npcqaz: shows [Jd Tc] (a straight, Eight to Queen)
Artuzo127: shows [7d 6d] (a straight, Five to Nine)
npcqaz collected $3.21 from pot
*** SUMMARY ***
Total pot $3.33 | Rake $0.12 
Board [8h 5s 9h Qd 6s]
Seat 1: Seregaa1998 (big blind) folded on the Flop
Seat 2: npcqaz showed [Jd Tc] and won ($3.21) with a straight, Eight to Queen
Seat 3: fakeaces27 folded before Flop (didn't bet)
Seat 4: fektivno folded before Flop (didn't bet)
Seat 5: dimitriusDZ folded before Flop (didn't bet)
Seat 6: Sharan628 folded before Flop (didn't bet)
Seat 7: Dorex2007 folded before Flop (didn't bet)
Seat 8: Artuzo127 (button) showed [7d 6d] and lost with a straight, Five to Nine
Seat 9: BrykmiD (small blind) folded before Flop



PokerStars Hand #225160692092:  Hold'em No Limit ($0.01/$0.02 USD) - 2021/03/25 0:14:31 PT [2021/03/25 3:14:31 ET]
Table 'Belopolskya VI' 9-max Seat #9 is the button
Seat 1: Seregaa1998 ($2.13 in chips) 
Seat 2: npcqaz ($3.21 in chips) 
Seat 3: fakeaces27 ($1.92 in chips) 
Seat 4: fektivno ($2 in chips) 
Seat 5: dimitriusDZ ($2.11 in chips) 
Seat 6: Sharan628 ($3.97 in chips) 
Seat 7: Dorex2007 ($2.20 in chips) 
Seat 8: Artuzo127 ($1.22 in chips) 
Seat 9: BrykmiD ($2.35 in chips) 
Seregaa1998: posts small blind $0.01
npcqaz: posts big blind $0.02
*** HOLE CARDS ***
Dealt to Dorex2007 [7d 2h]
fakeaces27: folds 
fektivno: folds 
dimitriusDZ: folds 
Sharan628: folds 
Dorex2007: folds 
Artuzo127: raises $0.05 to $0.07
BrykmiD: folds 
Seregaa1998: folds 
npcqaz: folds 
Uncalled bet ($0.05) returned to Artuzo127
Artuzo127 collected $0.05 from pot
Artuzo127: doesn't show hand 
*** SUMMARY ***
Total pot $0.05 | Rake $0 
Seat 1: Seregaa1998 (small blind) folded before Flop
Seat 2: npcqaz (big blind) folded before Flop
Seat 3: fakeaces27 folded before Flop (didn't bet)
Seat 4: fektivno folded before Flop (didn't bet)
Seat 5: dimitriusDZ folded before Flop (didn't bet)
Seat 6: Sharan628 folded before Flop (didn't bet)
Seat 7: Dorex2007 folded before Flop (didn't bet)
Seat 8: Artuzo127 collected ($0.05)
Seat 9: BrykmiD (button) folded before Flop (didn't bet)



PokerStars Hand #225160696452:  Hold'em No Limit ($0.01/$0.02 USD) - 2021/03/25 0:14:58 PT [2021/03/25 3:14:58 ET]
Table 'Belopolskya VI' 9-max Seat #1 is the button
Seat 1: Seregaa1998 ($2.12 in chips) 
Seat 2: npcqaz ($3.19 in chips) 
Seat 3: fakeaces27 ($1.92 in chips) 
Seat 4: fektivno ($2 in chips) 
Seat 5: dimitriusDZ ($2.11 in chips) 
Seat 6: Sharan628 ($3.97 in chips) 
Seat 7: Dorex2007 ($2.20 in chips) 
Seat 8: Artuzo127 ($1.25 in chips) 
Seat 9: BrykmiD ($2.35 in chips) 
npcqaz: posts small blind $0.01
fakeaces27: posts big blind $0.02
*** HOLE CARDS ***
Dealt to Dorex2007 [6c 4s]
fektivno: folds 
dimitriusDZ: folds 
Sharan628: folds 
Dorex2007: folds 
Artuzo127: raises $0.05 to $0.07
BrykmiD: calls $0.07
Seregaa1998: calls $0.07
npcqaz: calls $0.06
fakeaces27: folds 
*** FLOP *** [2c Jh Jc]
npcqaz: checks 
Artuzo127: checks 
BrykmiD: bets $0.03
Seregaa1998: folds 
npcqaz: calls $0.03
Artuzo127: calls $0.03
*** TURN *** [2c Jh Jc] [9c]
npcqaz: checks 
Artuzo127: checks 
BrykmiD: bets $0.04
npcqaz: calls $0.04
Artuzo127: calls $0.04
*** RIVER *** [2c Jh Jc 9c] [7c]
npcqaz: checks 
Artuzo127: checks 
BrykmiD: checks 
*** SHOW DOWN ***
npcqaz: shows [Td 9d] (two pair, Jacks and Nines)
Artuzo127: shows [Qd Qh] (two pair, Queens and Jacks)
BrykmiD: mucks hand 
Artuzo127 collected $0.49 from pot
*** SUMMARY ***
Total pot $0.51 | Rake $0.02 
Board [2c Jh Jc 9c 7c]
Seat 1: Seregaa1998 (button) folded on the Flop
Seat 2: npcqaz (small blind) showed [Td 9d] and lost with two pair, Jacks and Nines
Seat 3: fakeaces27 (big blind) folded before Flop
Seat 4: fektivno folded before Flop (didn't bet)
Seat 5: dimitriusDZ folded before Flop (didn't bet)
Seat 6: Sharan628 folded before Flop (didn't bet)
Seat 7: Dorex2007 folded before Flop (didn't bet)
Seat 8: Artuzo127 showed [Qd Qh] and won ($0.49) with two pair, Queens and Jacks
Seat 9: BrykmiD mucked [9h Ah]



PokerStars Hand #225160705419:  Hold'em No Limit ($0.01/$0.02 USD) - 2021/03/25 0:15:55 PT [2021/03/25 3:15:55 ET]
Table 'Belopolskya VI' 9-max Seat #2 is the button
Seat 1: Seregaa1998 ($2.05 in chips) 
Seat 2: npcqaz ($3.05 in chips) 
Seat 3: fakeaces27 ($1.90 in chips) 
Seat 4: fektivno ($2 in chips) 
Seat 5: dimitriusDZ ($2.11 in chips) 
Seat 6: Sharan628 ($3.97 in chips) 
Seat 7: Dorex2007 ($2.20 in chips) 
Seat 8: Artuzo127 ($1.60 in chips) 
Seat 9: BrykmiD ($2.21 in chips) 
fakeaces27: posts small blind $0.01
fektivno: posts big blind $0.02
*** HOLE CARDS ***
Dealt to Dorex2007 [5s Td]
dimitriusDZ: folds 
Sharan628: folds 
Dorex2007: folds 
Artuzo127: folds 
BrykmiD: folds 
Seregaa1998: raises $0.04 to $0.06
npcqaz: folds 
fakeaces27: calls $0.05
fektivno: folds 
*** FLOP *** [9c 4c Jc]
fakeaces27: bets $0.07
Seregaa1998: calls $0.07
*** TURN *** [9c 4c Jc] [Kh]
fakeaces27: checks 
Seregaa1998: bets $0.15
fakeaces27: folds 
Uncalled bet ($0.15) returned to Seregaa1998
Seregaa1998 collected $0.27 from pot
Seregaa1998: doesn't show hand 
*** SUMMARY ***
Total pot $0.28 | Rake $0.01 
Board [9c 4c Jc Kh]
Seat 1: Seregaa1998 collected ($0.27)
Seat 2: npcqaz (button) folded before Flop (didn't bet)
Seat 3: fakeaces27 (small blind) folded on the Turn
Seat 4: fektivno (big blind) folded before Flop
Seat 5: dimitriusDZ folded before Flop (didn't bet)
Seat 6: Sharan628 folded before Flop (didn't bet)
Seat 7: Dorex2007 folded before Flop (didn't bet)
Seat 8: Artuzo127 folded before Flop (didn't bet)
Seat 9: BrykmiD folded before Flop (didn't bet)



PokerStars Hand #225160714547:  Hold'em No Limit ($0.01/$0.02 USD) - 2021/03/25 0:16:54 PT [2021/03/25 3:16:54 ET]
Table 'Belopolskya VI' 9-max Seat #3 is the button
Seat 1: Seregaa1998 ($2.19 in chips) 
Seat 2: npcqaz ($3.05 in chips) 
Seat 3: fakeaces27 ($1.77 in chips) 
Seat 4: fektivno ($2 in chips) 
Seat 5: dimitriusDZ ($2.11 in chips) 
Seat 6: Sharan628 ($3.97 in chips) 
Seat 7: Dorex2007 ($2.20 in chips) 
Seat 8: Artuzo127 ($1.60 in chips) 
Seat 9: BrykmiD ($2.21 in chips) 
fektivno: posts small blind $0.01
dimitriusDZ: posts big blind $0.02
*** HOLE CARDS ***
Dealt to Dorex2007 [2s 5c]
Sharan628: folds 
Dorex2007: folds 
Artuzo127: folds 
BrykmiD: folds 
Seregaa1998: folds 
npcqaz: calls $0.02
fakeaces27: raises $0.06 to $0.08
fektivno: folds 
dimitriusDZ: folds 
npcqaz: calls $0.06
*** FLOP *** [7d Ac Kc]
npcqaz: checks 
fakeaces27: checks 
*** TURN *** [7d Ac Kc] [4h]
npcqaz: checks 
fakeaces27: bets $0.10
npcqaz: folds 
Uncalled bet ($0.10) returned to fakeaces27
fakeaces27 collected $0.18 from pot
fakeaces27: doesn't show hand 
*** SUMMARY ***
Total pot $0.19 | Rake $0.01 
Board [7d Ac Kc 4h]
Seat 1: Seregaa1998 folded before Flop (didn't bet)
Seat 2: npcqaz folded on the Turn
Seat 3: fakeaces27 (button) collected ($0.18)
Seat 4: fektivno (small blind) folded before Flop
Seat 5: dimitriusDZ (big blind) folded before Flop
Seat 6: Sharan628 folded before Flop (didn't bet)
Seat 7: Dorex2007 folded before Flop (didn't bet)
Seat 8: Artuzo127 folded before Flop (didn't bet)
Seat 9: BrykmiD folded before Flop (didn't bet)



PokerStars Hand #225160720605:  Hold'em No Limit ($0.01/$0.02 USD) - 2021/03/25 0:17:33 PT [2021/03/25 3:17:33 ET]
Table 'Belopolskya VI' 9-max Seat #4 is the button
Seat 1: Seregaa1998 ($2.19 in chips) 
Seat 2: npcqaz ($2.97 in chips) 
Seat 3: fakeaces27 ($1.87 in chips) 
Seat 4: fektivno ($2 in chips) 
Seat 5: dimitriusDZ ($2.09 in chips) 
Seat 6: Sharan628 ($3.97 in chips) 
Seat 7: Dorex2007 ($2.20 in chips) 
Seat 8: Artuzo127 ($1.60 in chips) 
Seat 9: BrykmiD ($2.21 in chips) 
dimitriusDZ: posts small blind $0.01
Sharan628: posts big blind $0.02
*** HOLE CARDS ***
Dealt to Dorex2007 [6h Qc]
Dorex2007: folds 
Artuzo127: raises $0.05 to $0.07
BrykmiD: folds 
Seregaa1998: folds 
npcqaz: folds 
fakeaces27: folds 
fektivno: folds 
dimitriusDZ: folds 
Sharan628: calls $0.05
*** FLOP *** [2h Jd 5s]
Sharan628: checks 
Artuzo127: checks 
*** TURN *** [2h Jd 5s] [2s]
Sharan628: bets $0.06
Artuzo127: calls $0.06
*** RIVER *** [2h Jd 5s 2s] [Kh]
Sharan628: checks 
Artuzo127: bets $0.20
Sharan628: folds 
Uncalled bet ($0.20) returned to Artuzo127
Artuzo127 collected $0.26 from pot
Artuzo127: doesn't show hand 
*** SUMMARY ***
Total pot $0.27 | Rake $0.01 
Board [2h Jd 5s 2s Kh]
Seat 1: Seregaa1998 folded before Flop (didn't bet)
Seat 2: npcqaz folded before Flop (didn't bet)
Seat 3: fakeaces27 folded before Flop (didn't bet)
Seat 4: fektivno (button) folded before Flop (didn't bet)
Seat 5: dimitriusDZ (small blind) folded before Flop
Seat 6: Sharan628 (big blind) folded on the River
Seat 7: Dorex2007 folded before Flop (didn't bet)
Seat 8: Artuzo127 collected ($0.26)
Seat 9: BrykmiD folded before Flop (didn't bet)



PokerStars Hand #225160730435:  Hold'em No Limit ($0.01/$0.02 USD) - 2021/03/25 0:18:35 PT [2021/03/25 3:18:35 ET]
Table 'Belopolskya VI' 9-max Seat #5 is the button
Seat 1: Seregaa1998 ($2.19 in chips) 
Seat 2: npcqaz ($2.97 in chips) 
Seat 3: fakeaces27 ($1.87 in chips) 
Seat 4: fektivno ($2 in chips) 
Seat 5: dimitriusDZ ($2.08 in chips) 
Seat 6: Sharan628 ($3.84 in chips) 
Seat 7: Dorex2007 ($2.20 in chips) 
Seat 8: Artuzo127 ($1.73 in chips) 
Seat 9: BrykmiD ($2.21 in chips) 
Sharan628: posts small blind $0.01
Dorex2007: posts big blind $0.02
*** HOLE CARDS ***
Dealt to Dorex2007 [Qs 4s]
Artuzo127: folds 
BrykmiD: folds 
Seregaa1998: folds 
npcqaz: folds 
fakeaces27: folds 
fektivno: folds 
dimitriusDZ: raises $0.03 to $0.05
Sharan628: folds 
Dorex2007: folds 
Uncalled bet ($0.03) returned to dimitriusDZ
dimitriusDZ collected $0.05 from pot
dimitriusDZ: doesn't show hand 
*** SUMMARY ***
Total pot $0.05 | Rake $0 
Seat 1: Seregaa1998 folded before Flop (didn't bet)
Seat 2: npcqaz folded before Flop (didn't bet)
Seat 3: fakeaces27 folded before Flop (didn't bet)
Seat 4: fektivno folded before Flop (didn't bet)
Seat 5: dimitriusDZ (button) collected ($0.05)
Seat 6: Sharan628 (small blind) folded before Flop
Seat 7: Dorex2007 (big blind) folded before Flop
Seat 8: Artuzo127 folded before Flop (didn't bet)
Seat 9: BrykmiD folded before Flop (didn't bet)



PokerStars Hand #225160735819:  Hold'em No Limit ($0.01/$0.02 USD) - 2021/03/25 0:19:10 PT [2021/03/25 3:19:10 ET]
Table 'Belopolskya VI' 9-max Seat #6 is the button
Seat 1: Seregaa1998 ($2.19 in chips) 
Seat 2: npcqaz ($2.97 in chips) 
Seat 3: fakeaces27 ($1.87 in chips) 
Seat 4: fektivno ($2 in chips) 
Seat 5: dimitriusDZ ($2.11 in chips) 
Seat 6: Sharan628 ($3.83 in chips) 
Seat 7: Dorex2007 ($2.18 in chips) 
Seat 8: Artuzo127 ($1.73 in chips) 
Seat 9: BrykmiD ($2.21 in chips) 
Dorex2007: posts small blind $0.01
Artuzo127: posts big blind $0.02
*** HOLE CARDS ***
Dealt to Dorex2007 [2h 9c]
BrykmiD: folds 
Seregaa1998: folds 
npcqaz: folds 
fakeaces27: folds 
fektivno: folds 
dimitriusDZ: raises $0.03 to $0.05
Sharan628: folds 
Dorex2007: folds 
Artuzo127: calls $0.03
*** FLOP *** [2s 7d Td]
Artuzo127: bets $0.11
dimitriusDZ: calls $0.11
*** TURN *** [2s 7d Td] [8d]
Artuzo127: checks 
dimitriusDZ: bets $0.23
Artuzo127: folds 
Uncalled bet ($0.23) returned to dimitriusDZ
dimitriusDZ collected $0.32 from pot
dimitriusDZ: doesn't show hand 
*** SUMMARY ***
Total pot $0.33 | Rake $0.01 
Board [2s 7d Td 8d]
Seat 1: Seregaa1998 folded before Flop (didn't bet)
Seat 2: npcqaz folded before Flop (didn't bet)
Seat 3: fakeaces27 folded before Flop (didn't bet)
Seat 4: fektivno folded before Flop (didn't bet)
Seat 5: dimitriusDZ collected ($0.32)
Seat 6: Sharan628 (button) folded before Flop (didn't bet)
Seat 7: Dorex2007 (small blind) folded before Flop
Seat 8: Artuzo127 (big blind) folded on the Turn
Seat 9: BrykmiD folded before Flop (didn't bet)



PokerStars Hand #225160742088:  Hold'em No Limit ($0.01/$0.02 USD) - 2021/03/25 0:19:49 PT [2021/03/25 3:19:49 ET]
Table 'Belopolskya VI' 9-max Seat #7 is the button
Seat 1: Seregaa1998 ($2.19 in chips) 
Seat 2: npcqaz ($2.97 in chips) 
Seat 3: fakeaces27 ($1.87 in chips) 
Seat 4: fektivno ($2 in chips) 
Seat 5: dimitriusDZ ($2.27 in chips) 
Seat 6: Sharan628 ($3.83 in chips) 
Seat 7: Dorex2007 ($2.17 in chips) 
Seat 8: Artuzo127 ($1.57 in chips) 
Seat 9: BrykmiD ($2.21 in chips) 
Artuzo127: posts small blind $0.01
BrykmiD: posts big blind $0.02
*** HOLE CARDS ***
Dealt to Dorex2007 [Jh As]
Seregaa1998: folds 
npcqaz: calls $0.02
fakeaces27: folds 
fektivno: folds 
dimitriusDZ: raises $0.15 to $0.17
Sharan628: folds 
Dorex2007: folds 
Artuzo127: calls $0.16
BrykmiD: folds 
npcqaz: calls $0.15
*** FLOP *** [Qh 4s 8s]
Artuzo127: checks 
npcqaz: bets $0.06
dimitriusDZ: calls $0.06
Artuzo127: calls $0.06
*** TURN *** [Qh 4s 8s] [3c]
Artuzo127: checks 
npcqaz: bets $0.20
dimitriusDZ: calls $0.20
Artuzo127: calls $0.20
*** RIVER *** [Qh 4s 8s 3c] [Tc]
Artuzo127: checks 
npcqaz: bets $1.26
dimitriusDZ: folds 
Artuzo127: folds 
Uncalled bet ($1.26) returned to npcqaz
npcqaz collected $1.26 from pot
npcqaz: doesn't show hand 
*** SUMMARY ***
Total pot $1.31 | Rake $0.05 
Board [Qh 4s 8s 3c Tc]
Seat 1: Seregaa1998 folded before Flop (didn't bet)
Seat 2: npcqaz collected ($1.26)
Seat 3: fakeaces27 folded before Flop (didn't bet)
Seat 4: fektivno folded before Flop (didn't bet)
Seat 5: dimitriusDZ folded on the River
Seat 6: Sharan628 folded before Flop (didn't bet)
Seat 7: Dorex2007 (button) folded before Flop (didn't bet)
Seat 8: Artuzo127 (small blind) folded on the River
Seat 9: BrykmiD (big blind) folded before Flop



PokerStars Hand #225160756363:  Hold'em No Limit ($0.01/$0.02 USD) - 2021/03/25 0:21:19 PT [2021/03/25 3:21:19 ET]
Table 'Belopolskya VI' 9-max Seat #8 is the button
Seat 1: Seregaa1998 ($2.19 in chips) 
Seat 2: npcqaz ($3.80 in chips) 
Seat 3: fakeaces27 ($1.87 in chips) 
Seat 4: fektivno ($2 in chips) 
Seat 5: dimitriusDZ ($2 in chips) 
Seat 6: Sharan628 ($3.83 in chips) 
Seat 7: Dorex2007 ($2.17 in chips) 
Seat 8: Artuzo127 ($1.14 in chips) 
Seat 9: BrykmiD ($2.19 in chips) 
BrykmiD: posts small blind $0.01
Seregaa1998: posts big blind $0.02
*** HOLE CARDS ***
Dealt to Dorex2007 [7s Ah]
npcqaz: folds 
fakeaces27: folds 
fektivno: folds 
dimitriusDZ: folds 
Sharan628: folds 
Dorex2007: folds 
Artuzo127: folds 
BrykmiD: calls $0.01
Seregaa1998: checks 
*** FLOP *** [8h 5c Ks]
BrykmiD: checks 
Seregaa1998: bets $0.02
BrykmiD: folds 
Uncalled bet ($0.02) returned to Seregaa1998
Seregaa1998 collected $0.04 from pot
Seregaa1998: doesn't show hand 
*** SUMMARY ***
Total pot $0.04 | Rake $0 
Board [8h 5c Ks]
Seat 1: Seregaa1998 (big blind) collected ($0.04)
Seat 2: npcqaz folded before Flop (didn't bet)
Seat 3: fakeaces27 folded before Flop (didn't bet)
Seat 4: fektivno folded before Flop (didn't bet)
Seat 5: dimitriusDZ folded before Flop (didn't bet)
Seat 6: Sharan628 folded before Flop (didn't bet)
Seat 7: Dorex2007 folded before Flop (didn't bet)
Seat 8: Artuzo127 (button) folded before Flop (didn't bet)
Seat 9: BrykmiD (small blind) folded on the Flop



PokerStars Hand #225160759912:  Hold'em No Limit ($0.01/$0.02 USD) - 2021/03/25 0:21:42 PT [2021/03/25 3:21:42 ET]
Table 'Belopolskya VI' 9-max Seat #9 is the button
Seat 1: Seregaa1998 ($2.21 in chips) 
Seat 2: npcqaz ($3.80 in chips) 
Seat 3: fakeaces27 ($1.87 in chips) 
Seat 4: fektivno ($2 in chips) 
Seat 5: dimitriusDZ ($2 in chips) 
Seat 6: Sharan628 ($3.83 in chips) 
Seat 7: Dorex2007 ($2.17 in chips) 
Seat 8: Artuzo127 ($1.14 in chips) 
Seat 9: BrykmiD ($2.17 in chips) 
Seregaa1998: posts small blind $0.01
npcqaz: posts big blind $0.02
*** HOLE CARDS ***
Dealt to Dorex2007 [Jd Ac]
fakeaces27: folds 
fektivno: folds 
dimitriusDZ: folds 
Sharan628: folds 
Dorex2007: raises $0.04 to $0.06
Artuzo127: calls $0.06
BrykmiD: calls $0.06
Seregaa1998: calls $0.05
npcqaz: folds 
*** FLOP *** [2d Qd 4s]
Seregaa1998: checks 
Dorex2007: checks 
Artuzo127: checks 
BrykmiD: bets $0.15
Seregaa1998: calls $0.15
Dorex2007: folds 
Artuzo127: folds 
*** TURN *** [2d Qd 4s] [Qs]
Seregaa1998: checks 
BrykmiD: bets $0.28
Seregaa1998: folds 
Uncalled bet ($0.28) returned to BrykmiD
BrykmiD collected $0.54 from pot
*** SUMMARY ***
Total pot $0.56 | Rake $0.02 
Board [2d Qd 4s Qs]
Seat 1: Seregaa1998 (small blind) folded on the Turn
Seat 2: npcqaz (big blind) folded before Flop
Seat 3: fakeaces27 folded before Flop (didn't bet)
Seat 4: fektivno folded before Flop (didn't bet)
Seat 5: dimitriusDZ folded before Flop (didn't bet)
Seat 6: Sharan628 folded before Flop (didn't bet)
Seat 7: Dorex2007 folded on the Flop
Seat 8: Artuzo127 folded on the Flop
Seat 9: BrykmiD (button) collected ($0.54)



PokerStars Hand #225160772818:  Hold'em No Limit ($0.01/$0.02 USD) - 2021/03/25 0:23:03 PT [2021/03/25 3:23:03 ET]
Table 'Belopolskya VI' 9-max Seat #1 is the button
Seat 1: Seregaa1998 ($2 in chips) 
Seat 2: npcqaz ($3.78 in chips) 
Seat 3: fakeaces27 ($1.87 in chips) 
Seat 4: fektivno ($2 in chips) 
Seat 5: dimitriusDZ ($2 in chips) 
Seat 6: Sharan628 ($3.83 in chips) 
Seat 7: Dorex2007 ($2.11 in chips) 
Seat 8: Artuzo127 ($1.08 in chips) 
Seat 9: BrykmiD ($2.50 in chips) 
npcqaz: posts small blind $0.01
fakeaces27: posts big blind $0.02
*** HOLE CARDS ***
Dealt to Dorex2007 [3d Ks]
fektivno: folds 
dimitriusDZ: folds 
Sharan628: folds 
Dorex2007: folds 
Artuzo127: folds 
BrykmiD: folds 
Seregaa1998: folds 
npcqaz: calls $0.01
fakeaces27: checks 
*** FLOP *** [4s 6h 4c]
npcqaz: bets $0.04
fakeaces27: folds 
Uncalled bet ($0.04) returned to npcqaz
npcqaz collected $0.04 from pot
npcqaz: doesn't show hand 
*** SUMMARY ***
Total pot $0.04 | Rake $0 
Board [4s 6h 4c]
Seat 1: Seregaa1998 (button) folded before Flop (didn't bet)
Seat 2: npcqaz (small blind) collected ($0.04)
Seat 3: fakeaces27 (big blind) folded on the Flop
Seat 4: fektivno folded before Flop (didn't bet)
Seat 5: dimitriusDZ folded before Flop (didn't bet)
Seat 6: Sharan628 folded before Flop (didn't bet)
Seat 7: Dorex2007 folded before Flop (didn't bet)
Seat 8: Artuzo127 folded before Flop (didn't bet)
Seat 9: BrykmiD folded before Flop (didn't bet)



PokerStars Hand #225160777830:  Hold'em No Limit ($0.01/$0.02 USD) - 2021/03/25 0:23:34 PT [2021/03/25 3:23:34 ET]
Table 'Belopolskya VI' 9-max Seat #2 is the button
Seat 1: Seregaa1998 ($2 in chips) 
Seat 2: npcqaz ($3.80 in chips) 
Seat 3: fakeaces27 ($1.85 in chips) 
Seat 4: fektivno ($2 in chips) 
Seat 5: dimitriusDZ ($2 in chips) 
Seat 6: Sharan628 ($3.83 in chips) 
Seat 7: Dorex2007 ($2.11 in chips) 
Seat 8: Artuzo127 ($1.08 in chips) 
Seat 9: BrykmiD ($2.50 in chips) 
fakeaces27: posts small blind $0.01
fektivno: posts big blind $0.02
*** HOLE CARDS ***
Dealt to Dorex2007 [3c 7s]
dimitriusDZ: folds 
Sharan628: folds 
Dorex2007: folds 
Artuzo127: calls $0.02
BrykmiD: folds 
Seregaa1998: folds 
npcqaz: calls $0.02
fakeaces27: folds 
fektivno: checks 
*** FLOP *** [4h 5s 3h]
fektivno: checks 
Artuzo127: checks 
npcqaz: checks 
*** TURN *** [4h 5s 3h] [5c]
fektivno: checks 
Artuzo127: checks 
npcqaz: checks 
*** RIVER *** [4h 5s 3h 5c] [4c]
fektivno: checks 
Artuzo127: checks 
npcqaz: checks 
*** SHOW DOWN ***
fektivno: shows [Qs Kh] (two pair, Fives and Fours)
Artuzo127: mucks hand 
npcqaz: mucks hand 
fektivno collected $0.07 from pot
*** SUMMARY ***
Total pot $0.07 | Rake $0 
Board [4h 5s 3h 5c 4c]
Seat 1: Seregaa1998 folded before Flop (didn't bet)
Seat 2: npcqaz (button) mucked [Ts 9s]
Seat 3: fakeaces27 (small blind) folded before Flop
Seat 4: fektivno (big blind) showed [Qs Kh] and won ($0.07) with two pair, Fives and Fours
Seat 5: dimitriusDZ folded before Flop (didn't bet)
Seat 6: Sharan628 folded before Flop (didn't bet)
Seat 7: Dorex2007 folded before Flop (didn't bet)
Seat 8: Artuzo127 mucked [7h 8d]
Seat 9: BrykmiD folded before Flop (didn't bet)



PokerStars Hand #225160785549:  Hold'em No Limit ($0.01/$0.02 USD) - 2021/03/25 0:24:22 PT [2021/03/25 3:24:22 ET]
Table 'Belopolskya VI' 9-max Seat #3 is the button
Seat 1: Seregaa1998 ($2 in chips) 
Seat 2: npcqaz ($3.78 in chips) 
Seat 3: fakeaces27 ($1.84 in chips) 
Seat 4: fektivno ($2.05 in chips) 
Seat 5: dimitriusDZ ($2 in chips) 
Seat 6: Sharan628 ($3.83 in chips) 
Seat 7: Dorex2007 ($2.11 in chips) 
Seat 8: Artuzo127 ($1.06 in chips) 
Seat 9: BrykmiD ($2.50 in chips) 
fektivno: posts small blind $0.01
dimitriusDZ: posts big blind $0.02
*** HOLE CARDS ***
Dealt to Dorex2007 [As Jh]
Sharan628: folds 
Dorex2007: raises $0.04 to $0.06
Artuzo127: folds 
BrykmiD: folds 
Seregaa1998: raises $0.14 to $0.20
npcqaz: folds 
fakeaces27: folds 
fektivno: folds 
dimitriusDZ: folds 
Dorex2007: folds 
Uncalled bet ($0.14) returned to Seregaa1998
Seregaa1998 collected $0.15 from pot
Seregaa1998: doesn't show hand 
*** SUMMARY ***
Total pot $0.15 | Rake $0 
Seat 1: Seregaa1998 collected ($0.15)
Seat 2: npcqaz folded before Flop (didn't bet)
Seat 3: fakeaces27 (button) folded before Flop (didn't bet)
Seat 4: fektivno (small blind) folded before Flop
Seat 5: dimitriusDZ (big blind) folded before Flop
Seat 6: Sharan628 folded before Flop (didn't bet)
Seat 7: Dorex2007 folded before Flop
Seat 8: Artuzo127 folded before Flop (didn't bet)
Seat 9: BrykmiD folded before Flop (didn't bet)



PokerStars Hand #225160791462:  Hold'em No Limit ($0.01/$0.02 USD) - 2021/03/25 0:24:59 PT [2021/03/25 3:24:59 ET]
Table 'Belopolskya VI' 9-max Seat #4 is the button
Seat 1: Seregaa1998 ($2.09 in chips) 
Seat 2: npcqaz ($3.78 in chips) 
Seat 3: fakeaces27 ($1.84 in chips) 
Seat 4: fektivno ($2.04 in chips) 
Seat 5: dimitriusDZ ($2 in chips) 
Seat 6: Sharan628 ($3.83 in chips) 
Seat 7: Dorex2007 ($2.05 in chips) 
Seat 8: Artuzo127 ($1.06 in chips) 
Seat 9: BrykmiD ($2.50 in chips) 
dimitriusDZ: posts small blind $0.01
Sharan628: posts big blind $0.02
*** HOLE CARDS ***
Dealt to Dorex2007 [2s 9s]
Dorex2007: folds 
Artuzo127: folds 
BrykmiD: folds 
Seregaa1998: folds 
npcqaz: folds 
fakeaces27: folds 
fektivno: folds 
dimitriusDZ: folds 
Uncalled bet ($0.01) returned to Sharan628
Sharan628 collected $0.02 from pot
Sharan628: doesn't show hand 
*** SUMMARY ***
Total pot $0.02 | Rake $0 
Seat 1: Seregaa1998 folded before Flop (didn't bet)
Seat 2: npcqaz folded before Flop (didn't bet)
Seat 3: fakeaces27 folded before Flop (didn't bet)
Seat 4: fektivno (button) folded before Flop (didn't bet)
Seat 5: dimitriusDZ (small blind) folded before Flop
Seat 6: Sharan628 (big blind) collected ($0.02)
Seat 7: Dorex2007 folded before Flop (didn't bet)
Seat 8: Artuzo127 folded before Flop (didn't bet)
Seat 9: BrykmiD folded before Flop (didn't bet)



PokerStars Hand #225160794219:  Hold'em No Limit ($0.01/$0.02 USD) - 2021/03/25 0:25:17 PT [2021/03/25 3:25:17 ET]
Table 'Belopolskya VI' 9-max Seat #5 is the button
Seat 1: Seregaa1998 ($2.09 in chips) 
Seat 2: npcqaz ($3.78 in chips) 
Seat 3: fakeaces27 ($1.84 in chips) 
Seat 4: fektivno ($2.04 in chips) 
Seat 5: dimitriusDZ ($2 in chips) 
Seat 6: Sharan628 ($3.84 in chips) 
Seat 7: Dorex2007 ($2.05 in chips) 
Seat 8: Artuzo127 ($1.06 in chips) 
Seat 9: BrykmiD ($2.50 in chips) 
Sharan628: posts small blind $0.01
Dorex2007: posts big blind $0.02
*** HOLE CARDS ***
Dealt to Dorex2007 [9d 4s]
Artuzo127: calls $0.02
BrykmiD: folds 
Seregaa1998: folds 
npcqaz: calls $0.02
fakeaces27: folds 
fektivno: raises $0.03 to $0.05
dimitriusDZ: calls $0.05
Sharan628: folds 
Dorex2007: folds 
Artuzo127: calls $0.03
npcqaz: calls $0.03
*** FLOP *** [Kc As 7h]
Artuzo127: checks 
npcqaz: checks 
fektivno: checks 
dimitriusDZ: checks 
*** TURN *** [Kc As 7h] [Ks]
Artuzo127: checks 
npcqaz: bets $0.11
fektivno: folds 
dimitriusDZ: calls $0.11
Artuzo127: calls $0.11
*** RIVER *** [Kc As 7h Ks] [Kh]
Artuzo127: checks 
npcqaz: checks 
dimitriusDZ: checks 
*** SHOW DOWN ***
Artuzo127: shows [Ts Ac] (a full house, Kings full of Aces)
npcqaz: mucks hand 
dimitriusDZ: mucks hand 
Artuzo127 collected $0.54 from pot
*** SUMMARY ***
Total pot $0.56 | Rake $0.02 
Board [Kc As 7h Ks Kh]
Seat 1: Seregaa1998 folded before Flop (didn't bet)
Seat 2: npcqaz mucked [Jc Qh]
Seat 3: fakeaces27 folded before Flop (didn't bet)
Seat 4: fektivno folded on the Turn
Seat 5: dimitriusDZ (button) mucked [8s 5s]
Seat 6: Sharan628 (small blind) folded before Flop
Seat 7: Dorex2007 (big blind) folded before Flop
Seat 8: Artuzo127 showed [Ts Ac] and won ($0.54) with a full house, Kings full of Aces
Seat 9: BrykmiD folded before Flop (didn't bet)



PokerStars Hand #225160803912:  Hold'em No Limit ($0.01/$0.02 USD) - 2021/03/25 0:26:18 PT [2021/03/25 3:26:18 ET]
Table 'Belopolskya VI' 9-max Seat #6 is the button
Seat 1: Seregaa1998 ($2.09 in chips) 
Seat 2: npcqaz ($3.62 in chips) 
Seat 3: fakeaces27 ($1.84 in chips) 
Seat 4: fektivno ($2 in chips) 
Seat 5: dimitriusDZ ($2 in chips) 
Seat 6: Sharan628 ($3.83 in chips) 
Seat 7: Dorex2007 ($2.03 in chips) 
Seat 8: Artuzo127 ($1.44 in chips) 
Seat 9: BrykmiD ($2.50 in chips) 
Dorex2007: posts small blind $0.01
Artuzo127: posts big blind $0.02
*** HOLE CARDS ***
Dealt to Dorex2007 [6h Js]
BrykmiD: folds 
Seregaa1998: folds 
npcqaz: calls $0.02
fakeaces27: raises $0.04 to $0.06
fektivno: folds 
dimitriusDZ: folds 
Sharan628: folds 
Dorex2007: folds 
Artuzo127: calls $0.04
npcqaz: calls $0.04
*** FLOP *** [7c Ts Jd]
Artuzo127: checks 
npcqaz: checks 
fakeaces27: bets $0.06
Artuzo127: calls $0.06
npcqaz: folds 
*** TURN *** [7c Ts Jd] [7d]
Artuzo127: checks 
fakeaces27: checks 
*** RIVER *** [7c Ts Jd 7d] [2c]
Artuzo127: checks 
fakeaces27: checks 
*** SHOW DOWN ***
Artuzo127: shows [5s 5h] (two pair, Sevens and Fives)
fakeaces27: shows [8h 8d] (two pair, Eights and Sevens)
fakeaces27 collected $0.30 from pot
*** SUMMARY ***
Total pot $0.31 | Rake $0.01 
Board [7c Ts Jd 7d 2c]
Seat 1: Seregaa1998 folded before Flop (didn't bet)
Seat 2: npcqaz folded on the Flop
Seat 3: fakeaces27 showed [8h 8d] and won ($0.30) with two pair, Eights and Sevens
Seat 4: fektivno folded before Flop (didn't bet)
Seat 5: dimitriusDZ folded before Flop (didn't bet)
Seat 6: Sharan628 (button) folded before Flop (didn't bet)
Seat 7: Dorex2007 (small blind) folded before Flop
Seat 8: Artuzo127 (big blind) showed [5s 5h] and lost with two pair, Sevens and Fives
Seat 9: BrykmiD folded before Flop (didn't bet)



PokerStars Hand #225160815106:  Hold'em No Limit ($0.01/$0.02 USD) - 2021/03/25 0:27:29 PT [2021/03/25 3:27:29 ET]
Table 'Belopolskya VI' 9-max Seat #7 is the button
Seat 1: Seregaa1998 ($2.09 in chips) 
Seat 2: npcqaz ($3.56 in chips) 
Seat 3: fakeaces27 ($2.02 in chips) 
Seat 4: fektivno ($2 in chips) 
Seat 5: dimitriusDZ ($2 in chips) 
Seat 6: Sharan628 ($3.83 in chips) 
Seat 7: Dorex2007 ($2.02 in chips) 
Seat 8: Artuzo127 ($1.32 in chips) 
Seat 9: BrykmiD ($2.50 in chips) 
Artuzo127: posts small blind $0.01
BrykmiD: posts big blind $0.02
*** HOLE CARDS ***
Dealt to Dorex2007 [3s 7h]
Seregaa1998: folds 
npcqaz: folds 
Seregaa1998 leaves the table
fakeaces27: folds 
fektivno: folds 
dimitriusDZ: raises $0.03 to $0.05
Sharan628: folds 
Dorex2007: folds 
Artuzo127: calls $0.04
BrykmiD: folds 
*** FLOP *** [8c Jh 5c]
vitakapa joins the table at seat #1 
Artuzo127: checks 
dimitriusDZ: checks 
*** TURN *** [8c Jh 5c] [7s]
Artuzo127: checks 
dimitriusDZ: bets $0.05
Artuzo127: calls $0.05
*** RIVER *** [8c Jh 5c 7s] [8d]
Artuzo127: checks 
dimitriusDZ: checks 
*** SHOW DOWN ***
Artuzo127: shows [5h Qs] (two pair, Eights and Fives)
dimitriusDZ: mucks hand 
Artuzo127 collected $0.21 from pot
*** SUMMARY ***
Total pot $0.22 | Rake $0.01 
Board [8c Jh 5c 7s 8d]
Seat 1: Seregaa1998 folded before Flop (didn't bet)
Seat 2: npcqaz folded before Flop (didn't bet)
Seat 3: fakeaces27 folded before Flop (didn't bet)
Seat 4: fektivno folded before Flop (didn't bet)
Seat 5: dimitriusDZ mucked [6s 5s]
Seat 6: Sharan628 folded before Flop (didn't bet)
Seat 7: Dorex2007 (button) folded before Flop (didn't bet)
Seat 8: Artuzo127 (small blind) showed [5h Qs] and won ($0.21) with two pair, Eights and Fives
Seat 9: BrykmiD (big blind) folded before Flop



PokerStars Hand #225160823647:  Hold'em No Limit ($0.01/$0.02 USD) - 2021/03/25 0:28:22 PT [2021/03/25 3:28:22 ET]
Table 'Belopolskya VI' 9-max Seat #8 is the button
Seat 1: vitakapa ($1.60 in chips) 
Seat 3: fakeaces27 ($2.02 in chips) 
Seat 4: fektivno ($2 in chips) 
Seat 5: dimitriusDZ ($2 in chips) 
Seat 6: Sharan628 ($3.83 in chips) 
Seat 7: Dorex2007 ($2.02 in chips) 
Seat 8: Artuzo127 ($1.43 in chips) 
Seat 9: BrykmiD ($2.48 in chips) 
BrykmiD: posts small blind $0.01
vitakapa: posts big blind $0.02
*** HOLE CARDS ***
Dealt to Dorex2007 [8d Jd]
fakeaces27: folds 
fektivno: folds 
dimitriusDZ: folds 
Sharan628: folds 
Dorex2007: folds 
Artuzo127: folds 
BrykmiD: folds 
Uncalled bet ($0.01) returned to vitakapa
vitakapa collected $0.02 from pot
vitakapa: doesn't show hand 
*** SUMMARY ***
Total pot $0.02 | Rake $0 
Seat 1: vitakapa (big blind) collected ($0.02)
Seat 3: fakeaces27 folded before Flop (didn't bet)
Seat 4: fektivno folded before Flop (didn't bet)
Seat 5: dimitriusDZ folded before Flop (didn't bet)
Seat 6: Sharan628 folded before Flop (didn't bet)
Seat 7: Dorex2007 folded before Flop (didn't bet)
Seat 8: Artuzo127 (button) folded before Flop (didn't bet)
Seat 9: BrykmiD (small blind) folded before Flop



PokerStars Hand #225160825783:  Hold'em No Limit ($0.01/$0.02 USD) - 2021/03/25 0:28:36 PT [2021/03/25 3:28:36 ET]
Table 'Belopolskya VI' 9-max Seat #9 is the button
Seat 1: vitakapa ($1.61 in chips) 
Seat 3: fakeaces27 ($2.02 in chips) 
Seat 4: fektivno ($2 in chips) 
Seat 5: dimitriusDZ ($2 in chips) 
Seat 6: Sharan628 ($3.83 in chips) 
Seat 7: Dorex2007 ($2.02 in chips) 
Seat 8: Artuzo127 ($1.43 in chips) 
Seat 9: BrykmiD ($2.47 in chips) 
vitakapa: posts small blind $0.01
fakeaces27: posts big blind $0.02
*** HOLE CARDS ***
Dealt to Dorex2007 [8s As]
fektivno: folds 
dimitriusDZ: raises $0.03 to $0.05
Sharan628: folds 
Dorex2007: folds 
Artuzo127: calls $0.05
BrykmiD: folds 
vitakapa: folds 
fakeaces27: folds 
*** FLOP *** [Ad Jd Ah]
vitakapa leaves the table
dimitriusDZ: checks 
Artuzo127: checks 
*** TURN *** [Ad Jd Ah] [Qc]
dimitriusDZ: checks 
Artuzo127: checks 
*** RIVER *** [Ad Jd Ah Qc] [7s]
dimitriusDZ: bets $0.09
Artuzo127: raises $0.55 to $0.64
dimitriusDZ: calls $0.55
*** SHOW DOWN ***
Artuzo127: shows [Jc Ac] (a full house, Aces full of Jacks)
dimitriusDZ: mucks hand 
Artuzo127 collected $1.36 from pot
*** SUMMARY ***
Total pot $1.41 | Rake $0.05 
Board [Ad Jd Ah Qc 7s]
Seat 1: vitakapa (small blind) folded before Flop
Seat 3: fakeaces27 (big blind) folded before Flop
Seat 4: fektivno folded before Flop (didn't bet)
Seat 5: dimitriusDZ mucked [7c 7d]
Seat 6: Sharan628 folded before Flop (didn't bet)
Seat 7: Dorex2007 folded before Flop (didn't bet)
Seat 8: Artuzo127 showed [Jc Ac] and won ($1.36) with a full house, Aces full of Jacks
Seat 9: BrykmiD (button) folded before Flop (didn't bet)



