PokerStars Hand #232165931038:  Hold'em No Limit ($0.01/$0.02 USD) - 2021/12/12 12:41:27 PT [2021/12/12 15:41:27 ET]
Table 'Lorcia' 9-max Seat #1 is the button
Seat 1: rjeg333 ($2.69 in chips) 
Seat 2: Mycartonfish ($2.28 in chips) 
Seat 3: Gust4v0_7 ($2.41 in chips) 
Seat 4: piller11 ($3.21 in chips) 
Seat 5: vova osa ($0.78 in chips) 
Seat 6: Roman.Leo75 ($1.22 in chips) 
Seat 7: thepospelov ($1.07 in chips) 
Seat 8: trueJamaican ($2.24 in chips) 
Seat 9: Dorex2007 ($2 in chips) 
Mycartonfish: posts small blind $0.01
Gust4v0_7: posts big blind $0.02
Dorex2007: posts big blind $0.02
*** HOLE CARDS ***
Dealt to Dorex2007 [Kd 6s]
piller11: raises $0.06 to $0.08
vova osa: folds 
Roman.Leo75: folds 
thepospelov: calls $0.08
trueJamaican: folds 
Dorex2007: folds 
rjeg333: folds 
Mycartonfish: folds 
Gust4v0_7: calls $0.06
*** FLOP *** [4d 8h 4c]
Gust4v0_7: checks 
piller11: bets $0.02
thepospelov: calls $0.02
Gust4v0_7: calls $0.02
*** TURN *** [4d 8h 4c] [2d]
Gust4v0_7: checks 
piller11: bets $0.10
thepospelov: folds 
Gust4v0_7: folds 
Uncalled bet ($0.10) returned to piller11
piller11 collected $0.32 from pot
*** SUMMARY ***
Total pot $0.33 | Rake $0.01 
Board [4d 8h 4c 2d]
Seat 1: rjeg333 (button) folded before Flop (didn't bet)
Seat 2: Mycartonfish (small blind) folded before Flop
Seat 3: Gust4v0_7 (big blind) folded on the Turn
Seat 4: piller11 collected ($0.32)
Seat 5: vova osa folded before Flop (didn't bet)
Seat 6: Roman.Leo75 folded before Flop (didn't bet)
Seat 7: thepospelov folded on the Turn
Seat 8: trueJamaican folded before Flop (didn't bet)
Seat 9: Dorex2007 folded before Flop (didn't bet)



PokerStars Hand #232165973702:  Hold'em No Limit ($0.01/$0.02 USD) - 2021/12/12 12:42:38 PT [2021/12/12 15:42:38 ET]
Table 'Lorcia' 9-max Seat #2 is the button
Seat 1: rjeg333 ($2.69 in chips) 
Seat 2: Mycartonfish ($2.27 in chips) 
Seat 3: Gust4v0_7 ($2.31 in chips) 
Seat 4: piller11 ($3.43 in chips) 
Seat 5: vova osa ($0.78 in chips) 
Seat 6: Roman.Leo75 ($1.22 in chips) 
Seat 7: thepospelov ($0.97 in chips) 
Seat 8: trueJamaican ($2.24 in chips) 
Seat 9: Dorex2007 ($2 in chips) 
Gust4v0_7: posts small blind $0.01
piller11: posts big blind $0.02
*** HOLE CARDS ***
Dealt to Dorex2007 [Qd Jd]
vova osa: raises $0.04 to $0.06
Roman.Leo75: folds 
thepospelov: calls $0.06
trueJamaican: folds 
Dorex2007: calls $0.06
rjeg333: folds 
Mycartonfish: calls $0.06
Gust4v0_7: folds 
piller11: folds 
*** FLOP *** [Ah 7h Ks]
vova osa: checks 
thepospelov: checks 
Dorex2007: checks 
Mycartonfish: checks 
*** TURN *** [Ah 7h Ks] [As]
vova osa: checks 
thepospelov: bets $0.10
Dorex2007: folds 
Mycartonfish: folds 
vova osa: folds 
Uncalled bet ($0.10) returned to thepospelov
thepospelov collected $0.26 from pot
thepospelov: doesn't show hand 
*** SUMMARY ***
Total pot $0.27 | Rake $0.01 
Board [Ah 7h Ks As]
Seat 1: rjeg333 folded before Flop (didn't bet)
Seat 2: Mycartonfish (button) folded on the Turn
Seat 3: Gust4v0_7 (small blind) folded before Flop
Seat 4: piller11 (big blind) folded before Flop
Seat 5: vova osa folded on the Turn
Seat 6: Roman.Leo75 folded before Flop (didn't bet)
Seat 7: thepospelov collected ($0.26)
Seat 8: trueJamaican folded before Flop (didn't bet)
Seat 9: Dorex2007 folded on the Turn



PokerStars Hand #232166035515:  Hold'em No Limit ($0.01/$0.02 USD) - 2021/12/12 12:44:07 PT [2021/12/12 15:44:07 ET]
Table 'Lorcia' 9-max Seat #3 is the button
Seat 1: rjeg333 ($2.69 in chips) 
Seat 2: Mycartonfish ($2.21 in chips) 
Seat 3: Gust4v0_7 ($2.30 in chips) 
Seat 4: piller11 ($3.41 in chips) 
Seat 5: vova osa ($0.72 in chips) 
Seat 6: Roman.Leo75 ($1.22 in chips) 
Seat 7: thepospelov ($1.17 in chips) 
Seat 8: trueJamaican ($2.24 in chips) 
Seat 9: Dorex2007 ($2 in chips) 
piller11: posts small blind $0.01
vova osa: posts big blind $0.02
*** HOLE CARDS ***
Dealt to Dorex2007 [7s 4c]
Roman.Leo75: folds 
thepospelov: calls $0.02
trueJamaican: folds 
Dorex2007: folds 
rjeg333: folds 
Mycartonfish: folds 
Gust4v0_7: calls $0.02
piller11: calls $0.01
vova osa: raises $0.06 to $0.08
thepospelov: calls $0.06
Gust4v0_7: folds 
piller11: calls $0.06
*** FLOP *** [6c 2h Jc]
piller11: checks 
vova osa: checks 
thepospelov: bets $0.04
piller11: folds 
vova osa: calls $0.04
*** TURN *** [6c 2h Jc] [Td]
vova osa: checks 
thepospelov: bets $0.08
vova osa: raises $0.08 to $0.16
thepospelov: folds 
Uncalled bet ($0.08) returned to vova osa
vova osa collected $0.48 from pot
vova osa: doesn't show hand 
*** SUMMARY ***
Total pot $0.50 | Rake $0.02 
Board [6c 2h Jc Td]
Seat 1: rjeg333 folded before Flop (didn't bet)
Seat 2: Mycartonfish folded before Flop (didn't bet)
Seat 3: Gust4v0_7 (button) folded before Flop
Seat 4: piller11 (small blind) folded on the Flop
Seat 5: vova osa (big blind) collected ($0.48)
Seat 6: Roman.Leo75 folded before Flop (didn't bet)
Seat 7: thepospelov folded on the Turn
Seat 8: trueJamaican folded before Flop (didn't bet)
Seat 9: Dorex2007 folded before Flop (didn't bet)



PokerStars Hand #232166077163:  Hold'em No Limit ($0.01/$0.02 USD) - 2021/12/12 12:45:15 PT [2021/12/12 15:45:15 ET]
Table 'Lorcia' 9-max Seat #4 is the button
Seat 1: rjeg333 ($2.69 in chips) 
Seat 2: Mycartonfish ($2.21 in chips) 
Seat 3: Gust4v0_7 ($2.28 in chips) 
Seat 4: piller11 ($3.33 in chips) 
Seat 5: vova osa ($1 in chips) 
Seat 6: Roman.Leo75 ($1.22 in chips) 
Seat 7: thepospelov ($0.97 in chips) 
Seat 8: trueJamaican ($2.24 in chips) 
Seat 9: Dorex2007 ($2 in chips) 
vova osa: posts small blind $0.01
Roman.Leo75: posts big blind $0.02
*** HOLE CARDS ***
Dealt to Dorex2007 [5h As]
thepospelov: folds 
trueJamaican: folds 
Dorex2007: folds 
rjeg333: folds 
Mycartonfish: folds 
Gust4v0_7: folds 
piller11: calls $0.02
vova osa: folds 
Roman.Leo75: folds 
Roman.Leo75 leaves the table
piller11 collected $0.05 from pot
*** SUMMARY ***
Total pot $0.05 | Rake $0 
Seat 1: rjeg333 folded before Flop (didn't bet)
Seat 2: Mycartonfish folded before Flop (didn't bet)
Seat 3: Gust4v0_7 folded before Flop (didn't bet)
Seat 4: piller11 (button) collected ($0.05)
Seat 5: vova osa (small blind) folded before Flop
Seat 6: Roman.Leo75 (big blind) folded before Flop
Seat 7: thepospelov folded before Flop (didn't bet)
Seat 8: trueJamaican folded before Flop (didn't bet)
Seat 9: Dorex2007 folded before Flop (didn't bet)



PokerStars Hand #232166092276:  Hold'em No Limit ($0.01/$0.02 USD) - 2021/12/12 12:45:40 PT [2021/12/12 15:45:40 ET]
Table 'Lorcia' 9-max Seat #5 is the button
Seat 1: rjeg333 ($2.69 in chips) 
Seat 2: Mycartonfish ($2.21 in chips) 
Seat 3: Gust4v0_7 ($2.28 in chips) 
Seat 4: piller11 ($3.36 in chips) 
Seat 5: vova osa ($0.99 in chips) 
Seat 7: thepospelov ($0.97 in chips) 
Seat 8: trueJamaican ($2.24 in chips) 
Seat 9: Dorex2007 ($2 in chips) 
thepospelov: posts small blind $0.01
trueJamaican: posts big blind $0.02
*** HOLE CARDS ***
Dealt to Dorex2007 [9d 7s]
Dorex2007: folds 
rjeg333: folds 
Mycartonfish: folds 
Gust4v0_7: folds 
piller11: calls $0.02
vova osa: folds 
thepospelov: raises $0.06 to $0.08
trueJamaican: folds 
piller11: folds 
Uncalled bet ($0.06) returned to thepospelov
thepospelov collected $0.06 from pot
thepospelov: doesn't show hand 
*** SUMMARY ***
Total pot $0.06 | Rake $0 
Seat 1: rjeg333 folded before Flop (didn't bet)
Seat 2: Mycartonfish folded before Flop (didn't bet)
Seat 3: Gust4v0_7 folded before Flop (didn't bet)
Seat 4: piller11 folded before Flop
Seat 5: vova osa (button) folded before Flop (didn't bet)
Seat 7: thepospelov (small blind) collected ($0.06)
Seat 8: trueJamaican (big blind) folded before Flop
Seat 9: Dorex2007 folded before Flop (didn't bet)



PokerStars Hand #232166105059:  Hold'em No Limit ($0.01/$0.02 USD) - 2021/12/12 12:46:01 PT [2021/12/12 15:46:01 ET]
Table 'Lorcia' 9-max Seat #7 is the button
Seat 1: rjeg333 ($2.69 in chips) 
Seat 2: Mycartonfish ($2.21 in chips) 
Seat 3: Gust4v0_7 ($2.28 in chips) 
Seat 4: piller11 ($3.34 in chips) 
Seat 5: vova osa ($0.99 in chips) 
Seat 7: thepospelov ($1.01 in chips) 
Seat 8: trueJamaican ($2.22 in chips) 
Seat 9: Dorex2007 ($2 in chips) 
trueJamaican: posts small blind $0.01
Dorex2007: posts big blind $0.02
*** HOLE CARDS ***
Dealt to Dorex2007 [8h Ac]
rjeg333: folds 
Mycartonfish: folds 
Gust4v0_7: calls $0.02
piller11: folds 
vova osa: folds 
thepospelov: raises $0.06 to $0.08
trueJamaican: folds 
Dorex2007: folds 
fbf58 joins the table at seat #6 
Gust4v0_7: calls $0.06
*** FLOP *** [7c Qc 9c]
Gust4v0_7: bets $0.06
thepospelov: raises $0.87 to $0.93 and is all-in
Gust4v0_7: calls $0.87
*** TURN *** [7c Qc 9c] [4s]
*** RIVER *** [7c Qc 9c 4s] [Js]
*** SHOW DOWN ***
Gust4v0_7: shows [8c 4c] (a flush, Queen high)
thepospelov: shows [Kd Ks] (a pair of Kings)
Gust4v0_7 collected $1.98 from pot
*** SUMMARY ***
Total pot $2.05 | Rake $0.07 
Board [7c Qc 9c 4s Js]
Seat 1: rjeg333 folded before Flop (didn't bet)
Seat 2: Mycartonfish folded before Flop (didn't bet)
Seat 3: Gust4v0_7 showed [8c 4c] and won ($1.98) with a flush, Queen high
Seat 4: piller11 folded before Flop (didn't bet)
Seat 5: vova osa folded before Flop (didn't bet)
Seat 7: thepospelov (button) showed [Kd Ks] and lost with a pair of Kings
Seat 8: trueJamaican (small blind) folded before Flop
Seat 9: Dorex2007 (big blind) folded before Flop



PokerStars Hand #232166144673:  Hold'em No Limit ($0.01/$0.02 USD) - 2021/12/12 12:47:07 PT [2021/12/12 15:47:07 ET]
Table 'Lorcia' 9-max Seat #8 is the button
Seat 1: rjeg333 ($2.69 in chips) 
Seat 2: Mycartonfish ($2.21 in chips) 
Seat 3: Gust4v0_7 ($3.25 in chips) 
Seat 4: piller11 ($3.34 in chips) 
Seat 5: vova osa ($0.99 in chips) 
Seat 8: trueJamaican ($2.21 in chips) 
Seat 9: Dorex2007 ($2 in chips) 
Dorex2007: posts small blind $0.01
rjeg333: posts big blind $0.02
fbf58: sits out 
*** HOLE CARDS ***
Dealt to Dorex2007 [4h Ac]
thepospelov leaves the table
Mycartonfish: folds 
Gust4v0_7: folds 
piller11: folds 
vova osa: folds 
trueJamaican: folds 
Dorex2007: folds 
Uncalled bet ($0.01) returned to rjeg333
pokertronde joins the table at seat #7 
rjeg333 collected $0.02 from pot
*** SUMMARY ***
Total pot $0.02 | Rake $0 
Seat 1: rjeg333 (big blind) collected ($0.02)
Seat 2: Mycartonfish folded before Flop (didn't bet)
Seat 3: Gust4v0_7 folded before Flop (didn't bet)
Seat 4: piller11 folded before Flop (didn't bet)
Seat 5: vova osa folded before Flop (didn't bet)
Seat 8: trueJamaican (button) folded before Flop (didn't bet)
Seat 9: Dorex2007 (small blind) folded before Flop



PokerStars Hand #232166154142:  Hold'em No Limit ($0.01/$0.02 USD) - 2021/12/12 12:47:22 PT [2021/12/12 15:47:22 ET]
Table 'Lorcia' 9-max Seat #9 is the button
Seat 1: rjeg333 ($2.70 in chips) 
Seat 2: Mycartonfish ($2.21 in chips) 
Seat 3: Gust4v0_7 ($3.25 in chips) 
Seat 4: piller11 ($3.34 in chips) 
Seat 5: vova osa ($0.99 in chips) 
Seat 8: trueJamaican ($2.21 in chips) 
Seat 9: Dorex2007 ($2 in chips) 
rjeg333: posts small blind $0.01
Mycartonfish: posts big blind $0.02
fbf58: sits out 
pokertronde: sits out 
*** HOLE CARDS ***
Dealt to Dorex2007 [Jc 6c]
Gust4v0_7: folds 
piller11: raises $0.10 to $0.12
vova osa: folds 
trueJamaican: folds 
Dorex2007: folds 
rjeg333: folds 
Mycartonfish: folds 
Uncalled bet ($0.10) returned to piller11
piller11 collected $0.05 from pot
*** SUMMARY ***
Total pot $0.05 | Rake $0 
Seat 1: rjeg333 (small blind) folded before Flop
Seat 2: Mycartonfish (big blind) folded before Flop
Seat 3: Gust4v0_7 folded before Flop (didn't bet)
Seat 4: piller11 collected ($0.05)
Seat 5: vova osa folded before Flop (didn't bet)
Seat 8: trueJamaican folded before Flop (didn't bet)
Seat 9: Dorex2007 (button) folded before Flop (didn't bet)



PokerStars Hand #232166168527:  Hold'em No Limit ($0.01/$0.02 USD) - 2021/12/12 12:47:46 PT [2021/12/12 15:47:46 ET]
Table 'Lorcia' 9-max Seat #1 is the button
Seat 1: rjeg333 ($2.69 in chips) 
Seat 2: Mycartonfish ($2.19 in chips) 
Seat 3: Gust4v0_7 ($3.25 in chips) 
Seat 4: piller11 ($3.37 in chips) 
Seat 5: vova osa ($0.99 in chips) 
Seat 8: trueJamaican ($2.21 in chips) 
Seat 9: Dorex2007 ($2 in chips) 
Mycartonfish: posts small blind $0.01
Gust4v0_7: posts big blind $0.02
fbf58: sits out 
pokertronde: sits out 
*** HOLE CARDS ***
Dealt to Dorex2007 [4h Tc]
piller11: folds 
vova osa: folds 
trueJamaican: raises $0.04 to $0.06
Dorex2007: folds 
rjeg333: calls $0.06
Mycartonfish: calls $0.05
Gust4v0_7: calls $0.04
*** FLOP *** [8c 9c 5h]
Mycartonfish: checks 
Gust4v0_7: checks 
trueJamaican: checks 
rjeg333: checks 
*** TURN *** [8c 9c 5h] [9s]
Mycartonfish: checks 
Gust4v0_7: bets $0.08
trueJamaican: folds 
rjeg333: calls $0.08
Mycartonfish: folds 
*** RIVER *** [8c 9c 5h 9s] [2s]
Gust4v0_7: checks 
rjeg333: checks 
*** SHOW DOWN ***
Gust4v0_7: shows [5s Qh] (two pair, Nines and Fives)
rjeg333: shows [8h Th] (two pair, Nines and Eights)
rjeg333 collected $0.39 from pot
*** SUMMARY ***
Total pot $0.40 | Rake $0.01 
Board [8c 9c 5h 9s 2s]
Seat 1: rjeg333 (button) showed [8h Th] and won ($0.39) with two pair, Nines and Eights
Seat 2: Mycartonfish (small blind) folded on the Turn
Seat 3: Gust4v0_7 (big blind) showed [5s Qh] and lost with two pair, Nines and Fives
Seat 4: piller11 folded before Flop (didn't bet)
Seat 5: vova osa folded before Flop (didn't bet)
Seat 8: trueJamaican folded on the Turn
Seat 9: Dorex2007 folded before Flop (didn't bet)



PokerStars Hand #232166226871:  Hold'em No Limit ($0.01/$0.02 USD) - 2021/12/12 12:49:14 PT [2021/12/12 15:49:14 ET]
Table 'Lorcia' 9-max Seat #2 is the button
Seat 1: rjeg333 ($2.94 in chips) 
Seat 2: Mycartonfish ($2.13 in chips) 
Seat 3: Gust4v0_7 ($3.11 in chips) 
Seat 4: piller11 ($3.37 in chips) 
Seat 5: vova osa ($0.99 in chips) 
Seat 6: fbf58 ($1.66 in chips) 
Seat 8: trueJamaican ($2.15 in chips) 
Seat 9: Dorex2007 ($2 in chips) 
Gust4v0_7: posts small blind $0.01
piller11: posts big blind $0.02
fbf58: posts big blind $0.02
pokertronde: sits out 
*** HOLE CARDS ***
Dealt to Dorex2007 [6h Tc]
vova osa: folds 
fbf58: checks 
trueJamaican: folds 
Dorex2007: folds 
rjeg333: folds 
Mycartonfish: calls $0.02
Gust4v0_7: calls $0.01
piller11: raises $0.02 to $0.04
fbf58: calls $0.02
Mycartonfish: folds 
Gust4v0_7: calls $0.02
*** FLOP *** [6c Th Qc]
Gust4v0_7: checks 
piller11: bets $0.12
fbf58: folds 
Gust4v0_7: folds 
Uncalled bet ($0.12) returned to piller11
piller11 collected $0.14 from pot
*** SUMMARY ***
Total pot $0.14 | Rake $0 
Board [6c Th Qc]
Seat 1: rjeg333 folded before Flop (didn't bet)
Seat 2: Mycartonfish (button) folded before Flop
Seat 3: Gust4v0_7 (small blind) folded on the Flop
Seat 4: piller11 (big blind) collected ($0.14)
Seat 5: vova osa folded before Flop (didn't bet)
Seat 6: fbf58 folded on the Flop
Seat 8: trueJamaican folded before Flop (didn't bet)
Seat 9: Dorex2007 folded before Flop (didn't bet)



PokerStars Hand #232166258949:  Hold'em No Limit ($0.01/$0.02 USD) - 2021/12/12 12:50:07 PT [2021/12/12 15:50:07 ET]
Table 'Lorcia' 9-max Seat #3 is the button
Seat 1: rjeg333 ($2.94 in chips) 
Seat 2: Mycartonfish ($2.11 in chips) 
Seat 3: Gust4v0_7 ($3.07 in chips) 
Seat 4: piller11 ($3.47 in chips) 
Seat 5: vova osa ($0.99 in chips) 
Seat 6: fbf58 ($1.62 in chips) 
Seat 8: trueJamaican ($2.15 in chips) 
Seat 9: Dorex2007 ($2 in chips) 
piller11: posts small blind $0.01
vova osa: posts big blind $0.02
pokertronde: sits out 
*** HOLE CARDS ***
Dealt to Dorex2007 [5s Ah]
fbf58: calls $0.02
trueJamaican: folds 
Dorex2007: folds 
rjeg333: folds 
Mycartonfish: folds 
Gust4v0_7: folds 
piller11: folds 
vova osa: checks 
*** FLOP *** [5c 6s 7s]
vova osa: bets $0.02
fbf58: calls $0.02
*** TURN *** [5c 6s 7s] [Kc]
vova osa: checks 
fbf58: checks 
*** RIVER *** [5c 6s 7s Kc] [7d]
vova osa: checks 
fbf58: bets $0.09
vova osa: folds 
Uncalled bet ($0.09) returned to fbf58
fbf58 collected $0.09 from pot
*** SUMMARY ***
Total pot $0.09 | Rake $0 
Board [5c 6s 7s Kc 7d]
Seat 1: rjeg333 folded before Flop (didn't bet)
Seat 2: Mycartonfish folded before Flop (didn't bet)
Seat 3: Gust4v0_7 (button) folded before Flop (didn't bet)
Seat 4: piller11 (small blind) folded before Flop
Seat 5: vova osa (big blind) folded on the River
Seat 6: fbf58 collected ($0.09)
Seat 8: trueJamaican folded before Flop (didn't bet)
Seat 9: Dorex2007 folded before Flop (didn't bet)



PokerStars Hand #232166283039:  Hold'em No Limit ($0.01/$0.02 USD) - 2021/12/12 12:50:48 PT [2021/12/12 15:50:48 ET]
Table 'Lorcia' 9-max Seat #4 is the button
Seat 1: rjeg333 ($2.94 in chips) 
Seat 2: Mycartonfish ($2.11 in chips) 
Seat 3: Gust4v0_7 ($3.07 in chips) 
Seat 4: piller11 ($3.46 in chips) 
Seat 5: vova osa ($0.95 in chips) 
Seat 6: fbf58 ($1.67 in chips) 
Seat 8: trueJamaican ($2.15 in chips) 
Seat 9: Dorex2007 ($2 in chips) 
vova osa: posts small blind $0.01
fbf58: posts big blind $0.02
pokertronde: sits out 
*** HOLE CARDS ***
Dealt to Dorex2007 [8h Ah]
trueJamaican: folds 
Dorex2007: raises $0.02 to $0.04
rjeg333: folds 
Mycartonfish: calls $0.04
Gust4v0_7: folds 
piller11: folds 
vova osa: folds 
fbf58: calls $0.02
*** FLOP *** [Ks 3c 3s]
fbf58: checks 
Dorex2007: checks 
Mycartonfish: bets $0.07
fbf58: folds 
Dorex2007: folds 
Uncalled bet ($0.07) returned to Mycartonfish
Mycartonfish collected $0.13 from pot
*** SUMMARY ***
Total pot $0.13 | Rake $0 
Board [Ks 3c 3s]
Seat 1: rjeg333 folded before Flop (didn't bet)
Seat 2: Mycartonfish collected ($0.13)
Seat 3: Gust4v0_7 folded before Flop (didn't bet)
Seat 4: piller11 (button) folded before Flop (didn't bet)
Seat 5: vova osa (small blind) folded before Flop
Seat 6: fbf58 (big blind) folded on the Flop
Seat 8: trueJamaican folded before Flop (didn't bet)
Seat 9: Dorex2007 folded on the Flop



PokerStars Hand #232166302608:  Hold'em No Limit ($0.01/$0.02 USD) - 2021/12/12 12:51:21 PT [2021/12/12 15:51:21 ET]
Table 'Lorcia' 9-max Seat #5 is the button
Seat 1: rjeg333 ($2.94 in chips) 
Seat 2: Mycartonfish ($2.20 in chips) 
Seat 3: Gust4v0_7 ($3.07 in chips) 
Seat 4: piller11 ($3.46 in chips) 
Seat 5: vova osa ($0.94 in chips) 
Seat 6: fbf58 ($1.63 in chips) 
Seat 7: pokertronde ($2 in chips) 
Seat 8: trueJamaican ($2.15 in chips) 
Seat 9: Dorex2007 ($2 in chips) 
fbf58: posts small blind $0.01
pokertronde: posts big blind $0.02
*** HOLE CARDS ***
Dealt to Dorex2007 [Jh 4s]
trueJamaican: folds 
Dorex2007: folds 
rjeg333: folds 
Mycartonfish: folds 
Gust4v0_7: folds 
piller11: calls $0.02
vova osa: folds 
fbf58: calls $0.01
pokertronde: checks 
*** FLOP *** [2h Qs 7s]
fbf58: checks 
pokertronde: checks 
piller11: checks 
*** TURN *** [2h Qs 7s] [Kc]
fbf58: checks 
pokertronde: checks 
piller11: checks 
*** RIVER *** [2h Qs 7s Kc] [5c]
fbf58: bets $0.02
pokertronde: folds 
piller11: folds 
Uncalled bet ($0.02) returned to fbf58
fbf58 collected $0.06 from pot
*** SUMMARY ***
Total pot $0.06 | Rake $0 
Board [2h Qs 7s Kc 5c]
Seat 1: rjeg333 folded before Flop (didn't bet)
Seat 2: Mycartonfish folded before Flop (didn't bet)
Seat 3: Gust4v0_7 folded before Flop (didn't bet)
Seat 4: piller11 folded on the River
Seat 5: vova osa (button) folded before Flop (didn't bet)
Seat 6: fbf58 (small blind) collected ($0.06)
Seat 7: pokertronde (big blind) folded on the River
Seat 8: trueJamaican folded before Flop (didn't bet)
Seat 9: Dorex2007 folded before Flop (didn't bet)



PokerStars Hand #232166351650:  Hold'em No Limit ($0.01/$0.02 USD) - 2021/12/12 12:52:43 PT [2021/12/12 15:52:43 ET]
Table 'Lorcia' 9-max Seat #6 is the button
Seat 1: rjeg333 ($2.94 in chips) 
Seat 2: Mycartonfish ($2.20 in chips) 
Seat 3: Gust4v0_7 ($3.07 in chips) 
Seat 4: piller11 ($3.44 in chips) 
Seat 5: vova osa ($0.94 in chips) 
Seat 6: fbf58 ($1.67 in chips) 
Seat 7: pokertronde ($2 in chips) 
Seat 8: trueJamaican ($2.15 in chips) 
Seat 9: Dorex2007 ($2 in chips) 
pokertronde: posts small blind $0.01
trueJamaican: posts big blind $0.02
*** HOLE CARDS ***
Dealt to Dorex2007 [3h 8h]
Dorex2007: folds 
rjeg333: folds 
Mycartonfish: calls $0.02
Gust4v0_7: folds 
piller11: folds 
vova osa: folds 
fbf58: calls $0.02
pokertronde: folds 
trueJamaican: checks 
*** FLOP *** [Qh As Ah]
trueJamaican: checks 
Mycartonfish: checks 
fbf58: checks 
*** TURN *** [Qh As Ah] [5d]
trueJamaican: checks 
Mycartonfish: checks 
fbf58: checks 
*** RIVER *** [Qh As Ah 5d] [7s]
trueJamaican: checks 
Mycartonfish: bets $0.04
fbf58: folds 
trueJamaican: folds 
Uncalled bet ($0.04) returned to Mycartonfish
Mycartonfish collected $0.07 from pot
*** SUMMARY ***
Total pot $0.07 | Rake $0 
Board [Qh As Ah 5d 7s]
Seat 1: rjeg333 folded before Flop (didn't bet)
Seat 2: Mycartonfish collected ($0.07)
Seat 3: Gust4v0_7 folded before Flop (didn't bet)
Seat 4: piller11 folded before Flop (didn't bet)
Seat 5: vova osa folded before Flop (didn't bet)
Seat 6: fbf58 (button) folded on the River
Seat 7: pokertronde (small blind) folded before Flop
Seat 8: trueJamaican (big blind) folded on the River
Seat 9: Dorex2007 folded before Flop (didn't bet)



PokerStars Hand #232166396961:  Hold'em No Limit ($0.01/$0.02 USD) - 2021/12/12 12:54:00 PT [2021/12/12 15:54:00 ET]
Table 'Lorcia' 9-max Seat #7 is the button
Seat 1: rjeg333 ($2.94 in chips) 
Seat 2: Mycartonfish ($2.25 in chips) 
Seat 3: Gust4v0_7 ($3.07 in chips) 
Seat 4: piller11 ($3.44 in chips) 
Seat 5: vova osa ($0.94 in chips) 
Seat 6: fbf58 ($1.65 in chips) 
Seat 7: pokertronde ($2 in chips) 
Seat 8: trueJamaican ($2.13 in chips) 
Seat 9: Dorex2007 ($2 in chips) 
trueJamaican: posts small blind $0.01
Dorex2007: posts big blind $0.02
*** HOLE CARDS ***
Dealt to Dorex2007 [Qs 6d]
rjeg333 has timed out
rjeg333: folds 
Mycartonfish: folds 
Gust4v0_7: folds 
piller11: raises $0.08 to $0.10
vova osa: folds 
fbf58: folds 
pokertronde: folds 
trueJamaican: folds 
Dorex2007: folds 
Uncalled bet ($0.08) returned to piller11
piller11 collected $0.05 from pot
*** SUMMARY ***
Total pot $0.05 | Rake $0 
Seat 1: rjeg333 folded before Flop (didn't bet)
Seat 2: Mycartonfish folded before Flop (didn't bet)
Seat 3: Gust4v0_7 folded before Flop (didn't bet)
Seat 4: piller11 collected ($0.05)
Seat 5: vova osa folded before Flop (didn't bet)
Seat 6: fbf58 folded before Flop (didn't bet)
Seat 7: pokertronde (button) folded before Flop (didn't bet)
Seat 8: trueJamaican (small blind) folded before Flop
Seat 9: Dorex2007 (big blind) folded before Flop



PokerStars Hand #232166417392:  Hold'em No Limit ($0.01/$0.02 USD) - 2021/12/12 12:54:34 PT [2021/12/12 15:54:34 ET]
Table 'Lorcia' 9-max Seat #8 is the button
Seat 1: rjeg333 ($2.94 in chips) 
Seat 2: Mycartonfish ($2.25 in chips) 
Seat 3: Gust4v0_7 ($3.07 in chips) 
Seat 4: piller11 ($3.47 in chips) 
Seat 5: vova osa ($0.94 in chips) 
Seat 6: fbf58 ($1.65 in chips) 
Seat 7: pokertronde ($2 in chips) 
Seat 8: trueJamaican ($2.12 in chips) 
Seat 9: Dorex2007 ($2 in chips) 
Dorex2007: posts small blind $0.01
rjeg333: posts big blind $0.02
*** HOLE CARDS ***
Dealt to Dorex2007 [9d Jc]
Mycartonfish: folds 
Gust4v0_7: folds 
piller11: folds 
vova osa: raises $0.04 to $0.06
fbf58: calls $0.06
pokertronde: calls $0.06
trueJamaican: folds 
Dorex2007: folds 
rjeg333: folds 
*** FLOP *** [3c Ac 2h]
vova osa: bets $0.10
fbf58: calls $0.10
pokertronde: folds 
*** TURN *** [3c Ac 2h] [3d]
vova osa: checks 
fbf58: bets $0.10
vova osa: folds 
Uncalled bet ($0.10) returned to fbf58
fbf58 collected $0.40 from pot
*** SUMMARY ***
Total pot $0.41 | Rake $0.01 
Board [3c Ac 2h 3d]
Seat 1: rjeg333 (big blind) folded before Flop
Seat 2: Mycartonfish folded before Flop (didn't bet)
Seat 3: Gust4v0_7 folded before Flop (didn't bet)
Seat 4: piller11 folded before Flop (didn't bet)
Seat 5: vova osa folded on the Turn
Seat 6: fbf58 collected ($0.40)
Seat 7: pokertronde folded on the Flop
Seat 8: trueJamaican (button) folded before Flop (didn't bet)
Seat 9: Dorex2007 (small blind) folded before Flop



PokerStars Hand #232166448922:  Hold'em No Limit ($0.01/$0.02 USD) - 2021/12/12 12:55:40 PT [2021/12/12 15:55:40 ET]
Table 'Lorcia' 9-max Seat #9 is the button
Seat 1: rjeg333 ($2.92 in chips) 
Seat 2: Mycartonfish ($2.25 in chips) 
Seat 3: Gust4v0_7 ($3.07 in chips) 
Seat 4: piller11 ($3.47 in chips) 
Seat 5: vova osa ($0.78 in chips) 
Seat 6: fbf58 ($1.89 in chips) 
Seat 7: pokertronde ($2 in chips) 
Seat 8: trueJamaican ($2.12 in chips) 
Seat 9: Dorex2007 ($2 in chips) 
rjeg333: posts small blind $0.01
Mycartonfish: posts big blind $0.02
*** HOLE CARDS ***
Dealt to Dorex2007 [4h 3d]
Gust4v0_7: raises $0.04 to $0.06
piller11: folds 
vova osa: folds 
fbf58: folds 
pokertronde: folds 
trueJamaican: folds 
Dorex2007: folds 
rjeg333: folds 
Mycartonfish: folds 
Uncalled bet ($0.04) returned to Gust4v0_7
Gust4v0_7 collected $0.05 from pot
Gust4v0_7: doesn't show hand 
*** SUMMARY ***
Total pot $0.05 | Rake $0 
Seat 1: rjeg333 (small blind) folded before Flop
Seat 2: Mycartonfish (big blind) folded before Flop
Seat 3: Gust4v0_7 collected ($0.05)
Seat 4: piller11 folded before Flop (didn't bet)
Seat 5: vova osa folded before Flop (didn't bet)
Seat 6: fbf58 folded before Flop (didn't bet)
Seat 7: pokertronde folded before Flop (didn't bet)
Seat 8: trueJamaican folded before Flop (didn't bet)
Seat 9: Dorex2007 (button) folded before Flop (didn't bet)



PokerStars Hand #232166456030:  Hold'em No Limit ($0.01/$0.02 USD) - 2021/12/12 12:55:59 PT [2021/12/12 15:55:59 ET]
Table 'Lorcia' 9-max Seat #1 is the button
Seat 1: rjeg333 ($2.91 in chips) 
Seat 2: Mycartonfish ($2.23 in chips) 
Seat 3: Gust4v0_7 ($3.10 in chips) 
Seat 4: piller11 ($3.47 in chips) 
Seat 5: vova osa ($0.78 in chips) 
Seat 6: fbf58 ($1.89 in chips) 
Seat 7: pokertronde ($2 in chips) 
Seat 8: trueJamaican ($2.12 in chips) 
Seat 9: Dorex2007 ($2 in chips) 
Mycartonfish: posts small blind $0.01
Gust4v0_7: posts big blind $0.02
*** HOLE CARDS ***
Dealt to Dorex2007 [7d As]
piller11 has timed out
piller11: folds 
vova osa: folds 
fbf58: calls $0.02
pokertronde: folds 
trueJamaican: folds 
Dorex2007: folds 
rjeg333: folds 
Mycartonfish: folds 
Gust4v0_7: checks 
*** FLOP *** [3h Td 6h]
Gust4v0_7: bets $0.02
fbf58: calls $0.02
*** TURN *** [3h Td 6h] [9s]
Gust4v0_7: checks 
fbf58: bets $0.09
Gust4v0_7: folds 
Uncalled bet ($0.09) returned to fbf58
fbf58 collected $0.09 from pot
*** SUMMARY ***
Total pot $0.09 | Rake $0 
Board [3h Td 6h 9s]
Seat 1: rjeg333 (button) folded before Flop (didn't bet)
Seat 2: Mycartonfish (small blind) folded before Flop
Seat 3: Gust4v0_7 (big blind) folded on the Turn
Seat 4: piller11 folded before Flop (didn't bet)
Seat 5: vova osa folded before Flop (didn't bet)
Seat 6: fbf58 collected ($0.09)
Seat 7: pokertronde folded before Flop (didn't bet)
Seat 8: trueJamaican folded before Flop (didn't bet)
Seat 9: Dorex2007 folded before Flop (didn't bet)



PokerStars Hand #232166470686:  Hold'em No Limit ($0.01/$0.02 USD) - 2021/12/12 12:56:38 PT [2021/12/12 15:56:38 ET]
Table 'Lorcia' 9-max Seat #2 is the button
Seat 1: rjeg333 ($2.91 in chips) 
Seat 2: Mycartonfish ($2.22 in chips) 
Seat 3: Gust4v0_7 ($3.06 in chips) 
Seat 5: vova osa ($0.78 in chips) 
Seat 6: fbf58 ($1.94 in chips) 
Seat 7: pokertronde ($2 in chips) 
Seat 8: trueJamaican ($2.12 in chips) 
Seat 9: Dorex2007 ($2 in chips) 
Gust4v0_7: posts small blind $0.01
vova osa: posts big blind $0.02
*** HOLE CARDS ***
Dealt to Dorex2007 [2s 4c]
fbf58: raises $0.04 to $0.06
pokertronde: folds 
trueJamaican: folds 
Dorex2007: folds 
rjeg333: folds 
Mycartonfish: folds 
Gust4v0_7: calls $0.05
vova osa: calls $0.04
*** FLOP *** [2c 8c Ad]
Gust4v0_7: checks 
vova osa: checks 
fbf58: bets $0.06
Gust4v0_7: calls $0.06
vova osa: calls $0.06
*** TURN *** [2c 8c Ad] [Js]
Gust4v0_7: checks 
vova osa: checks 
fbf58: checks 
*** RIVER *** [2c 8c Ad Js] [5d]
Gust4v0_7: bets $0.12
vova osa: calls $0.12
fbf58: folds 
*** SHOW DOWN ***
Gust4v0_7: shows [Ah Ts] (a pair of Aces)
vova osa: mucks hand 
Gust4v0_7 collected $0.58 from pot
*** SUMMARY ***
Total pot $0.60 | Rake $0.02 
Board [2c 8c Ad Js 5d]
Seat 1: rjeg333 folded before Flop (didn't bet)
Seat 2: Mycartonfish (button) folded before Flop (didn't bet)
Seat 3: Gust4v0_7 (small blind) showed [Ah Ts] and won ($0.58) with a pair of Aces
Seat 5: vova osa (big blind) mucked [Ac 9c]
Seat 6: fbf58 folded on the River
Seat 7: pokertronde folded before Flop (didn't bet)
Seat 8: trueJamaican folded before Flop (didn't bet)
Seat 9: Dorex2007 folded before Flop (didn't bet)



PokerStars Hand #232166491661:  Hold'em No Limit ($0.01/$0.02 USD) - 2021/12/12 12:57:34 PT [2021/12/12 15:57:34 ET]
Table 'Lorcia' 9-max Seat #3 is the button
Seat 1: rjeg333 ($2.91 in chips) 
Seat 2: Mycartonfish ($2.22 in chips) 
Seat 3: Gust4v0_7 ($3.40 in chips) 
Seat 5: vova osa ($0.54 in chips) 
Seat 6: fbf58 ($1.82 in chips) 
Seat 7: pokertronde ($2 in chips) 
Seat 8: trueJamaican ($2.12 in chips) 
Seat 9: Dorex2007 ($2 in chips) 
vova osa: posts small blind $0.01
fbf58: posts big blind $0.02
*** HOLE CARDS ***
Dealt to Dorex2007 [9s 8s]
pokertronde: folds 
trueJamaican: folds 
Dorex2007: raises $0.02 to $0.04
rjeg333: folds 
Mycartonfish: calls $0.04
Gust4v0_7: folds 
vova osa: folds 
fbf58: calls $0.02
*** FLOP *** [3d 9h 8h]
vova osa leaves the table
fbf58: checks 
Dorex2007: bets $0.13
Mycartonfish: calls $0.13
fbf58: calls $0.13
*** TURN *** [3d 9h 8h] [7s]
fbf58: checks 
demioni88 joins the table at seat #5 
Dorex2007: bets $1.83 and is all-in
Mycartonfish: calls $1.83
fbf58: folds 
*** RIVER *** [3d 9h 8h 7s] [2h]
*** SHOW DOWN ***
Dorex2007: shows [9s 8s] (two pair, Nines and Eights)
Mycartonfish: shows [Th Ah] (a flush, Ace high)
Mycartonfish collected $4.03 from pot
Dorex2007 cashed out the hand for $2.63 | Cash Out Fee $0.03
*** SUMMARY ***
Total pot $4.18 | Rake $0.15 
Board [3d 9h 8h 7s 2h]
Seat 1: rjeg333 folded before Flop (didn't bet)
Seat 2: Mycartonfish showed [Th Ah] and won ($4.03) with a flush, Ace high
Seat 3: Gust4v0_7 (button) folded before Flop (didn't bet)
Seat 5: vova osa (small blind) folded before Flop
Seat 6: fbf58 (big blind) folded on the Turn
Seat 7: pokertronde folded before Flop (didn't bet)
Seat 8: trueJamaican folded before Flop (didn't bet)
Seat 9: Dorex2007 showed [9s 8s] and lost with two pair, Nines and Eights (cashed out).



PokerStars Hand #232166517605:  Hold'em No Limit ($0.01/$0.02 USD) - 2021/12/12 12:58:42 PT [2021/12/12 15:58:42 ET]
Table 'Lorcia' 9-max Seat #6 is the button
Seat 1: rjeg333 ($2.91 in chips) 
Seat 2: Mycartonfish ($4.25 in chips) 
Seat 3: Gust4v0_7 ($3.40 in chips) 
Seat 4: piller11 ($3.47 in chips) 
Seat 6: fbf58 ($1.65 in chips) 
Seat 7: pokertronde ($2 in chips) 
Seat 8: trueJamaican ($2.12 in chips) 
Seat 9: Dorex2007 ($2.63 in chips) 
pokertronde: posts small blind $0.01
trueJamaican: posts big blind $0.02
piller11: posts small & big blinds $0.03
demioni88: sits out 
*** HOLE CARDS ***
Dealt to Dorex2007 [2d 8d]
Dorex2007: folds 
rjeg333: folds 
Mycartonfish: folds 
Gust4v0_7: raises $0.04 to $0.06
piller11: folds 
fbf58: folds 
pokertronde: folds 
trueJamaican: folds 
Uncalled bet ($0.04) returned to Gust4v0_7
Gust4v0_7 collected $0.08 from pot
Gust4v0_7: doesn't show hand 
*** SUMMARY ***
Total pot $0.08 | Rake $0 
Seat 1: rjeg333 folded before Flop (didn't bet)
Seat 2: Mycartonfish folded before Flop (didn't bet)
Seat 3: Gust4v0_7 collected ($0.08)
Seat 4: piller11 folded before Flop (didn't bet)
Seat 6: fbf58 (button) folded before Flop (didn't bet)
Seat 7: pokertronde (small blind) folded before Flop
Seat 8: trueJamaican (big blind) folded before Flop
Seat 9: Dorex2007 folded before Flop (didn't bet)



PokerStars Hand #232166526994:  Hold'em No Limit ($0.01/$0.02 USD) - 2021/12/12 12:59:07 PT [2021/12/12 15:59:07 ET]
Table 'Lorcia' 9-max Seat #7 is the button
Seat 1: rjeg333 ($2.91 in chips) 
Seat 2: Mycartonfish ($4.25 in chips) 
Seat 3: Gust4v0_7 ($3.46 in chips) 
Seat 4: piller11 ($3.44 in chips) 
Seat 6: fbf58 ($1.65 in chips) 
Seat 7: pokertronde ($2 in chips) 
Seat 8: trueJamaican ($2.10 in chips) 
Seat 9: Dorex2007 ($2.63 in chips) 
trueJamaican: posts small blind $0.01
Dorex2007: posts big blind $0.02
demioni88: sits out 
*** HOLE CARDS ***
Dealt to Dorex2007 [5h Js]
rjeg333: folds 
Mycartonfish: folds 
Gust4v0_7: raises $0.02 to $0.04
piller11: calls $0.04
fbf58: folds 
pokertronde: folds 
trueJamaican: folds 
Dorex2007: folds 
*** FLOP *** [7s 9h Td]
Gust4v0_7: bets $0.06
piller11: raises $0.16 to $0.22
Gust4v0_7: calls $0.16
*** TURN *** [7s 9h Td] [Kd]
Gust4v0_7: checks 
piller11: bets $0.26
Gust4v0_7: calls $0.26
*** RIVER *** [7s 9h Td Kd] [4s]
Gust4v0_7: checks 
piller11: bets $0.52
Gust4v0_7: calls $0.52
*** SHOW DOWN ***
piller11: shows [8h Jh] (a straight, Seven to Jack)
Gust4v0_7: mucks hand 
piller11 collected $2.02 from pot
*** SUMMARY ***
Total pot $2.11 | Rake $0.09 
Board [7s 9h Td Kd 4s]
Seat 1: rjeg333 folded before Flop (didn't bet)
Seat 2: Mycartonfish folded before Flop (didn't bet)
Seat 3: Gust4v0_7 mucked [Qh Kh]
Seat 4: piller11 showed [8h Jh] and won ($2.02) with a straight, Seven to Jack
Seat 6: fbf58 folded before Flop (didn't bet)
Seat 7: pokertronde (button) folded before Flop (didn't bet)
Seat 8: trueJamaican (small blind) folded before Flop
Seat 9: Dorex2007 (big blind) folded before Flop



PokerStars Hand #232166555440:  Hold'em No Limit ($0.01/$0.02 USD) - 2021/12/12 13:00:21 PT [2021/12/12 16:00:21 ET]
Table 'Lorcia' 9-max Seat #8 is the button
Seat 1: rjeg333 ($2.91 in chips) 
Seat 2: Mycartonfish ($4.25 in chips) 
Seat 3: Gust4v0_7 ($2.42 in chips) 
Seat 4: piller11 ($4.42 in chips) 
Seat 6: fbf58 ($1.65 in chips) 
Seat 7: pokertronde ($2 in chips) 
Seat 8: trueJamaican ($2.09 in chips) 
Seat 9: Dorex2007 ($2.61 in chips) 
Dorex2007: posts small blind $0.01
rjeg333: posts big blind $0.02
demioni88: sits out 
*** HOLE CARDS ***
Dealt to Dorex2007 [9s 4s]
Mycartonfish: folds 
Gust4v0_7: calls $0.02
piller11: raises $0.04 to $0.06
fbf58: folds 
pokertronde: folds 
trueJamaican: folds 
Gust4v0_7 said, "NH"
Dorex2007: folds 
rjeg333: folds 
Gust4v0_7: calls $0.04
*** FLOP *** [6c Ah Jd]
Gust4v0_7: checks 
piller11: bets $0.06
Gust4v0_7: folds 
Uncalled bet ($0.06) returned to piller11
piller11 collected $0.14 from pot
*** SUMMARY ***
Total pot $0.15 | Rake $0.01 
Board [6c Ah Jd]
Seat 1: rjeg333 (big blind) folded before Flop
Seat 2: Mycartonfish folded before Flop (didn't bet)
Seat 3: Gust4v0_7 folded on the Flop
Seat 4: piller11 collected ($0.14)
Seat 6: fbf58 folded before Flop (didn't bet)
Seat 7: pokertronde folded before Flop (didn't bet)
Seat 8: trueJamaican (button) folded before Flop (didn't bet)
Seat 9: Dorex2007 (small blind) folded before Flop



PokerStars Hand #232166581471:  Hold'em No Limit ($0.01/$0.02 USD) - 2021/12/12 13:01:01 PT [2021/12/12 16:01:01 ET]
Table 'Lorcia' 9-max Seat #9 is the button
Seat 1: rjeg333 ($2.89 in chips) 
Seat 2: Mycartonfish ($4.25 in chips) 
Seat 3: Gust4v0_7 ($2.36 in chips) 
Seat 4: piller11 ($4.50 in chips) 
Seat 6: fbf58 ($1.65 in chips) 
Seat 7: pokertronde ($2 in chips) 
Seat 8: trueJamaican ($2.09 in chips) 
Seat 9: Dorex2007 ($2.60 in chips) 
rjeg333: posts small blind $0.01
Mycartonfish: posts big blind $0.02
demioni88: sits out 
*** HOLE CARDS ***
Dealt to Dorex2007 [Jh 3d]
Gust4v0_7: folds 
piller11: folds 
fbf58: calls $0.02
pokertronde: folds 
trueJamaican: raises $0.06 to $0.08
Dorex2007: folds 
rjeg333: folds 
Mycartonfish: folds 
fbf58: calls $0.06
*** FLOP *** [8s 5c 2d]
fbf58: checks 
trueJamaican: checks 
*** TURN *** [8s 5c 2d] [Th]
fbf58: bets $0.09
trueJamaican: folds 
Uncalled bet ($0.09) returned to fbf58
fbf58 collected $0.18 from pot
*** SUMMARY ***
Total pot $0.19 | Rake $0.01 
Board [8s 5c 2d Th]
Seat 1: rjeg333 (small blind) folded before Flop
Seat 2: Mycartonfish (big blind) folded before Flop
Seat 3: Gust4v0_7 folded before Flop (didn't bet)
Seat 4: piller11 folded before Flop (didn't bet)
Seat 6: fbf58 collected ($0.18)
Seat 7: pokertronde folded before Flop (didn't bet)
Seat 8: trueJamaican folded on the Turn
Seat 9: Dorex2007 (button) folded before Flop (didn't bet)



PokerStars Hand #232166599575:  Hold'em No Limit ($0.01/$0.02 USD) - 2021/12/12 13:01:40 PT [2021/12/12 16:01:40 ET]
Table 'Lorcia' 9-max Seat #1 is the button
Seat 1: rjeg333 ($2.88 in chips) 
Seat 2: Mycartonfish ($4.23 in chips) 
Seat 3: Gust4v0_7 ($2.36 in chips) 
Seat 4: piller11 ($4.50 in chips) 
Seat 6: fbf58 ($1.75 in chips) 
Seat 7: pokertronde ($2 in chips) 
Seat 8: trueJamaican ($2.01 in chips) 
Seat 9: Dorex2007 ($2.60 in chips) 
Mycartonfish: posts small blind $0.01
Gust4v0_7: posts big blind $0.02
demioni88: sits out 
*** HOLE CARDS ***
Dealt to Dorex2007 [3d 3c]
piller11: calls $0.02
fbf58: folds 
pokertronde: folds 
trueJamaican: folds 
Dorex2007: calls $0.02
rjeg333: folds 
Mycartonfish: folds 
Gust4v0_7: checks 
*** FLOP *** [Jd Ad Tc]
Gust4v0_7: checks 
piller11: checks 
Dorex2007: checks 
*** TURN *** [Jd Ad Tc] [2c]
Gust4v0_7: bets $0.07
piller11: folds 
Dorex2007: folds 
Uncalled bet ($0.07) returned to Gust4v0_7
Gust4v0_7 collected $0.07 from pot
Gust4v0_7: doesn't show hand 
*** SUMMARY ***
Total pot $0.07 | Rake $0 
Board [Jd Ad Tc 2c]
Seat 1: rjeg333 (button) folded before Flop (didn't bet)
Seat 2: Mycartonfish (small blind) folded before Flop
Seat 3: Gust4v0_7 (big blind) collected ($0.07)
Seat 4: piller11 folded on the Turn
Seat 6: fbf58 folded before Flop (didn't bet)
Seat 7: pokertronde folded before Flop (didn't bet)
Seat 8: trueJamaican folded before Flop (didn't bet)
Seat 9: Dorex2007 folded on the Turn



PokerStars Hand #232166624077:  Hold'em No Limit ($0.01/$0.02 USD) - 2021/12/12 13:02:25 PT [2021/12/12 16:02:25 ET]
Table 'Lorcia' 9-max Seat #2 is the button
Seat 1: rjeg333 ($2.88 in chips) 
Seat 2: Mycartonfish ($4.22 in chips) 
Seat 3: Gust4v0_7 ($2.41 in chips) 
Seat 4: piller11 ($4.48 in chips) 
Seat 6: fbf58 ($1.75 in chips) 
Seat 7: pokertronde ($2 in chips) 
Seat 8: trueJamaican ($2.01 in chips) 
Seat 9: Dorex2007 ($2.58 in chips) 
Gust4v0_7: posts small blind $0.01
piller11: posts big blind $0.02
demioni88: sits out 
*** HOLE CARDS ***
Dealt to Dorex2007 [3h 4d]
fbf58: folds 
pokertronde: folds 
trueJamaican: folds 
Dorex2007: folds 
rjeg333: folds 
Mycartonfish: calls $0.02
Gust4v0_7: calls $0.01
piller11: checks 
*** FLOP *** [2d Ad 4h]
Gust4v0_7: checks 
piller11: checks 
Mycartonfish: checks 
*** TURN *** [2d Ad 4h] [9c]
Gust4v0_7: checks 
piller11: checks 
Mycartonfish: checks 
*** RIVER *** [2d Ad 4h 9c] [6h]
Gust4v0_7: checks 
piller11: checks 
Mycartonfish: checks 
*** SHOW DOWN ***
Gust4v0_7: shows [8c Ts] (high card Ace)
piller11: shows [Qs 5d] (high card Ace - Queen kicker)
Mycartonfish: mucks hand 
piller11 collected $0.06 from pot
*** SUMMARY ***
Total pot $0.06 | Rake $0 
Board [2d Ad 4h 9c 6h]
Seat 1: rjeg333 folded before Flop (didn't bet)
Seat 2: Mycartonfish (button) mucked [Js Tc]
Seat 3: Gust4v0_7 (small blind) showed [8c Ts] and lost with high card Ace
Seat 4: piller11 (big blind) showed [Qs 5d] and won ($0.06) with high card Ace
Seat 6: fbf58 folded before Flop (didn't bet)
Seat 7: pokertronde folded before Flop (didn't bet)
Seat 8: trueJamaican folded before Flop (didn't bet)
Seat 9: Dorex2007 folded before Flop (didn't bet)



PokerStars Hand #232166659729:  Hold'em No Limit ($0.01/$0.02 USD) - 2021/12/12 13:03:27 PT [2021/12/12 16:03:27 ET]
Table 'Lorcia' 9-max Seat #3 is the button
Seat 1: rjeg333 ($2.88 in chips) 
Seat 2: Mycartonfish ($4.20 in chips) 
Seat 3: Gust4v0_7 ($2.39 in chips) 
Seat 4: piller11 ($4.52 in chips) 
Seat 5: demioni88 ($1.60 in chips) 
Seat 6: fbf58 ($1.75 in chips) 
Seat 7: pokertronde ($2 in chips) 
Seat 8: trueJamaican ($2.01 in chips) 
Seat 9: Dorex2007 ($2.58 in chips) 
piller11: posts small blind $0.01
demioni88: posts big blind $0.02
*** HOLE CARDS ***
Dealt to Dorex2007 [5h 5c]
fbf58: calls $0.02
pokertronde: folds 
trueJamaican: folds 
Dorex2007: calls $0.02
rjeg333: folds 
Mycartonfish: calls $0.02
Gust4v0_7: folds 
piller11: folds 
demioni88: checks 
*** FLOP *** [Jh Qs Kd]
demioni88: checks 
fbf58: checks 
Dorex2007: checks 
Mycartonfish: checks 
*** TURN *** [Jh Qs Kd] [Jc]
demioni88: checks 
fbf58: bets $0.09
Dorex2007: folds 
Mycartonfish: folds 
demioni88: folds 
Uncalled bet ($0.09) returned to fbf58
fbf58 collected $0.09 from pot
*** SUMMARY ***
Total pot $0.09 | Rake $0 
Board [Jh Qs Kd Jc]
Seat 1: rjeg333 folded before Flop (didn't bet)
Seat 2: Mycartonfish folded on the Turn
Seat 3: Gust4v0_7 (button) folded before Flop (didn't bet)
Seat 4: piller11 (small blind) folded before Flop
Seat 5: demioni88 (big blind) folded on the Turn
Seat 6: fbf58 collected ($0.09)
Seat 7: pokertronde folded before Flop (didn't bet)
Seat 8: trueJamaican folded before Flop (didn't bet)
Seat 9: Dorex2007 folded on the Turn



PokerStars Hand #232166686993:  Hold'em No Limit ($0.01/$0.02 USD) - 2021/12/12 13:04:13 PT [2021/12/12 16:04:13 ET]
Table 'Lorcia' 9-max Seat #4 is the button
Seat 1: rjeg333 ($2.88 in chips) 
Seat 2: Mycartonfish ($4.18 in chips) 
Seat 3: Gust4v0_7 ($2.39 in chips) 
Seat 4: piller11 ($4.51 in chips) 
Seat 5: demioni88 ($1.58 in chips) 
Seat 6: fbf58 ($1.82 in chips) 
Seat 7: pokertronde ($2 in chips) 
Seat 8: trueJamaican ($2.01 in chips) 
Seat 9: Dorex2007 ($2.56 in chips) 
demioni88: posts small blind $0.01
fbf58: posts big blind $0.02
*** HOLE CARDS ***
Dealt to Dorex2007 [7h 2d]
pokertronde: folds 
trueJamaican: folds 
Dorex2007: folds 
rjeg333: folds 
Mycartonfish: folds 
Gust4v0_7: folds 
piller11: folds 
demioni88: calls $0.01
fbf58: checks 
*** FLOP *** [8d 6s Kc]
demioni88: bets $0.04
fbf58: folds 
Uncalled bet ($0.04) returned to demioni88
demioni88 collected $0.04 from pot
demioni88: doesn't show hand 
*** SUMMARY ***
Total pot $0.04 | Rake $0 
Board [8d 6s Kc]
Seat 1: rjeg333 folded before Flop (didn't bet)
Seat 2: Mycartonfish folded before Flop (didn't bet)
Seat 3: Gust4v0_7 folded before Flop (didn't bet)
Seat 4: piller11 (button) folded before Flop (didn't bet)
Seat 5: demioni88 (small blind) collected ($0.04)
Seat 6: fbf58 (big blind) folded on the Flop
Seat 7: pokertronde folded before Flop (didn't bet)
Seat 8: trueJamaican folded before Flop (didn't bet)
Seat 9: Dorex2007 folded before Flop (didn't bet)



PokerStars Hand #232166704210:  Hold'em No Limit ($0.01/$0.02 USD) - 2021/12/12 13:04:42 PT [2021/12/12 16:04:42 ET]
Table 'Lorcia' 9-max Seat #5 is the button
Seat 1: rjeg333 ($2.88 in chips) 
Seat 2: Mycartonfish ($4.18 in chips) 
Seat 3: Gust4v0_7 ($2.39 in chips) 
Seat 4: piller11 ($4.51 in chips) 
Seat 5: demioni88 ($1.60 in chips) 
Seat 6: fbf58 ($1.80 in chips) 
Seat 7: pokertronde ($2 in chips) 
Seat 8: trueJamaican ($2.01 in chips) 
Seat 9: Dorex2007 ($2.56 in chips) 
fbf58: posts small blind $0.01
pokertronde: posts big blind $0.02
*** HOLE CARDS ***
Dealt to Dorex2007 [Js 2c]
trueJamaican: raises $0.04 to $0.06
Dorex2007: folds 
rjeg333: folds 
Mycartonfish: folds 
Gust4v0_7: calls $0.06
piller11: calls $0.06
demioni88: folds 
fbf58: calls $0.05
pokertronde: calls $0.04
*** FLOP *** [3s 2d 6s]
fbf58: checks 
pokertronde: checks 
trueJamaican: checks 
Gust4v0_7: checks 
piller11: bets $0.14
fbf58: folds 
pokertronde: folds 
trueJamaican: folds 
Gust4v0_7: folds 
Uncalled bet ($0.14) returned to piller11
piller11 collected $0.29 from pot
*** SUMMARY ***
Total pot $0.30 | Rake $0.01 
Board [3s 2d 6s]
Seat 1: rjeg333 folded before Flop (didn't bet)
Seat 2: Mycartonfish folded before Flop (didn't bet)
Seat 3: Gust4v0_7 folded on the Flop
Seat 4: piller11 collected ($0.29)
Seat 5: demioni88 (button) folded before Flop (didn't bet)
Seat 6: fbf58 (small blind) folded on the Flop
Seat 7: pokertronde (big blind) folded on the Flop
Seat 8: trueJamaican folded on the Flop
Seat 9: Dorex2007 folded before Flop (didn't bet)



PokerStars Hand #232166737729:  Hold'em No Limit ($0.01/$0.02 USD) - 2021/12/12 13:05:40 PT [2021/12/12 16:05:40 ET]
Table 'Lorcia' 9-max Seat #6 is the button
Seat 1: rjeg333 ($2.88 in chips) 
Seat 2: Mycartonfish ($4.18 in chips) 
Seat 3: Gust4v0_7 ($2.33 in chips) 
Seat 4: piller11 ($4.74 in chips) 
Seat 5: demioni88 ($1.60 in chips) 
Seat 6: fbf58 ($1.74 in chips) 
Seat 7: pokertronde ($2 in chips) 
Seat 8: trueJamaican ($2 in chips) 
Seat 9: Dorex2007 ($2.56 in chips) 
pokertronde: posts small blind $0.01
trueJamaican: posts big blind $0.02
*** HOLE CARDS ***
Dealt to Dorex2007 [Jd Td]
Dorex2007: raises $0.02 to $0.04
rjeg333: raises $0.06 to $0.10
Mycartonfish: folds 
Gust4v0_7: folds 
piller11: folds 
demioni88: folds 
fbf58: folds 
pokertronde: folds 
trueJamaican: folds 
Dorex2007: calls $0.06
*** FLOP *** [Tc 4h 7c]
Dorex2007: checks 
rjeg333: bets $0.06
Dorex2007: calls $0.06
*** TURN *** [Tc 4h 7c] [Qh]
Dorex2007: checks 
rjeg333: checks 
*** RIVER *** [Tc 4h 7c Qh] [2h]
Dorex2007: bets $0.23
rjeg333: calls $0.23
*** SHOW DOWN ***
Dorex2007: shows [Jd Td] (a pair of Tens)
rjeg333: mucks hand 
Dorex2007 collected $0.78 from pot
*** SUMMARY ***
Total pot $0.81 | Rake $0.03 
Board [Tc 4h 7c Qh 2h]
Seat 1: rjeg333 mucked [Ts 9s]
Seat 2: Mycartonfish folded before Flop (didn't bet)
Seat 3: Gust4v0_7 folded before Flop (didn't bet)
Seat 4: piller11 folded before Flop (didn't bet)
Seat 5: demioni88 folded before Flop (didn't bet)
Seat 6: fbf58 (button) folded before Flop (didn't bet)
Seat 7: pokertronde (small blind) folded before Flop
Seat 8: trueJamaican (big blind) folded before Flop
Seat 9: Dorex2007 showed [Jd Td] and won ($0.78) with a pair of Tens



PokerStars Hand #232166790304:  Hold'em No Limit ($0.01/$0.02 USD) - 2021/12/12 13:07:09 PT [2021/12/12 16:07:09 ET]
Table 'Lorcia' 9-max Seat #7 is the button
Seat 1: rjeg333 ($2.49 in chips) 
Seat 2: Mycartonfish ($4.18 in chips) 
Seat 3: Gust4v0_7 ($2.33 in chips) 
Seat 4: piller11 ($4.74 in chips) 
Seat 5: demioni88 ($1.60 in chips) 
Seat 6: fbf58 ($1.74 in chips) 
Seat 7: pokertronde ($2 in chips) 
Seat 8: trueJamaican ($2 in chips) 
Seat 9: Dorex2007 ($2.95 in chips) 
trueJamaican: posts small blind $0.01
Dorex2007: posts big blind $0.02
*** HOLE CARDS ***
Dealt to Dorex2007 [4s 6s]
rjeg333: folds 
Mycartonfish: folds 
Gust4v0_7: calls $0.02
piller11: raises $0.02 to $0.04
demioni88: folds 
Dorex2007 said, "your equity calculator didn't work"
fbf58: calls $0.04
pokertronde: calls $0.04
trueJamaican: raises $0.16 to $0.20
Dorex2007: folds 
Gust4v0_7: folds 
piller11: folds 
fbf58: folds 
pokertronde: folds 
Uncalled bet ($0.16) returned to trueJamaican
trueJamaican collected $0.20 from pot
*** SUMMARY ***
Total pot $0.20 | Rake $0 
Seat 1: rjeg333 folded before Flop (didn't bet)
Seat 2: Mycartonfish folded before Flop (didn't bet)
Seat 3: Gust4v0_7 folded before Flop
Seat 4: piller11 folded before Flop
Seat 5: demioni88 folded before Flop (didn't bet)
Seat 6: fbf58 folded before Flop
Seat 7: pokertronde (button) folded before Flop
Seat 8: trueJamaican (small blind) collected ($0.20)
Seat 9: Dorex2007 (big blind) folded before Flop



PokerStars Hand #232166826261:  Hold'em No Limit ($0.01/$0.02 USD) - 2021/12/12 13:08:11 PT [2021/12/12 16:08:11 ET]
Table 'Lorcia' 9-max Seat #8 is the button
Seat 1: rjeg333 ($2.49 in chips) 
Seat 2: Mycartonfish ($4.18 in chips) 
Seat 3: Gust4v0_7 ($2.31 in chips) 
Seat 4: piller11 ($4.70 in chips) 
Seat 5: demioni88 ($1.60 in chips) 
Seat 6: fbf58 ($1.70 in chips) 
Seat 7: pokertronde ($2 in chips) 
Seat 8: trueJamaican ($2.16 in chips) 
Seat 9: Dorex2007 ($2.93 in chips) 
Dorex2007: posts small blind $0.01
rjeg333: posts big blind $0.02
*** HOLE CARDS ***
Dealt to Dorex2007 [2h Tc]
Mycartonfish: folds 
Gust4v0_7: folds 
piller11: raises $0.08 to $0.10
demioni88: folds 
fbf58: folds 
pokertronde: folds 
trueJamaican: folds 
Dorex2007: folds 
rjeg333: folds 
Uncalled bet ($0.08) returned to piller11
piller11 collected $0.05 from pot
*** SUMMARY ***
Total pot $0.05 | Rake $0 
Seat 1: rjeg333 (big blind) folded before Flop
Seat 2: Mycartonfish folded before Flop (didn't bet)
Seat 3: Gust4v0_7 folded before Flop (didn't bet)
Seat 4: piller11 collected ($0.05)
Seat 5: demioni88 folded before Flop (didn't bet)
Seat 6: fbf58 folded before Flop (didn't bet)
Seat 7: pokertronde folded before Flop (didn't bet)
Seat 8: trueJamaican (button) folded before Flop (didn't bet)
Seat 9: Dorex2007 (small blind) folded before Flop



PokerStars Hand #232166838896:  Hold'em No Limit ($0.01/$0.02 USD) - 2021/12/12 13:08:32 PT [2021/12/12 16:08:32 ET]
Table 'Lorcia' 9-max Seat #9 is the button
Seat 1: rjeg333 ($2.47 in chips) 
Seat 2: Mycartonfish ($4.18 in chips) 
Seat 3: Gust4v0_7 ($2.31 in chips) 
Seat 4: piller11 ($4.73 in chips) 
Seat 5: demioni88 ($1.60 in chips) 
Seat 6: fbf58 ($1.70 in chips) 
Seat 7: pokertronde ($2 in chips) 
Seat 8: trueJamaican ($2.16 in chips) 
Seat 9: Dorex2007 ($2.92 in chips) 
rjeg333: posts small blind $0.01
Mycartonfish: posts big blind $0.02
*** HOLE CARDS ***
Dealt to Dorex2007 [Ks 9s]
Gust4v0_7: raises $0.02 to $0.04
piller11: folds 
demioni88: calls $0.04
fbf58: calls $0.04
pokertronde: folds 
trueJamaican: folds 
Dorex2007: folds 
rjeg333: folds 
Mycartonfish: calls $0.02
*** FLOP *** [4s 3h 3c]
Mycartonfish: checks 
Gust4v0_7: bets $0.06
demioni88: folds 
fbf58: folds 
Mycartonfish: folds 
Uncalled bet ($0.06) returned to Gust4v0_7
Gust4v0_7 collected $0.16 from pot
Gust4v0_7: doesn't show hand 
*** SUMMARY ***
Total pot $0.17 | Rake $0.01 
Board [4s 3h 3c]
Seat 1: rjeg333 (small blind) folded before Flop
Seat 2: Mycartonfish (big blind) folded on the Flop
Seat 3: Gust4v0_7 collected ($0.16)
Seat 4: piller11 folded before Flop (didn't bet)
Seat 5: demioni88 folded on the Flop
Seat 6: fbf58 folded on the Flop
Seat 7: pokertronde folded before Flop (didn't bet)
Seat 8: trueJamaican folded before Flop (didn't bet)
Seat 9: Dorex2007 (button) folded before Flop (didn't bet)



PokerStars Hand #232166865799:  Hold'em No Limit ($0.01/$0.02 USD) - 2021/12/12 13:09:19 PT [2021/12/12 16:09:19 ET]
Table 'Lorcia' 9-max Seat #1 is the button
Seat 1: rjeg333 ($2.46 in chips) 
Seat 2: Mycartonfish ($4.14 in chips) 
Seat 3: Gust4v0_7 ($2.43 in chips) 
Seat 4: piller11 ($4.73 in chips) 
Seat 5: demioni88 ($1.56 in chips) 
Seat 6: fbf58 ($1.66 in chips) 
Seat 7: pokertronde ($2 in chips) 
Seat 8: trueJamaican ($2.16 in chips) 
Seat 9: Dorex2007 ($2.92 in chips) 
Mycartonfish: posts small blind $0.01
Gust4v0_7: posts big blind $0.02
*** HOLE CARDS ***
Dealt to Dorex2007 [Qh Qd]
piller11: raises $0.06 to $0.08
demioni88: folds 
fbf58: folds 
pokertronde: folds 
trueJamaican: folds 
Dorex2007: raises $0.19 to $0.27
rjeg333: folds 
Mycartonfish: folds 
Gust4v0_7: calls $0.25
piller11: calls $0.19
*** FLOP *** [8s Ac Ts]
Mycartonfish leaves the table
Gust4v0_7: checks 
littlebear2020 joins the table at seat #2 
piller11: bets $0.26
Dorex2007: folds 
Gust4v0_7: calls $0.26
*** TURN *** [8s Ac Ts] [2d]
Gust4v0_7: checks 
piller11: bets $0.52
Gust4v0_7: raises $0.52 to $1.04
piller11: raises $3.16 to $4.20 and is all-in
Gust4v0_7: calls $0.86 and is all-in
Uncalled bet ($2.30) returned to piller11
*** RIVER *** [8s Ac Ts 2d] [7c]
*** SHOW DOWN ***
Gust4v0_7: shows [Ah Ad] (three of a kind, Aces)
piller11: shows [Tc Th] (three of a kind, Tens)
Gust4v0_7 collected $4.96 from pot
*** SUMMARY ***
Total pot $5.14 | Rake $0.18 
Board [8s Ac Ts 2d 7c]
Seat 1: rjeg333 (button) folded before Flop (didn't bet)
Seat 2: Mycartonfish (small blind) folded before Flop
Seat 3: Gust4v0_7 (big blind) showed [Ah Ad] and won ($4.96) with three of a kind, Aces
Seat 4: piller11 showed [Tc Th] and lost with three of a kind, Tens
Seat 5: demioni88 folded before Flop (didn't bet)
Seat 6: fbf58 folded before Flop (didn't bet)
Seat 7: pokertronde folded before Flop (didn't bet)
Seat 8: trueJamaican folded before Flop (didn't bet)
Seat 9: Dorex2007 folded on the Flop



PokerStars Hand #232166917921:  Hold'em No Limit ($0.01/$0.02 USD) - 2021/12/12 13:10:34 PT [2021/12/12 16:10:34 ET]
Table 'Lorcia' 9-max Seat #3 is the button
Seat 1: rjeg333 ($2.46 in chips) 
Seat 3: Gust4v0_7 ($4.96 in chips) 
Seat 4: piller11 ($2.30 in chips) 
Seat 5: demioni88 ($1.56 in chips) 
Seat 6: fbf58 ($1.66 in chips) 
Seat 7: pokertronde ($2 in chips) 
Seat 8: trueJamaican ($2.16 in chips) 
Seat 9: Dorex2007 ($2.65 in chips) 
piller11: posts small blind $0.01
demioni88: posts big blind $0.02
littlebear2020: sits out 
*** HOLE CARDS ***
Dealt to Dorex2007 [8h Th]
fbf58: calls $0.02
pokertronde: folds 
trueJamaican: folds 
Dorex2007: calls $0.02
rjeg333: raises $0.09 to $0.11
Gust4v0_7: folds 
piller11: folds 
demioni88: folds 
fbf58: folds 
Dorex2007: folds 
Uncalled bet ($0.09) returned to rjeg333
rjeg333 collected $0.09 from pot
*** SUMMARY ***
Total pot $0.09 | Rake $0 
Seat 1: rjeg333 collected ($0.09)
Seat 3: Gust4v0_7 (button) folded before Flop (didn't bet)
Seat 4: piller11 (small blind) folded before Flop
Seat 5: demioni88 (big blind) folded before Flop
Seat 6: fbf58 folded before Flop
Seat 7: pokertronde folded before Flop (didn't bet)
Seat 8: trueJamaican folded before Flop (didn't bet)
Seat 9: Dorex2007 folded before Flop



PokerStars Hand #232166933483:  Hold'em No Limit ($0.01/$0.02 USD) - 2021/12/12 13:11:00 PT [2021/12/12 16:11:00 ET]
Table 'Lorcia' 9-max Seat #4 is the button
Seat 1: rjeg333 ($2.53 in chips) 
Seat 2: littlebear2020 ($2 in chips) 
Seat 3: Gust4v0_7 ($4.96 in chips) 
Seat 4: piller11 ($2.29 in chips) 
Seat 5: demioni88 ($1.54 in chips) 
Seat 6: fbf58 ($1.64 in chips) 
Seat 7: pokertronde ($2 in chips) 
Seat 8: trueJamaican ($2.16 in chips) 
Seat 9: Dorex2007 ($2.63 in chips) 
demioni88: posts small blind $0.01
fbf58: posts big blind $0.02
littlebear2020: posts big blind $0.02
*** HOLE CARDS ***
Dealt to Dorex2007 [Jc Jd]
pokertronde: folds 
trueJamaican: folds 
Dorex2007: raises $0.04 to $0.06
rjeg333: folds 
littlebear2020: folds 
Gust4v0_7: folds 
piller11: folds 
demioni88: folds 
fbf58: calls $0.04
*** FLOP *** [Jh 7c 8d]
fbf58: checks 
Dorex2007: checks 
*** TURN *** [Jh 7c 8d] [9c]
fbf58: bets $0.02
Dorex2007: calls $0.02
*** RIVER *** [Jh 7c 8d 9c] [7d]
fbf58: checks 
Dorex2007: bets $0.18
fbf58: folds 
Uncalled bet ($0.18) returned to Dorex2007
Dorex2007 collected $0.18 from pot
Dorex2007: doesn't show hand 
*** SUMMARY ***
Total pot $0.19 | Rake $0.01 
Board [Jh 7c 8d 9c 7d]
Seat 1: rjeg333 folded before Flop (didn't bet)
Seat 2: littlebear2020 folded before Flop (didn't bet)
Seat 3: Gust4v0_7 folded before Flop (didn't bet)
Seat 4: piller11 (button) folded before Flop (didn't bet)
Seat 5: demioni88 (small blind) folded before Flop
Seat 6: fbf58 (big blind) folded on the River
Seat 7: pokertronde folded before Flop (didn't bet)
Seat 8: trueJamaican folded before Flop (didn't bet)
Seat 9: Dorex2007 collected ($0.18)



PokerStars Hand #232166964074:  Hold'em No Limit ($0.01/$0.02 USD) - 2021/12/12 13:11:53 PT [2021/12/12 16:11:53 ET]
Table 'Lorcia' 9-max Seat #5 is the button
Seat 1: rjeg333 ($2.53 in chips) 
Seat 2: littlebear2020 ($1.98 in chips) 
Seat 3: Gust4v0_7 ($4.96 in chips) 
Seat 4: piller11 ($2.29 in chips) 
Seat 5: demioni88 ($1.53 in chips) 
Seat 6: fbf58 ($1.56 in chips) 
Seat 7: pokertronde ($2 in chips) 
Seat 8: trueJamaican ($2.16 in chips) 
Seat 9: Dorex2007 ($2.73 in chips) 
fbf58: posts small blind $0.01
pokertronde: posts big blind $0.02
*** HOLE CARDS ***
Dealt to Dorex2007 [6h As]
trueJamaican: folds 
Dorex2007: folds 
rjeg333: raises $0.04 to $0.06
littlebear2020: folds 
Gust4v0_7: folds 
piller11: folds 
demioni88: folds 
fbf58: folds 
pokertronde: folds 
Uncalled bet ($0.04) returned to rjeg333
rjeg333 collected $0.05 from pot
*** SUMMARY ***
Total pot $0.05 | Rake $0 
Seat 1: rjeg333 collected ($0.05)
Seat 2: littlebear2020 folded before Flop (didn't bet)
Seat 3: Gust4v0_7 folded before Flop (didn't bet)
Seat 4: piller11 folded before Flop (didn't bet)
Seat 5: demioni88 (button) folded before Flop (didn't bet)
Seat 6: fbf58 (small blind) folded before Flop
Seat 7: pokertronde (big blind) folded before Flop
Seat 8: trueJamaican folded before Flop (didn't bet)
Seat 9: Dorex2007 folded before Flop (didn't bet)



PokerStars Hand #232166987172:  Hold'em No Limit ($0.01/$0.02 USD) - 2021/12/12 13:12:33 PT [2021/12/12 16:12:33 ET]
Table 'Lorcia' 9-max Seat #6 is the button
Seat 1: rjeg333 ($2.56 in chips) 
Seat 2: littlebear2020 ($1.98 in chips) 
Seat 3: Gust4v0_7 ($4.96 in chips) 
Seat 4: piller11 ($2.29 in chips) 
Seat 5: demioni88 ($1.53 in chips) 
Seat 6: fbf58 ($1.55 in chips) 
Seat 7: pokertronde ($2 in chips) 
Seat 8: trueJamaican ($2.16 in chips) 
Seat 9: Dorex2007 ($2.73 in chips) 
pokertronde: posts small blind $0.01
trueJamaican: posts big blind $0.02
*** HOLE CARDS ***
Dealt to Dorex2007 [Qs 3d]
Dorex2007: folds 
rjeg333: raises $0.04 to $0.06
littlebear2020: folds 
Gust4v0_7: folds 
piller11: calls $0.06
demioni88: folds 
fbf58: folds 
pokertronde: folds 
trueJamaican: folds 
*** FLOP *** [5d 6h 7d]
rjeg333: checks 
piller11: bets $0.10
rjeg333: calls $0.10
*** TURN *** [5d 6h 7d] [Jh]
rjeg333: checks 
piller11: bets $0.10
rjeg333: calls $0.10
*** RIVER *** [5d 6h 7d Jh] [Qh]
rjeg333: bets $0.40
piller11: folds 
Uncalled bet ($0.40) returned to rjeg333
rjeg333 collected $0.53 from pot
*** SUMMARY ***
Total pot $0.55 | Rake $0.02 
Board [5d 6h 7d Jh Qh]
Seat 1: rjeg333 collected ($0.53)
Seat 2: littlebear2020 folded before Flop (didn't bet)
Seat 3: Gust4v0_7 folded before Flop (didn't bet)
Seat 4: piller11 folded on the River
Seat 5: demioni88 folded before Flop (didn't bet)
Seat 6: fbf58 (button) folded before Flop (didn't bet)
Seat 7: pokertronde (small blind) folded before Flop
Seat 8: trueJamaican (big blind) folded before Flop
Seat 9: Dorex2007 folded before Flop (didn't bet)



PokerStars Hand #232167031177:  Hold'em No Limit ($0.01/$0.02 USD) - 2021/12/12 13:13:48 PT [2021/12/12 16:13:48 ET]
Table 'Lorcia' 9-max Seat #7 is the button
Seat 1: rjeg333 ($2.83 in chips) 
Seat 2: littlebear2020 ($1.98 in chips) 
Seat 3: Gust4v0_7 ($4.96 in chips) 
Seat 4: piller11 ($2.03 in chips) 
Seat 5: demioni88 ($1.53 in chips) 
Seat 6: fbf58 ($1.55 in chips) 
Seat 7: pokertronde ($2 in chips) 
Seat 8: trueJamaican ($2.14 in chips) 
Seat 9: Dorex2007 ($2.73 in chips) 
trueJamaican: posts small blind $0.01
Dorex2007: posts big blind $0.02
*** HOLE CARDS ***
Dealt to Dorex2007 [3d Qs]
rjeg333: folds 
littlebear2020: folds 
Gust4v0_7: raises $0.04 to $0.06
piller11: folds 
demioni88: calls $0.06
fbf58: folds 
pokertronde: folds 
trueJamaican: folds 
Dorex2007: folds 
*** FLOP *** [7s Ah Kd]
Gust4v0_7: bets $0.06
demioni88: calls $0.06
*** TURN *** [7s Ah Kd] [5d]
Gust4v0_7: checks 
demioni88: checks 
*** RIVER *** [7s Ah Kd 5d] [4d]
Gust4v0_7: checks 
demioni88: checks 
*** SHOW DOWN ***
Gust4v0_7: shows [Qh Th] (high card Ace)
demioni88: shows [Tc Ts] (a pair of Tens)
demioni88 collected $0.26 from pot
*** SUMMARY ***
Total pot $0.27 | Rake $0.01 
Board [7s Ah Kd 5d 4d]
Seat 1: rjeg333 folded before Flop (didn't bet)
Seat 2: littlebear2020 folded before Flop (didn't bet)
Seat 3: Gust4v0_7 showed [Qh Th] and lost with high card Ace
Seat 4: piller11 folded before Flop (didn't bet)
Seat 5: demioni88 showed [Tc Ts] and won ($0.26) with a pair of Tens
Seat 6: fbf58 folded before Flop (didn't bet)
Seat 7: pokertronde (button) folded before Flop (didn't bet)
Seat 8: trueJamaican (small blind) folded before Flop
Seat 9: Dorex2007 (big blind) folded before Flop



PokerStars Hand #232167057965:  Hold'em No Limit ($0.01/$0.02 USD) - 2021/12/12 13:14:35 PT [2021/12/12 16:14:35 ET]
Table 'Lorcia' 9-max Seat #8 is the button
Seat 1: rjeg333 ($2.83 in chips) 
Seat 2: littlebear2020 ($1.98 in chips) 
Seat 3: Gust4v0_7 ($4.84 in chips) 
Seat 4: piller11 ($2.03 in chips) 
Seat 5: demioni88 ($1.67 in chips) 
Seat 6: fbf58 ($1.55 in chips) 
Seat 7: pokertronde ($2 in chips) 
Seat 8: trueJamaican ($2.13 in chips) 
Seat 9: Dorex2007 ($2.71 in chips) 
Dorex2007: posts small blind $0.01
rjeg333: posts big blind $0.02
*** HOLE CARDS ***
Dealt to Dorex2007 [9d Js]
littlebear2020: raises $0.04 to $0.06
Gust4v0_7: calls $0.06
piller11: folds 
demioni88: folds 
fbf58: folds 
pokertronde: folds 
trueJamaican: folds 
Dorex2007: folds 
rjeg333: folds 
*** FLOP *** [2h Qh Kd]
littlebear2020: bets $0.06
Gust4v0_7: calls $0.06
*** TURN *** [2h Qh Kd] [9c]
littlebear2020: bets $0.06
Gust4v0_7: calls $0.06
*** RIVER *** [2h Qh Kd 9c] [3h]
littlebear2020: checks 
Gust4v0_7: bets $0.32
littlebear2020: calls $0.32
*** SHOW DOWN ***
Gust4v0_7: shows [Jh 9h] (a flush, Queen high)
littlebear2020: mucks hand 
Gust4v0_7 collected $0.99 from pot
*** SUMMARY ***
Total pot $1.03 | Rake $0.04 
Board [2h Qh Kd 9c 3h]
Seat 1: rjeg333 (big blind) folded before Flop
Seat 2: littlebear2020 mucked [Ad Kh]
Seat 3: Gust4v0_7 showed [Jh 9h] and won ($0.99) with a flush, Queen high
Seat 4: piller11 folded before Flop (didn't bet)
Seat 5: demioni88 folded before Flop (didn't bet)
Seat 6: fbf58 folded before Flop (didn't bet)
Seat 7: pokertronde folded before Flop (didn't bet)
Seat 8: trueJamaican (button) folded before Flop (didn't bet)
Seat 9: Dorex2007 (small blind) folded before Flop



PokerStars Hand #232167093116:  Hold'em No Limit ($0.01/$0.02 USD) - 2021/12/12 13:15:35 PT [2021/12/12 16:15:35 ET]
Table 'Lorcia' 9-max Seat #9 is the button
Seat 1: rjeg333 ($2.81 in chips) 
Seat 2: littlebear2020 ($1.48 in chips) 
Seat 3: Gust4v0_7 ($5.33 in chips) 
Seat 4: piller11 ($2.03 in chips) 
Seat 5: demioni88 ($1.67 in chips) 
Seat 6: fbf58 ($1.55 in chips) 
Seat 7: pokertronde ($2 in chips) 
Seat 8: trueJamaican ($2.13 in chips) 
Seat 9: Dorex2007 ($2.70 in chips) 
rjeg333: posts small blind $0.01
littlebear2020: posts big blind $0.02
*** HOLE CARDS ***
Dealt to Dorex2007 [Ah 3s]
Gust4v0_7: folds 
piller11: folds 
demioni88: folds 
fbf58: calls $0.02
pokertronde: folds 
trueJamaican: folds 
Dorex2007: folds 
rjeg333: folds 
littlebear2020: checks 
*** FLOP *** [5c 3h 8s]
littlebear2020: bets $0.05
fbf58: calls $0.05
*** TURN *** [5c 3h 8s] [Ks]
littlebear2020: checks 
fbf58: bets $0.07
littlebear2020: folds 
Uncalled bet ($0.07) returned to fbf58
fbf58 collected $0.14 from pot
*** SUMMARY ***
Total pot $0.15 | Rake $0.01 
Board [5c 3h 8s Ks]
Seat 1: rjeg333 (small blind) folded before Flop
Seat 2: littlebear2020 (big blind) folded on the Turn
Seat 3: Gust4v0_7 folded before Flop (didn't bet)
Seat 4: piller11 folded before Flop (didn't bet)
Seat 5: demioni88 folded before Flop (didn't bet)
Seat 6: fbf58 collected ($0.14)
Seat 7: pokertronde folded before Flop (didn't bet)
Seat 8: trueJamaican folded before Flop (didn't bet)
Seat 9: Dorex2007 (button) folded before Flop (didn't bet)



PokerStars Hand #232167111507:  Hold'em No Limit ($0.01/$0.02 USD) - 2021/12/12 13:16:06 PT [2021/12/12 16:16:06 ET]
Table 'Lorcia' 9-max Seat #1 is the button
Seat 1: rjeg333 ($2.80 in chips) 
Seat 2: littlebear2020 ($1.41 in chips) 
Seat 3: Gust4v0_7 ($5.33 in chips) 
Seat 4: piller11 ($2.03 in chips) 
Seat 5: demioni88 ($1.67 in chips) 
Seat 6: fbf58 ($1.62 in chips) 
Seat 7: pokertronde ($2 in chips) 
Seat 8: trueJamaican ($2.13 in chips) 
Seat 9: Dorex2007 ($2.70 in chips) 
littlebear2020: posts small blind $0.01
Gust4v0_7: posts big blind $0.02
*** HOLE CARDS ***
Dealt to Dorex2007 [2h Ah]
piller11: folds 
demioni88: folds 
fbf58: raises $0.04 to $0.06
pokertronde: folds 
trueJamaican: folds 
Dorex2007: calls $0.06
rjeg333: folds 
littlebear2020: folds 
Gust4v0_7: folds 
*** FLOP *** [2d Qc 5h]
fbf58: checks 
Dorex2007: checks 
*** TURN *** [2d Qc 5h] [6c]
fbf58: bets $0.06
Dorex2007: calls $0.06
*** RIVER *** [2d Qc 5h 6c] [3d]
fbf58: bets $0.13
Dorex2007: folds 
Uncalled bet ($0.13) returned to fbf58
fbf58 collected $0.26 from pot
*** SUMMARY ***
Total pot $0.27 | Rake $0.01 
Board [2d Qc 5h 6c 3d]
Seat 1: rjeg333 (button) folded before Flop (didn't bet)
Seat 2: littlebear2020 (small blind) folded before Flop
Seat 3: Gust4v0_7 (big blind) folded before Flop
Seat 4: piller11 folded before Flop (didn't bet)
Seat 5: demioni88 folded before Flop (didn't bet)
Seat 6: fbf58 collected ($0.26)
Seat 7: pokertronde folded before Flop (didn't bet)
Seat 8: trueJamaican folded before Flop (didn't bet)
Seat 9: Dorex2007 folded on the River



PokerStars Hand #232167142077:  Hold'em No Limit ($0.01/$0.02 USD) - 2021/12/12 13:16:55 PT [2021/12/12 16:16:55 ET]
Table 'Lorcia' 9-max Seat #2 is the button
Seat 1: rjeg333 ($2.80 in chips) 
Seat 2: littlebear2020 ($2 in chips) 
Seat 3: Gust4v0_7 ($5.31 in chips) 
Seat 4: piller11 ($2.03 in chips) 
Seat 5: demioni88 ($1.67 in chips) 
Seat 6: fbf58 ($1.76 in chips) 
Seat 7: pokertronde ($2 in chips) 
Seat 8: trueJamaican ($2.13 in chips) 
Seat 9: Dorex2007 ($2.58 in chips) 
Gust4v0_7: posts small blind $0.01
piller11: posts big blind $0.02
*** HOLE CARDS ***
Dealt to Dorex2007 [Kc Ac]
demioni88: calls $0.02
fbf58: folds 
pokertronde: folds 
trueJamaican: folds 
Dorex2007: raises $0.02 to $0.04
rjeg333: folds 
littlebear2020: calls $0.04
Gust4v0_7: folds 
piller11: folds 
demioni88: calls $0.02
*** FLOP *** [Ah Qd Js]
demioni88: checks 
Dorex2007: bets $0.09
littlebear2020: calls $0.09
demioni88: calls $0.09
*** TURN *** [Ah Qd Js] [3h]
demioni88: checks 
Dorex2007: checks 
littlebear2020: checks 
*** RIVER *** [Ah Qd Js 3h] [6d]
demioni88: checks 
Dorex2007: bets $0.21
littlebear2020: folds 
demioni88: folds 
Uncalled bet ($0.21) returned to Dorex2007
Dorex2007 collected $0.41 from pot
Dorex2007: doesn't show hand 
*** SUMMARY ***
Total pot $0.42 | Rake $0.01 
Board [Ah Qd Js 3h 6d]
Seat 1: rjeg333 folded before Flop (didn't bet)
Seat 2: littlebear2020 (button) folded on the River
Seat 3: Gust4v0_7 (small blind) folded before Flop
Seat 4: piller11 (big blind) folded before Flop
Seat 5: demioni88 folded on the River
Seat 6: fbf58 folded before Flop (didn't bet)
Seat 7: pokertronde folded before Flop (didn't bet)
Seat 8: trueJamaican folded before Flop (didn't bet)
Seat 9: Dorex2007 collected ($0.41)



PokerStars Hand #232167191957:  Hold'em No Limit ($0.01/$0.02 USD) - 2021/12/12 13:18:20 PT [2021/12/12 16:18:20 ET]
Table 'Lorcia' 9-max Seat #3 is the button
Seat 1: rjeg333 ($2.80 in chips) 
Seat 2: littlebear2020 ($1.87 in chips) 
Seat 3: Gust4v0_7 ($5.30 in chips) 
Seat 4: piller11 ($2.01 in chips) 
Seat 5: demioni88 ($1.54 in chips) 
Seat 6: fbf58 ($1.76 in chips) 
Seat 7: pokertronde ($2 in chips) 
Seat 8: trueJamaican ($2.13 in chips) 
Seat 9: Dorex2007 ($2.86 in chips) 
piller11: posts small blind $0.01
demioni88: posts big blind $0.02
*** HOLE CARDS ***
Dealt to Dorex2007 [6s Ts]
fbf58: calls $0.02
pokertronde: folds 
trueJamaican: folds 
Dorex2007: folds 
rjeg333: folds 
littlebear2020: folds 
Gust4v0_7: folds 
piller11: raises $0.08 to $0.10
demioni88: folds 
fbf58: folds 
Uncalled bet ($0.08) returned to piller11
piller11 collected $0.06 from pot
*** SUMMARY ***
Total pot $0.06 | Rake $0 
Seat 1: rjeg333 folded before Flop (didn't bet)
Seat 2: littlebear2020 folded before Flop (didn't bet)
Seat 3: Gust4v0_7 (button) folded before Flop (didn't bet)
Seat 4: piller11 (small blind) collected ($0.06)
Seat 5: demioni88 (big blind) folded before Flop
Seat 6: fbf58 folded before Flop
Seat 7: pokertronde folded before Flop (didn't bet)
Seat 8: trueJamaican folded before Flop (didn't bet)
Seat 9: Dorex2007 folded before Flop (didn't bet)



PokerStars Hand #232167208352:  Hold'em No Limit ($0.01/$0.02 USD) - 2021/12/12 13:18:48 PT [2021/12/12 16:18:48 ET]
Table 'Lorcia' 9-max Seat #4 is the button
Seat 1: rjeg333 ($2.80 in chips) 
Seat 2: littlebear2020 ($1.87 in chips) 
Seat 3: Gust4v0_7 ($5.30 in chips) 
Seat 4: piller11 ($2.05 in chips) 
Seat 5: demioni88 ($1.52 in chips) 
Seat 6: fbf58 ($1.74 in chips) 
Seat 7: pokertronde ($2 in chips) 
Seat 8: trueJamaican ($2.13 in chips) 
Seat 9: Dorex2007 ($2.86 in chips) 
demioni88: posts small blind $0.01
fbf58: posts big blind $0.02
*** HOLE CARDS ***
Dealt to Dorex2007 [6d 2s]
pokertronde: raises $0.04 to $0.06
trueJamaican: folds 
Dorex2007: folds 
rjeg333: folds 
littlebear2020: folds 
Gust4v0_7: folds 
piller11: folds 
demioni88: folds 
fbf58: folds 
Uncalled bet ($0.04) returned to pokertronde
pokertronde collected $0.05 from pot
pokertronde: doesn't show hand 
*** SUMMARY ***
Total pot $0.05 | Rake $0 
Seat 1: rjeg333 folded before Flop (didn't bet)
Seat 2: littlebear2020 folded before Flop (didn't bet)
Seat 3: Gust4v0_7 folded before Flop (didn't bet)
Seat 4: piller11 (button) folded before Flop (didn't bet)
Seat 5: demioni88 (small blind) folded before Flop
Seat 6: fbf58 (big blind) folded before Flop
Seat 7: pokertronde collected ($0.05)
Seat 8: trueJamaican folded before Flop (didn't bet)
Seat 9: Dorex2007 folded before Flop (didn't bet)



PokerStars Hand #232167222107:  Hold'em No Limit ($0.01/$0.02 USD) - 2021/12/12 13:19:11 PT [2021/12/12 16:19:11 ET]
Table 'Lorcia' 9-max Seat #5 is the button
Seat 1: rjeg333 ($2.80 in chips) 
Seat 4: piller11 ($2.05 in chips) 
Seat 5: demioni88 ($1.51 in chips) 
Seat 6: fbf58 ($1.72 in chips) 
Seat 7: pokertronde ($2.03 in chips) 
Seat 8: trueJamaican ($2.13 in chips) 
Seat 9: Dorex2007 ($2.86 in chips) 
fbf58: posts small blind $0.01
pokertronde: posts big blind $0.02
*** HOLE CARDS ***
Dealt to Dorex2007 [Kd 3c]
trueJamaican: folds 
Dorex2007: folds 
rjeg333: folds 
piller11: calls $0.02
demioni88: calls $0.02
fbf58: calls $0.01
pokertronde: checks 
*** FLOP *** [9s 7d 4h]
fbf58: checks 
pokertronde: checks 
piller11: bets $0.10
demioni88: calls $0.10
fbf58: folds 
pokertronde: calls $0.10
*** TURN *** [9s 7d 4h] [Kc]
pokertronde: checks 
piller11: bets $0.08
demioni88: calls $0.08
pokertronde: folds 
*** RIVER *** [9s 7d 4h Kc] [Qs]
piller11: checks 
demioni88: bets $0.52
piller11: folds 
Uncalled bet ($0.52) returned to demioni88
demioni88 collected $0.52 from pot
demioni88: doesn't show hand 
*** SUMMARY ***
Total pot $0.54 | Rake $0.02 
Board [9s 7d 4h Kc Qs]
Seat 1: rjeg333 folded before Flop (didn't bet)
Seat 4: piller11 folded on the River
Seat 5: demioni88 (button) collected ($0.52)
Seat 6: fbf58 (small blind) folded on the Flop
Seat 7: pokertronde (big blind) folded on the Turn
Seat 8: trueJamaican folded before Flop (didn't bet)
Seat 9: Dorex2007 folded before Flop (didn't bet)



PokerStars Hand #232167265484:  Hold'em No Limit ($0.01/$0.02 USD) - 2021/12/12 13:20:25 PT [2021/12/12 16:20:25 ET]
Table 'Lorcia' 9-max Seat #6 is the button
Seat 1: rjeg333 ($2.80 in chips) 
Seat 3: Gust4v0_7 ($5.30 in chips) 
Seat 4: piller11 ($1.85 in chips) 
Seat 5: demioni88 ($1.83 in chips) 
Seat 6: fbf58 ($1.70 in chips) 
Seat 7: pokertronde ($2 in chips) 
Seat 8: trueJamaican ($2.13 in chips) 
Seat 9: Dorex2007 ($2.86 in chips) 
pokertronde: posts small blind $0.01
trueJamaican: posts big blind $0.02
*** HOLE CARDS ***
Dealt to Dorex2007 [2h Th]
Dorex2007: folds 
rjeg333: folds 
Gust4v0_7: calls $0.02
piller11: folds 
demioni88: calls $0.02
fbf58: folds 
pokertronde: folds 
trueJamaican: checks 
*** FLOP *** [2c 3d 3c]
trueJamaican: checks 
Gust4v0_7: checks 
demioni88: checks 
*** TURN *** [2c 3d 3c] [Qd]
trueJamaican: checks 
Gust4v0_7: bets $0.04
demioni88: calls $0.04
trueJamaican: folds 
*** RIVER *** [2c 3d 3c Qd] [Jc]
Gust4v0_7: checks 
demioni88: bets $0.06
Gust4v0_7: folds 
Uncalled bet ($0.06) returned to demioni88
demioni88 collected $0.14 from pot
demioni88: doesn't show hand 
*** SUMMARY ***
Total pot $0.15 | Rake $0.01 
Board [2c 3d 3c Qd Jc]
Seat 1: rjeg333 folded before Flop (didn't bet)
Seat 3: Gust4v0_7 folded on the River
Seat 4: piller11 folded before Flop (didn't bet)
Seat 5: demioni88 collected ($0.14)
Seat 6: fbf58 (button) folded before Flop (didn't bet)
Seat 7: pokertronde (small blind) folded before Flop
Seat 8: trueJamaican (big blind) folded on the Turn
Seat 9: Dorex2007 folded before Flop (didn't bet)



PokerStars Hand #232167298997:  Hold'em No Limit ($0.01/$0.02 USD) - 2021/12/12 13:21:23 PT [2021/12/12 16:21:23 ET]
Table 'Lorcia' 9-max Seat #7 is the button
Seat 1: rjeg333 ($2.80 in chips) 
Seat 2: littlebear2020 ($1.87 in chips) 
Seat 3: Gust4v0_7 ($5.24 in chips) 
Seat 4: piller11 ($1.85 in chips) 
Seat 5: demioni88 ($1.91 in chips) 
Seat 6: fbf58 ($1.70 in chips) 
Seat 7: pokertronde ($2 in chips) 
Seat 8: trueJamaican ($2.11 in chips) 
Seat 9: Dorex2007 ($2.86 in chips) 
trueJamaican: posts small blind $0.01
Dorex2007: posts big blind $0.02
*** HOLE CARDS ***
Dealt to Dorex2007 [Ad Ts]
rjeg333: folds 
littlebear2020: calls $0.02
Gust4v0_7: raises $0.02 to $0.04
piller11: folds 
demioni88: calls $0.04
fbf58: folds 
pokertronde: calls $0.04
trueJamaican: folds 
Dorex2007: calls $0.02
littlebear2020: calls $0.02
*** FLOP *** [7s 8s Kh]
Dorex2007: checks 
littlebear2020: checks 
Gust4v0_7: checks 
demioni88: bets $0.04
pokertronde: calls $0.04
Dorex2007: folds 
littlebear2020: calls $0.04
Gust4v0_7: folds 
*** TURN *** [7s 8s Kh] [Qd]
littlebear2020: checks 
demioni88: bets $0.06
pokertronde: raises $0.10 to $0.16
littlebear2020: folds 
demioni88: calls $0.10
*** RIVER *** [7s 8s Kh Qd] [Js]
demioni88: checks 
pokertronde: bets $0.63
demioni88: calls $0.63
*** SHOW DOWN ***
pokertronde: shows [As 9s] (a flush, Ace high)
demioni88: mucks hand 
pokertronde collected $1.82 from pot
*** SUMMARY ***
Total pot $1.91 | Rake $0.09 
Board [7s 8s Kh Qd Js]
Seat 1: rjeg333 folded before Flop (didn't bet)
Seat 2: littlebear2020 folded on the Turn
Seat 3: Gust4v0_7 folded on the Flop
Seat 4: piller11 folded before Flop (didn't bet)
Seat 5: demioni88 mucked [Kc 4c]
Seat 6: fbf58 folded before Flop (didn't bet)
Seat 7: pokertronde (button) showed [As 9s] and won ($1.82) with a flush, Ace high
Seat 8: trueJamaican (small blind) folded before Flop
Seat 9: Dorex2007 (big blind) folded on the Flop



PokerStars Hand #232167366248:  Hold'em No Limit ($0.01/$0.02 USD) - 2021/12/12 13:23:01 PT [2021/12/12 16:23:01 ET]
Table 'Lorcia' 9-max Seat #8 is the button
Seat 1: rjeg333 ($2.80 in chips) 
Seat 2: littlebear2020 ($1.79 in chips) 
Seat 3: Gust4v0_7 ($5.20 in chips) 
Seat 4: piller11 ($1.85 in chips) 
Seat 5: demioni88 ($1.04 in chips) 
Seat 6: fbf58 ($1.70 in chips) 
Seat 7: pokertronde ($2.95 in chips) 
Seat 8: trueJamaican ($2.10 in chips) 
Seat 9: Dorex2007 ($2.82 in chips) 
Dorex2007: posts small blind $0.01
rjeg333: posts big blind $0.02
*** HOLE CARDS ***
Dealt to Dorex2007 [Jh 5d]
littlebear2020: folds 
Gust4v0_7: raises $0.04 to $0.06
piller11: folds 
piller11 leaves the table
demioni88: folds 
fbf58: calls $0.06
pokertronde: calls $0.06
trueJamaican: folds 
Dorex2007: folds 
rjeg333: folds 
*** FLOP *** [Ad 6h 3c]
Gust4v0_7: checks 
takeshie1971 joins the table at seat #4 
fbf58: bets $0.10
pokertronde: folds 
Gust4v0_7: folds 
Uncalled bet ($0.10) returned to fbf58
fbf58 collected $0.20 from pot
*** SUMMARY ***
Total pot $0.21 | Rake $0.01 
Board [Ad 6h 3c]
Seat 1: rjeg333 (big blind) folded before Flop
Seat 2: littlebear2020 folded before Flop (didn't bet)
Seat 3: Gust4v0_7 folded on the Flop
Seat 4: piller11 folded before Flop (didn't bet)
Seat 5: demioni88 folded before Flop (didn't bet)
Seat 6: fbf58 collected ($0.20)
Seat 7: pokertronde folded on the Flop
Seat 8: trueJamaican (button) folded before Flop (didn't bet)
Seat 9: Dorex2007 (small blind) folded before Flop



PokerStars Hand #232167397934:  Hold'em No Limit ($0.01/$0.02 USD) - 2021/12/12 13:23:55 PT [2021/12/12 16:23:55 ET]
Table 'Lorcia' 9-max Seat #9 is the button
Seat 1: rjeg333 ($2.78 in chips) 
Seat 2: littlebear2020 ($1.79 in chips) 
Seat 3: Gust4v0_7 ($5.14 in chips) 
Seat 4: takeshie1971 ($1.61 in chips) 
Seat 5: demioni88 ($1.04 in chips) 
Seat 6: fbf58 ($1.84 in chips) 
Seat 7: pokertronde ($2.89 in chips) 
Seat 8: trueJamaican ($2.10 in chips) 
Seat 9: Dorex2007 ($2.81 in chips) 
rjeg333: posts small blind $0.01
littlebear2020: posts big blind $0.02
takeshie1971: posts big blind $0.02
*** HOLE CARDS ***
Dealt to Dorex2007 [4s Th]
Gust4v0_7: calls $0.02
takeshie1971: checks 
demioni88: calls $0.02
fbf58: calls $0.02
pokertronde: folds 
trueJamaican: folds 
Dorex2007: folds 
rjeg333: folds 
littlebear2020: checks 
*** FLOP *** [2d Jh Qc]
littlebear2020: checks 
Gust4v0_7: checks 
takeshie1971: checks 
demioni88: checks 
fbf58: checks 
*** TURN *** [2d Jh Qc] [9c]
littlebear2020: checks 
Gust4v0_7: checks 
takeshie1971: bets $0.07
demioni88: calls $0.07
fbf58: folds 
littlebear2020: folds 
Gust4v0_7: folds 
*** RIVER *** [2d Jh Qc 9c] [9s]
takeshie1971: checks 
demioni88: checks 
*** SHOW DOWN ***
takeshie1971: shows [Jd 4d] (two pair, Jacks and Nines)
demioni88: shows [Td Jc] (two pair, Jacks and Nines)
takeshie1971 collected $0.12 from pot
demioni88 collected $0.12 from pot
*** SUMMARY ***
Total pot $0.25 | Rake $0.01 
Board [2d Jh Qc 9c 9s]
Seat 1: rjeg333 (small blind) folded before Flop
Seat 2: littlebear2020 (big blind) folded on the Turn
Seat 3: Gust4v0_7 folded on the Turn
Seat 4: takeshie1971 showed [Jd 4d] and won ($0.12) with two pair, Jacks and Nines
Seat 5: demioni88 showed [Td Jc] and won ($0.12) with two pair, Jacks and Nines
Seat 6: fbf58 folded on the Turn
Seat 7: pokertronde folded before Flop (didn't bet)
Seat 8: trueJamaican folded before Flop (didn't bet)
Seat 9: Dorex2007 (button) folded before Flop (didn't bet)



PokerStars Hand #232167451896:  Hold'em No Limit ($0.01/$0.02 USD) - 2021/12/12 13:25:28 PT [2021/12/12 16:25:28 ET]
Table 'Lorcia' 9-max Seat #1 is the button
Seat 1: rjeg333 ($2.77 in chips) 
Seat 2: littlebear2020 ($1.77 in chips) 
Seat 4: takeshie1971 ($1.64 in chips) 
Seat 5: demioni88 ($1.07 in chips) 
Seat 6: fbf58 ($1.82 in chips) 
Seat 7: pokertronde ($2.89 in chips) 
Seat 8: trueJamaican ($2.10 in chips) 
Seat 9: Dorex2007 ($2.81 in chips) 
littlebear2020: posts small blind $0.01
takeshie1971: posts big blind $0.02
*** HOLE CARDS ***
Dealt to Dorex2007 [Qd Js]
demioni88: calls $0.02
fbf58: calls $0.02
pokertronde: folds 
trueJamaican: folds 
Dorex2007: calls $0.02
rjeg333: folds 
littlebear2020: calls $0.01
takeshie1971: checks 
*** FLOP *** [4h 2c 2d]
littlebear2020: bets $0.06
takeshie1971: folds 
demioni88: calls $0.06
fbf58: folds 
Dorex2007: folds 
*** TURN *** [4h 2c 2d] [6d]
littlebear2020: checks 
demioni88: checks 
*** RIVER *** [4h 2c 2d 6d] [3s]
littlebear2020: bets $0.21
demioni88: folds 
Uncalled bet ($0.21) returned to littlebear2020
littlebear2020 collected $0.21 from pot
littlebear2020: doesn't show hand 
*** SUMMARY ***
Total pot $0.22 | Rake $0.01 
Board [4h 2c 2d 6d 3s]
Seat 1: rjeg333 (button) folded before Flop (didn't bet)
Seat 2: littlebear2020 (small blind) collected ($0.21)
Seat 4: takeshie1971 (big blind) folded on the Flop
Seat 5: demioni88 folded on the River
Seat 6: fbf58 folded on the Flop
Seat 7: pokertronde folded before Flop (didn't bet)
Seat 8: trueJamaican folded before Flop (didn't bet)
Seat 9: Dorex2007 folded on the Flop



PokerStars Hand #232167488970:  Hold'em No Limit ($0.01/$0.02 USD) - 2021/12/12 13:26:32 PT [2021/12/12 16:26:32 ET]
Table 'Lorcia' 9-max Seat #2 is the button
Seat 1: rjeg333 ($2.77 in chips) 
Seat 2: littlebear2020 ($1.90 in chips) 
Seat 4: takeshie1971 ($1.62 in chips) 
Seat 5: demioni88 ($0.99 in chips) 
Seat 6: fbf58 ($1.80 in chips) 
Seat 7: pokertronde ($2.89 in chips) 
Seat 8: trueJamaican ($2.10 in chips) 
Seat 9: Dorex2007 ($2.79 in chips) 
takeshie1971: posts small blind $0.01
demioni88: posts big blind $0.02
*** HOLE CARDS ***
Dealt to Dorex2007 [3d Ts]
fbf58: folds 
pokertronde: folds 
trueJamaican: folds 
Dorex2007: folds 
rjeg333: folds 
littlebear2020: folds 
fbf58 leaves the table
takeshie1971: raises $0.04 to $0.06
demioni88: folds 
Uncalled bet ($0.04) returned to takeshie1971
Martin aus K joins the table at seat #6 
takeshie1971 collected $0.04 from pot
takeshie1971: doesn't show hand 
*** SUMMARY ***
Total pot $0.04 | Rake $0 
Seat 1: rjeg333 folded before Flop (didn't bet)
Seat 2: littlebear2020 (button) folded before Flop (didn't bet)
Seat 4: takeshie1971 (small blind) collected ($0.04)
Seat 5: demioni88 (big blind) folded before Flop
Seat 6: fbf58 folded before Flop (didn't bet)
Seat 7: pokertronde folded before Flop (didn't bet)
Seat 8: trueJamaican folded before Flop (didn't bet)
Seat 9: Dorex2007 folded before Flop (didn't bet)



PokerStars Hand #232167499995:  Hold'em No Limit ($0.01/$0.02 USD) - 2021/12/12 13:26:51 PT [2021/12/12 16:26:51 ET]
Table 'Lorcia' 9-max Seat #4 is the button
Seat 1: rjeg333 ($2.77 in chips) 
Seat 2: littlebear2020 ($1.90 in chips) 
Seat 4: takeshie1971 ($1.64 in chips) 
Seat 5: demioni88 ($0.97 in chips) 
Seat 6: Martin aus K ($2 in chips) 
Seat 7: pokertronde ($2.89 in chips) 
Seat 8: trueJamaican ($2.10 in chips) 
Seat 9: Dorex2007 ($2.79 in chips) 
demioni88: posts small blind $0.01
Martin aus K: posts big blind $0.02
*** HOLE CARDS ***
Dealt to Dorex2007 [7s Qc]
pokertronde: raises $0.04 to $0.06
trueJamaican: folds 
Dorex2007: folds 
rjeg333: folds 
littlebear2020: folds 
takeshie1971: folds 
demioni88: folds 
Martin aus K: folds 
Uncalled bet ($0.04) returned to pokertronde
pokertronde collected $0.05 from pot
pokertronde: doesn't show hand 
*** SUMMARY ***
Total pot $0.05 | Rake $0 
Seat 1: rjeg333 folded before Flop (didn't bet)
Seat 2: littlebear2020 folded before Flop (didn't bet)
Seat 4: takeshie1971 (button) folded before Flop (didn't bet)
Seat 5: demioni88 (small blind) folded before Flop
Seat 6: Martin aus K (big blind) folded before Flop
Seat 7: pokertronde collected ($0.05)
Seat 8: trueJamaican folded before Flop (didn't bet)
Seat 9: Dorex2007 folded before Flop (didn't bet)



PokerStars Hand #232167515550:  Hold'em No Limit ($0.01/$0.02 USD) - 2021/12/12 13:27:19 PT [2021/12/12 16:27:19 ET]
Table 'Lorcia' 9-max Seat #5 is the button
Seat 1: rjeg333 ($2.77 in chips) 
Seat 2: littlebear2020 ($1.90 in chips) 
Seat 4: takeshie1971 ($1.64 in chips) 
Seat 5: demioni88 ($0.96 in chips) 
Seat 6: Martin aus K ($1.98 in chips) 
Seat 7: pokertronde ($2.92 in chips) 
Seat 8: trueJamaican ($2.10 in chips) 
Seat 9: Dorex2007 ($2.79 in chips) 
Martin aus K: posts small blind $0.01
pokertronde: posts big blind $0.02
Gust4v0_7: sits out 
*** HOLE CARDS ***
Dealt to Dorex2007 [7h 6s]
trueJamaican: folds 
Dorex2007: folds 
rjeg333: folds 
littlebear2020: folds 
takeshie1971: folds 
demioni88: folds 
Martin aus K: folds 
Uncalled bet ($0.01) returned to pokertronde
pokertronde collected $0.02 from pot
pokertronde: doesn't show hand 
*** SUMMARY ***
Total pot $0.02 | Rake $0 
Seat 1: rjeg333 folded before Flop (didn't bet)
Seat 2: littlebear2020 folded before Flop (didn't bet)
Seat 4: takeshie1971 folded before Flop (didn't bet)
Seat 5: demioni88 (button) folded before Flop (didn't bet)
Seat 6: Martin aus K (small blind) folded before Flop
Seat 7: pokertronde (big blind) collected ($0.02)
Seat 8: trueJamaican folded before Flop (didn't bet)
Seat 9: Dorex2007 folded before Flop (didn't bet)



PokerStars Hand #232167523882:  Hold'em No Limit ($0.01/$0.02 USD) - 2021/12/12 13:27:33 PT [2021/12/12 16:27:33 ET]
Table 'Lorcia' 9-max Seat #6 is the button
Seat 1: rjeg333 ($2.77 in chips) 
Seat 2: littlebear2020 ($1.90 in chips) 
Seat 3: Gust4v0_7 ($5.12 in chips) 
Seat 4: takeshie1971 ($1.64 in chips) 
Seat 5: demioni88 ($0.96 in chips) 
Seat 6: Martin aus K ($1.97 in chips) 
Seat 7: pokertronde ($2.93 in chips) 
Seat 8: trueJamaican ($2.10 in chips) 
Seat 9: Dorex2007 ($2.79 in chips) 
pokertronde: posts small blind $0.01
trueJamaican: posts big blind $0.02
Gust4v0_7: posts small & big blinds $0.03
*** HOLE CARDS ***
Dealt to Dorex2007 [Th 6d]
Dorex2007: folds 
rjeg333: folds 
littlebear2020: folds 
Gust4v0_7: checks 
takeshie1971: folds 
demioni88: calls $0.02
Martin aus K: calls $0.02
pokertronde: folds 
trueJamaican: raises $0.08 to $0.10
Gust4v0_7: folds 
demioni88: calls $0.08
Martin aus K: folds 
*** FLOP *** [Qd As 7s]
trueJamaican: bets $0.17
demioni88: folds 
Uncalled bet ($0.17) returned to trueJamaican
trueJamaican collected $0.25 from pot
*** SUMMARY ***
Total pot $0.26 | Rake $0.01 
Board [Qd As 7s]
Seat 1: rjeg333 folded before Flop (didn't bet)
Seat 2: littlebear2020 folded before Flop (didn't bet)
Seat 3: Gust4v0_7 folded before Flop (didn't bet)
Seat 4: takeshie1971 folded before Flop (didn't bet)
Seat 5: demioni88 folded on the Flop
Seat 6: Martin aus K (button) folded before Flop
Seat 7: pokertronde (small blind) folded before Flop
Seat 8: trueJamaican (big blind) collected ($0.25)
Seat 9: Dorex2007 folded before Flop (didn't bet)



PokerStars Hand #232167551787:  Hold'em No Limit ($0.01/$0.02 USD) - 2021/12/12 13:28:22 PT [2021/12/12 16:28:22 ET]
Table 'Lorcia' 9-max Seat #7 is the button
Seat 1: rjeg333 ($2.77 in chips) 
Seat 2: littlebear2020 ($1.90 in chips) 
Seat 3: Gust4v0_7 ($5.09 in chips) 
Seat 4: takeshie1971 ($1.64 in chips) 
Seat 5: demioni88 ($0.86 in chips) 
Seat 6: Martin aus K ($1.95 in chips) 
Seat 7: pokertronde ($2.92 in chips) 
Seat 8: trueJamaican ($2.25 in chips) 
Seat 9: Dorex2007 ($2.79 in chips) 
trueJamaican: posts small blind $0.01
Dorex2007: posts big blind $0.02
*** HOLE CARDS ***
Dealt to Dorex2007 [Qh 8s]
rjeg333: folds 
littlebear2020: folds 
Gust4v0_7: folds 
takeshie1971: folds 
demioni88: folds 
Martin aus K: folds 
pokertronde: raises $0.04 to $0.06
trueJamaican: folds 
Dorex2007: folds 
Uncalled bet ($0.04) returned to pokertronde
pokertronde collected $0.05 from pot
pokertronde: doesn't show hand 
*** SUMMARY ***
Total pot $0.05 | Rake $0 
Seat 1: rjeg333 folded before Flop (didn't bet)
Seat 2: littlebear2020 folded before Flop (didn't bet)
Seat 3: Gust4v0_7 folded before Flop (didn't bet)
Seat 4: takeshie1971 folded before Flop (didn't bet)
Seat 5: demioni88 folded before Flop (didn't bet)
Seat 6: Martin aus K folded before Flop (didn't bet)
Seat 7: pokertronde (button) collected ($0.05)
Seat 8: trueJamaican (small blind) folded before Flop
Seat 9: Dorex2007 (big blind) folded before Flop



PokerStars Hand #232167563557:  Hold'em No Limit ($0.01/$0.02 USD) - 2021/12/12 13:28:43 PT [2021/12/12 16:28:43 ET]
Table 'Lorcia' 9-max Seat #8 is the button
Seat 1: rjeg333 ($2.77 in chips) 
Seat 2: littlebear2020 ($1.90 in chips) 
Seat 3: Gust4v0_7 ($5.09 in chips) 
Seat 4: takeshie1971 ($1.64 in chips) 
Seat 5: demioni88 ($0.86 in chips) 
Seat 6: Martin aus K ($1.95 in chips) 
Seat 7: pokertronde ($2.95 in chips) 
Seat 8: trueJamaican ($2.24 in chips) 
Seat 9: Dorex2007 ($2.77 in chips) 
Dorex2007: posts small blind $0.01
rjeg333: posts big blind $0.02
*** HOLE CARDS ***
Dealt to Dorex2007 [8c Qs]
littlebear2020: folds 
Gust4v0_7: folds 
takeshie1971: raises $0.04 to $0.06
demioni88: folds 
Martin aus K: folds 
pokertronde: calls $0.06
trueJamaican: folds 
Dorex2007: folds 
rjeg333: folds 
*** FLOP *** [3h As Ac]
takeshie1971: checks 
pokertronde: checks 
*** TURN *** [3h As Ac] [5c]
takeshie1971: checks 
pokertronde: bets $0.08
takeshie1971: calls $0.08
*** RIVER *** [3h As Ac 5c] [2s]
takeshie1971: checks 
pokertronde: checks 
*** SHOW DOWN ***
takeshie1971: shows [5h 3c] (two pair, Aces and Fives)
pokertronde: shows [Tc Ts] (two pair, Aces and Tens)
pokertronde collected $0.30 from pot
*** SUMMARY ***
Total pot $0.31 | Rake $0.01 
Board [3h As Ac 5c 2s]
Seat 1: rjeg333 (big blind) folded before Flop
Seat 2: littlebear2020 folded before Flop (didn't bet)
Seat 3: Gust4v0_7 folded before Flop (didn't bet)
Seat 4: takeshie1971 showed [5h 3c] and lost with two pair, Aces and Fives
Seat 5: demioni88 folded before Flop (didn't bet)
Seat 6: Martin aus K folded before Flop (didn't bet)
Seat 7: pokertronde showed [Tc Ts] and won ($0.30) with two pair, Aces and Tens
Seat 8: trueJamaican (button) folded before Flop (didn't bet)
Seat 9: Dorex2007 (small blind) folded before Flop



PokerStars Hand #232167598032:  Hold'em No Limit ($0.01/$0.02 USD) - 2021/12/12 13:29:43 PT [2021/12/12 16:29:43 ET]
Table 'Lorcia' 9-max Seat #9 is the button
Seat 1: rjeg333 ($2.75 in chips) 
Seat 2: littlebear2020 ($1.90 in chips) 
Seat 3: Gust4v0_7 ($5.09 in chips) 
Seat 4: takeshie1971 ($1.50 in chips) 
Seat 5: demioni88 ($0.86 in chips) 
Seat 6: Martin aus K ($1.95 in chips) 
Seat 7: pokertronde ($3.11 in chips) 
Seat 8: trueJamaican ($2.24 in chips) 
Seat 9: Dorex2007 ($2.76 in chips) 
rjeg333: posts small blind $0.01
littlebear2020: posts big blind $0.02
*** HOLE CARDS ***
Dealt to Dorex2007 [As 7d]
Gust4v0_7: calls $0.02
takeshie1971: folds 
demioni88: folds 
Martin aus K: folds 
pokertronde: folds 
trueJamaican: folds 
Dorex2007: calls $0.02
rjeg333: folds 
littlebear2020: checks 
*** FLOP *** [Kd Ah 9h]
littlebear2020: checks 
Gust4v0_7: bets $0.04
Dorex2007: calls $0.04
littlebear2020: folds 
*** TURN *** [Kd Ah 9h] [Jd]
Gust4v0_7: bets $0.07
Dorex2007: calls $0.07
*** RIVER *** [Kd Ah 9h Jd] [8d]
Gust4v0_7: bets $0.10
Dorex2007: calls $0.10
*** SHOW DOWN ***
Gust4v0_7: shows [9s Jh] (two pair, Jacks and Nines)
Dorex2007: mucks hand 
Gust4v0_7 collected $0.47 from pot
*** SUMMARY ***
Total pot $0.49 | Rake $0.02 
Board [Kd Ah 9h Jd 8d]
Seat 1: rjeg333 (small blind) folded before Flop
Seat 2: littlebear2020 (big blind) folded on the Flop
Seat 3: Gust4v0_7 showed [9s Jh] and won ($0.47) with two pair, Jacks and Nines
Seat 4: takeshie1971 folded before Flop (didn't bet)
Seat 5: demioni88 folded before Flop (didn't bet)
Seat 6: Martin aus K folded before Flop (didn't bet)
Seat 7: pokertronde folded before Flop (didn't bet)
Seat 8: trueJamaican folded before Flop (didn't bet)
Seat 9: Dorex2007 (button) mucked [As 7d]



PokerStars Hand #232167630673:  Hold'em No Limit ($0.01/$0.02 USD) - 2021/12/12 13:30:41 PT [2021/12/12 16:30:41 ET]
Table 'Lorcia' 9-max Seat #1 is the button
Seat 1: rjeg333 ($2.74 in chips) 
Seat 2: littlebear2020 ($1.88 in chips) 
Seat 3: Gust4v0_7 ($5.33 in chips) 
Seat 4: takeshie1971 ($1.50 in chips) 
Seat 5: demioni88 ($0.86 in chips) 
Seat 6: Martin aus K ($1.95 in chips) 
Seat 7: pokertronde ($3.11 in chips) 
Seat 8: trueJamaican ($2.24 in chips) 
Seat 9: Dorex2007 ($2.53 in chips) 
littlebear2020: posts small blind $0.01
Gust4v0_7: posts big blind $0.02
*** HOLE CARDS ***
Dealt to Dorex2007 [4h 9s]
takeshie1971: folds 
demioni88: folds 
Martin aus K: folds 
pokertronde: folds 
trueJamaican: folds 
Dorex2007: folds 
rjeg333: raises $0.04 to $0.06
littlebear2020: folds 
Gust4v0_7: calls $0.04
*** FLOP *** [9h Kd 4s]
Gust4v0_7: checks 
rjeg333: checks 
*** TURN *** [9h Kd 4s] [2s]
Gust4v0_7: bets $0.06
rjeg333: calls $0.06
*** RIVER *** [9h Kd 4s 2s] [Kh]
Gust4v0_7: checks 
rjeg333: bets $0.32
Gust4v0_7: folds 
Uncalled bet ($0.32) returned to rjeg333
rjeg333 collected $0.24 from pot
*** SUMMARY ***
Total pot $0.25 | Rake $0.01 
Board [9h Kd 4s 2s Kh]
Seat 1: rjeg333 (button) collected ($0.24)
Seat 2: littlebear2020 (small blind) folded before Flop
Seat 3: Gust4v0_7 (big blind) folded on the River
Seat 4: takeshie1971 folded before Flop (didn't bet)
Seat 5: demioni88 folded before Flop (didn't bet)
Seat 6: Martin aus K folded before Flop (didn't bet)
Seat 7: pokertronde folded before Flop (didn't bet)
Seat 8: trueJamaican folded before Flop (didn't bet)
Seat 9: Dorex2007 folded before Flop (didn't bet)



PokerStars Hand #232167663316:  Hold'em No Limit ($0.01/$0.02 USD) - 2021/12/12 13:31:39 PT [2021/12/12 16:31:39 ET]
Table 'Lorcia' 9-max Seat #2 is the button
Seat 1: rjeg333 ($2.86 in chips) 
Seat 2: littlebear2020 ($1.87 in chips) 
Seat 3: Gust4v0_7 ($5.21 in chips) 
Seat 4: takeshie1971 ($1.50 in chips) 
Seat 5: demioni88 ($0.86 in chips) 
Seat 6: Martin aus K ($1.95 in chips) 
Seat 7: pokertronde ($3.11 in chips) 
Seat 8: trueJamaican ($2.24 in chips) 
Seat 9: Dorex2007 ($2.53 in chips) 
Gust4v0_7: posts small blind $0.01
takeshie1971: posts big blind $0.02
*** HOLE CARDS ***
Dealt to Dorex2007 [Jc 8h]
demioni88: folds 
Martin aus K: folds 
pokertronde: folds 
trueJamaican: folds 
Dorex2007: folds 
rjeg333: folds 
littlebear2020: calls $0.02
Gust4v0_7: folds 
takeshie1971: checks 
*** FLOP *** [8s 7d Ts]
takeshie1971: checks 
littlebear2020: bets $0.05
takeshie1971: folds 
Uncalled bet ($0.05) returned to littlebear2020
littlebear2020 collected $0.05 from pot
littlebear2020: doesn't show hand 
*** SUMMARY ***
Total pot $0.05 | Rake $0 
Board [8s 7d Ts]
Seat 1: rjeg333 folded before Flop (didn't bet)
Seat 2: littlebear2020 (button) collected ($0.05)
Seat 3: Gust4v0_7 (small blind) folded before Flop
Seat 4: takeshie1971 (big blind) folded on the Flop
Seat 5: demioni88 folded before Flop (didn't bet)
Seat 6: Martin aus K folded before Flop (didn't bet)
Seat 7: pokertronde folded before Flop (didn't bet)
Seat 8: trueJamaican folded before Flop (didn't bet)
Seat 9: Dorex2007 folded before Flop (didn't bet)



PokerStars Hand #232167675381:  Hold'em No Limit ($0.01/$0.02 USD) - 2021/12/12 13:32:00 PT [2021/12/12 16:32:00 ET]
Table 'Lorcia' 9-max Seat #3 is the button
Seat 1: rjeg333 ($2.86 in chips) 
Seat 2: littlebear2020 ($1.90 in chips) 
Seat 3: Gust4v0_7 ($5.20 in chips) 
Seat 4: takeshie1971 ($1.48 in chips) 
Seat 5: demioni88 ($0.86 in chips) 
Seat 6: Martin aus K ($1.95 in chips) 
Seat 7: pokertronde ($3.11 in chips) 
Seat 8: trueJamaican ($2.24 in chips) 
Seat 9: Dorex2007 ($2.53 in chips) 
takeshie1971: posts small blind $0.01
demioni88: posts big blind $0.02
*** HOLE CARDS ***
Dealt to Dorex2007 [Kh 4d]
Martin aus K: folds 
pokertronde: folds 
trueJamaican: folds 
Dorex2007: folds 
rjeg333: folds 
littlebear2020: raises $0.04 to $0.06
Gust4v0_7: folds 
takeshie1971: raises $0.10 to $0.16
demioni88: folds 
littlebear2020: folds 
Uncalled bet ($0.10) returned to takeshie1971
takeshie1971 collected $0.14 from pot
takeshie1971: doesn't show hand 
*** SUMMARY ***
Total pot $0.14 | Rake $0 
Seat 1: rjeg333 folded before Flop (didn't bet)
Seat 2: littlebear2020 folded before Flop
Seat 3: Gust4v0_7 (button) folded before Flop (didn't bet)
Seat 4: takeshie1971 (small blind) collected ($0.14)
Seat 5: demioni88 (big blind) folded before Flop
Seat 6: Martin aus K folded before Flop (didn't bet)
Seat 7: pokertronde folded before Flop (didn't bet)
Seat 8: trueJamaican folded before Flop (didn't bet)
Seat 9: Dorex2007 folded before Flop (didn't bet)



PokerStars Hand #232167694110:  Hold'em No Limit ($0.01/$0.02 USD) - 2021/12/12 13:32:33 PT [2021/12/12 16:32:33 ET]
Table 'Lorcia' 9-max Seat #4 is the button
Seat 1: rjeg333 ($2.86 in chips) 
Seat 2: littlebear2020 ($1.84 in chips) 
Seat 3: Gust4v0_7 ($5.20 in chips) 
Seat 4: takeshie1971 ($1.56 in chips) 
Seat 5: demioni88 ($0.84 in chips) 
Seat 6: Martin aus K ($1.95 in chips) 
Seat 7: pokertronde ($3.11 in chips) 
Seat 8: trueJamaican ($2.24 in chips) 
Seat 9: Dorex2007 ($2.53 in chips) 
demioni88: posts small blind $0.01
Martin aus K: posts big blind $0.02
*** HOLE CARDS ***
Dealt to Dorex2007 [9c 4d]
pokertronde: raises $0.04 to $0.06
trueJamaican: folds 
Dorex2007: folds 
rjeg333: raises $0.10 to $0.16
littlebear2020: folds 
Gust4v0_7: folds 
takeshie1971: calls $0.16
demioni88: calls $0.15
Martin aus K: folds 
pokertronde: calls $0.10
*** FLOP *** [Kh 5d Jc]
demioni88: checks 
pokertronde: checks 
rjeg333: bets $0.28
takeshie1971: calls $0.28
demioni88: folds 
pokertronde: folds 
*** TURN *** [Kh 5d Jc] [7d]
rjeg333: bets $2.42 and is all-in
takeshie1971: calls $1.12 and is all-in
Uncalled bet ($1.30) returned to rjeg333
*** RIVER *** [Kh 5d Jc 7d] [Ks]
*** SHOW DOWN ***
rjeg333: shows [Ad Kc] (three of a kind, Kings)
takeshie1971: shows [Ah Kd] (three of a kind, Kings)
rjeg333 collected $1.67 from pot
takeshie1971 collected $1.67 from pot
*** SUMMARY ***
Total pot $3.46 | Rake $0.12 
Board [Kh 5d Jc 7d Ks]
Seat 1: rjeg333 showed [Ad Kc] and won ($1.67) with three of a kind, Kings
Seat 2: littlebear2020 folded before Flop (didn't bet)
Seat 3: Gust4v0_7 folded before Flop (didn't bet)
Seat 4: takeshie1971 (button) showed [Ah Kd] and won ($1.67) with three of a kind, Kings
Seat 5: demioni88 (small blind) folded on the Flop
Seat 6: Martin aus K (big blind) folded before Flop
Seat 7: pokertronde folded on the Flop
Seat 8: trueJamaican folded before Flop (didn't bet)
Seat 9: Dorex2007 folded before Flop (didn't bet)



PokerStars Hand #232167740217:  Hold'em No Limit ($0.01/$0.02 USD) - 2021/12/12 13:33:54 PT [2021/12/12 16:33:54 ET]
Table 'Lorcia' 9-max Seat #5 is the button
Seat 1: rjeg333 ($2.97 in chips) 
Seat 2: littlebear2020 ($1.84 in chips) 
Seat 3: Gust4v0_7 ($5.20 in chips) 
Seat 4: takeshie1971 ($1.67 in chips) 
Seat 5: demioni88 ($0.68 in chips) 
Seat 6: Martin aus K ($1.93 in chips) 
Seat 7: pokertronde ($2.95 in chips) 
Seat 8: trueJamaican ($2.24 in chips) 
Seat 9: Dorex2007 ($2.53 in chips) 
Martin aus K: posts small blind $0.01
pokertronde: posts big blind $0.02
*** HOLE CARDS ***
Dealt to Dorex2007 [Th Td]
trueJamaican: folds 
Dorex2007: raises $0.04 to $0.06
rjeg333: folds 
littlebear2020: folds 
Gust4v0_7: calls $0.06
takeshie1971: folds 
demioni88: calls $0.06
Martin aus K: folds 
pokertronde: folds 
*** FLOP *** [Ts 7c Kc]
Dorex2007: bets $0.13
Gust4v0_7: calls $0.13
demioni88: folds 
*** TURN *** [Ts 7c Kc] [2c]
Dorex2007: checks 
Gust4v0_7: bets $0.22
Dorex2007: calls $0.22
*** RIVER *** [Ts 7c Kc 2c] [5s]
Dorex2007: checks 
Gust4v0_7: bets $0.72
Dorex2007: calls $0.72
*** SHOW DOWN ***
Gust4v0_7: shows [8c 5c] (a flush, King high)
Dorex2007: mucks hand 
Gust4v0_7 collected $2.27 from pot
*** SUMMARY ***
Total pot $2.35 | Rake $0.08 
Board [Ts 7c Kc 2c 5s]
Seat 1: rjeg333 folded before Flop (didn't bet)
Seat 2: littlebear2020 folded before Flop (didn't bet)
Seat 3: Gust4v0_7 showed [8c 5c] and won ($2.27) with a flush, King high
Seat 4: takeshie1971 folded before Flop (didn't bet)
Seat 5: demioni88 (button) folded on the Flop
Seat 6: Martin aus K (small blind) folded before Flop
Seat 7: pokertronde (big blind) folded before Flop
Seat 8: trueJamaican folded before Flop (didn't bet)
Seat 9: Dorex2007 mucked [Th Td]



PokerStars Hand #232167785597:  Hold'em No Limit ($0.01/$0.02 USD) - 2021/12/12 13:35:04 PT [2021/12/12 16:35:04 ET]
Table 'Lorcia' 9-max Seat #6 is the button
Seat 1: rjeg333 ($2.97 in chips) 
Seat 2: littlebear2020 ($1.84 in chips) 
Seat 3: Gust4v0_7 ($6.34 in chips) 
Seat 4: takeshie1971 ($1.67 in chips) 
Seat 5: demioni88 ($0.62 in chips) 
Seat 6: Martin aus K ($1.92 in chips) 
Seat 7: pokertronde ($2.93 in chips) 
Seat 8: trueJamaican ($2.24 in chips) 
Seat 9: Dorex2007 ($2 in chips) 
pokertronde: posts small blind $0.01
trueJamaican: posts big blind $0.02
*** HOLE CARDS ***
Dealt to Dorex2007 [Ac 9s]
Dorex2007: folds 
rjeg333: raises $0.04 to $0.06
littlebear2020: folds 
Gust4v0_7: folds 
takeshie1971: calls $0.06
demioni88: folds 
Martin aus K: folds 
pokertronde: folds 
trueJamaican: folds 
*** FLOP *** [4h 3c 9d]
rjeg333: bets $0.08
takeshie1971: raises $0.12 to $0.20
rjeg333: folds 
Uncalled bet ($0.12) returned to takeshie1971
takeshie1971 collected $0.30 from pot
takeshie1971: doesn't show hand 
*** SUMMARY ***
Total pot $0.31 | Rake $0.01 
Board [4h 3c 9d]
Seat 1: rjeg333 folded on the Flop
Seat 2: littlebear2020 folded before Flop (didn't bet)
Seat 3: Gust4v0_7 folded before Flop (didn't bet)
Seat 4: takeshie1971 collected ($0.30)
Seat 5: demioni88 folded before Flop (didn't bet)
Seat 6: Martin aus K (button) folded before Flop (didn't bet)
Seat 7: pokertronde (small blind) folded before Flop
Seat 8: trueJamaican (big blind) folded before Flop
Seat 9: Dorex2007 folded before Flop (didn't bet)



PokerStars Hand #232167809599:  Hold'em No Limit ($0.01/$0.02 USD) - 2021/12/12 13:35:46 PT [2021/12/12 16:35:46 ET]
Table 'Lorcia' 9-max Seat #7 is the button
Seat 1: rjeg333 ($2.83 in chips) 
Seat 2: littlebear2020 ($1.84 in chips) 
Seat 3: Gust4v0_7 ($6.34 in chips) 
Seat 4: takeshie1971 ($1.83 in chips) 
Seat 5: demioni88 ($0.62 in chips) 
Seat 6: Martin aus K ($1.92 in chips) 
Seat 7: pokertronde ($2.92 in chips) 
Seat 8: trueJamaican ($2.22 in chips) 
Seat 9: Dorex2007 ($2 in chips) 
trueJamaican: posts small blind $0.01
Dorex2007: posts big blind $0.02
*** HOLE CARDS ***
Dealt to Dorex2007 [Ts 4c]
rjeg333: raises $0.04 to $0.06
littlebear2020: folds 
Gust4v0_7: folds 
takeshie1971: folds 
demioni88: folds 
Martin aus K: calls $0.06
pokertronde: calls $0.06
trueJamaican: folds 
Dorex2007: folds 
*** FLOP *** [6c Td As]
rjeg333: checks 
Martin aus K: checks 
pokertronde: checks 
*** TURN *** [6c Td As] [5s]
rjeg333: checks 
Martin aus K: checks 
pokertronde: checks 
*** RIVER *** [6c Td As 5s] [Qh]
rjeg333: bets $0.10
Martin aus K: folds 
pokertronde: folds 
Uncalled bet ($0.10) returned to rjeg333
rjeg333 collected $0.20 from pot
*** SUMMARY ***
Total pot $0.21 | Rake $0.01 
Board [6c Td As 5s Qh]
Seat 1: rjeg333 collected ($0.20)
Seat 2: littlebear2020 folded before Flop (didn't bet)
Seat 3: Gust4v0_7 folded before Flop (didn't bet)
Seat 4: takeshie1971 folded before Flop (didn't bet)
Seat 5: demioni88 folded before Flop (didn't bet)
Seat 6: Martin aus K folded on the River
Seat 7: pokertronde (button) folded on the River
Seat 8: trueJamaican (small blind) folded before Flop
Seat 9: Dorex2007 (big blind) folded before Flop



PokerStars Hand #232167835875:  Hold'em No Limit ($0.01/$0.02 USD) - 2021/12/12 13:36:33 PT [2021/12/12 16:36:33 ET]
Table 'Lorcia' 9-max Seat #8 is the button
Seat 1: rjeg333 ($2.97 in chips) 
Seat 2: littlebear2020 ($1.84 in chips) 
Seat 3: Gust4v0_7 ($6.34 in chips) 
Seat 4: takeshie1971 ($1.83 in chips) 
Seat 5: demioni88 ($0.62 in chips) 
Seat 6: Martin aus K ($1.86 in chips) 
Seat 7: pokertronde ($2.86 in chips) 
Seat 8: trueJamaican ($2.21 in chips) 
Seat 9: Dorex2007 ($2 in chips) 
Dorex2007: posts small blind $0.01
rjeg333: posts big blind $0.02
*** HOLE CARDS ***
Dealt to Dorex2007 [Ks 9c]
littlebear2020: folds 
Gust4v0_7: folds 
takeshie1971: folds 
demioni88: calls $0.02
Martin aus K: calls $0.02
pokertronde: folds 
trueJamaican: folds 
Dorex2007: folds 
rjeg333: checks 
*** FLOP *** [Qc Ad 6d]
rjeg333: checks 
demioni88: checks 
Martin aus K: bets $0.04
rjeg333: folds 
demioni88: calls $0.04
*** TURN *** [Qc Ad 6d] [Jh]
demioni88: bets $0.06
Martin aus K: calls $0.06
*** RIVER *** [Qc Ad 6d Jh] [8d]
demioni88: checks 
Martin aus K: bets $0.14
demioni88: folds 
Uncalled bet ($0.14) returned to Martin aus K
Martin aus K collected $0.26 from pot
Martin aus K: doesn't show hand 
*** SUMMARY ***
Total pot $0.27 | Rake $0.01 
Board [Qc Ad 6d Jh 8d]
Seat 1: rjeg333 (big blind) folded on the Flop
Seat 2: littlebear2020 folded before Flop (didn't bet)
Seat 3: Gust4v0_7 folded before Flop (didn't bet)
Seat 4: takeshie1971 folded before Flop (didn't bet)
Seat 5: demioni88 folded on the River
Seat 6: Martin aus K collected ($0.26)
Seat 7: pokertronde folded before Flop (didn't bet)
Seat 8: trueJamaican (button) folded before Flop (didn't bet)
Seat 9: Dorex2007 (small blind) folded before Flop



PokerStars Hand #232167873532:  Hold'em No Limit ($0.01/$0.02 USD) - 2021/12/12 13:37:41 PT [2021/12/12 16:37:41 ET]
Table 'Lorcia' 9-max Seat #9 is the button
Seat 1: rjeg333 ($2.95 in chips) 
Seat 2: littlebear2020 ($1.84 in chips) 
Seat 3: Gust4v0_7 ($6.34 in chips) 
Seat 4: takeshie1971 ($1.83 in chips) 
Seat 5: demioni88 ($0.50 in chips) 
Seat 6: Martin aus K ($2 in chips) 
Seat 7: pokertronde ($2.86 in chips) 
Seat 8: trueJamaican ($2.21 in chips) 
Seat 9: Dorex2007 ($2 in chips) 
rjeg333: posts small blind $0.01
littlebear2020: posts big blind $0.02
*** HOLE CARDS ***
Dealt to Dorex2007 [2s Jh]
Gust4v0_7: folds 
takeshie1971: folds 
demioni88: folds 
Martin aus K: folds 
pokertronde: folds 
trueJamaican: folds 
Dorex2007: folds 
rjeg333: folds 
Uncalled bet ($0.01) returned to littlebear2020
littlebear2020 collected $0.02 from pot
littlebear2020: doesn't show hand 
*** SUMMARY ***
Total pot $0.02 | Rake $0 
Seat 1: rjeg333 (small blind) folded before Flop
Seat 2: littlebear2020 (big blind) collected ($0.02)
Seat 3: Gust4v0_7 folded before Flop (didn't bet)
Seat 4: takeshie1971 folded before Flop (didn't bet)
Seat 5: demioni88 folded before Flop (didn't bet)
Seat 6: Martin aus K folded before Flop (didn't bet)
Seat 7: pokertronde folded before Flop (didn't bet)
Seat 8: trueJamaican folded before Flop (didn't bet)
Seat 9: Dorex2007 (button) folded before Flop (didn't bet)



PokerStars Hand #232167882236:  Hold'em No Limit ($0.01/$0.02 USD) - 2021/12/12 13:37:56 PT [2021/12/12 16:37:56 ET]
Table 'Lorcia' 9-max Seat #1 is the button
Seat 1: rjeg333 ($2.94 in chips) 
Seat 2: littlebear2020 ($1.85 in chips) 
Seat 3: Gust4v0_7 ($6.34 in chips) 
Seat 4: takeshie1971 ($1.83 in chips) 
Seat 5: demioni88 ($0.50 in chips) 
Seat 6: Martin aus K ($2 in chips) 
Seat 7: pokertronde ($2.86 in chips) 
Seat 8: trueJamaican ($2.21 in chips) 
Seat 9: Dorex2007 ($2 in chips) 
littlebear2020: posts small blind $0.01
Gust4v0_7: posts big blind $0.02
*** HOLE CARDS ***
Dealt to Dorex2007 [Td 3h]
takeshie1971: folds 
demioni88: folds 
Martin aus K: folds 
pokertronde: folds 
trueJamaican: raises $0.04 to $0.06
Dorex2007: folds 
rjeg333: raises $0.08 to $0.14
littlebear2020: folds 
Gust4v0_7: folds 
trueJamaican: folds 
Uncalled bet ($0.08) returned to rjeg333
rjeg333 collected $0.15 from pot
*** SUMMARY ***
Total pot $0.15 | Rake $0 
Seat 1: rjeg333 (button) collected ($0.15)
Seat 2: littlebear2020 (small blind) folded before Flop
Seat 3: Gust4v0_7 (big blind) folded before Flop
Seat 4: takeshie1971 folded before Flop (didn't bet)
Seat 5: demioni88 folded before Flop (didn't bet)
Seat 6: Martin aus K folded before Flop (didn't bet)
Seat 7: pokertronde folded before Flop (didn't bet)
Seat 8: trueJamaican folded before Flop
Seat 9: Dorex2007 folded before Flop (didn't bet)



PokerStars Hand #232167898764:  Hold'em No Limit ($0.01/$0.02 USD) - 2021/12/12 13:38:25 PT [2021/12/12 16:38:25 ET]
Table 'Lorcia' 9-max Seat #2 is the button
Seat 1: rjeg333 ($3.03 in chips) 
Seat 2: littlebear2020 ($1.84 in chips) 
Seat 3: Gust4v0_7 ($6.32 in chips) 
Seat 4: takeshie1971 ($1.83 in chips) 
Seat 6: Martin aus K ($2 in chips) 
Seat 7: pokertronde ($2.86 in chips) 
Seat 8: trueJamaican ($2.15 in chips) 
Seat 9: Dorex2007 ($2 in chips) 
Gust4v0_7: posts small blind $0.01
takeshie1971: posts big blind $0.02
*** HOLE CARDS ***
Dealt to Dorex2007 [5s 7s]
Martin aus K: folds 
pokertronde: raises $0.04 to $0.06
trueJamaican: folds 
Dorex2007: calls $0.06
rjeg333: folds 
littlebear2020: calls $0.06
Gust4v0_7: calls $0.05
takeshie1971: folds 
*** FLOP *** [7h 2d Kc]
Gust4v0_7: checks 
pokertronde: checks 
Dorex2007: bets $0.13
littlebear2020: folds 
Gust4v0_7: folds 
pokertronde: folds 
Uncalled bet ($0.13) returned to Dorex2007
Dorex2007 collected $0.25 from pot
Dorex2007: doesn't show hand 
*** SUMMARY ***
Total pot $0.26 | Rake $0.01 
Board [7h 2d Kc]
Seat 1: rjeg333 folded before Flop (didn't bet)
Seat 2: littlebear2020 (button) folded on the Flop
Seat 3: Gust4v0_7 (small blind) folded on the Flop
Seat 4: takeshie1971 (big blind) folded before Flop
Seat 6: Martin aus K folded before Flop (didn't bet)
Seat 7: pokertronde folded on the Flop
Seat 8: trueJamaican folded before Flop (didn't bet)
Seat 9: Dorex2007 collected ($0.25)



PokerStars Hand #232167919743:  Hold'em No Limit ($0.01/$0.02 USD) - 2021/12/12 13:39:03 PT [2021/12/12 16:39:03 ET]
Table 'Lorcia' 9-max Seat #3 is the button
Seat 1: rjeg333 ($3.03 in chips) 
Seat 2: littlebear2020 ($1.78 in chips) 
Seat 3: Gust4v0_7 ($6.26 in chips) 
Seat 4: takeshie1971 ($1.81 in chips) 
Seat 6: Martin aus K ($2 in chips) 
Seat 7: pokertronde ($2.80 in chips) 
Seat 8: trueJamaican ($2.15 in chips) 
Seat 9: Dorex2007 ($2.19 in chips) 
takeshie1971: posts small blind $0.01
Martin aus K: posts big blind $0.02
*** HOLE CARDS ***
Dealt to Dorex2007 [Ts 2h]
pokertronde: folds 
trueJamaican: folds 
Dorex2007: folds 
rjeg333: folds 
littlebear2020: folds 
Gust4v0_7: raises $0.04 to $0.06
takeshie1971: folds 
Martin aus K: folds 
Uncalled bet ($0.04) returned to Gust4v0_7
Gust4v0_7 collected $0.05 from pot
Gust4v0_7: doesn't show hand 
*** SUMMARY ***
Total pot $0.05 | Rake $0 
Seat 1: rjeg333 folded before Flop (didn't bet)
Seat 2: littlebear2020 folded before Flop (didn't bet)
Seat 3: Gust4v0_7 (button) collected ($0.05)
Seat 4: takeshie1971 (small blind) folded before Flop
Seat 6: Martin aus K (big blind) folded before Flop
Seat 7: pokertronde folded before Flop (didn't bet)
Seat 8: trueJamaican folded before Flop (didn't bet)
Seat 9: Dorex2007 folded before Flop (didn't bet)



PokerStars Hand #232167930311:  Hold'em No Limit ($0.01/$0.02 USD) - 2021/12/12 13:39:22 PT [2021/12/12 16:39:22 ET]
Table 'Lorcia' 9-max Seat #4 is the button
Seat 1: rjeg333 ($3.03 in chips) 
Seat 2: littlebear2020 ($1.78 in chips) 
Seat 3: Gust4v0_7 ($6.29 in chips) 
Seat 4: takeshie1971 ($1.80 in chips) 
Seat 6: Martin aus K ($1.98 in chips) 
Seat 7: pokertronde ($2.80 in chips) 
Seat 8: trueJamaican ($2.15 in chips) 
Seat 9: Dorex2007 ($2.19 in chips) 
Martin aus K: posts small blind $0.01
pokertronde: posts big blind $0.02
*** HOLE CARDS ***
Dealt to Dorex2007 [5s 4s]
trueJamaican: folds 
Dorex2007: folds 
rjeg333: folds 
littlebear2020: calls $0.02
demioni88 leaves the table
Gust4v0_7: raises $0.04 to $0.06
takeshie1971: calls $0.06
Martin aus K: calls $0.05
pokertronde: folds 
littlebear2020: calls $0.04
*** FLOP *** [5h Kh Tc]
Martin aus K: checks 
littlebear2020: checks 
Gust4v0_7: bets $0.10
takeshie1971: folds 
Martin aus K: calls $0.10
littlebear2020: folds 
*** TURN *** [5h Kh Tc] [Qd]
Martin aus K: checks 
Gust4v0_7: checks 
*** RIVER *** [5h Kh Tc Qd] [Ks]
Martin aus K: checks 
Gust4v0_7: checks 
*** SHOW DOWN ***
Martin aus K: shows [Jd Kd] (three of a kind, Kings)
Gust4v0_7: mucks hand 
Martin aus K collected $0.44 from pot
*** SUMMARY ***
Total pot $0.46 | Rake $0.02 
Board [5h Kh Tc Qd Ks]
Seat 1: rjeg333 folded before Flop (didn't bet)
Seat 2: littlebear2020 folded on the Flop
Seat 3: Gust4v0_7 mucked [9d 9s]
Seat 4: takeshie1971 (button) folded on the Flop
Seat 6: Martin aus K (small blind) showed [Jd Kd] and won ($0.44) with three of a kind, Kings
Seat 7: pokertronde (big blind) folded before Flop
Seat 8: trueJamaican folded before Flop (didn't bet)
Seat 9: Dorex2007 folded before Flop (didn't bet)



PokerStars Hand #232167958586:  Hold'em No Limit ($0.01/$0.02 USD) - 2021/12/12 13:40:13 PT [2021/12/12 16:40:13 ET]
Table 'Lorcia' 9-max Seat #6 is the button
Seat 1: rjeg333 ($3.03 in chips) 
Seat 2: littlebear2020 ($1.72 in chips) 
Seat 3: Gust4v0_7 ($6.13 in chips) 
Seat 4: takeshie1971 ($1.74 in chips) 
Seat 6: Martin aus K ($2.26 in chips) 
Seat 7: pokertronde ($2.78 in chips) 
Seat 8: trueJamaican ($2.15 in chips) 
Seat 9: Dorex2007 ($2.19 in chips) 
pokertronde: posts small blind $0.01
trueJamaican: posts big blind $0.02
*** HOLE CARDS ***
Dealt to Dorex2007 [7d Th]
Dorex2007: folds 
rjeg333: folds 
littlebear2020: folds 
Gust4v0_7: folds 
takeshie1971: folds 
Martin aus K: folds 
pokertronde: raises $0.06 to $0.08
trueJamaican: calls $0.06
*** FLOP *** [Jd Kh 9h]
amehame joins the table at seat #5 
pokertronde: bets $0.09
trueJamaican: raises $0.17 to $0.26
pokertronde: folds 
Uncalled bet ($0.17) returned to trueJamaican
trueJamaican collected $0.33 from pot
*** SUMMARY ***
Total pot $0.34 | Rake $0.01 
Board [Jd Kh 9h]
Seat 1: rjeg333 folded before Flop (didn't bet)
Seat 2: littlebear2020 folded before Flop (didn't bet)
Seat 3: Gust4v0_7 folded before Flop (didn't bet)
Seat 4: takeshie1971 folded before Flop (didn't bet)
Seat 6: Martin aus K (button) folded before Flop (didn't bet)
Seat 7: pokertronde (small blind) folded on the Flop
Seat 8: trueJamaican (big blind) collected ($0.33)
Seat 9: Dorex2007 folded before Flop (didn't bet)



PokerStars Hand #232167974965:  Hold'em No Limit ($0.01/$0.02 USD) - 2021/12/12 13:40:43 PT [2021/12/12 16:40:43 ET]
Table 'Lorcia' 9-max Seat #7 is the button
Seat 1: rjeg333 ($3.03 in chips) 
Seat 2: littlebear2020 ($1.72 in chips) 
Seat 3: Gust4v0_7 ($6.13 in chips) 
Seat 4: takeshie1971 ($1.74 in chips) 
Seat 6: Martin aus K ($2.26 in chips) 
Seat 7: pokertronde ($2.61 in chips) 
Seat 8: trueJamaican ($2.31 in chips) 
Seat 9: Dorex2007 ($2.19 in chips) 
trueJamaican: posts small blind $0.01
Dorex2007: posts big blind $0.02
amehame: sits out 
*** HOLE CARDS ***
Dealt to Dorex2007 [Kc Qs]
amehame leaves the table
rjeg333: folds 
littlebear2020: folds 
Inc4ognito joins the table at seat #5 
Gust4v0_7: calls $0.02
takeshie1971: folds 
Martin aus K: folds 
pokertronde: folds 
trueJamaican: folds 
Dorex2007: checks 
*** FLOP *** [Kd 6h 9s]
Dorex2007: bets $0.05
Gust4v0_7: calls $0.05
*** TURN *** [Kd 6h 9s] [Qd]
Dorex2007: bets $0.14
Gust4v0_7: folds 
Uncalled bet ($0.14) returned to Dorex2007
Dorex2007 collected $0.14 from pot
Dorex2007: doesn't show hand 
*** SUMMARY ***
Total pot $0.15 | Rake $0.01 
Board [Kd 6h 9s Qd]
Seat 1: rjeg333 folded before Flop (didn't bet)
Seat 2: littlebear2020 folded before Flop (didn't bet)
Seat 3: Gust4v0_7 folded on the Turn
Seat 4: takeshie1971 folded before Flop (didn't bet)
Seat 6: Martin aus K folded before Flop (didn't bet)
Seat 7: pokertronde (button) folded before Flop (didn't bet)
Seat 8: trueJamaican (small blind) folded before Flop
Seat 9: Dorex2007 (big blind) collected ($0.14)



PokerStars Hand #232168005526:  Hold'em No Limit ($0.01/$0.02 USD) - 2021/12/12 13:41:38 PT [2021/12/12 16:41:38 ET]
Table 'Lorcia' 9-max Seat #8 is the button
Seat 1: rjeg333 ($3.03 in chips) 
Seat 2: littlebear2020 ($1.72 in chips) 
Seat 3: Gust4v0_7 ($6.06 in chips) 
Seat 4: takeshie1971 ($1.74 in chips) 
Seat 6: Martin aus K ($2.26 in chips) 
Seat 7: pokertronde ($2.61 in chips) 
Seat 8: trueJamaican ($2.30 in chips) 
Seat 9: Dorex2007 ($2.26 in chips) 
Dorex2007: posts small blind $0.01
rjeg333: posts big blind $0.02
Inc4ognito: sits out 
*** HOLE CARDS ***
Dealt to Dorex2007 [Tc Js]
littlebear2020: folds 
Gust4v0_7: folds 
takeshie1971: raises $0.04 to $0.06
Martin aus K: folds 
pokertronde: folds 
trueJamaican: folds 
Dorex2007: calls $0.05
rjeg333: calls $0.04
*** FLOP *** [8c 4s Qc]
Dorex2007: checks 
rjeg333: checks 
takeshie1971: bets $0.10
Dorex2007: folds 
rjeg333: folds 
Uncalled bet ($0.10) returned to takeshie1971
takeshie1971 collected $0.17 from pot
takeshie1971: doesn't show hand 
*** SUMMARY ***
Total pot $0.18 | Rake $0.01 
Board [8c 4s Qc]
Seat 1: rjeg333 (big blind) folded on the Flop
Seat 2: littlebear2020 folded before Flop (didn't bet)
Seat 3: Gust4v0_7 folded before Flop (didn't bet)
Seat 4: takeshie1971 collected ($0.17)
Seat 6: Martin aus K folded before Flop (didn't bet)
Seat 7: pokertronde folded before Flop (didn't bet)
Seat 8: trueJamaican (button) folded before Flop (didn't bet)
Seat 9: Dorex2007 (small blind) folded on the Flop



PokerStars Hand #232168028485:  Hold'em No Limit ($0.01/$0.02 USD) - 2021/12/12 13:42:20 PT [2021/12/12 16:42:20 ET]
Table 'Lorcia' 9-max Seat #9 is the button
Seat 2: littlebear2020 ($1.72 in chips) 
Seat 3: Gust4v0_7 ($6.06 in chips) 
Seat 4: takeshie1971 ($1.85 in chips) 
Seat 6: Martin aus K ($2.26 in chips) 
Seat 7: pokertronde ($2.61 in chips) 
Seat 8: trueJamaican ($2.30 in chips) 
Seat 9: Dorex2007 ($2.20 in chips) 
littlebear2020: posts small blind $0.01
Gust4v0_7: posts big blind $0.02
Inc4ognito: sits out 
*** HOLE CARDS ***
Dealt to Dorex2007 [7s 9s]
takeshie1971: raises $0.04 to $0.06
Martin aus K: folds 
pokertronde: folds 
trueJamaican: folds 
Dorex2007: folds 
littlebear2020: folds 
Gust4v0_7: calls $0.04
*** FLOP *** [9h 4h 5c]
Gust4v0_7: checks 
takeshie1971: checks 
*** TURN *** [9h 4h 5c] [8d]
Gust4v0_7: bets $0.07
takeshie1971: folds 
Uncalled bet ($0.07) returned to Gust4v0_7
Gust4v0_7 collected $0.13 from pot
Gust4v0_7: doesn't show hand 
*** SUMMARY ***
Total pot $0.13 | Rake $0 
Board [9h 4h 5c 8d]
Seat 2: littlebear2020 (small blind) folded before Flop
Seat 3: Gust4v0_7 (big blind) collected ($0.13)
Seat 4: takeshie1971 folded on the Turn
Seat 6: Martin aus K folded before Flop (didn't bet)
Seat 7: pokertronde folded before Flop (didn't bet)
Seat 8: trueJamaican folded before Flop (didn't bet)
Seat 9: Dorex2007 (button) folded before Flop (didn't bet)



PokerStars Hand #232168047889:  Hold'em No Limit ($0.01/$0.02 USD) - 2021/12/12 13:42:55 PT [2021/12/12 16:42:55 ET]
Table 'Lorcia' 9-max Seat #2 is the button
Seat 2: littlebear2020 ($1.71 in chips) 
Seat 3: Gust4v0_7 ($6.13 in chips) 
Seat 4: takeshie1971 ($1.79 in chips) 
Seat 6: Martin aus K ($2.26 in chips) 
Seat 7: pokertronde ($2.61 in chips) 
Seat 8: trueJamaican ($2.30 in chips) 
Seat 9: Dorex2007 ($2.20 in chips) 
Gust4v0_7: posts small blind $0.01
takeshie1971: posts big blind $0.02
Inc4ognito: sits out 
*** HOLE CARDS ***
Dealt to Dorex2007 [4d 8d]
Martin aus K: folds 
pokertronde: folds 
trueJamaican has timed out
trueJamaican: folds 
Dorex2007: folds 
littlebear2020: raises $0.05 to $0.07
Gust4v0_7: folds 
takeshie1971: folds 
Uncalled bet ($0.05) returned to littlebear2020
littlebear2020 collected $0.05 from pot
littlebear2020: doesn't show hand 
*** SUMMARY ***
Total pot $0.05 | Rake $0 
Seat 2: littlebear2020 (button) collected ($0.05)
Seat 3: Gust4v0_7 (small blind) folded before Flop
Seat 4: takeshie1971 (big blind) folded before Flop
Seat 6: Martin aus K folded before Flop (didn't bet)
Seat 7: pokertronde folded before Flop (didn't bet)
Seat 8: trueJamaican folded before Flop (didn't bet)
Seat 9: Dorex2007 folded before Flop (didn't bet)



PokerStars Hand #232168062178:  Hold'em No Limit ($0.01/$0.02 USD) - 2021/12/12 13:43:21 PT [2021/12/12 16:43:21 ET]
Table 'Lorcia' 9-max Seat #3 is the button
Seat 2: littlebear2020 ($1.74 in chips) 
Seat 3: Gust4v0_7 ($6.12 in chips) 
Seat 4: takeshie1971 ($1.77 in chips) 
Seat 5: Inc4ognito ($2 in chips) 
Seat 6: Martin aus K ($2.26 in chips) 
Seat 7: pokertronde ($2.61 in chips) 
Seat 8: trueJamaican ($2.30 in chips) 
Seat 9: Dorex2007 ($2.20 in chips) 
takeshie1971: posts small blind $0.01
Inc4ognito: posts big blind $0.02
*** HOLE CARDS ***
Dealt to Dorex2007 [7d 4s]
Martin aus K: folds 
pokertronde: folds 
trueJamaican: folds 
Dorex2007: folds 
littlebear2020: folds 
Gust4v0_7: folds 
takeshie1971: raises $0.04 to $0.06
Inc4ognito: calls $0.04
*** FLOP *** [3h 6c 9s]
takeshie1971: bets $0.06
Inc4ognito: folds 
Uncalled bet ($0.06) returned to takeshie1971
takeshie1971 collected $0.12 from pot
takeshie1971: doesn't show hand 
*** SUMMARY ***
Total pot $0.12 | Rake $0 
Board [3h 6c 9s]
Seat 2: littlebear2020 folded before Flop (didn't bet)
Seat 3: Gust4v0_7 (button) folded before Flop (didn't bet)
Seat 4: takeshie1971 (small blind) collected ($0.12)
Seat 5: Inc4ognito (big blind) folded on the Flop
Seat 6: Martin aus K folded before Flop (didn't bet)
Seat 7: pokertronde folded before Flop (didn't bet)
Seat 8: trueJamaican folded before Flop (didn't bet)
Seat 9: Dorex2007 folded before Flop (didn't bet)



PokerStars Hand #232168079040:  Hold'em No Limit ($0.01/$0.02 USD) - 2021/12/12 13:43:52 PT [2021/12/12 16:43:52 ET]
Table 'Lorcia' 9-max Seat #4 is the button
Seat 2: littlebear2020 ($1.74 in chips) 
Seat 3: Gust4v0_7 ($6.12 in chips) 
Seat 4: takeshie1971 ($1.83 in chips) 
Seat 5: Inc4ognito ($2 in chips) 
Seat 6: Martin aus K ($2.26 in chips) 
Seat 7: pokertronde ($2.61 in chips) 
Seat 8: trueJamaican ($2.30 in chips) 
Seat 9: Dorex2007 ($2.20 in chips) 
Inc4ognito: posts small blind $0.01
Martin aus K: posts big blind $0.02
*** HOLE CARDS ***
Dealt to Dorex2007 [Ad Kc]
pokertronde: folds 
trueJamaican: folds 
Dorex2007: raises $0.02 to $0.04
littlebear2020: folds 
Gust4v0_7: raises $0.04 to $0.08
takeshie1971: folds 
Inc4ognito: folds 
Martin aus K: folds 
Dorex2007: calls $0.04
*** FLOP *** [7s 9c Ks]
Dorex2007: bets $0.18
Gust4v0_7: folds 
Uncalled bet ($0.18) returned to Dorex2007
Dorex2007 collected $0.18 from pot
Dorex2007: doesn't show hand 
*** SUMMARY ***
Total pot $0.19 | Rake $0.01 
Board [7s 9c Ks]
Seat 2: littlebear2020 folded before Flop (didn't bet)
Seat 3: Gust4v0_7 folded on the Flop
Seat 4: takeshie1971 (button) folded before Flop (didn't bet)
Seat 5: Inc4ognito (small blind) folded before Flop
Seat 6: Martin aus K (big blind) folded before Flop
Seat 7: pokertronde folded before Flop (didn't bet)
Seat 8: trueJamaican folded before Flop (didn't bet)
Seat 9: Dorex2007 collected ($0.18)



PokerStars Hand #232168107044:  Hold'em No Limit ($0.01/$0.02 USD) - 2021/12/12 13:44:44 PT [2021/12/12 16:44:44 ET]
Table 'Lorcia' 9-max Seat #5 is the button
Seat 2: littlebear2020 ($1.74 in chips) 
Seat 3: Gust4v0_7 ($6.04 in chips) 
Seat 4: takeshie1971 ($1.83 in chips) 
Seat 5: Inc4ognito ($2 in chips) 
Seat 6: Martin aus K ($2.24 in chips) 
Seat 7: pokertronde ($2.61 in chips) 
Seat 8: trueJamaican ($2.30 in chips) 
Seat 9: Dorex2007 ($2.30 in chips) 
Martin aus K: posts small blind $0.01
pokertronde: posts big blind $0.02
*** HOLE CARDS ***
Dealt to Dorex2007 [Td Ah]
trueJamaican: folds 
Dorex2007: raises $0.02 to $0.04
littlebear2020: calls $0.04
Gust4v0_7: calls $0.04
takeshie1971: folds 
Inc4ognito: folds 
Martin aus K: calls $0.03
pokertronde: folds 
*** FLOP *** [Js Qc 4d]
Martin aus K: checks 
Dorex2007: checks 
littlebear2020: checks 
Gust4v0_7: checks 
*** TURN *** [Js Qc 4d] [3s]
Martin aus K: bets $0.09
Dorex2007: folds 
littlebear2020: folds 
Gust4v0_7: calls $0.09
*** RIVER *** [Js Qc 4d 3s] [Qs]
Martin aus K: bets $0.19
Gust4v0_7: raises $0.19 to $0.38
Martin aus K: folds 
Uncalled bet ($0.19) returned to Gust4v0_7
Gust4v0_7 collected $0.71 from pot
Gust4v0_7: doesn't show hand 
*** SUMMARY ***
Total pot $0.74 | Rake $0.03 
Board [Js Qc 4d 3s Qs]
Seat 2: littlebear2020 folded on the Turn
Seat 3: Gust4v0_7 collected ($0.71)
Seat 4: takeshie1971 folded before Flop (didn't bet)
Seat 5: Inc4ognito (button) folded before Flop (didn't bet)
Seat 6: Martin aus K (small blind) folded on the River
Seat 7: pokertronde (big blind) folded before Flop
Seat 8: trueJamaican folded before Flop (didn't bet)
Seat 9: Dorex2007 folded on the Turn



PokerStars Hand #232168146080:  Hold'em No Limit ($0.01/$0.02 USD) - 2021/12/12 13:45:56 PT [2021/12/12 16:45:56 ET]
Table 'Lorcia' 9-max Seat #6 is the button
Seat 2: littlebear2020 ($1.70 in chips) 
Seat 3: Gust4v0_7 ($6.43 in chips) 
Seat 4: takeshie1971 ($1.83 in chips) 
Seat 5: Inc4ognito ($2 in chips) 
Seat 6: Martin aus K ($1.92 in chips) 
Seat 7: pokertronde ($2.59 in chips) 
Seat 8: trueJamaican ($2.30 in chips) 
Seat 9: Dorex2007 ($2.26 in chips) 
pokertronde: posts small blind $0.01
trueJamaican: posts big blind $0.02
*** HOLE CARDS ***
Dealt to Dorex2007 [2s Qh]
rjeg333 leaves the table
Dorex2007: folds 
littlebear2020: folds 
Gust4v0_7: folds 
takeshie1971: folds 
Inc4ognito: folds 
Martin aus K: raises $0.03 to $0.05
pokertronde: calls $0.04
trueJamaican: folds 
*** FLOP *** [8s 4h Ad]
pokertronde: checks 
Martin aus K: bets $0.04
pokertronde: raises $0.08 to $0.12
Martin aus K: calls $0.08
*** TURN *** [8s 4h Ad] [Jc]
pokertronde: checks 
Martin aus K: checks 
*** RIVER *** [8s 4h Ad Jc] [Ac]
pokertronde: checks 
Martin aus K: bets $0.19
pokertronde: folds 
Uncalled bet ($0.19) returned to Martin aus K
Martin aus K collected $0.35 from pot
Martin aus K: doesn't show hand 
*** SUMMARY ***
Total pot $0.36 | Rake $0.01 
Board [8s 4h Ad Jc Ac]
Seat 2: littlebear2020 folded before Flop (didn't bet)
Seat 3: Gust4v0_7 folded before Flop (didn't bet)
Seat 4: takeshie1971 folded before Flop (didn't bet)
Seat 5: Inc4ognito folded before Flop (didn't bet)
Seat 6: Martin aus K (button) collected ($0.35)
Seat 7: pokertronde (small blind) folded on the River
Seat 8: trueJamaican (big blind) folded before Flop
Seat 9: Dorex2007 folded before Flop (didn't bet)



PokerStars Hand #232168169399:  Hold'em No Limit ($0.01/$0.02 USD) - 2021/12/12 13:46:38 PT [2021/12/12 16:46:38 ET]
Table 'Lorcia' 9-max Seat #7 is the button
Seat 2: littlebear2020 ($1.70 in chips) 
Seat 3: Gust4v0_7 ($6.43 in chips) 
Seat 4: takeshie1971 ($1.83 in chips) 
Seat 5: Inc4ognito ($2 in chips) 
Seat 6: Martin aus K ($2.10 in chips) 
Seat 7: pokertronde ($2.42 in chips) 
Seat 8: trueJamaican ($2.28 in chips) 
Seat 9: Dorex2007 ($2.26 in chips) 
trueJamaican: posts small blind $0.01
Dorex2007: posts big blind $0.02
*** HOLE CARDS ***
Dealt to Dorex2007 [4c 8c]
littlebear2020: folds 
Gust4v0_7: folds 
takeshie1971 has timed out
takeshie1971: folds 
Inc4ognito: folds 
Martin aus K: folds 
pokertronde: raises $0.04 to $0.06
trueJamaican: folds 
Dorex2007: folds 
Uncalled bet ($0.04) returned to pokertronde
pokertronde collected $0.05 from pot
pokertronde: doesn't show hand 
*** SUMMARY ***
Total pot $0.05 | Rake $0 
Seat 2: littlebear2020 folded before Flop (didn't bet)
Seat 3: Gust4v0_7 folded before Flop (didn't bet)
Seat 4: takeshie1971 folded before Flop (didn't bet)
Seat 5: Inc4ognito folded before Flop (didn't bet)
Seat 6: Martin aus K folded before Flop (didn't bet)
Seat 7: pokertronde (button) collected ($0.05)
Seat 8: trueJamaican (small blind) folded before Flop
Seat 9: Dorex2007 (big blind) folded before Flop



PokerStars Hand #232168187281:  Hold'em No Limit ($0.01/$0.02 USD) - 2021/12/12 13:47:10 PT [2021/12/12 16:47:10 ET]
Table 'Lorcia' 9-max Seat #8 is the button
Seat 2: littlebear2020 ($1.70 in chips) 
Seat 3: Gust4v0_7 ($6.43 in chips) 
Seat 4: takeshie1971 ($1.83 in chips) 
Seat 5: Inc4ognito ($2 in chips) 
Seat 6: Martin aus K ($2.10 in chips) 
Seat 7: pokertronde ($2.45 in chips) 
Seat 8: trueJamaican ($2.27 in chips) 
Seat 9: Dorex2007 ($2.24 in chips) 
Dorex2007: posts small blind $0.01
littlebear2020: posts big blind $0.02
*** HOLE CARDS ***
Dealt to Dorex2007 [As Qs]
Gust4v0_7: folds 
takeshie1971 has timed out
takeshie1971: folds 
Inc4ognito: folds 
Martin aus K: raises $0.04 to $0.06
pokertronde: folds 
trueJamaican: folds 
Dorex2007: raises $0.12 to $0.18
littlebear2020: folds 
ThallesRO joins the table at seat #1 
Martin aus K: folds 
Uncalled bet ($0.12) returned to Dorex2007
Dorex2007 collected $0.14 from pot
Dorex2007: doesn't show hand 
*** SUMMARY ***
Total pot $0.14 | Rake $0 
Seat 2: littlebear2020 (big blind) folded before Flop
Seat 3: Gust4v0_7 folded before Flop (didn't bet)
Seat 4: takeshie1971 folded before Flop (didn't bet)
Seat 5: Inc4ognito folded before Flop (didn't bet)
Seat 6: Martin aus K folded before Flop
Seat 7: pokertronde folded before Flop (didn't bet)
Seat 8: trueJamaican (button) folded before Flop (didn't bet)
Seat 9: Dorex2007 (small blind) collected ($0.14)



PokerStars Hand #232168221739:  Hold'em No Limit ($0.01/$0.02 USD) - 2021/12/12 13:48:13 PT [2021/12/12 16:48:13 ET]
Table 'Lorcia' 9-max Seat #9 is the button
Seat 2: littlebear2020 ($1.68 in chips) 
Seat 3: Gust4v0_7 ($6.43 in chips) 
Seat 5: Inc4ognito ($2 in chips) 
Seat 6: Martin aus K ($2.04 in chips) 
Seat 7: pokertronde ($2.45 in chips) 
Seat 8: trueJamaican ($2.27 in chips) 
Seat 9: Dorex2007 ($2.32 in chips) 
littlebear2020: posts small blind $0.01
Gust4v0_7: posts big blind $0.02
*** HOLE CARDS ***
Dealt to Dorex2007 [3d 6c]
Inc4ognito: folds 
Martin aus K: folds 
pokertronde: folds 
trueJamaican: folds 
Dorex2007: folds 
littlebear2020: raises $0.02 to $0.04
Gust4v0_7: calls $0.02
*** FLOP *** [9s 3h Jc]
littlebear2020: bets $0.08
Gust4v0_7: folds 
Uncalled bet ($0.08) returned to littlebear2020
littlebear2020 collected $0.08 from pot
littlebear2020: doesn't show hand 
*** SUMMARY ***
Total pot $0.08 | Rake $0 
Board [9s 3h Jc]
Seat 2: littlebear2020 (small blind) collected ($0.08)
Seat 3: Gust4v0_7 (big blind) folded on the Flop
Seat 5: Inc4ognito folded before Flop (didn't bet)
Seat 6: Martin aus K folded before Flop (didn't bet)
Seat 7: pokertronde folded before Flop (didn't bet)
Seat 8: trueJamaican folded before Flop (didn't bet)
Seat 9: Dorex2007 (button) folded before Flop (didn't bet)



PokerStars Hand #232168232596:  Hold'em No Limit ($0.01/$0.02 USD) - 2021/12/12 13:48:33 PT [2021/12/12 16:48:33 ET]
Table 'Lorcia' 9-max Seat #2 is the button
Seat 2: littlebear2020 ($1.72 in chips) 
Seat 3: Gust4v0_7 ($6.39 in chips) 
Seat 5: Inc4ognito ($2 in chips) 
Seat 6: Martin aus K ($2.04 in chips) 
Seat 7: pokertronde ($2.45 in chips) 
Seat 8: trueJamaican ($2.27 in chips) 
Seat 9: Dorex2007 ($2.32 in chips) 
Gust4v0_7: posts small blind $0.01
Inc4ognito: posts big blind $0.02
ThallesRO: sits out 
*** HOLE CARDS ***
Dealt to Dorex2007 [7d 4h]
Martin aus K: folds 
pokertronde: folds 
trueJamaican: folds 
Dorex2007: folds 
littlebear2020: calls $0.02
Gust4v0_7: calls $0.01
Inc4ognito: checks 
*** FLOP *** [Qs Qc 3c]
Gust4v0_7: checks 
Inc4ognito: checks 
littlebear2020: bets $0.06
Gust4v0_7: folds 
Inc4ognito: folds 
Uncalled bet ($0.06) returned to littlebear2020
littlebear2020 collected $0.06 from pot
littlebear2020: doesn't show hand 
*** SUMMARY ***
Total pot $0.06 | Rake $0 
Board [Qs Qc 3c]
Seat 2: littlebear2020 (button) collected ($0.06)
Seat 3: Gust4v0_7 (small blind) folded on the Flop
Seat 5: Inc4ognito (big blind) folded on the Flop
Seat 6: Martin aus K folded before Flop (didn't bet)
Seat 7: pokertronde folded before Flop (didn't bet)
Seat 8: trueJamaican folded before Flop (didn't bet)
Seat 9: Dorex2007 folded before Flop (didn't bet)



PokerStars Hand #232168254127:  Hold'em No Limit ($0.01/$0.02 USD) - 2021/12/12 13:49:12 PT [2021/12/12 16:49:12 ET]
Table 'Lorcia' 9-max Seat #3 is the button
Seat 2: littlebear2020 ($1.76 in chips) 
Seat 3: Gust4v0_7 ($6.37 in chips) 
Seat 5: Inc4ognito ($2 in chips) 
Seat 6: Martin aus K ($2.04 in chips) 
Seat 7: pokertronde ($2.45 in chips) 
Seat 8: trueJamaican ($2.27 in chips) 
Seat 9: Dorex2007 ($2.32 in chips) 
Inc4ognito: posts small blind $0.01
Martin aus K: posts big blind $0.02
ThallesRO: sits out 
*** HOLE CARDS ***
Dealt to Dorex2007 [Ah 5s]
pokertronde: folds 
trueJamaican: folds 
Dorex2007: folds 
littlebear2020: folds 
Gust4v0_7: folds 
Inc4ognito: raises $0.03 to $0.05
Martin aus K: folds 
Uncalled bet ($0.03) returned to Inc4ognito
Inc4ognito collected $0.04 from pot
Inc4ognito: doesn't show hand 
*** SUMMARY ***
Total pot $0.04 | Rake $0 
Seat 2: littlebear2020 folded before Flop (didn't bet)
Seat 3: Gust4v0_7 (button) folded before Flop (didn't bet)
Seat 5: Inc4ognito (small blind) collected ($0.04)
Seat 6: Martin aus K (big blind) folded before Flop
Seat 7: pokertronde folded before Flop (didn't bet)
Seat 8: trueJamaican folded before Flop (didn't bet)
Seat 9: Dorex2007 folded before Flop (didn't bet)



PokerStars Hand #232168263881:  Hold'em No Limit ($0.01/$0.02 USD) - 2021/12/12 13:49:30 PT [2021/12/12 16:49:30 ET]
Table 'Lorcia' 9-max Seat #5 is the button
Seat 2: littlebear2020 ($1.76 in chips) 
Seat 3: Gust4v0_7 ($6.37 in chips) 
Seat 5: Inc4ognito ($2.02 in chips) 
Seat 6: Martin aus K ($2.02 in chips) 
Seat 7: pokertronde ($2.45 in chips) 
Seat 8: trueJamaican ($2.27 in chips) 
Seat 9: Dorex2007 ($2.32 in chips) 
Martin aus K: posts small blind $0.01
pokertronde: posts big blind $0.02
ThallesRO: sits out 
*** HOLE CARDS ***
Dealt to Dorex2007 [3h Td]
trueJamaican: folds 
Dorex2007: folds 
littlebear2020: folds 
Gust4v0_7: folds 
Inc4ognito: raises $0.03 to $0.05
Martin aus K: folds 
pokertronde: folds 
Uncalled bet ($0.03) returned to Inc4ognito
Inc4ognito collected $0.05 from pot
Inc4ognito: doesn't show hand 
*** SUMMARY ***
Total pot $0.05 | Rake $0 
Seat 2: littlebear2020 folded before Flop (didn't bet)
Seat 3: Gust4v0_7 folded before Flop (didn't bet)
Seat 5: Inc4ognito (button) collected ($0.05)
Seat 6: Martin aus K (small blind) folded before Flop
Seat 7: pokertronde (big blind) folded before Flop
Seat 8: trueJamaican folded before Flop (didn't bet)
Seat 9: Dorex2007 folded before Flop (didn't bet)



PokerStars Hand #232168276849:  Hold'em No Limit ($0.01/$0.02 USD) - 2021/12/12 13:49:54 PT [2021/12/12 16:49:54 ET]
Table 'Lorcia' 9-max Seat #6 is the button
Seat 2: littlebear2020 ($1.76 in chips) 
Seat 3: Gust4v0_7 ($6.37 in chips) 
Seat 5: Inc4ognito ($2.05 in chips) 
Seat 6: Martin aus K ($2.01 in chips) 
Seat 7: pokertronde ($2.43 in chips) 
Seat 8: trueJamaican ($2.27 in chips) 
Seat 9: Dorex2007 ($2.32 in chips) 
pokertronde: posts small blind $0.01
trueJamaican: posts big blind $0.02
ThallesRO: sits out 
*** HOLE CARDS ***
Dealt to Dorex2007 [3c 6c]
Dorex2007: folds 
littlebear2020: folds 
Gust4v0_7: calls $0.02
Inc4ognito: folds 
Martin aus K: folds 
pokertronde: folds 
trueJamaican: checks 
*** FLOP *** [7h Ks Ad]
trueJamaican: checks 
Gust4v0_7: checks 
*** TURN *** [7h Ks Ad] [9d]
trueJamaican: checks 
Gust4v0_7: bets $0.05
trueJamaican: folds 
Uncalled bet ($0.05) returned to Gust4v0_7
Gust4v0_7 collected $0.05 from pot
Gust4v0_7: doesn't show hand 
*** SUMMARY ***
Total pot $0.05 | Rake $0 
Board [7h Ks Ad 9d]
Seat 2: littlebear2020 folded before Flop (didn't bet)
Seat 3: Gust4v0_7 collected ($0.05)
Seat 5: Inc4ognito folded before Flop (didn't bet)
Seat 6: Martin aus K (button) folded before Flop (didn't bet)
Seat 7: pokertronde (small blind) folded before Flop
Seat 8: trueJamaican (big blind) folded on the Turn
Seat 9: Dorex2007 folded before Flop (didn't bet)



PokerStars Hand #232168296389:  Hold'em No Limit ($0.01/$0.02 USD) - 2021/12/12 13:50:30 PT [2021/12/12 16:50:30 ET]
Table 'Lorcia' 9-max Seat #7 is the button
Seat 2: littlebear2020 ($1.76 in chips) 
Seat 3: Gust4v0_7 ($6.40 in chips) 
Seat 5: Inc4ognito ($2.05 in chips) 
Seat 6: Martin aus K ($2.01 in chips) 
Seat 7: pokertronde ($2.42 in chips) 
Seat 8: trueJamaican ($2.25 in chips) 
Seat 9: Dorex2007 ($2.32 in chips) 
trueJamaican: posts small blind $0.01
Dorex2007: posts big blind $0.02
ThallesRO: sits out 
*** HOLE CARDS ***
Dealt to Dorex2007 [Qs 5d]
littlebear2020: calls $0.02
Gust4v0_7: calls $0.02
Inc4ognito: folds 
Martin aus K: folds 
pokertronde: folds 
trueJamaican: folds 
Dorex2007: checks 
*** FLOP *** [5s Js 2s]
Dorex2007: checks 
littlebear2020: checks 
Gust4v0_7: bets $0.07
Dorex2007: folds 
littlebear2020: folds 
Uncalled bet ($0.07) returned to Gust4v0_7
Gust4v0_7 collected $0.07 from pot
Gust4v0_7: doesn't show hand 
*** SUMMARY ***
Total pot $0.07 | Rake $0 
Board [5s Js 2s]
Seat 2: littlebear2020 folded on the Flop
Seat 3: Gust4v0_7 collected ($0.07)
Seat 5: Inc4ognito folded before Flop (didn't bet)
Seat 6: Martin aus K folded before Flop (didn't bet)
Seat 7: pokertronde (button) folded before Flop (didn't bet)
Seat 8: trueJamaican (small blind) folded before Flop
Seat 9: Dorex2007 (big blind) folded on the Flop



PokerStars Hand #232168333573:  Hold'em No Limit ($0.01/$0.02 USD) - 2021/12/12 13:51:40 PT [2021/12/12 16:51:40 ET]
Table 'Lorcia' 9-max Seat #8 is the button
Seat 1: ThallesRO ($2 in chips) 
Seat 2: littlebear2020 ($1.74 in chips) 
Seat 3: Gust4v0_7 ($6.45 in chips) 
Seat 5: Inc4ognito ($2.05 in chips) 
Seat 6: Martin aus K ($2.01 in chips) 
Seat 7: pokertronde ($2.42 in chips) 
Seat 8: trueJamaican ($2.24 in chips) 
Seat 9: Dorex2007 ($2.30 in chips) 
Dorex2007: posts small blind $0.01
ThallesRO: posts big blind $0.02
*** HOLE CARDS ***
Dealt to Dorex2007 [Ah 9d]
littlebear2020: calls $0.02
Gust4v0_7: raises $0.04 to $0.06
Inc4ognito: folds 
Martin aus K: folds 
pokertronde: folds 
trueJamaican: folds 
Dorex2007: folds 
ThallesRO: folds 
littlebear2020: calls $0.04
*** FLOP *** [7s 5c Js]
littlebear2020: checks 
takeshie1971 leaves the table
Gust4v0_7: bets $0.07
littlebear2020: raises $0.07 to $0.14
Gust4v0_7: calls $0.07
*** TURN *** [7s 5c Js] [7d]
littlebear2020: bets $0.12
Gust4v0_7: calls $0.12
*** RIVER *** [7s 5c Js 7d] [4h]
littlebear2020: checks 
Gust4v0_7: checks 
*** SHOW DOWN ***
littlebear2020: shows [Qc Jd] (two pair, Jacks and Sevens)
Gust4v0_7: mucks hand 
littlebear2020 collected $0.65 from pot
*** SUMMARY ***
Total pot $0.67 | Rake $0.02 
Board [7s 5c Js 7d 4h]
Seat 1: ThallesRO (big blind) folded before Flop
Seat 2: littlebear2020 showed [Qc Jd] and won ($0.65) with two pair, Jacks and Sevens
Seat 3: Gust4v0_7 mucked [8s 8d]
Seat 5: Inc4ognito folded before Flop (didn't bet)
Seat 6: Martin aus K folded before Flop (didn't bet)
Seat 7: pokertronde folded before Flop (didn't bet)
Seat 8: trueJamaican (button) folded before Flop (didn't bet)
Seat 9: Dorex2007 (small blind) folded before Flop



PokerStars Hand #232168360413:  Hold'em No Limit ($0.01/$0.02 USD) - 2021/12/12 13:52:30 PT [2021/12/12 16:52:30 ET]
Table 'Lorcia' 9-max Seat #9 is the button
Seat 1: ThallesRO ($1.98 in chips) 
Seat 2: littlebear2020 ($2.07 in chips) 
Seat 3: Gust4v0_7 ($6.13 in chips) 
Seat 5: Inc4ognito ($2.05 in chips) 
Seat 6: Martin aus K ($2.01 in chips) 
Seat 7: pokertronde ($2.42 in chips) 
Seat 8: trueJamaican ($2.24 in chips) 
Seat 9: Dorex2007 ($2.29 in chips) 
ThallesRO: posts small blind $0.01
littlebear2020: posts big blind $0.02
*** HOLE CARDS ***
Dealt to Dorex2007 [6c Kh]
Gust4v0_7: calls $0.02
Inc4ognito: folds 
Martin aus K: folds 
pokertronde: folds 
TurtleBob99 joins the table at seat #4 
trueJamaican: folds 
Dorex2007: folds 
ThallesRO: folds 
littlebear2020: raises $0.02 to $0.04
Gust4v0_7: calls $0.02
*** FLOP *** [Qc 2h Kd]
littlebear2020: bets $0.06
Gust4v0_7: calls $0.06
*** TURN *** [Qc 2h Kd] [9d]
littlebear2020: checks 
Gust4v0_7: bets $0.10
littlebear2020: folds 
Uncalled bet ($0.10) returned to Gust4v0_7
Gust4v0_7 collected $0.20 from pot
Gust4v0_7: doesn't show hand 
*** SUMMARY ***
Total pot $0.21 | Rake $0.01 
Board [Qc 2h Kd 9d]
Seat 1: ThallesRO (small blind) folded before Flop
Seat 2: littlebear2020 (big blind) folded on the Turn
Seat 3: Gust4v0_7 collected ($0.20)
Seat 5: Inc4ognito folded before Flop (didn't bet)
Seat 6: Martin aus K folded before Flop (didn't bet)
Seat 7: pokertronde folded before Flop (didn't bet)
Seat 8: trueJamaican folded before Flop (didn't bet)
Seat 9: Dorex2007 (button) folded before Flop (didn't bet)



PokerStars Hand #232168382909:  Hold'em No Limit ($0.01/$0.02 USD) - 2021/12/12 13:53:12 PT [2021/12/12 16:53:12 ET]
Table 'Lorcia' 9-max Seat #1 is the button
Seat 1: ThallesRO ($1.97 in chips) 
Seat 2: littlebear2020 ($1.97 in chips) 
Seat 3: Gust4v0_7 ($6.23 in chips) 
Seat 5: Inc4ognito ($2.05 in chips) 
Seat 6: Martin aus K ($2.01 in chips) 
Seat 7: pokertronde ($2.42 in chips) 
Seat 8: trueJamaican ($2.24 in chips) 
Seat 9: Dorex2007 ($2.29 in chips) 
littlebear2020: posts small blind $0.01
Gust4v0_7: posts big blind $0.02
TurtleBob99: sits out 
*** HOLE CARDS ***
Dealt to Dorex2007 [2d Qs]
Inc4ognito: folds 
Martin aus K: folds 
pokertronde: folds 
trueJamaican: folds 
Dorex2007: folds 
ThallesRO: calls $0.02
littlebear2020: calls $0.01
Gust4v0_7: checks 
*** FLOP *** [8c Ad 9h]
littlebear2020: checks 
Gust4v0_7: checks 
ThallesRO: checks 
*** TURN *** [8c Ad 9h] [As]
littlebear2020: checks 
Gust4v0_7: checks 
ThallesRO: checks 
*** RIVER *** [8c Ad 9h As] [Js]
littlebear2020: checks 
Gust4v0_7: bets $0.06
ThallesRO: folds 
littlebear2020: folds 
Uncalled bet ($0.06) returned to Gust4v0_7
Gust4v0_7 collected $0.06 from pot
Gust4v0_7: doesn't show hand 
*** SUMMARY ***
Total pot $0.06 | Rake $0 
Board [8c Ad 9h As Js]
Seat 1: ThallesRO (button) folded on the River
Seat 2: littlebear2020 (small blind) folded on the River
Seat 3: Gust4v0_7 (big blind) collected ($0.06)
Seat 5: Inc4ognito folded before Flop (didn't bet)
Seat 6: Martin aus K folded before Flop (didn't bet)
Seat 7: pokertronde folded before Flop (didn't bet)
Seat 8: trueJamaican folded before Flop (didn't bet)
Seat 9: Dorex2007 folded before Flop (didn't bet)



PokerStars Hand #232168411555:  Hold'em No Limit ($0.01/$0.02 USD) - 2021/12/12 13:53:52 PT [2021/12/12 16:53:52 ET]
Table 'Lorcia' 9-max Seat #2 is the button
Seat 1: ThallesRO ($1.95 in chips) 
Seat 2: littlebear2020 ($1.95 in chips) 
Seat 3: Gust4v0_7 ($6.27 in chips) 
Seat 4: TurtleBob99 ($2 in chips) 
Seat 5: Inc4ognito ($2.05 in chips) 
Seat 6: Martin aus K ($2.01 in chips) 
Seat 7: pokertronde ($2.42 in chips) 
Seat 8: trueJamaican ($2.24 in chips) 
Seat 9: Dorex2007 ($2.29 in chips) 
Gust4v0_7: posts small blind $0.01
TurtleBob99: posts big blind $0.02
*** HOLE CARDS ***
Dealt to Dorex2007 [3d Ah]
Inc4ognito: folds 
Martin aus K: folds 
pokertronde: folds 
trueJamaican has timed out
trueJamaican: folds 
Dorex2007: folds 
Inc4ognito leaves the table
ThallesRO: folds 
littlebear2020: calls $0.02
Gust4v0_7: calls $0.01
TurtleBob99: checks 
*** FLOP *** [Jd 4c 6s]
Gust4v0_7: checks 
Boomerok86 joins the table at seat #5 
TurtleBob99: bets $0.04
littlebear2020: calls $0.04
Gust4v0_7: folds 
*** TURN *** [Jd 4c 6s] [5s]
TurtleBob99: checks 
littlebear2020: checks 
*** RIVER *** [Jd 4c 6s 5s] [Tc]
TurtleBob99: checks 
littlebear2020: bets $0.08
TurtleBob99: folds 
Uncalled bet ($0.08) returned to littlebear2020
littlebear2020 collected $0.14 from pot
littlebear2020: doesn't show hand 
*** SUMMARY ***
Total pot $0.14 | Rake $0 
Board [Jd 4c 6s 5s Tc]
Seat 1: ThallesRO folded before Flop (didn't bet)
Seat 2: littlebear2020 (button) collected ($0.14)
Seat 3: Gust4v0_7 (small blind) folded on the Flop
Seat 4: TurtleBob99 (big blind) folded on the River
Seat 5: Inc4ognito folded before Flop (didn't bet)
Seat 6: Martin aus K folded before Flop (didn't bet)
Seat 7: pokertronde folded before Flop (didn't bet)
Seat 8: trueJamaican folded before Flop (didn't bet)
Seat 9: Dorex2007 folded before Flop (didn't bet)



PokerStars Hand #232168442653:  Hold'em No Limit ($0.01/$0.02 USD) - 2021/12/12 13:54:51 PT [2021/12/12 16:54:51 ET]
Table 'Lorcia' 9-max Seat #3 is the button
Seat 1: ThallesRO ($1.95 in chips) 
Seat 2: littlebear2020 ($2.03 in chips) 
Seat 3: Gust4v0_7 ($6.25 in chips) 
Seat 4: TurtleBob99 ($1.94 in chips) 
Seat 5: Boomerok86 ($0.80 in chips) 
Seat 6: Martin aus K ($2.01 in chips) 
Seat 7: pokertronde ($2.42 in chips) 
Seat 8: trueJamaican ($2.24 in chips) 
Seat 9: Dorex2007 ($2.29 in chips) 
TurtleBob99: posts small blind $0.01
Boomerok86: posts big blind $0.02
*** HOLE CARDS ***
Dealt to Dorex2007 [Th Qc]
Martin aus K: folds 
pokertronde: folds 
trueJamaican: folds 
Dorex2007: folds 
ThallesRO: folds 
littlebear2020: folds 
Gust4v0_7: calls $0.02
TurtleBob99: folds 
Boomerok86: checks 
*** FLOP *** [Kh 5s Ac]
Boomerok86: bets $0.02
Gust4v0_7: folds 
Uncalled bet ($0.02) returned to Boomerok86
Boomerok86 collected $0.05 from pot
Boomerok86: doesn't show hand 
*** SUMMARY ***
Total pot $0.05 | Rake $0 
Board [Kh 5s Ac]
Seat 1: ThallesRO folded before Flop (didn't bet)
Seat 2: littlebear2020 folded before Flop (didn't bet)
Seat 3: Gust4v0_7 (button) folded on the Flop
Seat 4: TurtleBob99 (small blind) folded before Flop
Seat 5: Boomerok86 (big blind) collected ($0.05)
Seat 6: Martin aus K folded before Flop (didn't bet)
Seat 7: pokertronde folded before Flop (didn't bet)
Seat 8: trueJamaican folded before Flop (didn't bet)
Seat 9: Dorex2007 folded before Flop (didn't bet)



PokerStars Hand #232168459541:  Hold'em No Limit ($0.01/$0.02 USD) - 2021/12/12 13:55:30 PT [2021/12/12 16:55:30 ET]
Table 'Lorcia' 9-max Seat #4 is the button
Seat 1: ThallesRO ($1.95 in chips) 
Seat 2: littlebear2020 ($2.03 in chips) 
Seat 3: Gust4v0_7 ($6.23 in chips) 
Seat 4: TurtleBob99 ($1.93 in chips) 
Seat 5: Boomerok86 ($0.83 in chips) 
Seat 6: Martin aus K ($2.01 in chips) 
Seat 7: pokertronde ($2.42 in chips) 
Seat 8: trueJamaican ($2.24 in chips) 
Seat 9: Dorex2007 ($2.29 in chips) 
Boomerok86: posts small blind $0.01
Martin aus K: posts big blind $0.02
*** HOLE CARDS ***
Dealt to Dorex2007 [Kc 6s]
pokertronde: folds 
trueJamaican has timed out
trueJamaican: folds 
Dorex2007: folds 
ThallesRO: folds 
littlebear2020: folds 
Gust4v0_7: folds 
TurtleBob99: folds 
Boomerok86: calls $0.01
Martin aus K: checks 
*** FLOP *** [4d Kd 7s]
Boomerok86: checks 
Martin aus K: checks 
*** TURN *** [4d Kd 7s] [Js]
Boomerok86: bets $0.02
Martin aus K: calls $0.02
*** RIVER *** [4d Kd 7s Js] [3c]
Boomerok86: bets $0.02
Martin aus K: calls $0.02
*** SHOW DOWN ***
Boomerok86: shows [8d 9s] (high card King)
Martin aus K: shows [8c 4c] (a pair of Fours)
Martin aus K collected $0.12 from pot
*** SUMMARY ***
Total pot $0.12 | Rake $0 
Board [4d Kd 7s Js 3c]
Seat 1: ThallesRO folded before Flop (didn't bet)
Seat 2: littlebear2020 folded before Flop (didn't bet)
Seat 3: Gust4v0_7 folded before Flop (didn't bet)
Seat 4: TurtleBob99 (button) folded before Flop (didn't bet)
Seat 5: Boomerok86 (small blind) showed [8d 9s] and lost with high card King
Seat 6: Martin aus K (big blind) showed [8c 4c] and won ($0.12) with a pair of Fours
Seat 7: pokertronde folded before Flop (didn't bet)
Seat 8: trueJamaican folded before Flop (didn't bet)
Seat 9: Dorex2007 folded before Flop (didn't bet)



PokerStars Hand #232168487420:  Hold'em No Limit ($0.01/$0.02 USD) - 2021/12/12 13:56:37 PT [2021/12/12 16:56:37 ET]
Table 'Lorcia' 9-max Seat #5 is the button
Seat 1: ThallesRO ($1.95 in chips) 
Seat 2: littlebear2020 ($2.03 in chips) 
Seat 3: Gust4v0_7 ($6.23 in chips) 
Seat 4: TurtleBob99 ($1.93 in chips) 
Seat 5: Boomerok86 ($0.77 in chips) 
Seat 6: Martin aus K ($2.07 in chips) 
Seat 7: pokertronde ($2.42 in chips) 
Seat 8: trueJamaican ($2.24 in chips) 
Seat 9: Dorex2007 ($2.29 in chips) 
Martin aus K: posts small blind $0.01
pokertronde: posts big blind $0.02
*** HOLE CARDS ***
Dealt to Dorex2007 [2c As]
trueJamaican: folds 
Dorex2007: folds 
ThallesRO: calls $0.02
littlebear2020: folds 
Gust4v0_7: folds 
TurtleBob99: folds 
Boomerok86: calls $0.02
Martin aus K: folds 
pokertronde: checks 
*** FLOP *** [3c 6h Jc]
pokertronde: checks 
ThallesRO: checks 
Boomerok86: bets $0.04
pokertronde: folds 
ThallesRO: folds 
Uncalled bet ($0.04) returned to Boomerok86
Boomerok86 collected $0.07 from pot
Boomerok86: doesn't show hand 
*** SUMMARY ***
Total pot $0.07 | Rake $0 
Board [3c 6h Jc]
Seat 1: ThallesRO folded on the Flop
Seat 2: littlebear2020 folded before Flop (didn't bet)
Seat 3: Gust4v0_7 folded before Flop (didn't bet)
Seat 4: TurtleBob99 folded before Flop (didn't bet)
Seat 5: Boomerok86 (button) collected ($0.07)
Seat 6: Martin aus K (small blind) folded before Flop
Seat 7: pokertronde (big blind) folded on the Flop
Seat 8: trueJamaican folded before Flop (didn't bet)
Seat 9: Dorex2007 folded before Flop (didn't bet)



PokerStars Hand #232168508402:  Hold'em No Limit ($0.01/$0.02 USD) - 2021/12/12 13:57:16 PT [2021/12/12 16:57:16 ET]
Table 'Lorcia' 9-max Seat #6 is the button
Seat 1: ThallesRO ($1.93 in chips) 
Seat 2: littlebear2020 ($2.03 in chips) 
Seat 3: Gust4v0_7 ($6.23 in chips) 
Seat 4: TurtleBob99 ($1.93 in chips) 
Seat 5: Boomerok86 ($0.82 in chips) 
Seat 6: Martin aus K ($2.06 in chips) 
Seat 7: pokertronde ($2.40 in chips) 
Seat 8: trueJamaican ($2.24 in chips) 
Seat 9: Dorex2007 ($2.29 in chips) 
pokertronde: posts small blind $0.01
trueJamaican: posts big blind $0.02
*** HOLE CARDS ***
Dealt to Dorex2007 [4d Ac]
Dorex2007: folds 
ThallesRO: calls $0.02
littlebear2020: folds 
Gust4v0_7: folds 
TurtleBob99: raises $0.07 to $0.09
Boomerok86: folds 
Martin aus K: folds 
pokertronde: folds 
trueJamaican: folds 
ThallesRO: calls $0.07
*** FLOP *** [Js 3s 8d]
ThallesRO: bets $0.10
TurtleBob99: raises $0.27 to $0.37
ThallesRO: calls $0.27
*** TURN *** [Js 3s 8d] [Jd]
ThallesRO: bets $0.02
TurtleBob99: calls $0.02
*** RIVER *** [Js 3s 8d Jd] [Kd]
ThallesRO: bets $0.02
TurtleBob99: calls $0.02
*** SHOW DOWN ***
ThallesRO: shows [Ad 8c] (two pair, Jacks and Eights)
TurtleBob99: shows [Qc Qs] (two pair, Queens and Jacks)
TurtleBob99 collected $0.99 from pot
*** SUMMARY ***
Total pot $1.03 | Rake $0.04 
Board [Js 3s 8d Jd Kd]
Seat 1: ThallesRO showed [Ad 8c] and lost with two pair, Jacks and Eights
Seat 2: littlebear2020 folded before Flop (didn't bet)
Seat 3: Gust4v0_7 folded before Flop (didn't bet)
Seat 4: TurtleBob99 showed [Qc Qs] and won ($0.99) with two pair, Queens and Jacks
Seat 5: Boomerok86 folded before Flop (didn't bet)
Seat 6: Martin aus K (button) folded before Flop (didn't bet)
Seat 7: pokertronde (small blind) folded before Flop
Seat 8: trueJamaican (big blind) folded before Flop
Seat 9: Dorex2007 folded before Flop (didn't bet)



PokerStars Hand #232168532114:  Hold'em No Limit ($0.01/$0.02 USD) - 2021/12/12 13:58:23 PT [2021/12/12 16:58:23 ET]
Table 'Lorcia' 9-max Seat #7 is the button
Seat 1: ThallesRO ($1.43 in chips) 
Seat 2: littlebear2020 ($2.03 in chips) 
Seat 3: Gust4v0_7 ($6.23 in chips) 
Seat 4: TurtleBob99 ($2.42 in chips) 
Seat 5: Boomerok86 ($0.82 in chips) 
Seat 6: Martin aus K ($2.06 in chips) 
Seat 7: pokertronde ($2.39 in chips) 
Seat 8: trueJamaican ($2.22 in chips) 
Seat 9: Dorex2007 ($2.29 in chips) 
trueJamaican: posts small blind $0.01
Dorex2007: posts big blind $0.02
*** HOLE CARDS ***
Dealt to Dorex2007 [9s Ts]
ThallesRO: calls $0.02
littlebear2020: folds 
Gust4v0_7: calls $0.02
TurtleBob99: folds 
Boomerok86: folds 
Martin aus K: folds 
pokertronde: folds 
trueJamaican: folds 
Dorex2007: checks 
*** FLOP *** [8d 3h Qc]
Dorex2007: checks 
ThallesRO: bets $0.02
Gust4v0_7: folds 
Dorex2007: folds 
Uncalled bet ($0.02) returned to ThallesRO
ThallesRO collected $0.07 from pot
ThallesRO: doesn't show hand 
*** SUMMARY ***
Total pot $0.07 | Rake $0 
Board [8d 3h Qc]
Seat 1: ThallesRO collected ($0.07)
Seat 2: littlebear2020 folded before Flop (didn't bet)
Seat 3: Gust4v0_7 folded on the Flop
Seat 4: TurtleBob99 folded before Flop (didn't bet)
Seat 5: Boomerok86 folded before Flop (didn't bet)
Seat 6: Martin aus K folded before Flop (didn't bet)
Seat 7: pokertronde (button) folded before Flop (didn't bet)
Seat 8: trueJamaican (small blind) folded before Flop
Seat 9: Dorex2007 (big blind) folded on the Flop



PokerStars Hand #232168545327:  Hold'em No Limit ($0.01/$0.02 USD) - 2021/12/12 13:59:00 PT [2021/12/12 16:59:00 ET]
Table 'Lorcia' 9-max Seat #8 is the button
Seat 1: ThallesRO ($1.48 in chips) 
Seat 2: littlebear2020 ($2.03 in chips) 
Seat 3: Gust4v0_7 ($6.21 in chips) 
Seat 4: TurtleBob99 ($2.42 in chips) 
Seat 5: Boomerok86 ($0.82 in chips) 
Seat 6: Martin aus K ($2.06 in chips) 
Seat 7: pokertronde ($2.39 in chips) 
Seat 8: trueJamaican ($2.21 in chips) 
Seat 9: Dorex2007 ($2.27 in chips) 
Dorex2007: posts small blind $0.01
ThallesRO: posts big blind $0.02
*** HOLE CARDS ***
Dealt to Dorex2007 [6s Ac]
littlebear2020: raises $0.04 to $0.06
Gust4v0_7: folds 
TurtleBob99: calls $0.06
Boomerok86: folds 
Martin aus K: folds 
pokertronde: folds 
trueJamaican: folds 
Dorex2007: folds 
ThallesRO: folds 
*** FLOP *** [7s 8d Qc]
littlebear2020: bets $0.07
TurtleBob99: calls $0.07
*** TURN *** [7s 8d Qc] [6c]
littlebear2020: checks 
TurtleBob99: bets $0.19
littlebear2020: raises $0.19 to $0.38
TurtleBob99: calls $0.19
*** RIVER *** [7s 8d Qc 6c] [Ts]
littlebear2020: checks 
TurtleBob99: bets $0.33
littlebear2020: calls $0.33
*** SHOW DOWN ***
TurtleBob99: shows [Ad 9d] (a straight, Six to Ten)
littlebear2020: mucks hand 
TurtleBob99 collected $1.65 from pot
*** SUMMARY ***
Total pot $1.71 | Rake $0.06 
Board [7s 8d Qc 6c Ts]
Seat 1: ThallesRO (big blind) folded before Flop
Seat 2: littlebear2020 mucked [As Qh]
Seat 3: Gust4v0_7 folded before Flop (didn't bet)
Seat 4: TurtleBob99 showed [Ad 9d] and won ($1.65) with a straight, Six to Ten
Seat 5: Boomerok86 folded before Flop (didn't bet)
Seat 6: Martin aus K folded before Flop (didn't bet)
Seat 7: pokertronde folded before Flop (didn't bet)
Seat 8: trueJamaican (button) folded before Flop (didn't bet)
Seat 9: Dorex2007 (small blind) folded before Flop



PokerStars Hand #232168565990:  Hold'em No Limit ($0.01/$0.02 USD) - 2021/12/12 13:59:58 PT [2021/12/12 16:59:58 ET]
Table 'Lorcia' 9-max Seat #9 is the button
Seat 1: ThallesRO ($1.46 in chips) 
Seat 2: littlebear2020 ($1.19 in chips) 
Seat 3: Gust4v0_7 ($6.21 in chips) 
Seat 4: TurtleBob99 ($3.23 in chips) 
Seat 5: Boomerok86 ($0.82 in chips) 
Seat 6: Martin aus K ($2.06 in chips) 
Seat 7: pokertronde ($2.39 in chips) 
Seat 8: trueJamaican ($2.21 in chips) 
Seat 9: Dorex2007 ($2.26 in chips) 
ThallesRO: posts small blind $0.01
littlebear2020: posts big blind $0.02
*** HOLE CARDS ***
Dealt to Dorex2007 [As 3s]
Gust4v0_7: folds 
TurtleBob99: folds 
Boomerok86: folds 
Martin aus K: folds 
pokertronde: folds 
trueJamaican: folds 
Dorex2007: raises $0.02 to $0.04
ThallesRO: folds 
littlebear2020: calls $0.02
*** FLOP *** [6h Kh Jc]
littlebear2020: bets $0.04
Dorex2007: calls $0.04
*** TURN *** [6h Kh Jc] [8h]
littlebear2020: bets $0.16
Dorex2007: folds 
Uncalled bet ($0.16) returned to littlebear2020
littlebear2020 collected $0.16 from pot
littlebear2020: doesn't show hand 
*** SUMMARY ***
Total pot $0.17 | Rake $0.01 
Board [6h Kh Jc 8h]
Seat 1: ThallesRO (small blind) folded before Flop
Seat 2: littlebear2020 (big blind) collected ($0.16)
Seat 3: Gust4v0_7 folded before Flop (didn't bet)
Seat 4: TurtleBob99 folded before Flop (didn't bet)
Seat 5: Boomerok86 folded before Flop (didn't bet)
Seat 6: Martin aus K folded before Flop (didn't bet)
Seat 7: pokertronde folded before Flop (didn't bet)
Seat 8: trueJamaican folded before Flop (didn't bet)
Seat 9: Dorex2007 (button) folded on the Turn



PokerStars Hand #232168576804:  Hold'em No Limit ($0.01/$0.02 USD) - 2021/12/12 14:00:27 PT [2021/12/12 17:00:27 ET]
Table 'Lorcia' 9-max Seat #1 is the button
Seat 1: ThallesRO ($1.45 in chips) 
Seat 2: littlebear2020 ($1.27 in chips) 
Seat 3: Gust4v0_7 ($6.21 in chips) 
Seat 4: TurtleBob99 ($3.23 in chips) 
Seat 5: Boomerok86 ($0.82 in chips) 
Seat 6: Martin aus K ($2.06 in chips) 
Seat 7: pokertronde ($2.39 in chips) 
Seat 8: trueJamaican ($2.21 in chips) 
Seat 9: Dorex2007 ($2.18 in chips) 
littlebear2020: posts small blind $0.01
Gust4v0_7: posts big blind $0.02
*** HOLE CARDS ***
Dealt to Dorex2007 [8d 6h]
TurtleBob99: folds 
Boomerok86: calls $0.02
Martin aus K: folds 
pokertronde: folds 
trueJamaican: folds 
Dorex2007: folds 
ThallesRO: folds 
littlebear2020: folds 
Gust4v0_7: checks 
*** FLOP *** [Kc 4h 5c]
Gust4v0_7: checks 
Boomerok86: checks 
*** TURN *** [Kc 4h 5c] [3s]
Gust4v0_7: bets $0.02
Boomerok86: calls $0.02
*** RIVER *** [Kc 4h 5c 3s] [Ts]
Gust4v0_7: checks 
Boomerok86: checks 
*** SHOW DOWN ***
Gust4v0_7: shows [3h 8c] (a pair of Threes)
Boomerok86: shows [6s 5s] (a pair of Fives)
Boomerok86 collected $0.09 from pot
*** SUMMARY ***
Total pot $0.09 | Rake $0 
Board [Kc 4h 5c 3s Ts]
Seat 1: ThallesRO (button) folded before Flop (didn't bet)
Seat 2: littlebear2020 (small blind) folded before Flop
Seat 3: Gust4v0_7 (big blind) showed [3h 8c] and lost with a pair of Threes
Seat 4: TurtleBob99 folded before Flop (didn't bet)
Seat 5: Boomerok86 showed [6s 5s] and won ($0.09) with a pair of Fives
Seat 6: Martin aus K folded before Flop (didn't bet)
Seat 7: pokertronde folded before Flop (didn't bet)
Seat 8: trueJamaican folded before Flop (didn't bet)
Seat 9: Dorex2007 folded before Flop (didn't bet)



PokerStars Hand #232168600248:  Hold'em No Limit ($0.01/$0.02 USD) - 2021/12/12 14:01:24 PT [2021/12/12 17:01:24 ET]
Table 'Lorcia' 9-max Seat #2 is the button
Seat 1: ThallesRO ($1.45 in chips) 
Seat 2: littlebear2020 ($2 in chips) 
Seat 3: Gust4v0_7 ($6.17 in chips) 
Seat 4: TurtleBob99 ($3.23 in chips) 
Seat 5: Boomerok86 ($0.87 in chips) 
Seat 6: Martin aus K ($2.06 in chips) 
Seat 7: pokertronde ($2.39 in chips) 
Seat 8: trueJamaican ($2.21 in chips) 
Seat 9: Dorex2007 ($2.18 in chips) 
Gust4v0_7: posts small blind $0.01
TurtleBob99: posts big blind $0.02
*** HOLE CARDS ***
Dealt to Dorex2007 [3s Ks]
Boomerok86: folds 
Martin aus K: folds 
pokertronde: folds 
trueJamaican: folds 
Dorex2007: calls $0.02
ThallesRO: calls $0.02
littlebear2020: calls $0.02
Gust4v0_7: calls $0.01
TurtleBob99: checks 
*** FLOP *** [9d 4c 3c]
Gust4v0_7: checks 
TurtleBob99: checks 
Dorex2007: checks 
ThallesRO: bets $0.10
littlebear2020: folds 
Gust4v0_7: folds 
TurtleBob99: folds 
Dorex2007: folds 
Uncalled bet ($0.10) returned to ThallesRO
ThallesRO collected $0.10 from pot
ThallesRO: doesn't show hand 
*** SUMMARY ***
Total pot $0.10 | Rake $0 
Board [9d 4c 3c]
Seat 1: ThallesRO collected ($0.10)
Seat 2: littlebear2020 (button) folded on the Flop
Seat 3: Gust4v0_7 (small blind) folded on the Flop
Seat 4: TurtleBob99 (big blind) folded on the Flop
Seat 5: Boomerok86 folded before Flop (didn't bet)
Seat 6: Martin aus K folded before Flop (didn't bet)
Seat 7: pokertronde folded before Flop (didn't bet)
Seat 8: trueJamaican folded before Flop (didn't bet)
Seat 9: Dorex2007 folded on the Flop



PokerStars Hand #232168621006:  Hold'em No Limit ($0.01/$0.02 USD) - 2021/12/12 14:02:07 PT [2021/12/12 17:02:07 ET]
Table 'Lorcia' 9-max Seat #3 is the button
Seat 1: ThallesRO ($1.53 in chips) 
Seat 2: littlebear2020 ($1.98 in chips) 
Seat 3: Gust4v0_7 ($6.15 in chips) 
Seat 4: TurtleBob99 ($3.21 in chips) 
Seat 5: Boomerok86 ($0.87 in chips) 
Seat 6: Martin aus K ($2.06 in chips) 
Seat 7: pokertronde ($2.39 in chips) 
Seat 8: trueJamaican ($2.21 in chips) 
Seat 9: Dorex2007 ($2.16 in chips) 
TurtleBob99: posts small blind $0.01
Boomerok86: posts big blind $0.02
*** HOLE CARDS ***
Dealt to Dorex2007 [Ad 9d]
Martin aus K: folds 
pokertronde: folds 
trueJamaican: raises $0.04 to $0.06
Dorex2007: folds 
ThallesRO: folds 
littlebear2020: folds 
Gust4v0_7: folds 
TurtleBob99: folds 
Boomerok86: calls $0.04
*** FLOP *** [Jc Jh 7h]
Boomerok86: checks 
trueJamaican: checks 
*** TURN *** [Jc Jh 7h] [Th]
Boomerok86: checks 
trueJamaican: checks 
*** RIVER *** [Jc Jh 7h Th] [7d]
Boomerok86: bets $0.04
trueJamaican: folds 
Uncalled bet ($0.04) returned to Boomerok86
Boomerok86 collected $0.13 from pot
Boomerok86: doesn't show hand 
*** SUMMARY ***
Total pot $0.13 | Rake $0 
Board [Jc Jh 7h Th 7d]
Seat 1: ThallesRO folded before Flop (didn't bet)
Seat 2: littlebear2020 folded before Flop (didn't bet)
Seat 3: Gust4v0_7 (button) folded before Flop (didn't bet)
Seat 4: TurtleBob99 (small blind) folded before Flop
Seat 5: Boomerok86 (big blind) collected ($0.13)
Seat 6: Martin aus K folded before Flop (didn't bet)
Seat 7: pokertronde folded before Flop (didn't bet)
Seat 8: trueJamaican folded on the River
Seat 9: Dorex2007 folded before Flop (didn't bet)



PokerStars Hand #232168652859:  Hold'em No Limit ($0.01/$0.02 USD) - 2021/12/12 14:03:08 PT [2021/12/12 17:03:08 ET]
Table 'Lorcia' 9-max Seat #4 is the button
Seat 1: ThallesRO ($1.53 in chips) 
Seat 2: littlebear2020 ($1.98 in chips) 
Seat 3: Gust4v0_7 ($6.15 in chips) 
Seat 4: TurtleBob99 ($3.20 in chips) 
Seat 5: Boomerok86 ($0.94 in chips) 
Seat 6: Martin aus K ($2.06 in chips) 
Seat 7: pokertronde ($2.39 in chips) 
Seat 8: trueJamaican ($2.15 in chips) 
Seat 9: Dorex2007 ($2.16 in chips) 
Boomerok86: posts small blind $0.01
Martin aus K: posts big blind $0.02
*** HOLE CARDS ***
Dealt to Dorex2007 [8h 2c]
pokertronde: raises $0.04 to $0.06
trueJamaican: folds 
Dorex2007: folds 
ThallesRO: folds 
littlebear2020: folds 
Gust4v0_7: folds 
TurtleBob99: calls $0.06
Boomerok86: folds 
Martin aus K: folds 
*** FLOP *** [6d Qc 3s]
pokertronde: bets $0.08
TurtleBob99: folds 
Uncalled bet ($0.08) returned to pokertronde
pokertronde collected $0.14 from pot
pokertronde: doesn't show hand 
*** SUMMARY ***
Total pot $0.15 | Rake $0.01 
Board [6d Qc 3s]
Seat 1: ThallesRO folded before Flop (didn't bet)
Seat 2: littlebear2020 folded before Flop (didn't bet)
Seat 3: Gust4v0_7 folded before Flop (didn't bet)
Seat 4: TurtleBob99 (button) folded on the Flop
Seat 5: Boomerok86 (small blind) folded before Flop
Seat 6: Martin aus K (big blind) folded before Flop
Seat 7: pokertronde collected ($0.14)
Seat 8: trueJamaican folded before Flop (didn't bet)
Seat 9: Dorex2007 folded before Flop (didn't bet)



PokerStars Hand #232168668492:  Hold'em No Limit ($0.01/$0.02 USD) - 2021/12/12 14:03:37 PT [2021/12/12 17:03:37 ET]
Table 'Lorcia' 9-max Seat #5 is the button
Seat 1: ThallesRO ($1.53 in chips) 
Seat 2: littlebear2020 ($1.98 in chips) 
Seat 3: Gust4v0_7 ($6.15 in chips) 
Seat 4: TurtleBob99 ($3.14 in chips) 
Seat 5: Boomerok86 ($0.93 in chips) 
Seat 6: Martin aus K ($2.04 in chips) 
Seat 7: pokertronde ($2.47 in chips) 
Seat 8: trueJamaican ($2.15 in chips) 
Seat 9: Dorex2007 ($2.16 in chips) 
Martin aus K: posts small blind $0.01
pokertronde: posts big blind $0.02
*** HOLE CARDS ***
Dealt to Dorex2007 [Qh 8c]
trueJamaican: raises $0.04 to $0.06
Dorex2007: folds 
ThallesRO: calls $0.06
littlebear2020: folds 
Gust4v0_7: folds 
TurtleBob99: calls $0.06
Boomerok86: folds 
Martin aus K: folds 
pokertronde: folds 
*** FLOP *** [6c 5h 9s]
trueJamaican: checks 
ThallesRO: bets $0.20
TurtleBob99: folds 
trueJamaican: folds 
Uncalled bet ($0.20) returned to ThallesRO
ThallesRO collected $0.20 from pot
ThallesRO: doesn't show hand 
*** SUMMARY ***
Total pot $0.21 | Rake $0.01 
Board [6c 5h 9s]
Seat 1: ThallesRO collected ($0.20)
Seat 2: littlebear2020 folded before Flop (didn't bet)
Seat 3: Gust4v0_7 folded before Flop (didn't bet)
Seat 4: TurtleBob99 folded on the Flop
Seat 5: Boomerok86 (button) folded before Flop (didn't bet)
Seat 6: Martin aus K (small blind) folded before Flop
Seat 7: pokertronde (big blind) folded before Flop
Seat 8: trueJamaican folded on the Flop
Seat 9: Dorex2007 folded before Flop (didn't bet)



PokerStars Hand #232168684725:  Hold'em No Limit ($0.01/$0.02 USD) - 2021/12/12 14:04:08 PT [2021/12/12 17:04:08 ET]
Table 'Lorcia' 9-max Seat #6 is the button
Seat 1: ThallesRO ($1.67 in chips) 
Seat 2: littlebear2020 ($1.98 in chips) 
Seat 3: Gust4v0_7 ($6.15 in chips) 
Seat 4: TurtleBob99 ($3.08 in chips) 
Seat 5: Boomerok86 ($0.93 in chips) 
Seat 6: Martin aus K ($2.03 in chips) 
Seat 7: pokertronde ($2.45 in chips) 
Seat 8: trueJamaican ($2.09 in chips) 
Seat 9: Dorex2007 ($2.16 in chips) 
pokertronde: posts small blind $0.01
trueJamaican: posts big blind $0.02
*** HOLE CARDS ***
Dealt to Dorex2007 [9h Ad]
Dorex2007: folds 
ThallesRO: calls $0.02
littlebear2020: folds 
Gust4v0_7: calls $0.02
TurtleBob99: folds 
Boomerok86: calls $0.02
Martin aus K: raises $0.11 to $0.13
pokertronde: folds 
trueJamaican: folds 
ThallesRO: folds 
Gust4v0_7: folds 
Boomerok86: folds 
Uncalled bet ($0.11) returned to Martin aus K
Martin aus K collected $0.11 from pot
Martin aus K: doesn't show hand 
*** SUMMARY ***
Total pot $0.11 | Rake $0 
Seat 1: ThallesRO folded before Flop
Seat 2: littlebear2020 folded before Flop (didn't bet)
Seat 3: Gust4v0_7 folded before Flop
Seat 4: TurtleBob99 folded before Flop (didn't bet)
Seat 5: Boomerok86 folded before Flop
Seat 6: Martin aus K (button) collected ($0.11)
Seat 7: pokertronde (small blind) folded before Flop
Seat 8: trueJamaican (big blind) folded before Flop
Seat 9: Dorex2007 folded before Flop (didn't bet)



PokerStars Hand #232168704956:  Hold'em No Limit ($0.01/$0.02 USD) - 2021/12/12 14:04:45 PT [2021/12/12 17:04:45 ET]
Table 'Lorcia' 9-max Seat #7 is the button
Seat 1: ThallesRO ($1.65 in chips) 
Seat 2: littlebear2020 ($1.98 in chips) 
Seat 3: Gust4v0_7 ($6.13 in chips) 
Seat 4: TurtleBob99 ($3.08 in chips) 
Seat 5: Boomerok86 ($0.91 in chips) 
Seat 6: Martin aus K ($2.12 in chips) 
Seat 7: pokertronde ($2.44 in chips) 
Seat 8: trueJamaican ($2.07 in chips) 
Seat 9: Dorex2007 ($2.16 in chips) 
trueJamaican: posts small blind $0.01
Dorex2007: posts big blind $0.02
*** HOLE CARDS ***
Dealt to Dorex2007 [Qs 8c]
ThallesRO: folds 
littlebear2020: folds 
Gust4v0_7: folds 
TurtleBob99: folds 
Boomerok86: calls $0.02
Martin aus K: folds 
pokertronde: calls $0.02
trueJamaican: raises $0.08 to $0.10
Dorex2007: folds 
Boomerok86: folds 
pokertronde: calls $0.08
*** FLOP *** [Qd 7d 6c]
trueJamaican: bets $0.15
pokertronde: calls $0.15
*** TURN *** [Qd 7d 6c] [9d]
trueJamaican: bets $0.34
pokertronde: calls $0.34
*** RIVER *** [Qd 7d 6c 9d] [Ks]
trueJamaican: checks 
pokertronde: bets $0.71
trueJamaican: calls $0.71
*** SHOW DOWN ***
pokertronde: shows [6s 6h] (three of a kind, Sixes)
trueJamaican: mucks hand 
pokertronde collected $2.53 from pot
*** SUMMARY ***
Total pot $2.64 | Rake $0.11 
Board [Qd 7d 6c 9d Ks]
Seat 1: ThallesRO folded before Flop (didn't bet)
Seat 2: littlebear2020 folded before Flop (didn't bet)
Seat 3: Gust4v0_7 folded before Flop (didn't bet)
Seat 4: TurtleBob99 folded before Flop (didn't bet)
Seat 5: Boomerok86 folded before Flop
Seat 6: Martin aus K folded before Flop (didn't bet)
Seat 7: pokertronde (button) showed [6s 6h] and won ($2.53) with three of a kind, Sixes
Seat 8: trueJamaican (small blind) mucked [Ah As]
Seat 9: Dorex2007 (big blind) folded before Flop



PokerStars Hand #232168743738:  Hold'em No Limit ($0.01/$0.02 USD) - 2021/12/12 14:05:58 PT [2021/12/12 17:05:58 ET]
Table 'Lorcia' 9-max Seat #8 is the button
Seat 1: ThallesRO ($1.65 in chips) 
Seat 2: littlebear2020 ($1.98 in chips) 
Seat 4: TurtleBob99 ($3.08 in chips) 
Seat 5: Boomerok86 ($0.89 in chips) 
Seat 6: Martin aus K ($2.12 in chips) 
Seat 7: pokertronde ($3.67 in chips) 
Seat 8: trueJamaican ($2 in chips) 
Seat 9: Dorex2007 ($2.14 in chips) 
Dorex2007: posts small blind $0.01
ThallesRO: posts big blind $0.02
*** HOLE CARDS ***
Dealt to Dorex2007 [6h 8d]
littlebear2020: folds 
TurtleBob99: folds 
Boomerok86: folds 
Martin aus K: raises $0.04 to $0.06
pokertronde: folds 
trueJamaican: folds 
Dorex2007: folds 
ThallesRO: folds 
Uncalled bet ($0.04) returned to Martin aus K
Martin aus K collected $0.05 from pot
Martin aus K: doesn't show hand 
*** SUMMARY ***
Total pot $0.05 | Rake $0 
Seat 1: ThallesRO (big blind) folded before Flop
Seat 2: littlebear2020 folded before Flop (didn't bet)
Seat 4: TurtleBob99 folded before Flop (didn't bet)
Seat 5: Boomerok86 folded before Flop (didn't bet)
Seat 6: Martin aus K collected ($0.05)
Seat 7: pokertronde folded before Flop (didn't bet)
Seat 8: trueJamaican (button) folded before Flop (didn't bet)
Seat 9: Dorex2007 (small blind) folded before Flop



PokerStars Hand #232168753205:  Hold'em No Limit ($0.01/$0.02 USD) - 2021/12/12 14:06:16 PT [2021/12/12 17:06:16 ET]
Table 'Lorcia' 9-max Seat #9 is the button
Seat 1: ThallesRO ($1.63 in chips) 
Seat 2: littlebear2020 ($1.98 in chips) 
Seat 4: TurtleBob99 ($3.08 in chips) 
Seat 5: Boomerok86 ($0.89 in chips) 
Seat 6: Martin aus K ($2.15 in chips) 
Seat 7: pokertronde ($3.67 in chips) 
Seat 8: trueJamaican ($2 in chips) 
Seat 9: Dorex2007 ($2.13 in chips) 
ThallesRO: posts small blind $0.01
littlebear2020: posts big blind $0.02
*** HOLE CARDS ***
Dealt to Dorex2007 [7h Jc]
TurtleBob99: folds 
Boomerok86: folds 
Martin aus K: folds 
pokertronde: folds 
trueJamaican: folds 
Dorex2007: folds 
ThallesRO: raises $0.02 to $0.04
littlebear2020: calls $0.02
*** FLOP *** [2c 8s 9d]
ThallesRO: bets $0.04
littlebear2020: folds 
Uncalled bet ($0.04) returned to ThallesRO
ThallesRO collected $0.08 from pot
ThallesRO: doesn't show hand 
*** SUMMARY ***
Total pot $0.08 | Rake $0 
Board [2c 8s 9d]
Seat 1: ThallesRO (small blind) collected ($0.08)
Seat 2: littlebear2020 (big blind) folded on the Flop
Seat 4: TurtleBob99 folded before Flop (didn't bet)
Seat 5: Boomerok86 folded before Flop (didn't bet)
Seat 6: Martin aus K folded before Flop (didn't bet)
Seat 7: pokertronde folded before Flop (didn't bet)
Seat 8: trueJamaican folded before Flop (didn't bet)
Seat 9: Dorex2007 (button) folded before Flop (didn't bet)



PokerStars Hand #232168765466:  Hold'em No Limit ($0.01/$0.02 USD) - 2021/12/12 14:06:38 PT [2021/12/12 17:06:38 ET]
Table 'Lorcia' 9-max Seat #1 is the button
Seat 1: ThallesRO ($1.67 in chips) 
Seat 2: littlebear2020 ($1.94 in chips) 
Seat 4: TurtleBob99 ($3.08 in chips) 
Seat 5: Boomerok86 ($0.89 in chips) 
Seat 6: Martin aus K ($2.15 in chips) 
Seat 7: pokertronde ($3.67 in chips) 
Seat 8: trueJamaican ($2 in chips) 
Seat 9: Dorex2007 ($2.13 in chips) 
littlebear2020: posts small blind $0.01
TurtleBob99: posts big blind $0.02
*** HOLE CARDS ***
Dealt to Dorex2007 [8d 3s]
Boomerok86: folds 
Martin aus K: folds 
pokertronde: folds 
trueJamaican: raises $0.04 to $0.06
Dorex2007: folds 
ThallesRO: folds 
littlebear2020: folds 
TurtleBob99: folds 
Uncalled bet ($0.04) returned to trueJamaican
trueJamaican collected $0.05 from pot
*** SUMMARY ***
Total pot $0.05 | Rake $0 
Seat 1: ThallesRO (button) folded before Flop (didn't bet)
Seat 2: littlebear2020 (small blind) folded before Flop
Seat 4: TurtleBob99 (big blind) folded before Flop
Seat 5: Boomerok86 folded before Flop (didn't bet)
Seat 6: Martin aus K folded before Flop (didn't bet)
Seat 7: pokertronde folded before Flop (didn't bet)
Seat 8: trueJamaican collected ($0.05)
Seat 9: Dorex2007 folded before Flop (didn't bet)



PokerStars Hand #232168775880:  Hold'em No Limit ($0.01/$0.02 USD) - 2021/12/12 14:06:58 PT [2021/12/12 17:06:58 ET]
Table 'Lorcia' 9-max Seat #2 is the button
Seat 1: ThallesRO ($1.67 in chips) 
Seat 2: littlebear2020 ($1.93 in chips) 
Seat 4: TurtleBob99 ($3.06 in chips) 
Seat 5: Boomerok86 ($0.89 in chips) 
Seat 6: Martin aus K ($2.15 in chips) 
Seat 7: pokertronde ($3.67 in chips) 
Seat 8: trueJamaican ($2.03 in chips) 
Seat 9: Dorex2007 ($2.13 in chips) 
TurtleBob99: posts small blind $0.01
Boomerok86: posts big blind $0.02
*** HOLE CARDS ***
Dealt to Dorex2007 [9s 6s]
Martin aus K: folds 
pokertronde: folds 
trueJamaican: folds 
Dorex2007: folds 
ThallesRO: calls $0.02
littlebear2020: calls $0.02
TurtleBob99: calls $0.01
Boomerok86: checks 
*** FLOP *** [2h 8s 3c]
TurtleBob99: bets $0.05
Boomerok86: folds 
ThallesRO: folds 
littlebear2020: folds 
Uncalled bet ($0.05) returned to TurtleBob99
TurtleBob99 collected $0.08 from pot
*** SUMMARY ***
Total pot $0.08 | Rake $0 
Board [2h 8s 3c]
Seat 1: ThallesRO folded on the Flop
Seat 2: littlebear2020 (button) folded on the Flop
Seat 4: TurtleBob99 (small blind) collected ($0.08)
Seat 5: Boomerok86 (big blind) folded on the Flop
Seat 6: Martin aus K folded before Flop (didn't bet)
Seat 7: pokertronde folded before Flop (didn't bet)
Seat 8: trueJamaican folded before Flop (didn't bet)
Seat 9: Dorex2007 folded before Flop (didn't bet)



PokerStars Hand #232168798528:  Hold'em No Limit ($0.01/$0.02 USD) - 2021/12/12 14:07:40 PT [2021/12/12 17:07:40 ET]
Table 'Lorcia' 9-max Seat #4 is the button
Seat 1: ThallesRO ($1.65 in chips) 
Seat 2: littlebear2020 ($1.91 in chips) 
Seat 4: TurtleBob99 ($3.12 in chips) 
Seat 5: Boomerok86 ($0.87 in chips) 
Seat 6: Martin aus K ($2.15 in chips) 
Seat 7: pokertronde ($3.67 in chips) 
Seat 8: trueJamaican ($2.03 in chips) 
Seat 9: Dorex2007 ($2.13 in chips) 
Boomerok86: posts small blind $0.01
Martin aus K: posts big blind $0.02
*** HOLE CARDS ***
Dealt to Dorex2007 [6c 9c]
pokertronde: folds 
trueJamaican: folds 
Dorex2007: folds 
ThallesRO: folds 
littlebear2020: folds 
TurtleBob99: folds 
Boomerok86: raises $0.02 to $0.04
Martin aus K: calls $0.02
*** FLOP *** [Ks 3d 5h]
Boomerok86: bets $0.04
Martin aus K: folds 
Uncalled bet ($0.04) returned to Boomerok86
Boomerok86 collected $0.08 from pot
Boomerok86: doesn't show hand 
*** SUMMARY ***
Total pot $0.08 | Rake $0 
Board [Ks 3d 5h]
Seat 1: ThallesRO folded before Flop (didn't bet)
Seat 2: littlebear2020 folded before Flop (didn't bet)
Seat 4: TurtleBob99 (button) folded before Flop (didn't bet)
Seat 5: Boomerok86 (small blind) collected ($0.08)
Seat 6: Martin aus K (big blind) folded on the Flop
Seat 7: pokertronde folded before Flop (didn't bet)
Seat 8: trueJamaican folded before Flop (didn't bet)
Seat 9: Dorex2007 folded before Flop (didn't bet)



PokerStars Hand #232168812509:  Hold'em No Limit ($0.01/$0.02 USD) - 2021/12/12 14:08:06 PT [2021/12/12 17:08:06 ET]
Table 'Lorcia' 9-max Seat #5 is the button
Seat 1: ThallesRO ($1.65 in chips) 
Seat 2: littlebear2020 ($1.91 in chips) 
Seat 4: TurtleBob99 ($3.12 in chips) 
Seat 5: Boomerok86 ($0.91 in chips) 
Seat 6: Martin aus K ($2.11 in chips) 
Seat 7: pokertronde ($3.67 in chips) 
Seat 8: trueJamaican ($2.03 in chips) 
Seat 9: Dorex2007 ($2.13 in chips) 
Martin aus K: posts small blind $0.01
pokertronde: posts big blind $0.02
*** HOLE CARDS ***
Dealt to Dorex2007 [Kd 5d]
trueJamaican: folds 
Dorex2007: folds 
ThallesRO: calls $0.02
littlebear2020: calls $0.02
TurtleBob99: folds 
Boomerok86: folds 
Martin aus K: calls $0.01
pokertronde: checks 
*** FLOP *** [8d Kc 2s]
Martin aus K: checks 
pokertronde: checks 
ThallesRO: bets $0.04
littlebear2020: folds 
Martin aus K: folds 
pokertronde: folds 
Uncalled bet ($0.04) returned to ThallesRO
ThallesRO collected $0.08 from pot
ThallesRO: doesn't show hand 
*** SUMMARY ***
Total pot $0.08 | Rake $0 
Board [8d Kc 2s]
Seat 1: ThallesRO collected ($0.08)
Seat 2: littlebear2020 folded on the Flop
Seat 4: TurtleBob99 folded before Flop (didn't bet)
Seat 5: Boomerok86 (button) folded before Flop (didn't bet)
Seat 6: Martin aus K (small blind) folded on the Flop
Seat 7: pokertronde (big blind) folded on the Flop
Seat 8: trueJamaican folded before Flop (didn't bet)
Seat 9: Dorex2007 folded before Flop (didn't bet)



PokerStars Hand #232168832230:  Hold'em No Limit ($0.01/$0.02 USD) - 2021/12/12 14:08:44 PT [2021/12/12 17:08:44 ET]
Table 'Lorcia' 9-max Seat #6 is the button
Seat 1: ThallesRO ($1.71 in chips) 
Seat 2: littlebear2020 ($1.89 in chips) 
Seat 4: TurtleBob99 ($3.12 in chips) 
Seat 5: Boomerok86 ($0.91 in chips) 
Seat 6: Martin aus K ($2.09 in chips) 
Seat 7: pokertronde ($3.65 in chips) 
Seat 8: trueJamaican ($2.03 in chips) 
Seat 9: Dorex2007 ($2.13 in chips) 
pokertronde: posts small blind $0.01
trueJamaican: posts big blind $0.02
*** HOLE CARDS ***
Dealt to Dorex2007 [4c 2s]
Dorex2007: folds 
ThallesRO: folds 
littlebear2020: raises $0.04 to $0.06
TurtleBob99: calls $0.06
Boomerok86: folds 
Martin aus K: folds 
pokertronde: calls $0.05
trueJamaican: folds 
*** FLOP *** [Kd 6c Td]
pokertronde: checks 
littlebear2020: checks 
TurtleBob99: checks 
*** TURN *** [Kd 6c Td] [8h]
pokertronde: bets $0.11
littlebear2020: folds 
TurtleBob99: folds 
Uncalled bet ($0.11) returned to pokertronde
pokertronde collected $0.19 from pot
pokertronde: doesn't show hand 
*** SUMMARY ***
Total pot $0.20 | Rake $0.01 
Board [Kd 6c Td 8h]
Seat 1: ThallesRO folded before Flop (didn't bet)
Seat 2: littlebear2020 folded on the Turn
Seat 4: TurtleBob99 folded on the Turn
Seat 5: Boomerok86 folded before Flop (didn't bet)
Seat 6: Martin aus K (button) folded before Flop (didn't bet)
Seat 7: pokertronde (small blind) collected ($0.19)
Seat 8: trueJamaican (big blind) folded before Flop
Seat 9: Dorex2007 folded before Flop (didn't bet)



PokerStars Hand #232168863320:  Hold'em No Limit ($0.01/$0.02 USD) - 2021/12/12 14:09:24 PT [2021/12/12 17:09:24 ET]
Table 'Lorcia' 9-max Seat #7 is the button
Seat 1: ThallesRO ($1.71 in chips) 
Seat 2: littlebear2020 ($1.83 in chips) 
Seat 4: TurtleBob99 ($3.06 in chips) 
Seat 5: Boomerok86 ($0.91 in chips) 
Seat 6: Martin aus K ($2.09 in chips) 
Seat 7: pokertronde ($3.78 in chips) 
Seat 8: trueJamaican ($2.01 in chips) 
Seat 9: Dorex2007 ($2.13 in chips) 
trueJamaican: posts small blind $0.01
Dorex2007: posts big blind $0.02
*** HOLE CARDS ***
Dealt to Dorex2007 [Qs Ts]
ThallesRO: raises $0.02 to $0.04
littlebear2020: folds 
TurtleBob99: calls $0.04
Boomerok86: calls $0.04
Martin aus K: calls $0.04
pokertronde: folds 
trueJamaican: folds 
Dorex2007: calls $0.02
*** FLOP *** [Qc 2s 5s]
Dorex2007: checks 
ThallesRO: bets $0.10
TurtleBob99: folds 
Boomerok86: calls $0.10
Martin aus K: calls $0.10
Dorex2007: calls $0.10
*** TURN *** [Qc 2s 5s] [Kh]
Dorex2007: checks 
ThallesRO: bets $0.30
Boomerok86: folds 
Martin aus K: folds 
Dorex2007: calls $0.30
*** RIVER *** [Qc 2s 5s Kh] [5h]
Dorex2007: checks 
ThallesRO: bets $1.17
Dorex2007: folds 
Uncalled bet ($1.17) returned to ThallesRO
ThallesRO collected $1.17 from pot
ThallesRO: doesn't show hand 
*** SUMMARY ***
Total pot $1.21 | Rake $0.04 
Board [Qc 2s 5s Kh 5h]
Seat 1: ThallesRO collected ($1.17)
Seat 2: littlebear2020 folded before Flop (didn't bet)
Seat 4: TurtleBob99 folded on the Flop
Seat 5: Boomerok86 folded on the Turn
Seat 6: Martin aus K folded on the Turn
Seat 7: pokertronde (button) folded before Flop (didn't bet)
Seat 8: trueJamaican (small blind) folded before Flop
Seat 9: Dorex2007 (big blind) folded on the River



PokerStars Hand #232168902035:  Hold'em No Limit ($0.01/$0.02 USD) - 2021/12/12 14:10:38 PT [2021/12/12 17:10:38 ET]
Table 'Lorcia' 9-max Seat #8 is the button
Seat 1: ThallesRO ($2.44 in chips) 
Seat 2: littlebear2020 ($1.83 in chips) 
Seat 4: TurtleBob99 ($3.02 in chips) 
Seat 5: Boomerok86 ($0.77 in chips) 
Seat 6: Martin aus K ($1.95 in chips) 
Seat 7: pokertronde ($3.78 in chips) 
Seat 8: trueJamaican ($2 in chips) 
Seat 9: Dorex2007 ($2 in chips) 
Dorex2007: posts small blind $0.01
ThallesRO: posts big blind $0.02
*** HOLE CARDS ***
Dealt to Dorex2007 [8d Qh]
littlebear2020: folds 
TurtleBob99: raises $0.03 to $0.05
Boomerok86: calls $0.05
Martin aus K: folds 
pokertronde: folds 
trueJamaican: folds 
Dorex2007: folds 
ThallesRO: folds 
*** FLOP *** [6h Td Ah]
TurtleBob99: bets $0.08
Boomerok86: raises $0.10 to $0.18
TurtleBob99: folds 
Uncalled bet ($0.10) returned to Boomerok86
Boomerok86 collected $0.28 from pot
Boomerok86: doesn't show hand 
*** SUMMARY ***
Total pot $0.29 | Rake $0.01 
Board [6h Td Ah]
Seat 1: ThallesRO (big blind) folded before Flop
Seat 2: littlebear2020 folded before Flop (didn't bet)
Seat 4: TurtleBob99 folded on the Flop
Seat 5: Boomerok86 collected ($0.28)
Seat 6: Martin aus K folded before Flop (didn't bet)
Seat 7: pokertronde folded before Flop (didn't bet)
Seat 8: trueJamaican (button) folded before Flop (didn't bet)
Seat 9: Dorex2007 (small blind) folded before Flop



PokerStars Hand #232168921079:  Hold'em No Limit ($0.01/$0.02 USD) - 2021/12/12 14:11:14 PT [2021/12/12 17:11:14 ET]
Table 'Lorcia' 9-max Seat #9 is the button
Seat 1: ThallesRO ($2.42 in chips) 
Seat 2: littlebear2020 ($1.83 in chips) 
Seat 4: TurtleBob99 ($2.89 in chips) 
Seat 5: Boomerok86 ($0.92 in chips) 
Seat 6: Martin aus K ($1.95 in chips) 
Seat 7: pokertronde ($3.78 in chips) 
Seat 8: trueJamaican ($2 in chips) 
Seat 9: Dorex2007 ($2 in chips) 
ThallesRO: posts small blind $0.01
littlebear2020: posts big blind $0.02
*** HOLE CARDS ***
Dealt to Dorex2007 [Ac 9c]
TurtleBob99: folds 
Boomerok86: calls $0.02
Martin aus K: folds 
pokertronde: folds 
trueJamaican: folds 
Dorex2007: calls $0.02
ThallesRO: calls $0.01
littlebear2020: checks 
*** FLOP *** [Ts Th 8d]
ThallesRO: checks 
littlebear2020: checks 
Boomerok86: checks 
Dorex2007: checks 
*** TURN *** [Ts Th 8d] [Qd]
ThallesRO: checks 
littlebear2020: checks 
Boomerok86: checks 
Dorex2007: checks 
*** RIVER *** [Ts Th 8d Qd] [Ad]
ThallesRO: checks 
littlebear2020: checks 
Boomerok86: bets $0.06
Dorex2007: calls $0.06
ThallesRO: folds 
littlebear2020: folds 
*** SHOW DOWN ***
Boomerok86: shows [Kc 6d] (a pair of Tens)
Dorex2007: shows [Ac 9c] (two pair, Aces and Tens)
Dorex2007 collected $0.19 from pot
*** SUMMARY ***
Total pot $0.20 | Rake $0.01 
Board [Ts Th 8d Qd Ad]
Seat 1: ThallesRO (small blind) folded on the River
Seat 2: littlebear2020 (big blind) folded on the River
Seat 4: TurtleBob99 folded before Flop (didn't bet)
Seat 5: Boomerok86 showed [Kc 6d] and lost with a pair of Tens
Seat 6: Martin aus K folded before Flop (didn't bet)
Seat 7: pokertronde folded before Flop (didn't bet)
Seat 8: trueJamaican folded before Flop (didn't bet)
Seat 9: Dorex2007 (button) showed [Ac 9c] and won ($0.19) with two pair, Aces and Tens



PokerStars Hand #232168962086:  Hold'em No Limit ($0.01/$0.02 USD) - 2021/12/12 14:12:31 PT [2021/12/12 17:12:31 ET]
Table 'Lorcia' 9-max Seat #1 is the button
Seat 1: ThallesRO ($2.40 in chips) 
Seat 2: littlebear2020 ($1.81 in chips) 
Seat 3: Gust4v0_7 ($6.13 in chips) 
Seat 4: TurtleBob99 ($2.89 in chips) 
Seat 5: Boomerok86 ($0.84 in chips) 
Seat 6: Martin aus K ($1.95 in chips) 
Seat 7: pokertronde ($3.78 in chips) 
Seat 8: trueJamaican ($2 in chips) 
Seat 9: Dorex2007 ($2.11 in chips) 
littlebear2020: posts small blind $0.01
Gust4v0_7: posts big blind $0.02
*** HOLE CARDS ***
Dealt to Dorex2007 [5c 7s]
TurtleBob99: folds 
Boomerok86: folds 
Martin aus K: folds 
pokertronde: folds 
trueJamaican: folds 
Dorex2007: folds 
ThallesRO: raises $0.02 to $0.04
littlebear2020: folds 
Gust4v0_7: folds 
Uncalled bet ($0.02) returned to ThallesRO
ThallesRO collected $0.05 from pot
ThallesRO: doesn't show hand 
*** SUMMARY ***
Total pot $0.05 | Rake $0 
Seat 1: ThallesRO (button) collected ($0.05)
Seat 2: littlebear2020 (small blind) folded before Flop
Seat 3: Gust4v0_7 (big blind) folded before Flop
Seat 4: TurtleBob99 folded before Flop (didn't bet)
Seat 5: Boomerok86 folded before Flop (didn't bet)
Seat 6: Martin aus K folded before Flop (didn't bet)
Seat 7: pokertronde folded before Flop (didn't bet)
Seat 8: trueJamaican folded before Flop (didn't bet)
Seat 9: Dorex2007 folded before Flop (didn't bet)



PokerStars Hand #232168971959:  Hold'em No Limit ($0.01/$0.02 USD) - 2021/12/12 14:12:50 PT [2021/12/12 17:12:50 ET]
Table 'Lorcia' 9-max Seat #2 is the button
Seat 1: ThallesRO ($2.43 in chips) 
Seat 2: littlebear2020 ($1.80 in chips) 
Seat 3: Gust4v0_7 ($6.11 in chips) 
Seat 4: TurtleBob99 ($2.89 in chips) 
Seat 5: Boomerok86 ($0.84 in chips) 
Seat 6: Martin aus K ($1.95 in chips) 
Seat 7: pokertronde ($3.78 in chips) 
Seat 8: trueJamaican ($2 in chips) 
Seat 9: Dorex2007 ($2.11 in chips) 
Gust4v0_7: posts small blind $0.01
TurtleBob99: posts big blind $0.02
*** HOLE CARDS ***
Dealt to Dorex2007 [2d 3s]
Boomerok86: calls $0.02
Martin aus K: raises $0.07 to $0.09
pokertronde: folds 
trueJamaican: folds 
Dorex2007: folds 
ThallesRO: calls $0.09
littlebear2020: folds 
Gust4v0_7: folds 
TurtleBob99: folds 
Boomerok86: calls $0.07
*** FLOP *** [Th Qd 3d]
Boomerok86: checks 
Martin aus K: bets $0.16
ThallesRO: calls $0.16
Boomerok86: folds 
*** TURN *** [Th Qd 3d] [7s]
Martin aus K: checks 
ThallesRO: bets $0.30
Martin aus K: calls $0.30
*** RIVER *** [Th Qd 3d 7s] [Ah]
Martin aus K: checks 
ThallesRO: bets $1.88 and is all-in
Martin aus K: calls $1.40 and is all-in
Uncalled bet ($0.48) returned to ThallesRO
*** SHOW DOWN ***
ThallesRO: shows [Ad Ac] (three of a kind, Aces)
Martin aus K: shows [Ts As] (two pair, Aces and Tens)
ThallesRO collected $3.88 from pot
*** SUMMARY ***
Total pot $4.02 | Rake $0.14 
Board [Th Qd 3d 7s Ah]
Seat 1: ThallesRO showed [Ad Ac] and won ($3.88) with three of a kind, Aces
Seat 2: littlebear2020 (button) folded before Flop (didn't bet)
Seat 3: Gust4v0_7 (small blind) folded before Flop
Seat 4: TurtleBob99 (big blind) folded before Flop
Seat 5: Boomerok86 folded on the Flop
Seat 6: Martin aus K showed [Ts As] and lost with two pair, Aces and Tens
Seat 7: pokertronde folded before Flop (didn't bet)
Seat 8: trueJamaican folded before Flop (didn't bet)
Seat 9: Dorex2007 folded before Flop (didn't bet)



PokerStars Hand #232169024865:  Hold'em No Limit ($0.01/$0.02 USD) - 2021/12/12 14:14:33 PT [2021/12/12 17:14:33 ET]
Table 'Lorcia' 9-max Seat #3 is the button
Seat 1: ThallesRO ($4.36 in chips) 
Seat 2: littlebear2020 ($1.80 in chips) 
Seat 3: Gust4v0_7 ($6.10 in chips) 
Seat 4: TurtleBob99 ($2.87 in chips) 
Seat 5: Boomerok86 ($0.75 in chips) 
Seat 6: Martin aus K ($1.94 in chips) 
Seat 7: pokertronde ($3.78 in chips) 
Seat 8: trueJamaican ($2 in chips) 
Seat 9: Dorex2007 ($2.11 in chips) 
TurtleBob99: posts small blind $0.01
Boomerok86: posts big blind $0.02
*** HOLE CARDS ***
Dealt to Dorex2007 [Th Kc]
Martin aus K: folds 
pokertronde: folds 
trueJamaican: folds 
Dorex2007: folds 
ThallesRO: folds 
littlebear2020: folds 
Gust4v0_7: calls $0.02
TurtleBob99: raises $0.06 to $0.08
Boomerok86: folds 
Gust4v0_7: calls $0.06
*** FLOP *** [9h Jh 6s]
TurtleBob99: bets $0.11
Gust4v0_7: folds 
Uncalled bet ($0.11) returned to TurtleBob99
TurtleBob99 collected $0.17 from pot
*** SUMMARY ***
Total pot $0.18 | Rake $0.01 
Board [9h Jh 6s]
Seat 1: ThallesRO folded before Flop (didn't bet)
Seat 2: littlebear2020 folded before Flop (didn't bet)
Seat 3: Gust4v0_7 (button) folded on the Flop
Seat 4: TurtleBob99 (small blind) collected ($0.17)
Seat 5: Boomerok86 (big blind) folded before Flop
Seat 6: Martin aus K folded before Flop (didn't bet)
Seat 7: pokertronde folded before Flop (didn't bet)
Seat 8: trueJamaican folded before Flop (didn't bet)
Seat 9: Dorex2007 folded before Flop (didn't bet)



PokerStars Hand #232169048893:  Hold'em No Limit ($0.01/$0.02 USD) - 2021/12/12 14:15:19 PT [2021/12/12 17:15:19 ET]
Table 'Lorcia' 9-max Seat #4 is the button
Seat 1: ThallesRO ($4.36 in chips) 
Seat 2: littlebear2020 ($1.80 in chips) 
Seat 3: Gust4v0_7 ($6.02 in chips) 
Seat 4: TurtleBob99 ($2.96 in chips) 
Seat 5: Boomerok86 ($0.73 in chips) 
Seat 6: Martin aus K ($1.94 in chips) 
Seat 7: pokertronde ($3.78 in chips) 
Seat 8: trueJamaican ($2 in chips) 
Seat 9: Dorex2007 ($2.11 in chips) 
Boomerok86: posts small blind $0.01
Martin aus K: posts big blind $0.02
*** HOLE CARDS ***
Dealt to Dorex2007 [4h 5s]
pokertronde: raises $0.06 to $0.08
trueJamaican: folds 
Dorex2007: folds 
ThallesRO: folds 
littlebear2020: folds 
Gust4v0_7: folds 
TurtleBob99: folds 
Boomerok86: folds 
Martin aus K: folds 
Uncalled bet ($0.06) returned to pokertronde
pokertronde collected $0.05 from pot
pokertronde: doesn't show hand 
*** SUMMARY ***
Total pot $0.05 | Rake $0 
Seat 1: ThallesRO folded before Flop (didn't bet)
Seat 2: littlebear2020 folded before Flop (didn't bet)
Seat 3: Gust4v0_7 folded before Flop (didn't bet)
Seat 4: TurtleBob99 (button) folded before Flop (didn't bet)
Seat 5: Boomerok86 (small blind) folded before Flop
Seat 6: Martin aus K (big blind) folded before Flop
Seat 7: pokertronde collected ($0.05)
Seat 8: trueJamaican folded before Flop (didn't bet)
Seat 9: Dorex2007 folded before Flop (didn't bet)



PokerStars Hand #232169063043:  Hold'em No Limit ($0.01/$0.02 USD) - 2021/12/12 14:15:47 PT [2021/12/12 17:15:47 ET]
Table 'Lorcia' 9-max Seat #5 is the button
Seat 1: ThallesRO ($4.36 in chips) 
Seat 2: littlebear2020 ($1.80 in chips) 
Seat 3: Gust4v0_7 ($6.02 in chips) 
Seat 4: TurtleBob99 ($2.96 in chips) 
Seat 5: Boomerok86 ($0.72 in chips) 
Seat 6: Martin aus K ($1.92 in chips) 
Seat 7: pokertronde ($3.81 in chips) 
Seat 8: trueJamaican ($2 in chips) 
Seat 9: Dorex2007 ($2.11 in chips) 
Martin aus K: posts small blind $0.01
pokertronde: posts big blind $0.02
*** HOLE CARDS ***
Dealt to Dorex2007 [4c 8d]
trueJamaican: folds 
Dorex2007: folds 
ThallesRO: folds 
littlebear2020: folds 
Gust4v0_7: folds 
TurtleBob99: folds 
Boomerok86: raises $0.02 to $0.04
Martin aus K: folds 
pokertronde: calls $0.02
*** FLOP *** [9c 2h Tc]
pokertronde: checks 
Boomerok86: checks 
*** TURN *** [9c 2h Tc] [4d]
pokertronde: bets $0.05
Boomerok86: calls $0.05
*** RIVER *** [9c 2h Tc 4d] [Th]
pokertronde: bets $0.18
Boomerok86: folds 
Uncalled bet ($0.18) returned to pokertronde
pokertronde collected $0.18 from pot
pokertronde: doesn't show hand 
*** SUMMARY ***
Total pot $0.19 | Rake $0.01 
Board [9c 2h Tc 4d Th]
Seat 1: ThallesRO folded before Flop (didn't bet)
Seat 2: littlebear2020 folded before Flop (didn't bet)
Seat 3: Gust4v0_7 folded before Flop (didn't bet)
Seat 4: TurtleBob99 folded before Flop (didn't bet)
Seat 5: Boomerok86 (button) folded on the River
Seat 6: Martin aus K (small blind) folded before Flop
Seat 7: pokertronde (big blind) collected ($0.18)
Seat 8: trueJamaican folded before Flop (didn't bet)
Seat 9: Dorex2007 folded before Flop (didn't bet)



PokerStars Hand #232169097562:  Hold'em No Limit ($0.01/$0.02 USD) - 2021/12/12 14:16:54 PT [2021/12/12 17:16:54 ET]
Table 'Lorcia' 9-max Seat #6 is the button
Seat 1: ThallesRO ($4.36 in chips) 
Seat 2: littlebear2020 ($1.80 in chips) 
Seat 3: Gust4v0_7 ($6.02 in chips) 
Seat 4: TurtleBob99 ($2.96 in chips) 
Seat 5: Boomerok86 ($0.63 in chips) 
Seat 6: Martin aus K ($1.91 in chips) 
Seat 7: pokertronde ($3.90 in chips) 
Seat 8: trueJamaican ($2 in chips) 
Seat 9: Dorex2007 ($2.11 in chips) 
pokertronde: posts small blind $0.01
trueJamaican: posts big blind $0.02
*** HOLE CARDS ***
Dealt to Dorex2007 [Ks Qs]
Dorex2007: raises $0.04 to $0.06
ThallesRO: folds 
littlebear2020: folds 
Gust4v0_7: calls $0.06
TurtleBob99: folds 
Boomerok86: folds 
Martin aus K: folds 
pokertronde: folds 
trueJamaican: folds 
*** FLOP *** [Kc 4d 3c]
Dorex2007: checks 
Gust4v0_7: checks 
*** TURN *** [Kc 4d 3c] [Tc]
Dorex2007: bets $0.09
Gust4v0_7: folds 
Uncalled bet ($0.09) returned to Dorex2007
Dorex2007 collected $0.14 from pot
Dorex2007: doesn't show hand 
*** SUMMARY ***
Total pot $0.15 | Rake $0.01 
Board [Kc 4d 3c Tc]
Seat 1: ThallesRO folded before Flop (didn't bet)
Seat 2: littlebear2020 folded before Flop (didn't bet)
Seat 3: Gust4v0_7 folded on the Turn
Seat 4: TurtleBob99 folded before Flop (didn't bet)
Seat 5: Boomerok86 folded before Flop (didn't bet)
Seat 6: Martin aus K (button) folded before Flop (didn't bet)
Seat 7: pokertronde (small blind) folded before Flop
Seat 8: trueJamaican (big blind) folded before Flop
Seat 9: Dorex2007 collected ($0.14)



PokerStars Hand #232169119278:  Hold'em No Limit ($0.01/$0.02 USD) - 2021/12/12 14:17:36 PT [2021/12/12 17:17:36 ET]
Table 'Lorcia' 9-max Seat #7 is the button
Seat 1: ThallesRO ($4.36 in chips) 
Seat 2: littlebear2020 ($1.80 in chips) 
Seat 3: Gust4v0_7 ($5.96 in chips) 
Seat 4: TurtleBob99 ($2.96 in chips) 
Seat 5: Boomerok86 ($0.63 in chips) 
Seat 6: Martin aus K ($1.91 in chips) 
Seat 7: pokertronde ($3.89 in chips) 
Seat 8: trueJamaican ($2 in chips) 
Seat 9: Dorex2007 ($2.19 in chips) 
trueJamaican: posts small blind $0.01
Dorex2007: posts big blind $0.02
*** HOLE CARDS ***
Dealt to Dorex2007 [Qs Kh]
ThallesRO: calls $0.02
littlebear2020: folds 
Gust4v0_7: raises $0.04 to $0.06
TurtleBob99: calls $0.06
Boomerok86: calls $0.06
Martin aus K: folds 
pokertronde: folds 
trueJamaican: folds 
Dorex2007: calls $0.04
ThallesRO: calls $0.04
*** FLOP *** [5h 4d 5c]
Dorex2007: checks 
ThallesRO: checks 
Gust4v0_7: checks 
TurtleBob99: bets $0.20
Boomerok86: calls $0.20
Dorex2007: folds 
ThallesRO: folds 
Gust4v0_7: folds 
*** TURN *** [5h 4d 5c] [Kd]
TurtleBob99: bets $0.46
Boomerok86: calls $0.37 and is all-in
Uncalled bet ($0.09) returned to TurtleBob99
*** RIVER *** [5h 4d 5c Kd] [Jd]
*** SHOW DOWN ***
TurtleBob99: shows [6c 4c] (two pair, Fives and Fours)
Boomerok86: shows [Ah Ac] (two pair, Aces and Fives)
Boomerok86 collected $1.40 from pot
*** SUMMARY ***
Total pot $1.45 | Rake $0.05 
Board [5h 4d 5c Kd Jd]
Seat 1: ThallesRO folded on the Flop
Seat 2: littlebear2020 folded before Flop (didn't bet)
Seat 3: Gust4v0_7 folded on the Flop
Seat 4: TurtleBob99 showed [6c 4c] and lost with two pair, Fives and Fours
Seat 5: Boomerok86 showed [Ah Ac] and won ($1.40) with two pair, Aces and Fives
Seat 6: Martin aus K folded before Flop (didn't bet)
Seat 7: pokertronde (button) folded before Flop (didn't bet)
Seat 8: trueJamaican (small blind) folded before Flop
Seat 9: Dorex2007 (big blind) folded on the Flop



PokerStars Hand #232169202162:  Hold'em No Limit ($0.01/$0.02 USD) - 2021/12/12 14:20:07 PT [2021/12/12 17:20:07 ET]
Table 'Lorcia' 9-max Seat #1 is the button
Seat 1: ThallesRO ($4.24 in chips) 
Seat 2: littlebear2020 ($1.78 in chips) 
Seat 3: Gust4v0_7 ($5.90 in chips) 
Seat 4: TurtleBob99 ($2.33 in chips) 
Seat 5: Boomerok86 ($1.74 in chips) 
Seat 6: Martin aus K ($1.91 in chips) 
Seat 7: pokertronde ($3.89 in chips) 
Seat 8: trueJamaican ($2 in chips) 
Seat 9: Dorex2007 ($2.13 in chips) 
littlebear2020: posts small blind $0.01
Gust4v0_7: posts big blind $0.02
Dorex2007: posts small blind $0.01
*** HOLE CARDS ***
Dealt to Dorex2007 [8h 4d]
TurtleBob99: folds 
Boomerok86: folds 
Martin aus K: raises $0.04 to $0.06
pokertronde: folds 
trueJamaican: folds 
Dorex2007: folds 
ThallesRO: folds 
littlebear2020: folds 
Gust4v0_7: folds 
Uncalled bet ($0.04) returned to Martin aus K
Martin aus K collected $0.06 from pot
Martin aus K: doesn't show hand 
*** SUMMARY ***
Total pot $0.06 | Rake $0 
Seat 1: ThallesRO (button) folded before Flop (didn't bet)
Seat 2: littlebear2020 (small blind) folded before Flop
Seat 3: Gust4v0_7 (big blind) folded before Flop
Seat 4: TurtleBob99 folded before Flop (didn't bet)
Seat 5: Boomerok86 folded before Flop (didn't bet)
Seat 6: Martin aus K collected ($0.06)
Seat 7: pokertronde folded before Flop (didn't bet)
Seat 8: trueJamaican folded before Flop (didn't bet)
Seat 9: Dorex2007 folded before Flop (didn't bet)



PokerStars Hand #232169217457:  Hold'em No Limit ($0.01/$0.02 USD) - 2021/12/12 14:20:36 PT [2021/12/12 17:20:36 ET]
Table 'Lorcia' 9-max Seat #2 is the button
Seat 1: ThallesRO ($4.24 in chips) 
Seat 2: littlebear2020 ($1.77 in chips) 
Seat 3: Gust4v0_7 ($5.88 in chips) 
Seat 4: TurtleBob99 ($2.33 in chips) 
Seat 5: Boomerok86 ($1.74 in chips) 
Seat 6: Martin aus K ($1.95 in chips) 
Seat 7: pokertronde ($3.89 in chips) 
Seat 8: trueJamaican ($2 in chips) 
Seat 9: Dorex2007 ($2.12 in chips) 
Gust4v0_7: posts small blind $0.01
TurtleBob99: posts big blind $0.02
*** HOLE CARDS ***
Dealt to Dorex2007 [9c Ad]
Boomerok86: folds 
Martin aus K: folds 
pokertronde: folds 
trueJamaican: folds 
Dorex2007: folds 
ThallesRO: folds 
littlebear2020: raises $0.02 to $0.04
Gust4v0_7: calls $0.03
TurtleBob99: folds 
*** FLOP *** [9h 8h Qs]
Gust4v0_7: checks 
littlebear2020: bets $0.10
Gust4v0_7: folds 
Uncalled bet ($0.10) returned to littlebear2020
littlebear2020 collected $0.10 from pot
littlebear2020: doesn't show hand 
*** SUMMARY ***
Total pot $0.10 | Rake $0 
Board [9h 8h Qs]
Seat 1: ThallesRO folded before Flop (didn't bet)
Seat 2: littlebear2020 (button) collected ($0.10)
Seat 3: Gust4v0_7 (small blind) folded on the Flop
Seat 4: TurtleBob99 (big blind) folded before Flop
Seat 5: Boomerok86 folded before Flop (didn't bet)
Seat 6: Martin aus K folded before Flop (didn't bet)
Seat 7: pokertronde folded before Flop (didn't bet)
Seat 8: trueJamaican folded before Flop (didn't bet)
Seat 9: Dorex2007 folded before Flop (didn't bet)



PokerStars Hand #232169234950:  Hold'em No Limit ($0.01/$0.02 USD) - 2021/12/12 14:21:11 PT [2021/12/12 17:21:11 ET]
Table 'Lorcia' 9-max Seat #3 is the button
Seat 1: ThallesRO ($4.24 in chips) 
Seat 2: littlebear2020 ($1.83 in chips) 
Seat 3: Gust4v0_7 ($5.84 in chips) 
Seat 4: TurtleBob99 ($2.31 in chips) 
Seat 5: Boomerok86 ($1.74 in chips) 
Seat 6: Martin aus K ($1.95 in chips) 
Seat 7: pokertronde ($3.89 in chips) 
Seat 8: trueJamaican ($2 in chips) 
Seat 9: Dorex2007 ($2.12 in chips) 
TurtleBob99: posts small blind $0.01
Boomerok86: posts big blind $0.02
*** HOLE CARDS ***
Dealt to Dorex2007 [Ts Qh]
Martin aus K: folds 
pokertronde: folds 
trueJamaican: folds 
Dorex2007: folds 
ThallesRO: folds 
littlebear2020: raises $0.02 to $0.04
Gust4v0_7: folds 
TurtleBob99: calls $0.03
Boomerok86: calls $0.02
*** FLOP *** [9h Kc 4h]
TurtleBob99: checks 
Boomerok86: checks 
littlebear2020: checks 
*** TURN *** [9h Kc 4h] [2s]
TurtleBob99: bets $0.04
Boomerok86: calls $0.04
littlebear2020: folds 
*** RIVER *** [9h Kc 4h 2s] [5c]
TurtleBob99: bets $0.06
Boomerok86: folds 
Uncalled bet ($0.06) returned to TurtleBob99
TurtleBob99 collected $0.19 from pot
*** SUMMARY ***
Total pot $0.20 | Rake $0.01 
Board [9h Kc 4h 2s 5c]
Seat 1: ThallesRO folded before Flop (didn't bet)
Seat 2: littlebear2020 folded on the Turn
Seat 3: Gust4v0_7 (button) folded before Flop (didn't bet)
Seat 4: TurtleBob99 (small blind) collected ($0.19)
Seat 5: Boomerok86 (big blind) folded on the River
Seat 6: Martin aus K folded before Flop (didn't bet)
Seat 7: pokertronde folded before Flop (didn't bet)
Seat 8: trueJamaican folded before Flop (didn't bet)
Seat 9: Dorex2007 folded before Flop (didn't bet)



PokerStars Hand #232169263615:  Hold'em No Limit ($0.01/$0.02 USD) - 2021/12/12 14:22:07 PT [2021/12/12 17:22:07 ET]
Table 'Lorcia' 9-max Seat #4 is the button
Seat 1: ThallesRO ($4.24 in chips) 
Seat 2: littlebear2020 ($1.79 in chips) 
Seat 3: Gust4v0_7 ($5.84 in chips) 
Seat 4: TurtleBob99 ($2.42 in chips) 
Seat 5: Boomerok86 ($1.66 in chips) 
Seat 6: Martin aus K ($1.95 in chips) 
Seat 7: pokertronde ($3.89 in chips) 
Seat 8: trueJamaican ($2 in chips) 
Seat 9: Dorex2007 ($2.12 in chips) 
Boomerok86: posts small blind $0.01
Martin aus K: posts big blind $0.02
*** HOLE CARDS ***
Dealt to Dorex2007 [4h Kh]
pokertronde: folds 
trueJamaican: folds 
Dorex2007: folds 
ThallesRO: calls $0.02
littlebear2020: folds 
Gust4v0_7: calls $0.02
TurtleBob99: folds 
Boomerok86: calls $0.01
Martin aus K: checks 
*** FLOP *** [Jh Jd 2d]
Boomerok86: bets $0.04
Martin aus K: folds 
ThallesRO: folds 
Gust4v0_7: folds 
Uncalled bet ($0.04) returned to Boomerok86
Boomerok86 collected $0.08 from pot
Boomerok86: doesn't show hand 
*** SUMMARY ***
Total pot $0.08 | Rake $0 
Board [Jh Jd 2d]
Seat 1: ThallesRO folded on the Flop
Seat 2: littlebear2020 folded before Flop (didn't bet)
Seat 3: Gust4v0_7 folded on the Flop
Seat 4: TurtleBob99 (button) folded before Flop (didn't bet)
Seat 5: Boomerok86 (small blind) collected ($0.08)
Seat 6: Martin aus K (big blind) folded on the Flop
Seat 7: pokertronde folded before Flop (didn't bet)
Seat 8: trueJamaican folded before Flop (didn't bet)
Seat 9: Dorex2007 folded before Flop (didn't bet)



PokerStars Hand #232169282870:  Hold'em No Limit ($0.01/$0.02 USD) - 2021/12/12 14:22:45 PT [2021/12/12 17:22:45 ET]
Table 'Lorcia' 9-max Seat #5 is the button
Seat 1: ThallesRO ($4.22 in chips) 
Seat 2: littlebear2020 ($1.79 in chips) 
Seat 3: Gust4v0_7 ($5.82 in chips) 
Seat 4: TurtleBob99 ($2.42 in chips) 
Seat 5: Boomerok86 ($1.72 in chips) 
Seat 6: Martin aus K ($1.93 in chips) 
Seat 7: pokertronde ($3.89 in chips) 
Seat 8: trueJamaican ($2 in chips) 
Seat 9: Dorex2007 ($2.12 in chips) 
Martin aus K: posts small blind $0.01
pokertronde: posts big blind $0.02
*** HOLE CARDS ***
Dealt to Dorex2007 [6s 3h]
trueJamaican: folds 
Dorex2007: folds 
ThallesRO: folds 
littlebear2020: folds 
Gust4v0_7: folds 
TurtleBob99: raises $0.03 to $0.05
Boomerok86: folds 
Martin aus K: raises $0.15 to $0.20
pokertronde: folds 
TurtleBob99: calls $0.15
*** FLOP *** [Jh 8s 2h]
Martin aus K: bets $0.24
TurtleBob99: folds 
Uncalled bet ($0.24) returned to Martin aus K
Martin aus K collected $0.41 from pot
Martin aus K: doesn't show hand 
*** SUMMARY ***
Total pot $0.42 | Rake $0.01 
Board [Jh 8s 2h]
Seat 1: ThallesRO folded before Flop (didn't bet)
Seat 2: littlebear2020 folded before Flop (didn't bet)
Seat 3: Gust4v0_7 folded before Flop (didn't bet)
Seat 4: TurtleBob99 folded on the Flop
Seat 5: Boomerok86 (button) folded before Flop (didn't bet)
Seat 6: Martin aus K (small blind) collected ($0.41)
Seat 7: pokertronde (big blind) folded before Flop
Seat 8: trueJamaican folded before Flop (didn't bet)
Seat 9: Dorex2007 folded before Flop (didn't bet)



PokerStars Hand #232169304146:  Hold'em No Limit ($0.01/$0.02 USD) - 2021/12/12 14:23:27 PT [2021/12/12 17:23:27 ET]
Table 'Lorcia' 9-max Seat #6 is the button
Seat 1: ThallesRO ($4.22 in chips) 
Seat 2: littlebear2020 ($1.79 in chips) 
Seat 3: Gust4v0_7 ($5.82 in chips) 
Seat 4: TurtleBob99 ($2.22 in chips) 
Seat 5: Boomerok86 ($1.72 in chips) 
Seat 6: Martin aus K ($2.14 in chips) 
Seat 7: pokertronde ($3.87 in chips) 
Seat 8: trueJamaican ($2 in chips) 
Seat 9: Dorex2007 ($2.12 in chips) 
pokertronde: posts small blind $0.01
trueJamaican: posts big blind $0.02
*** HOLE CARDS ***
Dealt to Dorex2007 [5h 4c]
Dorex2007: folds 
ThallesRO: folds 
littlebear2020: folds 
Gust4v0_7: calls $0.02
TurtleBob99: folds 
Boomerok86: calls $0.02
Martin aus K: calls $0.02
pokertronde: folds 
trueJamaican: checks 
*** FLOP *** [8h 7h 5s]
trueJamaican: checks 
Gust4v0_7: bets $0.04
Boomerok86: folds 
Martin aus K: calls $0.04
trueJamaican: folds 
*** TURN *** [8h 7h 5s] [7d]
Gust4v0_7: bets $0.08
Martin aus K: folds 
Uncalled bet ($0.08) returned to Gust4v0_7
Gust4v0_7 collected $0.16 from pot
Gust4v0_7: doesn't show hand 
*** SUMMARY ***
Total pot $0.17 | Rake $0.01 
Board [8h 7h 5s 7d]
Seat 1: ThallesRO folded before Flop (didn't bet)
Seat 2: littlebear2020 folded before Flop (didn't bet)
Seat 3: Gust4v0_7 collected ($0.16)
Seat 4: TurtleBob99 folded before Flop (didn't bet)
Seat 5: Boomerok86 folded on the Flop
Seat 6: Martin aus K (button) folded on the Turn
Seat 7: pokertronde (small blind) folded before Flop
Seat 8: trueJamaican (big blind) folded on the Flop
Seat 9: Dorex2007 folded before Flop (didn't bet)



PokerStars Hand #232169336688:  Hold'em No Limit ($0.01/$0.02 USD) - 2021/12/12 14:24:31 PT [2021/12/12 17:24:31 ET]
Table 'Lorcia' 9-max Seat #7 is the button
Seat 1: ThallesRO ($4.22 in chips) 
Seat 2: littlebear2020 ($1.79 in chips) 
Seat 3: Gust4v0_7 ($5.92 in chips) 
Seat 4: TurtleBob99 ($2.22 in chips) 
Seat 5: Boomerok86 ($1.70 in chips) 
Seat 6: Martin aus K ($2.08 in chips) 
Seat 7: pokertronde ($3.86 in chips) 
Seat 8: trueJamaican ($2 in chips) 
Seat 9: Dorex2007 ($2.12 in chips) 
trueJamaican: posts small blind $0.01
Dorex2007: posts big blind $0.02
*** HOLE CARDS ***
Dealt to Dorex2007 [Jd Ks]
ThallesRO: calls $0.02
littlebear2020: folds 
Gust4v0_7: calls $0.02
TurtleBob99: folds 
Boomerok86: calls $0.02
Martin aus K: raises $0.11 to $0.13
pokertronde: folds 
trueJamaican: folds 
Dorex2007: folds 
ThallesRO: folds 
Gust4v0_7: folds 
Boomerok86: folds 
Uncalled bet ($0.11) returned to Martin aus K
Martin aus K collected $0.11 from pot
Martin aus K: doesn't show hand 
*** SUMMARY ***
Total pot $0.11 | Rake $0 
Seat 1: ThallesRO folded before Flop
Seat 2: littlebear2020 folded before Flop (didn't bet)
Seat 3: Gust4v0_7 folded before Flop
Seat 4: TurtleBob99 folded before Flop (didn't bet)
Seat 5: Boomerok86 folded before Flop
Seat 6: Martin aus K collected ($0.11)
Seat 7: pokertronde (button) folded before Flop (didn't bet)
Seat 8: trueJamaican (small blind) folded before Flop
Seat 9: Dorex2007 (big blind) folded before Flop



PokerStars Hand #232169354756:  Hold'em No Limit ($0.01/$0.02 USD) - 2021/12/12 14:25:06 PT [2021/12/12 17:25:06 ET]
Table 'Lorcia' 9-max Seat #8 is the button
Seat 1: ThallesRO ($4.20 in chips) 
Seat 2: littlebear2020 ($1.79 in chips) 
Seat 3: Gust4v0_7 ($5.90 in chips) 
Seat 4: TurtleBob99 ($2.22 in chips) 
Seat 5: Boomerok86 ($1.68 in chips) 
Seat 6: Martin aus K ($2.17 in chips) 
Seat 7: pokertronde ($3.86 in chips) 
Seat 8: trueJamaican ($2 in chips) 
Seat 9: Dorex2007 ($2.10 in chips) 
Dorex2007: posts small blind $0.01
ThallesRO: posts big blind $0.02
*** HOLE CARDS ***
Dealt to Dorex2007 [Qs 8h]
littlebear2020: calls $0.02
Gust4v0_7: folds 
TurtleBob99: folds 
Boomerok86: folds 
Martin aus K: folds 
pokertronde: raises $0.06 to $0.08
trueJamaican: folds 
Dorex2007: folds 
ThallesRO: calls $0.06
littlebear2020: folds 
*** FLOP *** [Kh 8s 8d]
ThallesRO: bets $0.09
pokertronde: folds 
Uncalled bet ($0.09) returned to ThallesRO
ThallesRO collected $0.18 from pot
ThallesRO: doesn't show hand 
*** SUMMARY ***
Total pot $0.19 | Rake $0.01 
Board [Kh 8s 8d]
Seat 1: ThallesRO (big blind) collected ($0.18)
Seat 2: littlebear2020 folded before Flop
Seat 3: Gust4v0_7 folded before Flop (didn't bet)
Seat 4: TurtleBob99 folded before Flop (didn't bet)
Seat 5: Boomerok86 folded before Flop (didn't bet)
Seat 6: Martin aus K folded before Flop (didn't bet)
Seat 7: pokertronde folded on the Flop
Seat 8: trueJamaican (button) folded before Flop (didn't bet)
Seat 9: Dorex2007 (small blind) folded before Flop



PokerStars Hand #232169377287:  Hold'em No Limit ($0.01/$0.02 USD) - 2021/12/12 14:25:51 PT [2021/12/12 17:25:51 ET]
Table 'Lorcia' 9-max Seat #9 is the button
Seat 1: ThallesRO ($4.30 in chips) 
Seat 2: littlebear2020 ($1.77 in chips) 
Seat 3: Gust4v0_7 ($5.90 in chips) 
Seat 4: TurtleBob99 ($2.22 in chips) 
Seat 5: Boomerok86 ($1.68 in chips) 
Seat 6: Martin aus K ($2.17 in chips) 
Seat 7: pokertronde ($3.78 in chips) 
Seat 8: trueJamaican ($2 in chips) 
Seat 9: Dorex2007 ($2.09 in chips) 
ThallesRO: posts small blind $0.01
littlebear2020: posts big blind $0.02
*** HOLE CARDS ***
Dealt to Dorex2007 [8c Kh]
Gust4v0_7: folds 
TurtleBob99: folds 
Boomerok86: folds 
Martin aus K: raises $0.04 to $0.06
pokertronde: folds 
trueJamaican: folds 
Dorex2007: calls $0.06
ThallesRO: calls $0.05
littlebear2020: calls $0.04
*** FLOP *** [Kd 3c Ac]
ThallesRO: bets $0.12
littlebear2020: folds 
Martin aus K: calls $0.12
Dorex2007: folds 
*** TURN *** [Kd 3c Ac] [4c]
ThallesRO: bets $0.23
Martin aus K: folds 
Uncalled bet ($0.23) returned to ThallesRO
ThallesRO collected $0.46 from pot
ThallesRO: doesn't show hand 
*** SUMMARY ***
Total pot $0.48 | Rake $0.02 
Board [Kd 3c Ac 4c]
Seat 1: ThallesRO (small blind) collected ($0.46)
Seat 2: littlebear2020 (big blind) folded on the Flop
Seat 3: Gust4v0_7 folded before Flop (didn't bet)
Seat 4: TurtleBob99 folded before Flop (didn't bet)
Seat 5: Boomerok86 folded before Flop (didn't bet)
Seat 6: Martin aus K folded on the Turn
Seat 7: pokertronde folded before Flop (didn't bet)
Seat 8: trueJamaican folded before Flop (didn't bet)
Seat 9: Dorex2007 (button) folded on the Flop



PokerStars Hand #232169404896:  Hold'em No Limit ($0.01/$0.02 USD) - 2021/12/12 14:26:46 PT [2021/12/12 17:26:46 ET]
Table 'Lorcia' 9-max Seat #1 is the button
Seat 1: ThallesRO ($4.58 in chips) 
Seat 2: littlebear2020 ($1.71 in chips) 
Seat 3: Gust4v0_7 ($5.90 in chips) 
Seat 4: TurtleBob99 ($2.22 in chips) 
Seat 5: Boomerok86 ($1.68 in chips) 
Seat 6: Martin aus K ($1.99 in chips) 
Seat 7: pokertronde ($3.78 in chips) 
Seat 8: trueJamaican ($2 in chips) 
Seat 9: Dorex2007 ($2.03 in chips) 
littlebear2020: posts small blind $0.01
Gust4v0_7: posts big blind $0.02
*** HOLE CARDS ***
Dealt to Dorex2007 [3s Ac]
TurtleBob99: folds 
Boomerok86: calls $0.02
Martin aus K: folds 
pokertronde: raises $0.06 to $0.08
trueJamaican: folds 
Dorex2007: folds 
ThallesRO: folds 
littlebear2020: folds 
Gust4v0_7: folds 
Boomerok86: calls $0.06
*** FLOP *** [5d 8s Jh]
Boomerok86: checks 
pokertronde: bets $0.11
Boomerok86: calls $0.11
*** TURN *** [5d 8s Jh] [4h]
Boomerok86: checks 
pokertronde: checks 
*** RIVER *** [5d 8s Jh 4h] [4c]
Boomerok86: checks 
pokertronde: checks 
*** SHOW DOWN ***
Boomerok86: shows [Ks As] (a pair of Fours)
pokertronde: mucks hand 
Boomerok86 collected $0.40 from pot
*** SUMMARY ***
Total pot $0.41 | Rake $0.01 
Board [5d 8s Jh 4h 4c]
Seat 1: ThallesRO (button) folded before Flop (didn't bet)
Seat 2: littlebear2020 (small blind) folded before Flop
Seat 3: Gust4v0_7 (big blind) folded before Flop
Seat 4: TurtleBob99 folded before Flop (didn't bet)
Seat 5: Boomerok86 showed [Ks As] and won ($0.40) with a pair of Fours
Seat 6: Martin aus K folded before Flop (didn't bet)
Seat 7: pokertronde mucked [Ad Tc]
Seat 8: trueJamaican folded before Flop (didn't bet)
Seat 9: Dorex2007 folded before Flop (didn't bet)



PokerStars Hand #232169431056:  Hold'em No Limit ($0.01/$0.02 USD) - 2021/12/12 14:27:38 PT [2021/12/12 17:27:38 ET]
Table 'Lorcia' 9-max Seat #2 is the button
Seat 1: ThallesRO ($4.58 in chips) 
Seat 2: littlebear2020 ($1.70 in chips) 
Seat 3: Gust4v0_7 ($5.88 in chips) 
Seat 4: TurtleBob99 ($2.22 in chips) 
Seat 5: Boomerok86 ($1.89 in chips) 
Seat 6: Martin aus K ($1.99 in chips) 
Seat 7: pokertronde ($3.59 in chips) 
Seat 8: trueJamaican ($2 in chips) 
Seat 9: Dorex2007 ($2.03 in chips) 
Gust4v0_7: posts small blind $0.01
TurtleBob99: posts big blind $0.02
*** HOLE CARDS ***
Dealt to Dorex2007 [4c Qc]
Boomerok86: folds 
Martin aus K: raises $0.04 to $0.06
pokertronde: calls $0.06
trueJamaican: folds 
Dorex2007: folds 
ThallesRO: calls $0.06
littlebear2020: folds 
Gust4v0_7: calls $0.05
TurtleBob99: folds 
*** FLOP *** [5d 5h 8s]
Gust4v0_7: checks 
Martin aus K: bets $0.14
pokertronde: folds 
ThallesRO: folds 
Gust4v0_7: folds 
Uncalled bet ($0.14) returned to Martin aus K
Martin aus K collected $0.25 from pot
Martin aus K: doesn't show hand 
*** SUMMARY ***
Total pot $0.26 | Rake $0.01 
Board [5d 5h 8s]
Seat 1: ThallesRO folded on the Flop
Seat 2: littlebear2020 (button) folded before Flop (didn't bet)
Seat 3: Gust4v0_7 (small blind) folded on the Flop
Seat 4: TurtleBob99 (big blind) folded before Flop
Seat 5: Boomerok86 folded before Flop (didn't bet)
Seat 6: Martin aus K collected ($0.25)
Seat 7: pokertronde folded on the Flop
Seat 8: trueJamaican folded before Flop (didn't bet)
Seat 9: Dorex2007 folded before Flop (didn't bet)



PokerStars Hand #232169450039:  Hold'em No Limit ($0.01/$0.02 USD) - 2021/12/12 14:28:16 PT [2021/12/12 17:28:16 ET]
Table 'Lorcia' 9-max Seat #3 is the button
Seat 1: ThallesRO ($4.52 in chips) 
Seat 2: littlebear2020 ($1.70 in chips) 
Seat 3: Gust4v0_7 ($5.82 in chips) 
Seat 4: TurtleBob99 ($2.20 in chips) 
Seat 5: Boomerok86 ($1.89 in chips) 
Seat 6: Martin aus K ($2.18 in chips) 
Seat 7: pokertronde ($3.53 in chips) 
Seat 8: trueJamaican ($2 in chips) 
Seat 9: Dorex2007 ($2.03 in chips) 
TurtleBob99: posts small blind $0.01
Boomerok86: posts big blind $0.02
*** HOLE CARDS ***
Dealt to Dorex2007 [2c 7d]
Martin aus K: folds 
pokertronde: folds 
trueJamaican has timed out
trueJamaican: folds 
Dorex2007: folds 
ThallesRO: calls $0.02
littlebear2020: folds 
Gust4v0_7: folds 
TurtleBob99: folds 
Boomerok86: checks 
*** FLOP *** [8c 9c Kc]
Boomerok86: checks 
ThallesRO: bets $0.05
Boomerok86: folds 
Uncalled bet ($0.05) returned to ThallesRO
ThallesRO collected $0.05 from pot
ThallesRO: doesn't show hand 
*** SUMMARY ***
Total pot $0.05 | Rake $0 
Board [8c 9c Kc]
Seat 1: ThallesRO collected ($0.05)
Seat 2: littlebear2020 folded before Flop (didn't bet)
Seat 3: Gust4v0_7 (button) folded before Flop (didn't bet)
Seat 4: TurtleBob99 (small blind) folded before Flop
Seat 5: Boomerok86 (big blind) folded on the Flop
Seat 6: Martin aus K folded before Flop (didn't bet)
Seat 7: pokertronde folded before Flop (didn't bet)
Seat 8: trueJamaican folded before Flop (didn't bet)
Seat 9: Dorex2007 folded before Flop (didn't bet)



