PokerStars Hand #238222290310:  Hold'em No Limit ($0.05/$0.10 USD) - 2022/08/26 0:56:00 PT [2022/08/26 3:56:00 ET]
Table 'Rollandia' 9-max Seat #4 is the button
Seat 1: soultee88 ($11.82 in chips) 
Seat 2: luchocpeistor29 ($17.68 in chips) 
Seat 3: Dorex2007 ($10 in chips) 
Seat 4: AverageJo247 ($9.21 in chips) 
Seat 5: rookietm1978 ($9.30 in chips) 
Seat 6: MusaiT ($12.27 in chips) 
Seat 7: radubkk ($11.71 in chips) 
Seat 8: masaki0617 ($4.74 in chips) 
Seat 9: NEMESIS 5555 ($13.10 in chips) 
rookietm1978: posts small blind $0.05
MusaiT: posts big blind $0.10
Dorex2007: posts big blind $0.10
*** HOLE CARDS ***
Dealt to Dorex2007 [8c Qs]
radubkk: folds 
masaki0617: folds 
NEMESIS 5555: folds 
soultee88: folds 
luchocpeistor29: folds 
Dorex2007: checks 
AverageJo247: calls $0.10
rookietm1978: calls $0.05
MusaiT: checks 
*** FLOP *** [9d 6h Kd]
rookietm1978: checks 
MusaiT: checks 
Dorex2007: checks 
AverageJo247: checks 
*** TURN *** [9d 6h Kd] [6d]
rookietm1978: bets $0.38
MusaiT: folds 
Dorex2007: folds 
AverageJo247: folds 
Uncalled bet ($0.38) returned to rookietm1978
rookietm1978 collected $0.38 from pot
rookietm1978: doesn't show hand 
*** SUMMARY ***
Total pot $0.40 | Rake $0.02 
Board [9d 6h Kd 6d]
Seat 1: soultee88 folded before Flop (didn't bet)
Seat 2: luchocpeistor29 folded before Flop (didn't bet)
Seat 3: Dorex2007 folded on the Turn (didn't bet)
Seat 4: AverageJo247 (button) folded on the Turn
Seat 5: rookietm1978 (small blind) collected ($0.38)
Seat 6: MusaiT (big blind) folded on the Turn
Seat 7: radubkk folded before Flop (didn't bet)
Seat 8: masaki0617 folded before Flop (didn't bet)
Seat 9: NEMESIS 5555 folded before Flop (didn't bet)



PokerStars Hand #238222295084:  Hold'em No Limit ($0.05/$0.10 USD) - 2022/08/26 0:56:43 PT [2022/08/26 3:56:43 ET]
Table 'Rollandia' 9-max Seat #5 is the button
Seat 1: soultee88 ($11.82 in chips) 
Seat 2: luchocpeistor29 ($17.68 in chips) 
Seat 3: Dorex2007 ($10 in chips) 
Seat 4: AverageJo247 ($9.11 in chips) 
Seat 5: rookietm1978 ($9.58 in chips) 
Seat 6: MusaiT ($12.17 in chips) 
Seat 7: radubkk ($11.71 in chips) 
Seat 8: masaki0617 ($4.74 in chips) 
Seat 9: NEMESIS 5555 ($13.10 in chips) 
MusaiT: posts small blind $0.05
radubkk: posts big blind $0.10
*** HOLE CARDS ***
Dealt to Dorex2007 [Th Ah]
masaki0617: folds 
NEMESIS 5555 has timed out
NEMESIS 5555: folds 
soultee88: folds 
luchocpeistor29: folds 
Dorex2007: raises $0.20 to $0.30
AverageJo247: folds 
rookietm1978: folds 
MusaiT: folds 
radubkk: folds 
Uncalled bet ($0.20) returned to Dorex2007
Dorex2007 collected $0.25 from pot
Dorex2007: doesn't show hand 
*** SUMMARY ***
Total pot $0.25 | Rake $0 
Seat 1: soultee88 folded before Flop (didn't bet)
Seat 2: luchocpeistor29 folded before Flop (didn't bet)
Seat 3: Dorex2007 collected ($0.25)
Seat 4: AverageJo247 folded before Flop (didn't bet)
Seat 5: rookietm1978 (button) folded before Flop (didn't bet)
Seat 6: MusaiT (small blind) folded before Flop
Seat 7: radubkk (big blind) folded before Flop
Seat 8: masaki0617 folded before Flop (didn't bet)
Seat 9: NEMESIS 5555 folded before Flop (didn't bet)



PokerStars Hand #238222298071:  Hold'em No Limit ($0.05/$0.10 USD) - 2022/08/26 0:57:11 PT [2022/08/26 3:57:11 ET]
Table 'Rollandia' 9-max Seat #6 is the button
Seat 1: soultee88 ($11.82 in chips) 
Seat 2: luchocpeistor29 ($17.68 in chips) 
Seat 3: Dorex2007 ($10.15 in chips) 
Seat 4: AverageJo247 ($9.11 in chips) 
Seat 5: rookietm1978 ($9.58 in chips) 
Seat 6: MusaiT ($12.12 in chips) 
Seat 7: radubkk ($11.61 in chips) 
Seat 8: masaki0617 ($4.74 in chips) 
radubkk: posts small blind $0.05
masaki0617: posts big blind $0.10
*** HOLE CARDS ***
Dealt to Dorex2007 [8d 8h]
soultee88: folds 
luchocpeistor29: raises $0.20 to $0.30
Dorex2007: calls $0.30
AverageJo247: folds 
rookietm1978: folds 
MusaiT: folds 
radubkk: folds 
masaki0617: folds 
*** FLOP *** [2s Qc As]
luchocpeistor29: bets $0.36
Dorex2007: folds 
Uncalled bet ($0.36) returned to luchocpeistor29
luchocpeistor29 collected $0.72 from pot
luchocpeistor29: doesn't show hand 
*** SUMMARY ***
Total pot $0.75 | Rake $0.03 
Board [2s Qc As]
Seat 1: soultee88 folded before Flop (didn't bet)
Seat 2: luchocpeistor29 collected ($0.72)
Seat 3: Dorex2007 folded on the Flop
Seat 4: AverageJo247 folded before Flop (didn't bet)
Seat 5: rookietm1978 folded before Flop (didn't bet)
Seat 6: MusaiT (button) folded before Flop (didn't bet)
Seat 7: radubkk (small blind) folded before Flop
Seat 8: masaki0617 (big blind) folded before Flop



PokerStars Hand #238222302845:  Hold'em No Limit ($0.05/$0.10 USD) - 2022/08/26 0:57:53 PT [2022/08/26 3:57:53 ET]
Table 'Rollandia' 9-max Seat #7 is the button
Seat 1: soultee88 ($11.82 in chips) 
Seat 2: luchocpeistor29 ($18.10 in chips) 
Seat 3: Dorex2007 ($10 in chips) 
Seat 4: AverageJo247 ($9.11 in chips) 
Seat 5: rookietm1978 ($9.58 in chips) 
Seat 6: MusaiT ($12.12 in chips) 
Seat 7: radubkk ($11.56 in chips) 
Seat 8: masaki0617 ($4.64 in chips) 
Seat 9: NEMESIS 5555 ($13.10 in chips) 
masaki0617: posts small blind $0.05
NEMESIS 5555: posts big blind $0.10
*** HOLE CARDS ***
Dealt to Dorex2007 [2d 8s]
soultee88: folds 
luchocpeistor29: folds 
Dorex2007: folds 
AverageJo247: raises $0.10 to $0.20
rookietm1978: folds 
MusaiT: folds 
radubkk: folds 
masaki0617: calls $0.15
NEMESIS 5555: calls $0.10
*** FLOP *** [As 3s 3d]
masaki0617: checks 
NEMESIS 5555: checks 
AverageJo247: bets $0.25
masaki0617: calls $0.25
NEMESIS 5555: folds 
*** TURN *** [As 3s 3d] [9c]
masaki0617: checks 
AverageJo247: bets $1
masaki0617: calls $1
*** RIVER *** [As 3s 3d 9c] [Qh]
masaki0617: checks 
AverageJo247: bets $1.50
masaki0617: calls $1.50
*** SHOW DOWN ***
AverageJo247: shows [Ad Qd] (two pair, Aces and Queens)
masaki0617: mucks hand 
AverageJo247 collected $5.83 from pot
*** SUMMARY ***
Total pot $6.10 | Rake $0.27 
Board [As 3s 3d 9c Qh]
Seat 1: soultee88 folded before Flop (didn't bet)
Seat 2: luchocpeistor29 folded before Flop (didn't bet)
Seat 3: Dorex2007 folded before Flop (didn't bet)
Seat 4: AverageJo247 showed [Ad Qd] and won ($5.83) with two pair, Aces and Queens
Seat 5: rookietm1978 folded before Flop (didn't bet)
Seat 6: MusaiT folded before Flop (didn't bet)
Seat 7: radubkk (button) folded before Flop (didn't bet)
Seat 8: masaki0617 (small blind) mucked [Ac 6h]
Seat 9: NEMESIS 5555 (big blind) folded on the Flop



PokerStars Hand #238222310873:  Hold'em No Limit ($0.05/$0.10 USD) - 2022/08/26 0:59:05 PT [2022/08/26 3:59:05 ET]
Table 'Rollandia' 9-max Seat #8 is the button
Seat 1: soultee88 ($11.82 in chips) 
Seat 2: luchocpeistor29 ($18.10 in chips) 
Seat 3: Dorex2007 ($10 in chips) 
Seat 4: AverageJo247 ($11.99 in chips) 
Seat 5: rookietm1978 ($9.58 in chips) 
Seat 6: MusaiT ($12.12 in chips) 
Seat 7: radubkk ($11.56 in chips) 
Seat 8: masaki0617 ($1.69 in chips) 
Seat 9: NEMESIS 5555 ($12.90 in chips) 
NEMESIS 5555: posts small blind $0.05
soultee88: posts big blind $0.10
*** HOLE CARDS ***
Dealt to Dorex2007 [5c 9h]
luchocpeistor29: folds 
Dorex2007: folds 
AverageJo247: folds 
rookietm1978: folds 
MusaiT: folds 
radubkk: folds 
masaki0617: raises $0.10 to $0.20
NEMESIS 5555: calls $0.15
soultee88: folds 
*** FLOP *** [Qd Ac Td]
NEMESIS 5555: checks 
masaki0617: checks 
*** TURN *** [Qd Ac Td] [6d]
NEMESIS 5555: checks 
masaki0617: bets $0.24
NEMESIS 5555: calls $0.24
*** RIVER *** [Qd Ac Td 6d] [Ts]
NEMESIS 5555: checks 
masaki0617: bets $0.47
NEMESIS 5555: folds 
Uncalled bet ($0.47) returned to masaki0617
masaki0617 collected $0.94 from pot
*** SUMMARY ***
Total pot $0.98 | Rake $0.04 
Board [Qd Ac Td 6d Ts]
Seat 1: soultee88 (big blind) folded before Flop
Seat 2: luchocpeistor29 folded before Flop (didn't bet)
Seat 3: Dorex2007 folded before Flop (didn't bet)
Seat 4: AverageJo247 folded before Flop (didn't bet)
Seat 5: rookietm1978 folded before Flop (didn't bet)
Seat 6: MusaiT folded before Flop (didn't bet)
Seat 7: radubkk folded before Flop (didn't bet)
Seat 8: masaki0617 (button) collected ($0.94)
Seat 9: NEMESIS 5555 (small blind) folded on the River



PokerStars Hand #238222314817:  Hold'em No Limit ($0.05/$0.10 USD) - 2022/08/26 0:59:42 PT [2022/08/26 3:59:42 ET]
Table 'Rollandia' 9-max Seat #9 is the button
Seat 1: soultee88 ($11.72 in chips) 
Seat 2: luchocpeistor29 ($18.10 in chips) 
Seat 3: Dorex2007 ($10 in chips) 
Seat 4: AverageJo247 ($11.99 in chips) 
Seat 5: rookietm1978 ($9.58 in chips) 
Seat 6: MusaiT ($12.12 in chips) 
Seat 7: radubkk ($11.56 in chips) 
Seat 8: masaki0617 ($2.19 in chips) 
Seat 9: NEMESIS 5555 ($12.46 in chips) 
soultee88: posts small blind $0.05
luchocpeistor29: posts big blind $0.10
*** HOLE CARDS ***
Dealt to Dorex2007 [Ts 6d]
Dorex2007: folds 
AverageJo247: raises $0.10 to $0.20
rookietm1978: folds 
MusaiT: folds 
radubkk: folds 
masaki0617: folds 
NEMESIS 5555: calls $0.20
soultee88: folds 
luchocpeistor29: folds 
*** FLOP *** [7s 8c Qc]
AverageJo247: checks 
NEMESIS 5555: checks 
*** TURN *** [7s 8c Qc] [Ah]
AverageJo247: checks 
NEMESIS 5555: checks 
*** RIVER *** [7s 8c Qc Ah] [6s]
AverageJo247: bets $0.53
NEMESIS 5555: folds 
Uncalled bet ($0.53) returned to AverageJo247
AverageJo247 collected $0.53 from pot
*** SUMMARY ***
Total pot $0.55 | Rake $0.02 
Board [7s 8c Qc Ah 6s]
Seat 1: soultee88 (small blind) folded before Flop
Seat 2: luchocpeistor29 (big blind) folded before Flop
Seat 3: Dorex2007 folded before Flop (didn't bet)
Seat 4: AverageJo247 collected ($0.53)
Seat 5: rookietm1978 folded before Flop (didn't bet)
Seat 6: MusaiT folded before Flop (didn't bet)
Seat 7: radubkk folded before Flop (didn't bet)
Seat 8: masaki0617 folded before Flop (didn't bet)
Seat 9: NEMESIS 5555 (button) folded on the River



PokerStars Hand #238222319207:  Hold'em No Limit ($0.05/$0.10 USD) - 2022/08/26 1:00:21 PT [2022/08/26 4:00:21 ET]
Table 'Rollandia' 9-max Seat #1 is the button
Seat 1: soultee88 ($11.67 in chips) 
Seat 2: luchocpeistor29 ($18 in chips) 
Seat 3: Dorex2007 ($10 in chips) 
Seat 4: AverageJo247 ($12.32 in chips) 
Seat 5: rookietm1978 ($9.58 in chips) 
Seat 6: MusaiT ($12.12 in chips) 
Seat 7: radubkk ($11.56 in chips) 
Seat 8: masaki0617 ($2.19 in chips) 
Seat 9: NEMESIS 5555 ($12.26 in chips) 
luchocpeistor29: posts small blind $0.05
Dorex2007: posts big blind $0.10
*** HOLE CARDS ***
Dealt to Dorex2007 [Th 2d]
AverageJo247 has timed out
AverageJo247: folds 
rookietm1978: folds 
MusaiT: folds 
radubkk: folds 
masaki0617: raises $0.10 to $0.20
NEMESIS 5555: raises $0.55 to $0.75
soultee88: folds 
luchocpeistor29: folds 
Dorex2007: folds 
masaki0617: calls $0.55
*** FLOP *** [Jd Tc 6s]
masaki0617: checks 
NEMESIS 5555: bets $1.58
masaki0617: calls $1.44 and is all-in
Uncalled bet ($0.14) returned to NEMESIS 5555
*** TURN *** [Jd Tc 6s] [6d]
*** RIVER *** [Jd Tc 6s 6d] [4d]
*** SHOW DOWN ***
masaki0617: shows [Kd Jc] (two pair, Jacks and Sixes)
NEMESIS 5555: shows [As Jh] (two pair, Jacks and Sixes - Ace kicker)
NEMESIS 5555 cashed out the hand for $3.66 | Cash Out Fee $0.04
*** SUMMARY ***
Total pot $4.53 | Rake $0.20 
Board [Jd Tc 6s 6d 4d]
Seat 1: soultee88 (button) folded before Flop (didn't bet)
Seat 2: luchocpeistor29 (small blind) folded before Flop
Seat 3: Dorex2007 (big blind) folded before Flop
Seat 4: AverageJo247 folded before Flop (didn't bet)
Seat 5: rookietm1978 folded before Flop (didn't bet)
Seat 6: MusaiT folded before Flop (didn't bet)
Seat 7: radubkk folded before Flop (didn't bet)
Seat 8: masaki0617 showed [Kd Jc] and lost with two pair, Jacks and Sixes
Seat 9: NEMESIS 5555 showed [As Jh] and won ($4.33) with two pair, Jacks and Sixes (pot not awarded as player cashed out)



PokerStars Hand #238222325233:  Hold'em No Limit ($0.05/$0.10 USD) - 2022/08/26 1:01:13 PT [2022/08/26 4:01:13 ET]
Table 'Rollandia' 9-max Seat #2 is the button
Seat 1: soultee88 ($11.67 in chips) 
Seat 2: luchocpeistor29 ($17.95 in chips) 
Seat 3: Dorex2007 ($10 in chips) 
Seat 4: AverageJo247 ($12.32 in chips) 
Seat 5: rookietm1978 ($9.58 in chips) 
Seat 6: MusaiT ($12.12 in chips) 
Seat 7: radubkk ($11.56 in chips) 
Seat 9: NEMESIS 5555 ($13.73 in chips) 
Dorex2007: posts small blind $0.05
AverageJo247: posts big blind $0.10
*** HOLE CARDS ***
Dealt to Dorex2007 [Th 2s]
rookietm1978: folds 
MusaiT: folds 
radubkk: folds 
NEMESIS 5555 has timed out
NEMESIS 5555: folds 
soultee88: folds 
luchocpeistor29: raises $0.15 to $0.25
Dorex2007: folds 
AverageJo247: folds 
Uncalled bet ($0.15) returned to luchocpeistor29
luchocpeistor29 collected $0.25 from pot
luchocpeistor29: doesn't show hand 
*** SUMMARY ***
Total pot $0.25 | Rake $0 
Seat 1: soultee88 folded before Flop (didn't bet)
Seat 2: luchocpeistor29 (button) collected ($0.25)
Seat 3: Dorex2007 (small blind) folded before Flop
Seat 4: AverageJo247 (big blind) folded before Flop
Seat 5: rookietm1978 folded before Flop (didn't bet)
Seat 6: MusaiT folded before Flop (didn't bet)
Seat 7: radubkk folded before Flop (didn't bet)
Seat 9: NEMESIS 5555 folded before Flop (didn't bet)



PokerStars Hand #238222328866:  Hold'em No Limit ($0.05/$0.10 USD) - 2022/08/26 1:01:44 PT [2022/08/26 4:01:44 ET]
Table 'Rollandia' 9-max Seat #3 is the button
Seat 1: soultee88 ($11.67 in chips) 
Seat 2: luchocpeistor29 ($18.10 in chips) 
Seat 3: Dorex2007 ($10 in chips) 
Seat 4: AverageJo247 ($12.22 in chips) 
Seat 5: rookietm1978 ($9.58 in chips) 
Seat 6: MusaiT ($12.12 in chips) 
Seat 7: radubkk ($11.56 in chips) 
Seat 9: NEMESIS 5555 ($13.73 in chips) 
AverageJo247: posts small blind $0.05
rookietm1978: posts big blind $0.10
*** HOLE CARDS ***
Dealt to Dorex2007 [4c Ac]
MusaiT: folds 
radubkk: raises $0.15 to $0.25
NEMESIS 5555: calls $0.25
soultee88: folds 
luchocpeistor29: folds 
Dorex2007: calls $0.25
AverageJo247: folds 
rookietm1978: folds 
*** FLOP *** [2c Ad 8s]
radubkk: checks 
NEMESIS 5555: checks 
Dorex2007: bets $0.57
radubkk: folds 
NEMESIS 5555: folds 
Uncalled bet ($0.57) returned to Dorex2007
Dorex2007 collected $0.86 from pot
Dorex2007: doesn't show hand 
*** SUMMARY ***
Total pot $0.90 | Rake $0.04 
Board [2c Ad 8s]
Seat 1: soultee88 folded before Flop (didn't bet)
Seat 2: luchocpeistor29 folded before Flop (didn't bet)
Seat 3: Dorex2007 (button) collected ($0.86)
Seat 4: AverageJo247 (small blind) folded before Flop
Seat 5: rookietm1978 (big blind) folded before Flop
Seat 6: MusaiT folded before Flop (didn't bet)
Seat 7: radubkk folded on the Flop
Seat 9: NEMESIS 5555 folded on the Flop



PokerStars Hand #238222333371:  Hold'em No Limit ($0.05/$0.10 USD) - 2022/08/26 1:02:21 PT [2022/08/26 4:02:21 ET]
Table 'Rollandia' 9-max Seat #4 is the button
Seat 1: soultee88 ($11.67 in chips) 
Seat 2: luchocpeistor29 ($18.10 in chips) 
Seat 3: Dorex2007 ($10.61 in chips) 
Seat 4: AverageJo247 ($12.17 in chips) 
Seat 5: rookietm1978 ($9.48 in chips) 
Seat 6: MusaiT ($12.12 in chips) 
Seat 7: radubkk ($11.31 in chips) 
Seat 9: NEMESIS 5555 ($13.48 in chips) 
rookietm1978: posts small blind $0.05
MusaiT: posts big blind $0.10
*** HOLE CARDS ***
Dealt to Dorex2007 [4h Jh]
radubkk: folds 
NEMESIS 5555: folds 
soultee88: folds 
luchocpeistor29: folds 
Dorex2007: folds 
AverageJo247: folds 
rookietm1978: calls $0.05
MusaiT: checks 
*** FLOP *** [Ks 9s As]
rookietm1978: checks 
MusaiT: checks 
*** TURN *** [Ks 9s As] [7h]
rookietm1978: checks 
MusaiT: bets $0.13
rookietm1978: folds 
Uncalled bet ($0.13) returned to MusaiT
MusaiT collected $0.19 from pot
MusaiT: doesn't show hand 
*** SUMMARY ***
Total pot $0.20 | Rake $0.01 
Board [Ks 9s As 7h]
Seat 1: soultee88 folded before Flop (didn't bet)
Seat 2: luchocpeistor29 folded before Flop (didn't bet)
Seat 3: Dorex2007 folded before Flop (didn't bet)
Seat 4: AverageJo247 (button) folded before Flop (didn't bet)
Seat 5: rookietm1978 (small blind) folded on the Turn
Seat 6: MusaiT (big blind) collected ($0.19)
Seat 7: radubkk folded before Flop (didn't bet)
Seat 9: NEMESIS 5555 folded before Flop (didn't bet)



PokerStars Hand #238222338279:  Hold'em No Limit ($0.05/$0.10 USD) - 2022/08/26 1:03:02 PT [2022/08/26 4:03:02 ET]
Table 'Rollandia' 9-max Seat #5 is the button
Seat 1: soultee88 ($11.67 in chips) 
Seat 2: luchocpeistor29 ($18.10 in chips) 
Seat 3: Dorex2007 ($10.61 in chips) 
Seat 4: AverageJo247 ($12.17 in chips) 
Seat 5: rookietm1978 ($9.38 in chips) 
Seat 6: MusaiT ($12.21 in chips) 
Seat 9: NEMESIS 5555 ($13.48 in chips) 
MusaiT: posts small blind $0.05
radubkk: is sitting out 
NEMESIS 5555: posts big blind $0.10
*** HOLE CARDS ***
Dealt to Dorex2007 [Ac Ts]
soultee88: folds 
luchocpeistor29: folds 
Dorex2007: folds 
AverageJo247: raises $0.10 to $0.20
rookietm1978: folds 
MusaiT: raises $0.60 to $0.80
NEMESIS 5555: folds 
AverageJo247: calls $0.60
*** FLOP *** [5d Tc Qh]
MusaiT: checks 
AverageJo247: checks 
*** TURN *** [5d Tc Qh] [5s]
MusaiT: checks 
AverageJo247: checks 
*** RIVER *** [5d Tc Qh 5s] [3s]
MusaiT: checks 
AverageJo247: checks 
*** SHOW DOWN ***
MusaiT: shows [Ks Js] (a pair of Fives)
AverageJo247: shows [9c As] (a pair of Fives - Ace kicker)
AverageJo247 collected $1.62 from pot
*** SUMMARY ***
Total pot $1.70 | Rake $0.08 
Board [5d Tc Qh 5s 3s]
Seat 1: soultee88 folded before Flop (didn't bet)
Seat 2: luchocpeistor29 folded before Flop (didn't bet)
Seat 3: Dorex2007 folded before Flop (didn't bet)
Seat 4: AverageJo247 showed [9c As] and won ($1.62) with a pair of Fives
Seat 5: rookietm1978 (button) folded before Flop (didn't bet)
Seat 6: MusaiT (small blind) showed [Ks Js] and lost with a pair of Fives
Seat 9: NEMESIS 5555 (big blind) folded before Flop



PokerStars Hand #238222343596:  Hold'em No Limit ($0.05/$0.10 USD) - 2022/08/26 1:03:45 PT [2022/08/26 4:03:45 ET]
Table 'Rollandia' 9-max Seat #6 is the button
Seat 1: soultee88 ($11.67 in chips) 
Seat 2: luchocpeistor29 ($18.10 in chips) 
Seat 3: Dorex2007 ($10.61 in chips) 
Seat 4: AverageJo247 ($12.99 in chips) 
Seat 5: rookietm1978 ($9.38 in chips) 
Seat 6: MusaiT ($11.41 in chips) 
Seat 9: NEMESIS 5555 ($13.38 in chips) 
NEMESIS 5555: posts small blind $0.05
soultee88: posts big blind $0.10
*** HOLE CARDS ***
Dealt to Dorex2007 [Js 4d]
luchocpeistor29: folds 
Dorex2007: folds 
AverageJo247: raises $0.10 to $0.20
rookietm1978: folds 
MusaiT: folds 
NEMESIS 5555: calls $0.15
soultee88: folds 
*** FLOP *** [Ts Ks 8h]
NEMESIS 5555: checks 
AverageJo247: checks 
*** TURN *** [Ts Ks 8h] [Th]
NEMESIS 5555: checks 
AverageJo247: bets $0.24
NEMESIS 5555: folds 
Uncalled bet ($0.24) returned to AverageJo247
AverageJo247 collected $0.48 from pot
*** SUMMARY ***
Total pot $0.50 | Rake $0.02 
Board [Ts Ks 8h Th]
Seat 1: soultee88 (big blind) folded before Flop
Seat 2: luchocpeistor29 folded before Flop (didn't bet)
Seat 3: Dorex2007 folded before Flop (didn't bet)
Seat 4: AverageJo247 collected ($0.48)
Seat 5: rookietm1978 folded before Flop (didn't bet)
Seat 6: MusaiT (button) folded before Flop (didn't bet)
Seat 9: NEMESIS 5555 (small blind) folded on the Turn



PokerStars Hand #238222347706:  Hold'em No Limit ($0.05/$0.10 USD) - 2022/08/26 1:04:19 PT [2022/08/26 4:04:19 ET]
Table 'Rollandia' 9-max Seat #9 is the button
Seat 1: soultee88 ($11.57 in chips) 
Seat 2: luchocpeistor29 ($18.10 in chips) 
Seat 3: Dorex2007 ($10.61 in chips) 
Seat 4: AverageJo247 ($13.27 in chips) 
Seat 5: rookietm1978 ($9.38 in chips) 
Seat 6: MusaiT ($11.41 in chips) 
Seat 9: NEMESIS 5555 ($13.18 in chips) 
soultee88: posts small blind $0.05
luchocpeistor29: posts big blind $0.10
*** HOLE CARDS ***
Dealt to Dorex2007 [5d Ah]
Dorex2007: folds 
AverageJo247: folds 
rookietm1978: folds 
MusaiT: folds 
NEMESIS 5555: raises $0.10 to $0.20
soultee88: folds 
luchocpeistor29: calls $0.10
*** FLOP *** [9c Js Jc]
luchocpeistor29: checks 
NEMESIS 5555: bets $0.30
luchocpeistor29: calls $0.30
*** TURN *** [9c Js Jc] [8c]
luchocpeistor29: checks 
NEMESIS 5555: bets $0.50
luchocpeistor29: calls $0.50
*** RIVER *** [9c Js Jc 8c] [4h]
luchocpeistor29: checks 
NEMESIS 5555: bets $1.96
luchocpeistor29: folds 
Uncalled bet ($1.96) returned to NEMESIS 5555
NEMESIS 5555 collected $1.96 from pot
*** SUMMARY ***
Total pot $2.05 | Rake $0.09 
Board [9c Js Jc 8c 4h]
Seat 1: soultee88 (small blind) folded before Flop
Seat 2: luchocpeistor29 (big blind) folded on the River
Seat 3: Dorex2007 folded before Flop (didn't bet)
Seat 4: AverageJo247 folded before Flop (didn't bet)
Seat 5: rookietm1978 folded before Flop (didn't bet)
Seat 6: MusaiT folded before Flop (didn't bet)
Seat 9: NEMESIS 5555 (button) collected ($1.96)



PokerStars Hand #238222353734:  Hold'em No Limit ($0.05/$0.10 USD) - 2022/08/26 1:05:10 PT [2022/08/26 4:05:10 ET]
Table 'Rollandia' 9-max Seat #1 is the button
Seat 1: soultee88 ($11.52 in chips) 
Seat 2: luchocpeistor29 ($17.10 in chips) 
Seat 3: Dorex2007 ($10.61 in chips) 
Seat 4: AverageJo247 ($13.27 in chips) 
Seat 5: rookietm1978 ($9.38 in chips) 
Seat 6: MusaiT ($11.41 in chips) 
Seat 9: NEMESIS 5555 ($14.14 in chips) 
luchocpeistor29: posts small blind $0.05
Dorex2007: posts big blind $0.10
*** HOLE CARDS ***
Dealt to Dorex2007 [Jd Kd]
AverageJo247: raises $0.10 to $0.20
rookietm1978: folds 
MusaiT: folds 
NEMESIS 5555: folds 
soultee88: folds 
luchocpeistor29: folds 
Dorex2007: calls $0.10
*** FLOP *** [Ah 4c 8s]
Dorex2007: checks 
AverageJo247: bets $0.20
Dorex2007: folds 
Uncalled bet ($0.20) returned to AverageJo247
AverageJo247 collected $0.43 from pot
*** SUMMARY ***
Total pot $0.45 | Rake $0.02 
Board [Ah 4c 8s]
Seat 1: soultee88 (button) folded before Flop (didn't bet)
Seat 2: luchocpeistor29 (small blind) folded before Flop
Seat 3: Dorex2007 (big blind) folded on the Flop
Seat 4: AverageJo247 collected ($0.43)
Seat 5: rookietm1978 folded before Flop (didn't bet)
Seat 6: MusaiT folded before Flop (didn't bet)
Seat 9: NEMESIS 5555 folded before Flop (didn't bet)



PokerStars Hand #238222358863:  Hold'em No Limit ($0.05/$0.10 USD) - 2022/08/26 1:05:53 PT [2022/08/26 4:05:53 ET]
Table 'Rollandia' 9-max Seat #2 is the button
Seat 1: soultee88 ($11.52 in chips) 
Seat 2: luchocpeistor29 ($17.05 in chips) 
Seat 3: Dorex2007 ($10.41 in chips) 
Seat 4: AverageJo247 ($13.50 in chips) 
Seat 5: rookietm1978 ($9.38 in chips) 
Seat 6: MusaiT ($11.41 in chips) 
Seat 9: NEMESIS 5555 ($14.14 in chips) 
Dorex2007: posts small blind $0.05
AverageJo247: posts big blind $0.10
*** HOLE CARDS ***
Dealt to Dorex2007 [3s Ad]
rookietm1978: folds 
MusaiT: folds 
NEMESIS 5555: raises $0.10 to $0.20
soultee88: folds 
luchocpeistor29: folds 
Dorex2007: folds 
AverageJo247: folds 
Uncalled bet ($0.10) returned to NEMESIS 5555
NEMESIS 5555 collected $0.25 from pot
*** SUMMARY ***
Total pot $0.25 | Rake $0 
Seat 1: soultee88 folded before Flop (didn't bet)
Seat 2: luchocpeistor29 (button) folded before Flop (didn't bet)
Seat 3: Dorex2007 (small blind) folded before Flop
Seat 4: AverageJo247 (big blind) folded before Flop
Seat 5: rookietm1978 folded before Flop (didn't bet)
Seat 6: MusaiT folded before Flop (didn't bet)
Seat 9: NEMESIS 5555 collected ($0.25)



PokerStars Hand #238222361326:  Hold'em No Limit ($0.05/$0.10 USD) - 2022/08/26 1:06:14 PT [2022/08/26 4:06:14 ET]
Table 'Rollandia' 9-max Seat #3 is the button
Seat 1: soultee88 ($11.52 in chips) 
Seat 2: luchocpeistor29 ($17.05 in chips) 
Seat 3: Dorex2007 ($10.36 in chips) 
Seat 4: AverageJo247 ($13.40 in chips) 
Seat 5: rookietm1978 ($9.38 in chips) 
Seat 6: MusaiT ($11.41 in chips) 
Seat 9: NEMESIS 5555 ($14.29 in chips) 
AverageJo247: posts small blind $0.05
rookietm1978: posts big blind $0.10
*** HOLE CARDS ***
Dealt to Dorex2007 [6s 9c]
MusaiT: folds 
NEMESIS 5555: folds 
soultee88: folds 
luchocpeistor29: folds 
Dorex2007: folds 
AverageJo247: calls $0.05
rookietm1978: checks 
*** FLOP *** [6c 5c Kc]
AverageJo247: checks 
rookietm1978: checks 
*** TURN *** [6c 5c Kc] [3c]
AverageJo247: bets $0.19
rookietm1978: calls $0.19
*** RIVER *** [6c 5c Kc 3c] [As]
AverageJo247: bets $0.55
rookietm1978: folds 
Uncalled bet ($0.55) returned to AverageJo247
AverageJo247 collected $0.55 from pot
*** SUMMARY ***
Total pot $0.58 | Rake $0.03 
Board [6c 5c Kc 3c As]
Seat 1: soultee88 folded before Flop (didn't bet)
Seat 2: luchocpeistor29 folded before Flop (didn't bet)
Seat 3: Dorex2007 (button) folded before Flop (didn't bet)
Seat 4: AverageJo247 (small blind) collected ($0.55)
Seat 5: rookietm1978 (big blind) folded on the River
Seat 6: MusaiT folded before Flop (didn't bet)
Seat 9: NEMESIS 5555 folded before Flop (didn't bet)



PokerStars Hand #238222365444:  Hold'em No Limit ($0.05/$0.10 USD) - 2022/08/26 1:06:50 PT [2022/08/26 4:06:50 ET]
Table 'Rollandia' 9-max Seat #4 is the button
Seat 1: soultee88 ($11.52 in chips) 
Seat 2: luchocpeistor29 ($17.05 in chips) 
Seat 3: Dorex2007 ($10.36 in chips) 
Seat 4: AverageJo247 ($13.66 in chips) 
Seat 5: rookietm1978 ($9.09 in chips) 
Seat 6: MusaiT ($11.41 in chips) 
Seat 9: NEMESIS 5555 ($14.29 in chips) 
rookietm1978: posts small blind $0.05
MusaiT: posts big blind $0.10
*** HOLE CARDS ***
Dealt to Dorex2007 [3s Ah]
NEMESIS 5555: raises $0.10 to $0.20
soultee88: folds 
luchocpeistor29 has timed out
luchocpeistor29: folds 
Dorex2007: folds 
AverageJo247: folds 
rookietm1978: calls $0.15
MusaiT: folds 
*** FLOP *** [Ad 4d 3d]
rookietm1978: checks 
NEMESIS 5555: bets $0.40
rookietm1978: raises $0.60 to $1
NEMESIS 5555: folds 
Uncalled bet ($0.60) returned to rookietm1978
rookietm1978 collected $1.22 from pot
rookietm1978: doesn't show hand 
*** SUMMARY ***
Total pot $1.30 | Rake $0.08 
Board [Ad 4d 3d]
Seat 1: soultee88 folded before Flop (didn't bet)
Seat 2: luchocpeistor29 folded before Flop (didn't bet)
Seat 3: Dorex2007 folded before Flop (didn't bet)
Seat 4: AverageJo247 (button) folded before Flop (didn't bet)
Seat 5: rookietm1978 (small blind) collected ($1.22)
Seat 6: MusaiT (big blind) folded before Flop
Seat 9: NEMESIS 5555 folded on the Flop



PokerStars Hand #238222372148:  Hold'em No Limit ($0.05/$0.10 USD) - 2022/08/26 1:07:47 PT [2022/08/26 4:07:47 ET]
Table 'Rollandia' 9-max Seat #5 is the button
Seat 1: soultee88 ($11.52 in chips) 
Seat 2: luchocpeistor29 ($17.05 in chips) 
Seat 3: Dorex2007 ($10.36 in chips) 
Seat 4: AverageJo247 ($13.66 in chips) 
Seat 5: rookietm1978 ($9.71 in chips) 
Seat 6: MusaiT ($11.31 in chips) 
Seat 9: NEMESIS 5555 ($13.69 in chips) 
MusaiT: posts small blind $0.05
NEMESIS 5555: posts big blind $0.10
*** HOLE CARDS ***
Dealt to Dorex2007 [8c 5h]
soultee88: folds 
luchocpeistor29: folds 
Dorex2007: folds 
AverageJo247: raises $0.10 to $0.20
rookietm1978: calls $0.20
MusaiT: folds 
NEMESIS 5555: raises $0.65 to $0.85
AverageJo247: folds 
rookietm1978: folds 
Uncalled bet ($0.65) returned to NEMESIS 5555
NEMESIS 5555 collected $0.65 from pot
*** SUMMARY ***
Total pot $0.65 | Rake $0 
Seat 1: soultee88 folded before Flop (didn't bet)
Seat 2: luchocpeistor29 folded before Flop (didn't bet)
Seat 3: Dorex2007 folded before Flop (didn't bet)
Seat 4: AverageJo247 folded before Flop
Seat 5: rookietm1978 (button) folded before Flop
Seat 6: MusaiT (small blind) folded before Flop
Seat 9: NEMESIS 5555 (big blind) collected ($0.65)



PokerStars Hand #238222376447:  Hold'em No Limit ($0.05/$0.10 USD) - 2022/08/26 1:08:24 PT [2022/08/26 4:08:24 ET]
Table 'Rollandia' 9-max Seat #6 is the button
Seat 1: soultee88 ($11.52 in chips) 
Seat 2: luchocpeistor29 ($17.05 in chips) 
Seat 3: Dorex2007 ($10.36 in chips) 
Seat 4: AverageJo247 ($13.46 in chips) 
Seat 5: rookietm1978 ($9.51 in chips) 
Seat 6: MusaiT ($11.26 in chips) 
Seat 9: NEMESIS 5555 ($14.14 in chips) 
NEMESIS 5555: posts small blind $0.05
soultee88: posts big blind $0.10
*** HOLE CARDS ***
Dealt to Dorex2007 [Td Ts]
luchocpeistor29: folds 
Dorex2007: calls $0.10
AverageJo247: folds 
rookietm1978: folds 
MusaiT: raises $0.25 to $0.35
NEMESIS 5555: folds 
soultee88: calls $0.25
Dorex2007: calls $0.25
*** FLOP *** [3h 7h As]
soultee88: checks 
Dorex2007: checks 
MusaiT: checks 
*** TURN *** [3h 7h As] [6d]
soultee88: checks 
Dorex2007: checks 
MusaiT: checks 
*** RIVER *** [3h 7h As 6d] [3s]
soultee88: checks 
Dorex2007: bets $0.52
MusaiT: folds 
soultee88: folds 
Uncalled bet ($0.52) returned to Dorex2007
Dorex2007 collected $1.05 from pot
Dorex2007: doesn't show hand 
*** SUMMARY ***
Total pot $1.10 | Rake $0.05 
Board [3h 7h As 6d 3s]
Seat 1: soultee88 (big blind) folded on the River
Seat 2: luchocpeistor29 folded before Flop (didn't bet)
Seat 3: Dorex2007 collected ($1.05)
Seat 4: AverageJo247 folded before Flop (didn't bet)
Seat 5: rookietm1978 folded before Flop (didn't bet)
Seat 6: MusaiT (button) folded on the River
Seat 9: NEMESIS 5555 (small blind) folded before Flop



PokerStars Hand #238222380757:  Hold'em No Limit ($0.05/$0.10 USD) - 2022/08/26 1:09:00 PT [2022/08/26 4:09:00 ET]
Table 'Rollandia' 9-max Seat #9 is the button
Seat 1: soultee88 ($11.17 in chips) 
Seat 2: luchocpeistor29 ($17.05 in chips) 
Seat 3: Dorex2007 ($11.06 in chips) 
Seat 4: AverageJo247 ($13.46 in chips) 
Seat 5: rookietm1978 ($9.51 in chips) 
Seat 6: MusaiT ($10.91 in chips) 
Seat 9: NEMESIS 5555 ($14.09 in chips) 
soultee88: posts small blind $0.05
luchocpeistor29: posts big blind $0.10
*** HOLE CARDS ***
Dealt to Dorex2007 [Ks 8c]
Dorex2007: folds 
AverageJo247: raises $0.10 to $0.20
rookietm1978: folds 
MusaiT: folds 
NEMESIS 5555: folds 
soultee88: folds 
luchocpeistor29: folds 
Uncalled bet ($0.10) returned to AverageJo247
AverageJo247 collected $0.25 from pot
*** SUMMARY ***
Total pot $0.25 | Rake $0 
Seat 1: soultee88 (small blind) folded before Flop
Seat 2: luchocpeistor29 (big blind) folded before Flop
Seat 3: Dorex2007 folded before Flop (didn't bet)
Seat 4: AverageJo247 collected ($0.25)
Seat 5: rookietm1978 folded before Flop (didn't bet)
Seat 6: MusaiT folded before Flop (didn't bet)
Seat 9: NEMESIS 5555 (button) folded before Flop (didn't bet)



PokerStars Hand #238222382402:  Hold'em No Limit ($0.05/$0.10 USD) - 2022/08/26 1:09:13 PT [2022/08/26 4:09:13 ET]
Table 'Rollandia' 9-max Seat #1 is the button
Seat 1: soultee88 ($11.12 in chips) 
Seat 2: luchocpeistor29 ($16.95 in chips) 
Seat 3: Dorex2007 ($11.06 in chips) 
Seat 4: AverageJo247 ($13.61 in chips) 
Seat 5: rookietm1978 ($9.51 in chips) 
Seat 6: MusaiT ($10.91 in chips) 
Seat 9: NEMESIS 5555 ($14.09 in chips) 
luchocpeistor29: posts small blind $0.05
Dorex2007: posts big blind $0.10
*** HOLE CARDS ***
Dealt to Dorex2007 [5d 5s]
AverageJo247: raises $0.15 to $0.25
rookietm1978: folds 
MusaiT: folds 
NEMESIS 5555: folds 
soultee88: calls $0.25
luchocpeistor29: folds 
Dorex2007: calls $0.15
*** FLOP *** [Ad 7d Ac]
Dorex2007: checks 
AverageJo247: checks 
soultee88: bets $0.53
Dorex2007: folds 
AverageJo247: folds 
Uncalled bet ($0.53) returned to soultee88
soultee88 collected $0.76 from pot
soultee88: doesn't show hand 
*** SUMMARY ***
Total pot $0.80 | Rake $0.04 
Board [Ad 7d Ac]
Seat 1: soultee88 (button) collected ($0.76)
Seat 2: luchocpeistor29 (small blind) folded before Flop
Seat 3: Dorex2007 (big blind) folded on the Flop
Seat 4: AverageJo247 folded on the Flop
Seat 5: rookietm1978 folded before Flop (didn't bet)
Seat 6: MusaiT folded before Flop (didn't bet)
Seat 9: NEMESIS 5555 folded before Flop (didn't bet)



PokerStars Hand #238222386609:  Hold'em No Limit ($0.05/$0.10 USD) - 2022/08/26 1:09:48 PT [2022/08/26 4:09:48 ET]
Table 'Rollandia' 9-max Seat #2 is the button
Seat 1: soultee88 ($11.63 in chips) 
Seat 2: luchocpeistor29 ($16.90 in chips) 
Seat 3: Dorex2007 ($10.81 in chips) 
Seat 4: AverageJo247 ($13.36 in chips) 
Seat 5: rookietm1978 ($9.51 in chips) 
Seat 6: MusaiT ($10.91 in chips) 
Seat 9: NEMESIS 5555 ($14.09 in chips) 
Dorex2007: posts small blind $0.05
AverageJo247: posts big blind $0.10
*** HOLE CARDS ***
Dealt to Dorex2007 [Ts 5d]
rookietm1978: folds 
MusaiT: folds 
NEMESIS 5555: folds 
soultee88: folds 
luchocpeistor29: raises $0.15 to $0.25
Dorex2007: folds 
AverageJo247: folds 
Uncalled bet ($0.15) returned to luchocpeistor29
luchocpeistor29 collected $0.25 from pot
luchocpeistor29: doesn't show hand 
*** SUMMARY ***
Total pot $0.25 | Rake $0 
Seat 1: soultee88 folded before Flop (didn't bet)
Seat 2: luchocpeistor29 (button) collected ($0.25)
Seat 3: Dorex2007 (small blind) folded before Flop
Seat 4: AverageJo247 (big blind) folded before Flop
Seat 5: rookietm1978 folded before Flop (didn't bet)
Seat 6: MusaiT folded before Flop (didn't bet)
Seat 9: NEMESIS 5555 folded before Flop (didn't bet)



PokerStars Hand #238222388834:  Hold'em No Limit ($0.05/$0.10 USD) - 2022/08/26 1:10:06 PT [2022/08/26 4:10:06 ET]
Table 'Rollandia' 9-max Seat #3 is the button
Seat 1: soultee88 ($11.63 in chips) 
Seat 2: luchocpeistor29 ($17.05 in chips) 
Seat 3: Dorex2007 ($10.76 in chips) 
Seat 4: AverageJo247 ($13.26 in chips) 
Seat 5: rookietm1978 ($9.51 in chips) 
Seat 6: MusaiT ($10.91 in chips) 
Seat 9: NEMESIS 5555 ($14.09 in chips) 
AverageJo247: posts small blind $0.05
rookietm1978: posts big blind $0.10
*** HOLE CARDS ***
Dealt to Dorex2007 [9c 5d]
MusaiT: folds 
NEMESIS 5555: folds 
soultee88: folds 
luchocpeistor29: raises $0.20 to $0.30
Dorex2007: folds 
AverageJo247: folds 
rookietm1978: folds 
Uncalled bet ($0.20) returned to luchocpeistor29
luchocpeistor29 collected $0.25 from pot
luchocpeistor29: doesn't show hand 
*** SUMMARY ***
Total pot $0.25 | Rake $0 
Seat 1: soultee88 folded before Flop (didn't bet)
Seat 2: luchocpeistor29 collected ($0.25)
Seat 3: Dorex2007 (button) folded before Flop (didn't bet)
Seat 4: AverageJo247 (small blind) folded before Flop
Seat 5: rookietm1978 (big blind) folded before Flop
Seat 6: MusaiT folded before Flop (didn't bet)
Seat 9: NEMESIS 5555 folded before Flop (didn't bet)



PokerStars Hand #238222391327:  Hold'em No Limit ($0.05/$0.10 USD) - 2022/08/26 1:10:27 PT [2022/08/26 4:10:27 ET]
Table 'Rollandia' 9-max Seat #4 is the button
Seat 1: soultee88 ($11.63 in chips) 
Seat 2: luchocpeistor29 ($17.20 in chips) 
Seat 3: Dorex2007 ($10.76 in chips) 
Seat 4: AverageJo247 ($13.21 in chips) 
Seat 5: rookietm1978 ($9.41 in chips) 
Seat 6: MusaiT ($10.91 in chips) 
Seat 9: NEMESIS 5555 ($14.09 in chips) 
rookietm1978: posts small blind $0.05
MusaiT: posts big blind $0.10
*** HOLE CARDS ***
Dealt to Dorex2007 [8d 9h]
NEMESIS 5555: folds 
soultee88: folds 
luchocpeistor29: folds 
Dorex2007: folds 
AverageJo247: folds 
rookietm1978: folds 
Uncalled bet ($0.05) returned to MusaiT
MusaiT collected $0.10 from pot
MusaiT: doesn't show hand 
*** SUMMARY ***
Total pot $0.10 | Rake $0 
Seat 1: soultee88 folded before Flop (didn't bet)
Seat 2: luchocpeistor29 folded before Flop (didn't bet)
Seat 3: Dorex2007 folded before Flop (didn't bet)
Seat 4: AverageJo247 (button) folded before Flop (didn't bet)
Seat 5: rookietm1978 (small blind) folded before Flop
Seat 6: MusaiT (big blind) collected ($0.10)
Seat 9: NEMESIS 5555 folded before Flop (didn't bet)



PokerStars Hand #238222393078:  Hold'em No Limit ($0.05/$0.10 USD) - 2022/08/26 1:10:42 PT [2022/08/26 4:10:42 ET]
Table 'Rollandia' 9-max Seat #5 is the button
Seat 1: soultee88 ($11.63 in chips) 
Seat 2: luchocpeistor29 ($17.20 in chips) 
Seat 3: Dorex2007 ($10.76 in chips) 
Seat 4: AverageJo247 ($13.21 in chips) 
Seat 5: rookietm1978 ($9.36 in chips) 
Seat 6: MusaiT ($10.96 in chips) 
Seat 9: NEMESIS 5555 ($14.09 in chips) 
MusaiT: posts small blind $0.05
NEMESIS 5555: posts big blind $0.10
*** HOLE CARDS ***
Dealt to Dorex2007 [6d 4s]
soultee88: folds 
luchocpeistor29: folds 
Dorex2007: folds 
AverageJo247: raises $0.15 to $0.25
rookietm1978: folds 
MusaiT: folds 
NEMESIS 5555: calls $0.15
*** FLOP *** [7h Qd As]
NEMESIS 5555: bets $0.26
AverageJo247: calls $0.26
*** TURN *** [7h Qd As] [9h]
NEMESIS 5555: bets $0.80
AverageJo247: calls $0.80
*** RIVER *** [7h Qd As 9h] [Jc]
NEMESIS 5555: bets $1.27
AverageJo247: folds 
Uncalled bet ($1.27) returned to NEMESIS 5555
NEMESIS 5555 collected $2.55 from pot
*** SUMMARY ***
Total pot $2.67 | Rake $0.12 
Board [7h Qd As 9h Jc]
Seat 1: soultee88 folded before Flop (didn't bet)
Seat 2: luchocpeistor29 folded before Flop (didn't bet)
Seat 3: Dorex2007 folded before Flop (didn't bet)
Seat 4: AverageJo247 folded on the River
Seat 5: rookietm1978 (button) folded before Flop (didn't bet)
Seat 6: MusaiT (small blind) folded before Flop
Seat 9: NEMESIS 5555 (big blind) collected ($2.55)



PokerStars Hand #238222399423:  Hold'em No Limit ($0.05/$0.10 USD) - 2022/08/26 1:11:34 PT [2022/08/26 4:11:34 ET]
Table 'Rollandia' 9-max Seat #6 is the button
Seat 1: soultee88 ($11.63 in chips) 
Seat 2: luchocpeistor29 ($17.20 in chips) 
Seat 3: Dorex2007 ($10.76 in chips) 
Seat 4: AverageJo247 ($11.90 in chips) 
Seat 5: rookietm1978 ($9.36 in chips) 
Seat 6: MusaiT ($10.91 in chips) 
Seat 9: NEMESIS 5555 ($15.33 in chips) 
NEMESIS 5555: posts small blind $0.05
soultee88: posts big blind $0.10
*** HOLE CARDS ***
Dealt to Dorex2007 [Kd Jh]
luchocpeistor29: folds 
Dorex2007: raises $0.10 to $0.20
AverageJo247: folds 
rookietm1978: raises $0.30 to $0.50
MusaiT: folds 
NEMESIS 5555: calls $0.45
soultee88: folds 
Dorex2007: calls $0.30
*** FLOP *** [3c 4h Jd]
NEMESIS 5555: bets $0.76
Dorex2007: calls $0.76
rookietm1978: calls $0.76
*** TURN *** [3c 4h Jd] [4d]
NEMESIS 5555: bets $1.85
Dorex2007: calls $1.85
rookietm1978: raises $6.25 to $8.10 and is all-in
NEMESIS 5555: raises $5.97 to $14.07 and is all-in
Dorex2007: folds 
Uncalled bet ($5.97) returned to NEMESIS 5555
*** RIVER *** [3c 4h Jd 4d] [Ks]
*** SHOW DOWN ***
NEMESIS 5555: shows [4c 8h] (three of a kind, Fours)
rookietm1978: shows [Ad Ah] (two pair, Aces and Fours)
NEMESIS 5555 cashed out the hand for $19.79 | Cash Out Fee $0.20
*** SUMMARY ***
Total pot $21.93 | Rake $0.99 
Board [3c 4h Jd 4d Ks]
Seat 1: soultee88 (big blind) folded before Flop
Seat 2: luchocpeistor29 folded before Flop (didn't bet)
Seat 3: Dorex2007 folded on the Turn
Seat 4: AverageJo247 folded before Flop (didn't bet)
Seat 5: rookietm1978 showed [Ad Ah] and lost with two pair, Aces and Fours
Seat 6: MusaiT (button) folded before Flop (didn't bet)
Seat 9: NEMESIS 5555 (small blind) showed [4c 8h] and won ($20.94) with three of a kind, Fours (pot not awarded as player cashed out)



PokerStars Hand #238222405558:  Hold'em No Limit ($0.05/$0.10 USD) - 2022/08/26 1:12:24 PT [2022/08/26 4:12:24 ET]
Table 'Rollandia' 9-max Seat #9 is the button
Seat 1: soultee88 ($11.53 in chips) 
Seat 3: Dorex2007 ($10 in chips) 
Seat 4: AverageJo247 ($11.90 in chips) 
Seat 5: rookietm1978 ($10 in chips) 
Seat 6: MusaiT ($10.91 in chips) 
Seat 9: NEMESIS 5555 ($25.76 in chips) 
soultee88: posts small blind $0.05
luchocpeistor29: is sitting out 
Dorex2007: posts big blind $0.10
*** HOLE CARDS ***
Dealt to Dorex2007 [4d 9h]
luchocpeistor29 leaves the table
AverageJo247: folds 
rookietm1978: folds 
MusaiT: folds 
ACEHbKA777 joins the table at seat #2 
NEMESIS 5555: raises $0.10 to $0.20
soultee88: folds 
Dorex2007: folds 
Uncalled bet ($0.10) returned to NEMESIS 5555
NEMESIS 5555 collected $0.25 from pot
*** SUMMARY ***
Total pot $0.25 | Rake $0 
Seat 1: soultee88 (small blind) folded before Flop
Seat 3: Dorex2007 (big blind) folded before Flop
Seat 4: AverageJo247 folded before Flop (didn't bet)
Seat 5: rookietm1978 folded before Flop (didn't bet)
Seat 6: MusaiT folded before Flop (didn't bet)
Seat 9: NEMESIS 5555 (button) collected ($0.25)



PokerStars Hand #238222407604:  Hold'em No Limit ($0.05/$0.10 USD) - 2022/08/26 1:12:41 PT [2022/08/26 4:12:41 ET]
Table 'Rollandia' 9-max Seat #1 is the button
Seat 1: soultee88 ($11.48 in chips) 
Seat 3: Dorex2007 ($10 in chips) 
Seat 4: AverageJo247 ($11.90 in chips) 
Seat 5: rookietm1978 ($10 in chips) 
Seat 6: MusaiT ($10.91 in chips) 
Seat 9: NEMESIS 5555 ($25.91 in chips) 
Dorex2007: posts small blind $0.05
AverageJo247: posts big blind $0.10
*** HOLE CARDS ***
Dealt to Dorex2007 [Ks 8s]
rookietm1978: folds 
MusaiT: folds 
NEMESIS 5555: raises $0.25 to $0.35
soultee88: calls $0.35
Dorex2007: folds 
AverageJo247: folds 
*** FLOP *** [Tc 7d 8h]
NEMESIS 5555: bets $0.81
masaki0617 is disconnected 
soultee88: folds 
Uncalled bet ($0.81) returned to NEMESIS 5555
NEMESIS 5555 collected $0.81 from pot
*** SUMMARY ***
Total pot $0.85 | Rake $0.04 
Board [Tc 7d 8h]
Seat 1: soultee88 (button) folded on the Flop
Seat 3: Dorex2007 (small blind) folded before Flop
Seat 4: AverageJo247 (big blind) folded before Flop
Seat 5: rookietm1978 folded before Flop (didn't bet)
Seat 6: MusaiT folded before Flop (didn't bet)
Seat 9: NEMESIS 5555 collected ($0.81)



PokerStars Hand #238222411965:  Hold'em No Limit ($0.05/$0.10 USD) - 2022/08/26 1:13:16 PT [2022/08/26 4:13:16 ET]
Table 'Rollandia' 9-max Seat #3 is the button
Seat 1: soultee88 ($11.13 in chips) 
Seat 3: Dorex2007 ($10 in chips) 
Seat 4: AverageJo247 ($11.80 in chips) 
Seat 5: rookietm1978 ($10 in chips) 
Seat 6: MusaiT ($10.91 in chips) 
Seat 9: NEMESIS 5555 ($26.37 in chips) 
AverageJo247: posts small blind $0.05
rookietm1978: posts big blind $0.10
ACEHbKA777: sits out 
*** HOLE CARDS ***
Dealt to Dorex2007 [3c Jd]
MusaiT: folds 
NEMESIS 5555: raises $0.20 to $0.30
soultee88: folds 
Dorex2007: folds 
AverageJo247: folds 
rookietm1978: folds 
Uncalled bet ($0.20) returned to NEMESIS 5555
NEMESIS 5555 collected $0.25 from pot
*** SUMMARY ***
Total pot $0.25 | Rake $0 
Seat 1: soultee88 folded before Flop (didn't bet)
Seat 3: Dorex2007 (button) folded before Flop (didn't bet)
Seat 4: AverageJo247 (small blind) folded before Flop
Seat 5: rookietm1978 (big blind) folded before Flop
Seat 6: MusaiT folded before Flop (didn't bet)
Seat 9: NEMESIS 5555 collected ($0.25)



PokerStars Hand #238222414156:  Hold'em No Limit ($0.05/$0.10 USD) - 2022/08/26 1:13:33 PT [2022/08/26 4:13:33 ET]
Table 'Rollandia' 9-max Seat #4 is the button
Seat 1: soultee88 ($11.13 in chips) 
Seat 3: Dorex2007 ($10 in chips) 
Seat 4: AverageJo247 ($11.75 in chips) 
Seat 5: rookietm1978 ($9.90 in chips) 
Seat 6: MusaiT ($10.91 in chips) 
Seat 9: NEMESIS 5555 ($26.52 in chips) 
rookietm1978: posts small blind $0.05
MusaiT: posts big blind $0.10
ACEHbKA777: sits out 
*** HOLE CARDS ***
Dealt to Dorex2007 [Ks Qd]
NEMESIS 5555: raises $0.25 to $0.35
soultee88: folds 
Dorex2007: calls $0.35
AverageJo247: folds 
rookietm1978: folds 
MusaiT: folds 
*** FLOP *** [Kd 8s 7c]
NEMESIS 5555: bets $0.40
Dorex2007: raises $0.67 to $1.07
NEMESIS 5555: calls $0.67
*** TURN *** [Kd 8s 7c] [Ts]
NEMESIS 5555: checks 
Dorex2007: bets $2.86
NEMESIS 5555: calls $2.86
*** RIVER *** [Kd 8s 7c Ts] [2c]
NEMESIS 5555: checks 
Dorex2007: checks 
*** SHOW DOWN ***
NEMESIS 5555: shows [Jh Jc] (a pair of Jacks)
Dorex2007: shows [Ks Qd] (a pair of Kings)
Dorex2007 collected $8.32 from pot
*** SUMMARY ***
Total pot $8.71 | Rake $0.39 
Board [Kd 8s 7c Ts 2c]
Seat 1: soultee88 folded before Flop (didn't bet)
Seat 3: Dorex2007 showed [Ks Qd] and won ($8.32) with a pair of Kings
Seat 4: AverageJo247 (button) folded before Flop (didn't bet)
Seat 5: rookietm1978 (small blind) folded before Flop
Seat 6: MusaiT (big blind) folded before Flop
Seat 9: NEMESIS 5555 showed [Jh Jc] and lost with a pair of Jacks



PokerStars Hand #238222418839:  Hold'em No Limit ($0.05/$0.10 USD) - 2022/08/26 1:14:11 PT [2022/08/26 4:14:11 ET]
Table 'Rollandia' 9-max Seat #5 is the button
Seat 1: soultee88 ($11.13 in chips) 
Seat 3: Dorex2007 ($14.04 in chips) 
Seat 4: AverageJo247 ($11.75 in chips) 
Seat 5: rookietm1978 ($9.85 in chips) 
Seat 6: MusaiT ($10.81 in chips) 
Seat 9: NEMESIS 5555 ($22.24 in chips) 
MusaiT: posts small blind $0.05
NEMESIS 5555: posts big blind $0.10
ACEHbKA777: sits out 
*** HOLE CARDS ***
Dealt to Dorex2007 [Qs 4s]
soultee88: folds 
Dorex2007: folds 
AverageJo247: folds 
rookietm1978: raises $0.20 to $0.30
MusaiT: folds 
NEMESIS 5555: calls $0.20
*** FLOP *** [2d 2h 7s]
NEMESIS 5555: checks 
rookietm1978: checks 
*** TURN *** [2d 2h 7s] [7h]
NEMESIS 5555: bets $0.31
rookietm1978: calls $0.31
*** RIVER *** [2d 2h 7s 7h] [3s]
NEMESIS 5555: bets $0.60
rookietm1978: raises $0.60 to $1.20
NEMESIS 5555: calls $0.60
*** SHOW DOWN ***
rookietm1978: shows [Qh Qd] (two pair, Queens and Sevens)
NEMESIS 5555: mucks hand 
rookietm1978 collected $3.46 from pot
radubkk leaves the table
masaki0617 leaves the table
*** SUMMARY ***
Total pot $3.67 | Rake $0.21 
Board [2d 2h 7s 7h 3s]
Seat 1: soultee88 folded before Flop (didn't bet)
Seat 3: Dorex2007 folded before Flop (didn't bet)
Seat 4: AverageJo247 folded before Flop (didn't bet)
Seat 5: rookietm1978 (button) showed [Qh Qd] and won ($3.46) with two pair, Queens and Sevens
Seat 6: MusaiT (small blind) folded before Flop
Seat 9: NEMESIS 5555 (big blind) mucked [8s Ah]



PokerStars Hand #238222422980:  Hold'em No Limit ($0.05/$0.10 USD) - 2022/08/26 1:14:45 PT [2022/08/26 4:14:45 ET]
Table 'Rollandia' 9-max Seat #6 is the button
Seat 1: soultee88 ($11.13 in chips) 
Seat 3: Dorex2007 ($14.04 in chips) 
Seat 4: AverageJo247 ($11.75 in chips) 
Seat 5: rookietm1978 ($11.50 in chips) 
Seat 6: MusaiT ($10.76 in chips) 
Seat 9: NEMESIS 5555 ($20.43 in chips) 
NEMESIS 5555: posts small blind $0.05
soultee88: posts big blind $0.10
ACEHbKA777: sits out 
*** HOLE CARDS ***
Dealt to Dorex2007 [Qs 6s]
Dorex2007: folds 
AverageJo247: folds 
rookietm1978: folds 
MusaiT: folds 
NEMESIS 5555: raises $0.10 to $0.20
soultee88: calls $0.10
*** FLOP *** [7c 2h 6h]
Vorontsov28 joins the table at seat #7 
NEMESIS 5555: bets $0.38
gizmondouk joins the table at seat #8 
soultee88: folds 
Uncalled bet ($0.38) returned to NEMESIS 5555
NEMESIS 5555 collected $0.38 from pot
*** SUMMARY ***
Total pot $0.40 | Rake $0.02 
Board [7c 2h 6h]
Seat 1: soultee88 (big blind) folded on the Flop
Seat 3: Dorex2007 folded before Flop (didn't bet)
Seat 4: AverageJo247 folded before Flop (didn't bet)
Seat 5: rookietm1978 folded before Flop (didn't bet)
Seat 6: MusaiT (button) folded before Flop (didn't bet)
Seat 9: NEMESIS 5555 (small blind) collected ($0.38)



PokerStars Hand #238222426318:  Hold'em No Limit ($0.05/$0.10 USD) - 2022/08/26 1:15:12 PT [2022/08/26 4:15:12 ET]
Table 'Rollandia' 9-max Seat #9 is the button
Seat 1: soultee88 ($10.93 in chips) 
Seat 2: ACEHbKA777 ($10 in chips) 
Seat 3: Dorex2007 ($14.04 in chips) 
Seat 4: AverageJo247 ($11.75 in chips) 
Seat 5: rookietm1978 ($11.50 in chips) 
Seat 6: MusaiT ($10.76 in chips) 
Seat 9: NEMESIS 5555 ($20.61 in chips) 
soultee88: posts small blind $0.05
ACEHbKA777: posts big blind $0.10
Vorontsov28: sits out 
gizmondouk: sits out 
*** HOLE CARDS ***
Dealt to Dorex2007 [Td 2h]
Dorex2007: folds 
AverageJo247: folds 
rookietm1978: folds 
MusaiT: folds 
NEMESIS 5555: raises $0.25 to $0.35
soultee88: raises $1.05 to $1.40
ACEHbKA777: folds 
NEMESIS 5555: calls $1.05
*** FLOP *** [5d 2s Ac]
soultee88: bets $0.91
NEMESIS 5555: folds 
Uncalled bet ($0.91) returned to soultee88
soultee88 collected $2.77 from pot
soultee88: doesn't show hand 
*** SUMMARY ***
Total pot $2.90 | Rake $0.13 
Board [5d 2s Ac]
Seat 1: soultee88 (small blind) collected ($2.77)
Seat 2: ACEHbKA777 (big blind) folded before Flop
Seat 3: Dorex2007 folded before Flop (didn't bet)
Seat 4: AverageJo247 folded before Flop (didn't bet)
Seat 5: rookietm1978 folded before Flop (didn't bet)
Seat 6: MusaiT folded before Flop (didn't bet)
Seat 9: NEMESIS 5555 (button) folded on the Flop



PokerStars Hand #238222430558:  Hold'em No Limit ($0.05/$0.10 USD) - 2022/08/26 1:15:47 PT [2022/08/26 4:15:47 ET]
Table 'Rollandia' 9-max Seat #1 is the button
Seat 1: soultee88 ($12.30 in chips) 
Seat 2: ACEHbKA777 ($10 in chips) 
Seat 3: Dorex2007 ($14.04 in chips) 
Seat 4: AverageJo247 ($11.75 in chips) 
Seat 5: rookietm1978 ($11.50 in chips) 
Seat 6: MusaiT ($10.76 in chips) 
Seat 9: NEMESIS 5555 ($19.21 in chips) 
ACEHbKA777: posts small blind $0.05
Dorex2007: posts big blind $0.10
Vorontsov28: sits out 
gizmondouk: sits out 
*** HOLE CARDS ***
Dealt to Dorex2007 [3c 4d]
AverageJo247: folds 
rookietm1978: folds 
MusaiT: folds 
NEMESIS 5555: folds 
soultee88: raises $0.30 to $0.40
ACEHbKA777: folds 
Dorex2007: folds 
Uncalled bet ($0.30) returned to soultee88
soultee88 collected $0.25 from pot
soultee88: doesn't show hand 
*** SUMMARY ***
Total pot $0.25 | Rake $0 
Seat 1: soultee88 (button) collected ($0.25)
Seat 2: ACEHbKA777 (small blind) folded before Flop
Seat 3: Dorex2007 (big blind) folded before Flop
Seat 4: AverageJo247 folded before Flop (didn't bet)
Seat 5: rookietm1978 folded before Flop (didn't bet)
Seat 6: MusaiT folded before Flop (didn't bet)
Seat 9: NEMESIS 5555 folded before Flop (didn't bet)



PokerStars Hand #238222432026:  Hold'em No Limit ($0.05/$0.10 USD) - 2022/08/26 1:15:58 PT [2022/08/26 4:15:58 ET]
Table 'Rollandia' 9-max Seat #2 is the button
Seat 1: soultee88 ($12.45 in chips) 
Seat 2: ACEHbKA777 ($10 in chips) 
Seat 3: Dorex2007 ($13.94 in chips) 
Seat 4: AverageJo247 ($11.75 in chips) 
Seat 5: rookietm1978 ($11.50 in chips) 
Seat 6: MusaiT ($10.76 in chips) 
Seat 9: NEMESIS 5555 ($19.21 in chips) 
Dorex2007: posts small blind $0.05
AverageJo247: posts big blind $0.10
Vorontsov28: sits out 
gizmondouk: sits out 
*** HOLE CARDS ***
Dealt to Dorex2007 [4c 5s]
rookietm1978: folds 
MusaiT: folds 
NEMESIS 5555: folds 
soultee88: folds 
ACEHbKA777: folds 
Dorex2007: folds 
Uncalled bet ($0.05) returned to AverageJo247
AverageJo247 collected $0.10 from pot
*** SUMMARY ***
Total pot $0.10 | Rake $0 
Seat 1: soultee88 folded before Flop (didn't bet)
Seat 2: ACEHbKA777 (button) folded before Flop (didn't bet)
Seat 3: Dorex2007 (small blind) folded before Flop
Seat 4: AverageJo247 (big blind) collected ($0.10)
Seat 5: rookietm1978 folded before Flop (didn't bet)
Seat 6: MusaiT folded before Flop (didn't bet)
Seat 9: NEMESIS 5555 folded before Flop (didn't bet)



PokerStars Hand #238222433303:  Hold'em No Limit ($0.05/$0.10 USD) - 2022/08/26 1:16:09 PT [2022/08/26 4:16:09 ET]
Table 'Rollandia' 9-max Seat #3 is the button
Seat 1: soultee88 ($12.45 in chips) 
Seat 2: ACEHbKA777 ($10 in chips) 
Seat 3: Dorex2007 ($13.89 in chips) 
Seat 4: AverageJo247 ($11.80 in chips) 
Seat 5: rookietm1978 ($11.50 in chips) 
Seat 6: MusaiT ($10.76 in chips) 
Seat 9: NEMESIS 5555 ($19.21 in chips) 
AverageJo247: posts small blind $0.05
rookietm1978: posts big blind $0.10
Vorontsov28: sits out 
gizmondouk: sits out 
*** HOLE CARDS ***
Dealt to Dorex2007 [Qs 3c]
MusaiT: folds 
NEMESIS 5555: raises $0.25 to $0.35
soultee88: folds 
ACEHbKA777: folds 
Dorex2007: folds 
AverageJo247: folds 
rookietm1978: calls $0.25
*** FLOP *** [Kd 2c Ah]
rookietm1978: checks 
NEMESIS 5555: bets $0.72
rookietm1978: calls $0.72
*** TURN *** [Kd 2c Ah] [Js]
rookietm1978: checks 
NEMESIS 5555: checks 
*** RIVER *** [Kd 2c Ah Js] [8c]
rookietm1978: checks 
NEMESIS 5555: checks 
*** SHOW DOWN ***
rookietm1978: shows [Ad 6c] (a pair of Aces)
NEMESIS 5555: mucks hand 
rookietm1978 collected $2.07 from pot
*** SUMMARY ***
Total pot $2.19 | Rake $0.12 
Board [Kd 2c Ah Js 8c]
Seat 1: soultee88 folded before Flop (didn't bet)
Seat 2: ACEHbKA777 folded before Flop (didn't bet)
Seat 3: Dorex2007 (button) folded before Flop (didn't bet)
Seat 4: AverageJo247 (small blind) folded before Flop
Seat 5: rookietm1978 (big blind) showed [Ad 6c] and won ($2.07) with a pair of Aces
Seat 6: MusaiT folded before Flop (didn't bet)
Seat 9: NEMESIS 5555 mucked [3d 2d]



PokerStars Hand #238222437302:  Hold'em No Limit ($0.05/$0.10 USD) - 2022/08/26 1:16:41 PT [2022/08/26 4:16:41 ET]
Table 'Rollandia' 9-max Seat #4 is the button
Seat 1: soultee88 ($12.45 in chips) 
Seat 2: ACEHbKA777 ($10 in chips) 
Seat 3: Dorex2007 ($13.89 in chips) 
Seat 4: AverageJo247 ($11.75 in chips) 
Seat 5: rookietm1978 ($12.50 in chips) 
Seat 6: MusaiT ($10.76 in chips) 
Seat 9: NEMESIS 5555 ($18.14 in chips) 
rookietm1978: posts small blind $0.05
MusaiT: posts big blind $0.10
Vorontsov28: sits out 
gizmondouk: sits out 
*** HOLE CARDS ***
Dealt to Dorex2007 [7d 7c]
NEMESIS 5555: folds 
soultee88: folds 
ACEHbKA777: folds 
Dorex2007: calls $0.10
AverageJo247: folds 
rookietm1978: calls $0.05
MusaiT: checks 
*** FLOP *** [9d Qh Kd]
rookietm1978: checks 
MusaiT: checks 
Dorex2007: checks 
*** TURN *** [9d Qh Kd] [7s]
rookietm1978: checks 
MusaiT: checks 
Dorex2007: bets $0.19
rookietm1978: folds 
MusaiT: folds 
Uncalled bet ($0.19) returned to Dorex2007
Dorex2007 collected $0.29 from pot
Dorex2007: doesn't show hand 
*** SUMMARY ***
Total pot $0.30 | Rake $0.01 
Board [9d Qh Kd 7s]
Seat 1: soultee88 folded before Flop (didn't bet)
Seat 2: ACEHbKA777 folded before Flop (didn't bet)
Seat 3: Dorex2007 collected ($0.29)
Seat 4: AverageJo247 (button) folded before Flop (didn't bet)
Seat 5: rookietm1978 (small blind) folded on the Turn
Seat 6: MusaiT (big blind) folded on the Turn
Seat 9: NEMESIS 5555 folded before Flop (didn't bet)



PokerStars Hand #238222442511:  Hold'em No Limit ($0.05/$0.10 USD) - 2022/08/26 1:17:23 PT [2022/08/26 4:17:23 ET]
Table 'Rollandia' 9-max Seat #5 is the button
Seat 1: soultee88 ($12.45 in chips) 
Seat 2: ACEHbKA777 ($10 in chips) 
Seat 3: Dorex2007 ($14.08 in chips) 
Seat 4: AverageJo247 ($11.75 in chips) 
Seat 5: rookietm1978 ($12.40 in chips) 
Seat 6: MusaiT ($10.66 in chips) 
Seat 7: Vorontsov28 ($10 in chips) 
Seat 9: NEMESIS 5555 ($18.14 in chips) 
MusaiT: posts small blind $0.05
Vorontsov28: posts big blind $0.10
gizmondouk: sits out 
*** HOLE CARDS ***
Dealt to Dorex2007 [2c 7s]
NEMESIS 5555: raises $0.10 to $0.20
soultee88: folds 
ACEHbKA777: calls $0.20
Dorex2007: folds 
AverageJo247: raises $0.40 to $0.60
rookietm1978: folds 
MusaiT: folds 
Vorontsov28: folds 
NEMESIS 5555: calls $0.40
ACEHbKA777: folds 
*** FLOP *** [7c 7h 8s]
NEMESIS 5555: checks 
AverageJo247: bets $0.70
NEMESIS 5555: folds 
Uncalled bet ($0.70) returned to AverageJo247
AverageJo247 collected $1.48 from pot
*** SUMMARY ***
Total pot $1.55 | Rake $0.07 
Board [7c 7h 8s]
Seat 1: soultee88 folded before Flop (didn't bet)
Seat 2: ACEHbKA777 folded before Flop
Seat 3: Dorex2007 folded before Flop (didn't bet)
Seat 4: AverageJo247 collected ($1.48)
Seat 5: rookietm1978 (button) folded before Flop (didn't bet)
Seat 6: MusaiT (small blind) folded before Flop
Seat 7: Vorontsov28 (big blind) folded before Flop
Seat 9: NEMESIS 5555 folded on the Flop



PokerStars Hand #238222451196:  Hold'em No Limit ($0.05/$0.10 USD) - 2022/08/26 1:18:32 PT [2022/08/26 4:18:32 ET]
Table 'Rollandia' 9-max Seat #6 is the button
Seat 1: soultee88 ($12.45 in chips) 
Seat 2: ACEHbKA777 ($10 in chips) 
Seat 3: Dorex2007 ($14.08 in chips) 
Seat 4: AverageJo247 ($12.63 in chips) 
Seat 5: rookietm1978 ($12.40 in chips) 
Seat 6: MusaiT ($10.61 in chips) 
Seat 7: Vorontsov28 ($10 in chips) 
Seat 8: gizmondouk ($10 in chips) 
Seat 9: NEMESIS 5555 ($17.54 in chips) 
Vorontsov28: posts small blind $0.05
gizmondouk: posts big blind $0.10
*** HOLE CARDS ***
Dealt to Dorex2007 [9d Js]
NEMESIS 5555: folds 
soultee88: folds 
ACEHbKA777: folds 
Dorex2007: folds 
AverageJo247: folds 
rookietm1978: calls $0.10
MusaiT: folds 
Vorontsov28: folds 
gizmondouk: checks 
*** FLOP *** [3h 3d Kd]
gizmondouk: bets $0.12
rookietm1978: calls $0.12
*** TURN *** [3h 3d Kd] [8h]
gizmondouk: bets $0.30
rookietm1978: folds 
Uncalled bet ($0.30) returned to gizmondouk
gizmondouk collected $0.47 from pot
gizmondouk: doesn't show hand 
*** SUMMARY ***
Total pot $0.49 | Rake $0.02 
Board [3h 3d Kd 8h]
Seat 1: soultee88 folded before Flop (didn't bet)
Seat 2: ACEHbKA777 folded before Flop (didn't bet)
Seat 3: Dorex2007 folded before Flop (didn't bet)
Seat 4: AverageJo247 folded before Flop (didn't bet)
Seat 5: rookietm1978 folded on the Turn
Seat 6: MusaiT (button) folded before Flop (didn't bet)
Seat 7: Vorontsov28 (small blind) folded before Flop
Seat 8: gizmondouk (big blind) collected ($0.47)
Seat 9: NEMESIS 5555 folded before Flop (didn't bet)



PokerStars Hand #238222456623:  Hold'em No Limit ($0.05/$0.10 USD) - 2022/08/26 1:19:16 PT [2022/08/26 4:19:16 ET]
Table 'Rollandia' 9-max Seat #7 is the button
Seat 1: soultee88 ($12.45 in chips) 
Seat 2: ACEHbKA777 ($10 in chips) 
Seat 3: Dorex2007 ($14.08 in chips) 
Seat 4: AverageJo247 ($12.63 in chips) 
Seat 5: rookietm1978 ($12.18 in chips) 
Seat 6: MusaiT ($10.61 in chips) 
Seat 7: Vorontsov28 ($10 in chips) 
Seat 8: gizmondouk ($10.25 in chips) 
Seat 9: NEMESIS 5555 ($17.54 in chips) 
gizmondouk: posts small blind $0.05
NEMESIS 5555: posts big blind $0.10
*** HOLE CARDS ***
Dealt to Dorex2007 [4d Kh]
soultee88: folds 
ACEHbKA777: raises $0.25 to $0.35
Dorex2007: folds 
AverageJo247: folds 
rookietm1978: folds 
MusaiT: folds 
Vorontsov28: folds 
gizmondouk: folds 
NEMESIS 5555 has timed out
NEMESIS 5555: folds 
Uncalled bet ($0.25) returned to ACEHbKA777
ACEHbKA777 collected $0.25 from pot
*** SUMMARY ***
Total pot $0.25 | Rake $0 
Seat 1: soultee88 folded before Flop (didn't bet)
Seat 2: ACEHbKA777 collected ($0.25)
Seat 3: Dorex2007 folded before Flop (didn't bet)
Seat 4: AverageJo247 folded before Flop (didn't bet)
Seat 5: rookietm1978 folded before Flop (didn't bet)
Seat 6: MusaiT folded before Flop (didn't bet)
Seat 7: Vorontsov28 (button) folded before Flop (didn't bet)
Seat 8: gizmondouk (small blind) folded before Flop
Seat 9: NEMESIS 5555 (big blind) folded before Flop



PokerStars Hand #238222465388:  Hold'em No Limit ($0.05/$0.10 USD) - 2022/08/26 1:20:25 PT [2022/08/26 4:20:25 ET]
Table 'Rollandia' 9-max Seat #8 is the button
Seat 1: soultee88 ($12.45 in chips) 
Seat 2: ACEHbKA777 ($10.15 in chips) 
Seat 3: Dorex2007 ($14.08 in chips) 
Seat 4: AverageJo247 ($12.63 in chips) 
Seat 5: rookietm1978 ($12.18 in chips) 
Seat 6: MusaiT ($10.61 in chips) 
Seat 7: Vorontsov28 ($10 in chips) 
Seat 8: gizmondouk ($10.20 in chips) 
Seat 9: NEMESIS 5555 ($17.44 in chips) 
NEMESIS 5555: posts small blind $0.05
soultee88: posts big blind $0.10
*** HOLE CARDS ***
Dealt to Dorex2007 [8s Ac]
ACEHbKA777: raises $0.20 to $0.30
Dorex2007: folds 
AverageJo247: folds 
rookietm1978: folds 
MusaiT: folds 
Vorontsov28: folds 
gizmondouk: raises $0.60 to $0.90
NEMESIS 5555: calls $0.85
soultee88: folds 
ACEHbKA777: calls $0.60
*** FLOP *** [6h Kh 6d]
NEMESIS 5555: checks 
ACEHbKA777: checks 
gizmondouk: checks 
*** TURN *** [6h Kh 6d] [3s]
NEMESIS 5555: bets $0.40
ACEHbKA777: raises $0.88 to $1.28
gizmondouk: folds 
NEMESIS 5555: calls $0.88
*** RIVER *** [6h Kh 6d 3s] [5h]
NEMESIS 5555: checks 
ACEHbKA777: checks 
*** SHOW DOWN ***
NEMESIS 5555: shows [5d 4h] (two pair, Sixes and Fives)
ACEHbKA777: shows [Qc Qh] (two pair, Queens and Sixes)
ACEHbKA777 collected $5.12 from pot
*** SUMMARY ***
Total pot $5.36 | Rake $0.24 
Board [6h Kh 6d 3s 5h]
Seat 1: soultee88 (big blind) folded before Flop
Seat 2: ACEHbKA777 showed [Qc Qh] and won ($5.12) with two pair, Queens and Sixes
Seat 3: Dorex2007 folded before Flop (didn't bet)
Seat 4: AverageJo247 folded before Flop (didn't bet)
Seat 5: rookietm1978 folded before Flop (didn't bet)
Seat 6: MusaiT folded before Flop (didn't bet)
Seat 7: Vorontsov28 folded before Flop (didn't bet)
Seat 8: gizmondouk (button) folded on the Turn
Seat 9: NEMESIS 5555 (small blind) showed [5d 4h] and lost with two pair, Sixes and Fives



PokerStars Hand #238222473478:  Hold'em No Limit ($0.05/$0.10 USD) - 2022/08/26 1:21:30 PT [2022/08/26 4:21:30 ET]
Table 'Rollandia' 9-max Seat #9 is the button
Seat 1: soultee88 ($12.35 in chips) 
Seat 2: ACEHbKA777 ($13.09 in chips) 
Seat 3: Dorex2007 ($14.08 in chips) 
Seat 4: AverageJo247 ($12.63 in chips) 
Seat 5: rookietm1978 ($12.18 in chips) 
Seat 6: MusaiT ($10.61 in chips) 
Seat 7: Vorontsov28 ($10 in chips) 
Seat 8: gizmondouk ($10 in chips) 
Seat 9: NEMESIS 5555 ($15.26 in chips) 
soultee88: posts small blind $0.05
ACEHbKA777: posts big blind $0.10
*** HOLE CARDS ***
Dealt to Dorex2007 [5s Ac]
Dorex2007: folds 
AverageJo247: folds 
rookietm1978: folds 
MusaiT: folds 
Vorontsov28: raises $0.20 to $0.30
gizmondouk: folds 
NEMESIS 5555: calls $0.30
soultee88: folds 
ACEHbKA777: folds 
*** FLOP *** [Kc Jd 7d]
Vorontsov28: bets $0.50
NEMESIS 5555: calls $0.50
*** TURN *** [Kc Jd 7d] [As]
Vorontsov28: checks 
NEMESIS 5555: bets $1.67
Vorontsov28: calls $1.67
*** RIVER *** [Kc Jd 7d As] [6c]
Vorontsov28: checks 
NEMESIS 5555: bets $4.86
Vorontsov28: folds 
Uncalled bet ($4.86) returned to NEMESIS 5555
NEMESIS 5555 collected $4.86 from pot
*** SUMMARY ***
Total pot $5.09 | Rake $0.23 
Board [Kc Jd 7d As 6c]
Seat 1: soultee88 (small blind) folded before Flop
Seat 2: ACEHbKA777 (big blind) folded before Flop
Seat 3: Dorex2007 folded before Flop (didn't bet)
Seat 4: AverageJo247 folded before Flop (didn't bet)
Seat 5: rookietm1978 folded before Flop (didn't bet)
Seat 6: MusaiT folded before Flop (didn't bet)
Seat 7: Vorontsov28 folded on the River
Seat 8: gizmondouk folded before Flop (didn't bet)
Seat 9: NEMESIS 5555 (button) collected ($4.86)



PokerStars Hand #238222478901:  Hold'em No Limit ($0.05/$0.10 USD) - 2022/08/26 1:22:13 PT [2022/08/26 4:22:13 ET]
Table 'Rollandia' 9-max Seat #1 is the button
Seat 1: soultee88 ($12.30 in chips) 
Seat 2: ACEHbKA777 ($12.99 in chips) 
Seat 3: Dorex2007 ($14.08 in chips) 
Seat 4: AverageJo247 ($12.63 in chips) 
Seat 5: rookietm1978 ($12.18 in chips) 
Seat 6: MusaiT ($10.61 in chips) 
Seat 7: Vorontsov28 ($10 in chips) 
Seat 8: gizmondouk ($10 in chips) 
Seat 9: NEMESIS 5555 ($17.65 in chips) 
ACEHbKA777: posts small blind $0.05
Dorex2007: posts big blind $0.10
*** HOLE CARDS ***
Dealt to Dorex2007 [Ad Qc]
AverageJo247: folds 
rookietm1978: raises $0.20 to $0.30
MusaiT: folds 
Vorontsov28: folds 
gizmondouk: folds 
NEMESIS 5555: folds 
soultee88: calls $0.30
ACEHbKA777: folds 
Dorex2007: calls $0.20
*** FLOP *** [Kc Jc 8h]
Dorex2007: checks 
rookietm1978: checks 
soultee88: bets $0.50
Dorex2007: calls $0.50
rookietm1978: folds 
*** TURN *** [Kc Jc 8h] [3c]
Dorex2007: checks 
soultee88: checks 
*** RIVER *** [Kc Jc 8h 3c] [9c]
Dorex2007: bets $1.86
soultee88: folds 
Uncalled bet ($1.86) returned to Dorex2007
Dorex2007 collected $1.86 from pot
Dorex2007: doesn't show hand 
*** SUMMARY ***
Total pot $1.95 | Rake $0.09 
Board [Kc Jc 8h 3c 9c]
Seat 1: soultee88 (button) folded on the River
Seat 2: ACEHbKA777 (small blind) folded before Flop
Seat 3: Dorex2007 (big blind) collected ($1.86)
Seat 4: AverageJo247 folded before Flop (didn't bet)
Seat 5: rookietm1978 folded on the Flop
Seat 6: MusaiT folded before Flop (didn't bet)
Seat 7: Vorontsov28 folded before Flop (didn't bet)
Seat 8: gizmondouk folded before Flop (didn't bet)
Seat 9: NEMESIS 5555 folded before Flop (didn't bet)



PokerStars Hand #238222486919:  Hold'em No Limit ($0.05/$0.10 USD) - 2022/08/26 1:23:17 PT [2022/08/26 4:23:17 ET]
Table 'Rollandia' 9-max Seat #2 is the button
Seat 1: soultee88 ($11.50 in chips) 
Seat 2: ACEHbKA777 ($12.94 in chips) 
Seat 3: Dorex2007 ($15.14 in chips) 
Seat 4: AverageJo247 ($12.63 in chips) 
Seat 5: rookietm1978 ($11.88 in chips) 
Seat 6: MusaiT ($10.61 in chips) 
Seat 8: gizmondouk ($10 in chips) 
Seat 9: NEMESIS 5555 ($17.65 in chips) 
Dorex2007: posts small blind $0.05
AverageJo247: posts big blind $0.10
*** HOLE CARDS ***
Dealt to Dorex2007 [Th As]
rookietm1978: folds 
MusaiT: folds 
gizmondouk: raises $0.20 to $0.30
NEMESIS 5555: calls $0.30
soultee88: calls $0.30
ACEHbKA777: folds 
Dorex2007: folds 
AverageJo247: folds 
*** FLOP *** [7h 7d 8d]
gizmondouk: checks 
NEMESIS 5555: checks 
soultee88: checks 
*** TURN *** [7h 7d 8d] [6c]
gizmondouk: bets $0.60
NEMESIS 5555: calls $0.60
soultee88: folds 
*** RIVER *** [7h 7d 8d 6c] [8s]
gizmondouk: checks 
NEMESIS 5555: checks 
*** SHOW DOWN ***
gizmondouk: shows [6d 6s] (a full house, Sixes full of Eights)
NEMESIS 5555: mucks hand 
gizmondouk collected $2.15 from pot
*** SUMMARY ***
Total pot $2.25 | Rake $0.10 
Board [7h 7d 8d 6c 8s]
Seat 1: soultee88 folded on the Turn
Seat 2: ACEHbKA777 (button) folded before Flop (didn't bet)
Seat 3: Dorex2007 (small blind) folded before Flop
Seat 4: AverageJo247 (big blind) folded before Flop
Seat 5: rookietm1978 folded before Flop (didn't bet)
Seat 6: MusaiT folded before Flop (didn't bet)
Seat 8: gizmondouk showed [6d 6s] and won ($2.15) with a full house, Sixes full of Eights
Seat 9: NEMESIS 5555 mucked [Tc Ah]



PokerStars Hand #238222492977:  Hold'em No Limit ($0.05/$0.10 USD) - 2022/08/26 1:24:05 PT [2022/08/26 4:24:05 ET]
Table 'Rollandia' 9-max Seat #3 is the button
Seat 1: soultee88 ($11.20 in chips) 
Seat 2: ACEHbKA777 ($12.94 in chips) 
Seat 3: Dorex2007 ($15.09 in chips) 
Seat 4: AverageJo247 ($12.53 in chips) 
Seat 5: rookietm1978 ($11.88 in chips) 
Seat 6: MusaiT ($10.61 in chips) 
Seat 8: gizmondouk ($11.25 in chips) 
Seat 9: NEMESIS 5555 ($16.75 in chips) 
AverageJo247: posts small blind $0.05
rookietm1978: posts big blind $0.10
*** HOLE CARDS ***
Dealt to Dorex2007 [Tc Qh]
MusaiT: folds 
gizmondouk: folds 
NEMESIS 5555: folds 
soultee88: folds 
ACEHbKA777: folds 
Dorex2007: calls $0.10
AverageJo247: calls $0.05
rookietm1978: checks 
*** FLOP *** [4s 7s 9h]
AverageJo247: checks 
rookietm1978: bets $0.14
Dorex2007: folds 
AverageJo247: calls $0.14
*** TURN *** [4s 7s 9h] [3c]
AverageJo247: checks 
rookietm1978: bets $0.40
AverageJo247: folds 
Uncalled bet ($0.40) returned to rookietm1978
rookietm1978 collected $0.54 from pot
rookietm1978: doesn't show hand 
*** SUMMARY ***
Total pot $0.58 | Rake $0.04 
Board [4s 7s 9h 3c]
Seat 1: soultee88 folded before Flop (didn't bet)
Seat 2: ACEHbKA777 folded before Flop (didn't bet)
Seat 3: Dorex2007 (button) folded on the Flop
Seat 4: AverageJo247 (small blind) folded on the Turn
Seat 5: rookietm1978 (big blind) collected ($0.54)
Seat 6: MusaiT folded before Flop (didn't bet)
Seat 8: gizmondouk folded before Flop (didn't bet)
Seat 9: NEMESIS 5555 folded before Flop (didn't bet)



PokerStars Hand #238222500424:  Hold'em No Limit ($0.05/$0.10 USD) - 2022/08/26 1:25:03 PT [2022/08/26 4:25:03 ET]
Table 'Rollandia' 9-max Seat #4 is the button
Seat 1: soultee88 ($11.20 in chips) 
Seat 2: ACEHbKA777 ($12.94 in chips) 
Seat 3: Dorex2007 ($14.99 in chips) 
Seat 4: AverageJo247 ($12.29 in chips) 
Seat 5: rookietm1978 ($12.18 in chips) 
Seat 6: MusaiT ($10.61 in chips) 
Seat 8: gizmondouk ($11.25 in chips) 
Seat 9: NEMESIS 5555 ($16.75 in chips) 
rookietm1978: posts small blind $0.05
MusaiT: posts big blind $0.10
*** HOLE CARDS ***
Dealt to Dorex2007 [Td 6s]
gizmondouk: folds 
NEMESIS 5555: folds 
soultee88: folds 
ACEHbKA777: raises $0.10 to $0.20
Dorex2007: folds 
AverageJo247: folds 
rookietm1978: folds 
MusaiT: calls $0.10
*** FLOP *** [4h 8d Ts]
MusaiT: checks 
AverageJo247 leaves the table
ACEHbKA777: checks 
*** TURN *** [4h 8d Ts] [Js]
MusaiT: checks 
ACEHbKA777: checks 
*** RIVER *** [4h 8d Ts Js] [Ad]
_ne katit_1 joins the table at seat #4 
MusaiT: checks 
ACEHbKA777: checks 
*** SHOW DOWN ***
MusaiT: shows [4d 4c] (three of a kind, Fours)
ACEHbKA777: mucks hand 
MusaiT collected $0.43 from pot
*** SUMMARY ***
Total pot $0.45 | Rake $0.02 
Board [4h 8d Ts Js Ad]
Seat 1: soultee88 folded before Flop (didn't bet)
Seat 2: ACEHbKA777 mucked [3c 3h]
Seat 3: Dorex2007 folded before Flop (didn't bet)
Seat 4: AverageJo247 (button) folded before Flop (didn't bet)
Seat 5: rookietm1978 (small blind) folded before Flop
Seat 6: MusaiT (big blind) showed [4d 4c] and won ($0.43) with three of a kind, Fours
Seat 8: gizmondouk folded before Flop (didn't bet)
Seat 9: NEMESIS 5555 folded before Flop (didn't bet)



PokerStars Hand #238222505480:  Hold'em No Limit ($0.05/$0.10 USD) - 2022/08/26 1:25:44 PT [2022/08/26 4:25:44 ET]
Table 'Rollandia' 9-max Seat #5 is the button
Seat 1: soultee88 ($11.20 in chips) 
Seat 2: ACEHbKA777 ($12.74 in chips) 
Seat 3: Dorex2007 ($14.99 in chips) 
Seat 5: rookietm1978 ($12.13 in chips) 
Seat 6: MusaiT ($10.84 in chips) 
Seat 8: gizmondouk ($11.25 in chips) 
Seat 9: NEMESIS 5555 ($16.75 in chips) 
MusaiT: posts small blind $0.05
gizmondouk: posts big blind $0.10
_ne katit_1: sits out 
*** HOLE CARDS ***
Dealt to Dorex2007 [2d 4d]
NEMESIS 5555: raises $0.25 to $0.35
soultee88: folds 
ACEHbKA777: folds 
Dorex2007: folds 
rookietm1978: folds 
MusaiT: folds 
gizmondouk: folds 
Uncalled bet ($0.25) returned to NEMESIS 5555
NEMESIS 5555 collected $0.25 from pot
*** SUMMARY ***
Total pot $0.25 | Rake $0 
Seat 1: soultee88 folded before Flop (didn't bet)
Seat 2: ACEHbKA777 folded before Flop (didn't bet)
Seat 3: Dorex2007 folded before Flop (didn't bet)
Seat 5: rookietm1978 (button) folded before Flop (didn't bet)
Seat 6: MusaiT (small blind) folded before Flop
Seat 8: gizmondouk (big blind) folded before Flop
Seat 9: NEMESIS 5555 collected ($0.25)



PokerStars Hand #238222507546:  Hold'em No Limit ($0.05/$0.10 USD) - 2022/08/26 1:26:00 PT [2022/08/26 4:26:00 ET]
Table 'Rollandia' 9-max Seat #6 is the button
Seat 1: soultee88 ($11.20 in chips) 
Seat 2: ACEHbKA777 ($12.74 in chips) 
Seat 3: Dorex2007 ($14.99 in chips) 
Seat 5: rookietm1978 ($12.13 in chips) 
Seat 6: MusaiT ($10.79 in chips) 
Seat 8: gizmondouk ($11.15 in chips) 
Seat 9: NEMESIS 5555 ($16.90 in chips) 
gizmondouk: posts small blind $0.05
NEMESIS 5555: posts big blind $0.10
_ne katit_1: sits out 
*** HOLE CARDS ***
Dealt to Dorex2007 [Js 7d]
soultee88: folds 
ACEHbKA777: calls $0.10
Dorex2007: folds 
rookietm1978: folds 
MusaiT: raises $0.25 to $0.35
gizmondouk: folds 
NEMESIS 5555: folds 
ACEHbKA777: calls $0.25
*** FLOP *** [8d Ah Kh]
ACEHbKA777: checks 
MusaiT: bets $0.49
ACEHbKA777: folds 
Uncalled bet ($0.49) returned to MusaiT
MusaiT collected $0.81 from pot
MusaiT: doesn't show hand 
*** SUMMARY ***
Total pot $0.85 | Rake $0.04 
Board [8d Ah Kh]
Seat 1: soultee88 folded before Flop (didn't bet)
Seat 2: ACEHbKA777 folded on the Flop
Seat 3: Dorex2007 folded before Flop (didn't bet)
Seat 5: rookietm1978 folded before Flop (didn't bet)
Seat 6: MusaiT (button) collected ($0.81)
Seat 8: gizmondouk (small blind) folded before Flop
Seat 9: NEMESIS 5555 (big blind) folded before Flop



PokerStars Hand #238222511791:  Hold'em No Limit ($0.05/$0.10 USD) - 2022/08/26 1:26:33 PT [2022/08/26 4:26:33 ET]
Table 'Rollandia' 9-max Seat #8 is the button
Seat 1: soultee88 ($11.20 in chips) 
Seat 2: ACEHbKA777 ($12.39 in chips) 
Seat 3: Dorex2007 ($14.99 in chips) 
Seat 5: rookietm1978 ($12.13 in chips) 
Seat 6: MusaiT ($11.25 in chips) 
Seat 8: gizmondouk ($11.10 in chips) 
Seat 9: NEMESIS 5555 ($16.80 in chips) 
NEMESIS 5555: posts small blind $0.05
soultee88: posts big blind $0.10
_ne katit_1: sits out 
*** HOLE CARDS ***
Dealt to Dorex2007 [5s Ah]
ACEHbKA777: folds 
Dorex2007: folds 
rookietm1978: raises $0.20 to $0.30
MusaiT: folds 
gizmondouk: folds 
NEMESIS 5555: calls $0.25
soultee88: folds 
*** FLOP *** [As 9c 3d]
NEMESIS 5555: checks 
rookietm1978: checks 
*** TURN *** [As 9c 3d] [2d]
NEMESIS 5555: checks 
rookietm1978: bets $0.33
NEMESIS 5555: folds 
Uncalled bet ($0.33) returned to rookietm1978
rookietm1978 collected $0.66 from pot
rookietm1978: doesn't show hand 
*** SUMMARY ***
Total pot $0.70 | Rake $0.04 
Board [As 9c 3d 2d]
Seat 1: soultee88 (big blind) folded before Flop
Seat 2: ACEHbKA777 folded before Flop (didn't bet)
Seat 3: Dorex2007 folded before Flop (didn't bet)
Seat 5: rookietm1978 collected ($0.66)
Seat 6: MusaiT folded before Flop (didn't bet)
Seat 8: gizmondouk (button) folded before Flop (didn't bet)
Seat 9: NEMESIS 5555 (small blind) folded on the Turn



PokerStars Hand #238222517059:  Hold'em No Limit ($0.05/$0.10 USD) - 2022/08/26 1:27:15 PT [2022/08/26 4:27:15 ET]
Table 'Rollandia' 9-max Seat #9 is the button
Seat 1: soultee88 ($11.10 in chips) 
Seat 2: ACEHbKA777 ($12.39 in chips) 
Seat 3: Dorex2007 ($14.99 in chips) 
Seat 5: rookietm1978 ($12.49 in chips) 
Seat 6: MusaiT ($11.25 in chips) 
Seat 8: gizmondouk ($11.10 in chips) 
Seat 9: NEMESIS 5555 ($16.50 in chips) 
soultee88: posts small blind $0.05
ACEHbKA777: posts big blind $0.10
_ne katit_1: sits out 
*** HOLE CARDS ***
Dealt to Dorex2007 [8c 3c]
Dorex2007: folds 
rookietm1978: folds 
MusaiT: folds 
gizmondouk: folds 
NEMESIS 5555: raises $0.10 to $0.20
soultee88: folds 
ACEHbKA777: calls $0.10
*** FLOP *** [Kd Jh 8d]
ACEHbKA777: checks 
NEMESIS 5555: bets $0.43
ACEHbKA777: folds 
Uncalled bet ($0.43) returned to NEMESIS 5555
NEMESIS 5555 collected $0.43 from pot
*** SUMMARY ***
Total pot $0.45 | Rake $0.02 
Board [Kd Jh 8d]
Seat 1: soultee88 (small blind) folded before Flop
Seat 2: ACEHbKA777 (big blind) folded on the Flop
Seat 3: Dorex2007 folded before Flop (didn't bet)
Seat 5: rookietm1978 folded before Flop (didn't bet)
Seat 6: MusaiT folded before Flop (didn't bet)
Seat 8: gizmondouk folded before Flop (didn't bet)
Seat 9: NEMESIS 5555 (button) collected ($0.43)



PokerStars Hand #238222519201:  Hold'em No Limit ($0.05/$0.10 USD) - 2022/08/26 1:27:32 PT [2022/08/26 4:27:32 ET]
Table 'Rollandia' 9-max Seat #1 is the button
Seat 1: soultee88 ($11.05 in chips) 
Seat 2: ACEHbKA777 ($12.19 in chips) 
Seat 3: Dorex2007 ($14.99 in chips) 
Seat 5: rookietm1978 ($12.49 in chips) 
Seat 6: MusaiT ($11.25 in chips) 
Seat 8: gizmondouk ($11.10 in chips) 
Seat 9: NEMESIS 5555 ($16.73 in chips) 
ACEHbKA777: posts small blind $0.05
Dorex2007: posts big blind $0.10
_ne katit_1: sits out 
*** HOLE CARDS ***
Dealt to Dorex2007 [2s Td]
rookietm1978: folds 
MusaiT: folds 
gizmondouk: raises $0.20 to $0.30
NEMESIS 5555: calls $0.30
soultee88: folds 
ACEHbKA777: calls $0.25
Dorex2007: folds 
*** FLOP *** [Ac Th 7d]
ACEHbKA777: checks 
gizmondouk: checks 
NEMESIS 5555: checks 
*** TURN *** [Ac Th 7d] [As]
ACEHbKA777: bets $0.47
gizmondouk: folds 
NEMESIS 5555: calls $0.47
*** RIVER *** [Ac Th 7d As] [6d]
ACEHbKA777: bets $0.62
NEMESIS 5555: calls $0.62
*** SHOW DOWN ***
ACEHbKA777: shows [Qs Ad] (three of a kind, Aces)
NEMESIS 5555: mucks hand 
ACEHbKA777 collected $3.04 from pot
*** SUMMARY ***
Total pot $3.18 | Rake $0.14 
Board [Ac Th 7d As 6d]
Seat 1: soultee88 (button) folded before Flop (didn't bet)
Seat 2: ACEHbKA777 (small blind) showed [Qs Ad] and won ($3.04) with three of a kind, Aces
Seat 3: Dorex2007 (big blind) folded before Flop
Seat 5: rookietm1978 folded before Flop (didn't bet)
Seat 6: MusaiT folded before Flop (didn't bet)
Seat 8: gizmondouk folded on the Turn
Seat 9: NEMESIS 5555 mucked [Jh 7s]



PokerStars Hand #238222524226:  Hold'em No Limit ($0.05/$0.10 USD) - 2022/08/26 1:28:11 PT [2022/08/26 4:28:11 ET]
Table 'Rollandia' 9-max Seat #2 is the button
Seat 1: soultee88 ($11.05 in chips) 
Seat 2: ACEHbKA777 ($13.84 in chips) 
Seat 3: Dorex2007 ($14.89 in chips) 
Seat 4: _ne katit_1 ($10 in chips) 
Seat 5: rookietm1978 ($12.49 in chips) 
Seat 6: MusaiT ($11.25 in chips) 
Seat 8: gizmondouk ($10.80 in chips) 
Seat 9: NEMESIS 5555 ($15.34 in chips) 
Dorex2007: posts small blind $0.05
_ne katit_1: posts big blind $0.10
*** HOLE CARDS ***
Dealt to Dorex2007 [Tc 7d]
rookietm1978: folds 
MusaiT: folds 
gizmondouk: folds 
NEMESIS 5555: folds 
soultee88: folds 
ACEHbKA777: folds 
Dorex2007: folds 
Uncalled bet ($0.05) returned to _ne katit_1
_ne katit_1 collected $0.10 from pot
_ne katit_1: doesn't show hand 
*** SUMMARY ***
Total pot $0.10 | Rake $0 
Seat 1: soultee88 folded before Flop (didn't bet)
Seat 2: ACEHbKA777 (button) folded before Flop (didn't bet)
Seat 3: Dorex2007 (small blind) folded before Flop
Seat 4: _ne katit_1 (big blind) collected ($0.10)
Seat 5: rookietm1978 folded before Flop (didn't bet)
Seat 6: MusaiT folded before Flop (didn't bet)
Seat 8: gizmondouk folded before Flop (didn't bet)
Seat 9: NEMESIS 5555 folded before Flop (didn't bet)



PokerStars Hand #238222525679:  Hold'em No Limit ($0.05/$0.10 USD) - 2022/08/26 1:28:22 PT [2022/08/26 4:28:22 ET]
Table 'Rollandia' 9-max Seat #3 is the button
Seat 1: soultee88 ($11.05 in chips) 
Seat 2: ACEHbKA777 ($13.84 in chips) 
Seat 3: Dorex2007 ($14.84 in chips) 
Seat 4: _ne katit_1 ($10.05 in chips) 
Seat 5: rookietm1978 ($12.49 in chips) 
Seat 6: MusaiT ($11.25 in chips) 
Seat 8: gizmondouk ($10.80 in chips) 
Seat 9: NEMESIS 5555 ($15.34 in chips) 
_ne katit_1: posts small blind $0.05
rookietm1978: posts big blind $0.10
*** HOLE CARDS ***
Dealt to Dorex2007 [7d 7h]
MusaiT: folds 
gizmondouk: folds 
NEMESIS 5555: raises $0.25 to $0.35
soultee88: folds 
ACEHbKA777: folds 
Dorex2007: calls $0.35
_ne katit_1: folds 
rookietm1978: calls $0.25
*** FLOP *** [Qh 2s 4d]
Vorontsov28 leaves the table
rookietm1978: checks 
NEMESIS 5555: checks 
Dorex2007: checks 
*** TURN *** [Qh 2s 4d] [Th]
rookietm1978: checks 
NEMESIS 5555: bets $0.52
Dorex2007: folds 
rookietm1978: calls $0.52
*** RIVER *** [Qh 2s 4d Th] [Ah]
rookietm1978: checks 
NEMESIS 5555: checks 
*** SHOW DOWN ***
rookietm1978: shows [Tc Jh] (a pair of Tens)
NEMESIS 5555: mucks hand 
rookietm1978 collected $2.02 from pot
*** SUMMARY ***
Total pot $2.14 | Rake $0.12 
Board [Qh 2s 4d Th Ah]
Seat 1: soultee88 folded before Flop (didn't bet)
Seat 2: ACEHbKA777 folded before Flop (didn't bet)
Seat 3: Dorex2007 (button) folded on the Turn
Seat 4: _ne katit_1 (small blind) folded before Flop
Seat 5: rookietm1978 (big blind) showed [Tc Jh] and won ($2.02) with a pair of Tens
Seat 6: MusaiT folded before Flop (didn't bet)
Seat 8: gizmondouk folded before Flop (didn't bet)
Seat 9: NEMESIS 5555 mucked [8s 5s]



PokerStars Hand #238222531325:  Hold'em No Limit ($0.05/$0.10 USD) - 2022/08/26 1:29:06 PT [2022/08/26 4:29:06 ET]
Table 'Rollandia' 9-max Seat #4 is the button
Seat 1: soultee88 ($11.05 in chips) 
Seat 2: ACEHbKA777 ($13.84 in chips) 
Seat 3: Dorex2007 ($14.49 in chips) 
Seat 4: _ne katit_1 ($10 in chips) 
Seat 5: rookietm1978 ($13.64 in chips) 
Seat 6: MusaiT ($11.25 in chips) 
Seat 8: gizmondouk ($10.80 in chips) 
Seat 9: NEMESIS 5555 ($14.47 in chips) 
rookietm1978: posts small blind $0.05
MusaiT: posts big blind $0.10
*** HOLE CARDS ***
Dealt to Dorex2007 [6h 8c]
gizmondouk: folds 
NEMESIS 5555: raises $0.10 to $0.20
soultee88: folds 
ACEHbKA777: folds 
Dorex2007: folds 
_ne katit_1: folds 
rookietm1978: calls $0.15
MusaiT: folds 
*** FLOP *** [Qs 7h 9d]
rookietm1978: checks 
NEMESIS 5555: bets $0.48
rookietm1978: folds 
Uncalled bet ($0.48) returned to NEMESIS 5555
NEMESIS 5555 collected $0.48 from pot
*** SUMMARY ***
Total pot $0.50 | Rake $0.02 
Board [Qs 7h 9d]
Seat 1: soultee88 folded before Flop (didn't bet)
Seat 2: ACEHbKA777 folded before Flop (didn't bet)
Seat 3: Dorex2007 folded before Flop (didn't bet)
Seat 4: _ne katit_1 (button) folded before Flop (didn't bet)
Seat 5: rookietm1978 (small blind) folded on the Flop
Seat 6: MusaiT (big blind) folded before Flop
Seat 8: gizmondouk folded before Flop (didn't bet)
Seat 9: NEMESIS 5555 collected ($0.48)



PokerStars Hand #238222535152:  Hold'em No Limit ($0.05/$0.10 USD) - 2022/08/26 1:29:36 PT [2022/08/26 4:29:36 ET]
Table 'Rollandia' 9-max Seat #5 is the button
Seat 1: soultee88 ($11.05 in chips) 
Seat 2: ACEHbKA777 ($13.84 in chips) 
Seat 3: Dorex2007 ($14.49 in chips) 
Seat 4: _ne katit_1 ($10 in chips) 
Seat 5: rookietm1978 ($13.44 in chips) 
Seat 6: MusaiT ($11.15 in chips) 
Seat 8: gizmondouk ($10.80 in chips) 
Seat 9: NEMESIS 5555 ($14.75 in chips) 
MusaiT: posts small blind $0.05
gizmondouk: posts big blind $0.10
*** HOLE CARDS ***
Dealt to Dorex2007 [Ks 3c]
NEMESIS 5555: raises $0.25 to $0.35
soultee88: calls $0.35
ACEHbKA777: folds 
Dorex2007: folds 
_ne katit_1: calls $0.35
rookietm1978: folds 
MusaiT: folds 
gizmondouk: folds 
*** FLOP *** [5s 3h 9h]
NEMESIS 5555: checks 
soultee88: checks 
_ne katit_1: checks 
*** TURN *** [5s 3h 9h] [9c]
NEMESIS 5555: checks 
soultee88: checks 
_ne katit_1: checks 
*** RIVER *** [5s 3h 9h 9c] [Jd]
NEMESIS 5555: checks 
soultee88: checks 
watersofain joins the table at seat #7 
_ne katit_1: bets $0.65
NEMESIS 5555: folds 
soultee88: folds 
Uncalled bet ($0.65) returned to _ne katit_1
_ne katit_1 collected $1.15 from pot
_ne katit_1: doesn't show hand 
*** SUMMARY ***
Total pot $1.20 | Rake $0.05 
Board [5s 3h 9h 9c Jd]
Seat 1: soultee88 folded on the River
Seat 2: ACEHbKA777 folded before Flop (didn't bet)
Seat 3: Dorex2007 folded before Flop (didn't bet)
Seat 4: _ne katit_1 collected ($1.15)
Seat 5: rookietm1978 (button) folded before Flop (didn't bet)
Seat 6: MusaiT (small blind) folded before Flop
Seat 8: gizmondouk (big blind) folded before Flop
Seat 9: NEMESIS 5555 folded on the River



PokerStars Hand #238222542844:  Hold'em No Limit ($0.05/$0.10 USD) - 2022/08/26 1:30:36 PT [2022/08/26 4:30:36 ET]
Table 'Rollandia' 9-max Seat #6 is the button
Seat 1: soultee88 ($10.70 in chips) 
Seat 2: ACEHbKA777 ($13.84 in chips) 
Seat 3: Dorex2007 ($14.49 in chips) 
Seat 4: _ne katit_1 ($10.80 in chips) 
Seat 5: rookietm1978 ($13.44 in chips) 
Seat 6: MusaiT ($11.10 in chips) 
Seat 8: gizmondouk ($10.70 in chips) 
Seat 9: NEMESIS 5555 ($14.40 in chips) 
gizmondouk: posts small blind $0.05
NEMESIS 5555: posts big blind $0.10
*** HOLE CARDS ***
Dealt to Dorex2007 [Ts 6h]
soultee88: folds 
ACEHbKA777: folds 
Dorex2007: folds 
_ne katit_1: folds 
rookietm1978: folds 
MusaiT: folds 
gizmondouk: folds 
Uncalled bet ($0.05) returned to NEMESIS 5555
NEMESIS 5555 collected $0.10 from pot
*** SUMMARY ***
Total pot $0.10 | Rake $0 
Seat 1: soultee88 folded before Flop (didn't bet)
Seat 2: ACEHbKA777 folded before Flop (didn't bet)
Seat 3: Dorex2007 folded before Flop (didn't bet)
Seat 4: _ne katit_1 folded before Flop (didn't bet)
Seat 5: rookietm1978 folded before Flop (didn't bet)
Seat 6: MusaiT (button) folded before Flop (didn't bet)
Seat 8: gizmondouk (small blind) folded before Flop
Seat 9: NEMESIS 5555 (big blind) collected ($0.10)



PokerStars Hand #238222545560:  Hold'em No Limit ($0.05/$0.10 USD) - 2022/08/26 1:30:57 PT [2022/08/26 4:30:57 ET]
Table 'Rollandia' 9-max Seat #8 is the button
Seat 1: soultee88 ($10.70 in chips) 
Seat 2: ACEHbKA777 ($13.84 in chips) 
Seat 3: Dorex2007 ($14.49 in chips) 
Seat 4: _ne katit_1 ($10.80 in chips) 
Seat 5: rookietm1978 ($13.44 in chips) 
Seat 6: MusaiT ($11.10 in chips) 
Seat 7: watersofain ($10 in chips) 
Seat 8: gizmondouk ($10.65 in chips) 
Seat 9: NEMESIS 5555 ($14.45 in chips) 
NEMESIS 5555: posts small blind $0.05
soultee88: posts big blind $0.10
watersofain: posts big blind $0.10
*** HOLE CARDS ***
Dealt to Dorex2007 [8d Kh]
ACEHbKA777: folds 
Dorex2007: folds 
_ne katit_1: folds 
rookietm1978: folds 
MusaiT: folds 
watersofain: checks 
gizmondouk: folds 
NEMESIS 5555: raises $0.30 to $0.40
soultee88: folds 
watersofain: folds 
Uncalled bet ($0.30) returned to NEMESIS 5555
NEMESIS 5555 collected $0.30 from pot
*** SUMMARY ***
Total pot $0.30 | Rake $0 
Seat 1: soultee88 (big blind) folded before Flop
Seat 2: ACEHbKA777 folded before Flop (didn't bet)
Seat 3: Dorex2007 folded before Flop (didn't bet)
Seat 4: _ne katit_1 folded before Flop (didn't bet)
Seat 5: rookietm1978 folded before Flop (didn't bet)
Seat 6: MusaiT folded before Flop (didn't bet)
Seat 7: watersofain folded before Flop (didn't bet)
Seat 8: gizmondouk (button) folded before Flop (didn't bet)
Seat 9: NEMESIS 5555 (small blind) collected ($0.30)



PokerStars Hand #238222548587:  Hold'em No Limit ($0.05/$0.10 USD) - 2022/08/26 1:31:22 PT [2022/08/26 4:31:22 ET]
Table 'Rollandia' 9-max Seat #9 is the button
Seat 1: soultee88 ($10.60 in chips) 
Seat 2: ACEHbKA777 ($13.84 in chips) 
Seat 3: Dorex2007 ($14.49 in chips) 
Seat 4: _ne katit_1 ($10.80 in chips) 
Seat 5: rookietm1978 ($13.44 in chips) 
Seat 6: MusaiT ($11.10 in chips) 
Seat 7: watersofain ($9.90 in chips) 
Seat 8: gizmondouk ($10.65 in chips) 
Seat 9: NEMESIS 5555 ($14.65 in chips) 
soultee88: posts small blind $0.05
ACEHbKA777: posts big blind $0.10
*** HOLE CARDS ***
Dealt to Dorex2007 [Kh Jc]
Dorex2007: calls $0.10
_ne katit_1: folds 
rookietm1978: folds 
MusaiT: folds 
watersofain: folds 
gizmondouk: folds 
NEMESIS 5555: calls $0.10
soultee88: folds 
ACEHbKA777: checks 
*** FLOP *** [4s 9d Qh]
ACEHbKA777: checks 
Dorex2007: checks 
NEMESIS 5555: bets $0.16
ACEHbKA777: folds 
Dorex2007: calls $0.16
*** TURN *** [4s 9d Qh] [Ah]
Dorex2007: checks 
NEMESIS 5555: checks 
*** RIVER *** [4s 9d Qh Ah] [7d]
Dorex2007: checks 
NEMESIS 5555: checks 
*** SHOW DOWN ***
Dorex2007: shows [Kh Jc] (high card Ace)
NEMESIS 5555: shows [4d 2c] (a pair of Fours)
NEMESIS 5555 collected $0.64 from pot
*** SUMMARY ***
Total pot $0.67 | Rake $0.03 
Board [4s 9d Qh Ah 7d]
Seat 1: soultee88 (small blind) folded before Flop
Seat 2: ACEHbKA777 (big blind) folded on the Flop
Seat 3: Dorex2007 showed [Kh Jc] and lost with high card Ace
Seat 4: _ne katit_1 folded before Flop (didn't bet)
Seat 5: rookietm1978 folded before Flop (didn't bet)
Seat 6: MusaiT folded before Flop (didn't bet)
Seat 7: watersofain folded before Flop (didn't bet)
Seat 8: gizmondouk folded before Flop (didn't bet)
Seat 9: NEMESIS 5555 (button) showed [4d 2c] and won ($0.64) with a pair of Fours



PokerStars Hand #238222556701:  Hold'em No Limit ($0.05/$0.10 USD) - 2022/08/26 1:32:25 PT [2022/08/26 4:32:25 ET]
Table 'Rollandia' 9-max Seat #1 is the button
Seat 1: soultee88 ($10.55 in chips) 
Seat 2: ACEHbKA777 ($13.74 in chips) 
Seat 3: Dorex2007 ($14.23 in chips) 
Seat 4: _ne katit_1 ($10.80 in chips) 
Seat 5: rookietm1978 ($13.44 in chips) 
Seat 6: MusaiT ($11.10 in chips) 
Seat 7: watersofain ($9.90 in chips) 
Seat 8: gizmondouk ($10.65 in chips) 
Seat 9: NEMESIS 5555 ($15.03 in chips) 
ACEHbKA777: posts small blind $0.05
Dorex2007: posts big blind $0.10
*** HOLE CARDS ***
Dealt to Dorex2007 [6d Tc]
_ne katit_1: folds 
rookietm1978: folds 
MusaiT: folds 
watersofain: folds 
gizmondouk: folds 
NEMESIS 5555: folds 
soultee88: folds 
ACEHbKA777: raises $0.12 to $0.22
Dorex2007: folds 
Uncalled bet ($0.12) returned to ACEHbKA777
ACEHbKA777 collected $0.20 from pot
*** SUMMARY ***
Total pot $0.20 | Rake $0 
Seat 1: soultee88 (button) folded before Flop (didn't bet)
Seat 2: ACEHbKA777 (small blind) collected ($0.20)
Seat 3: Dorex2007 (big blind) folded before Flop
Seat 4: _ne katit_1 folded before Flop (didn't bet)
Seat 5: rookietm1978 folded before Flop (didn't bet)
Seat 6: MusaiT folded before Flop (didn't bet)
Seat 7: watersofain folded before Flop (didn't bet)
Seat 8: gizmondouk folded before Flop (didn't bet)
Seat 9: NEMESIS 5555 folded before Flop (didn't bet)



PokerStars Hand #238222559027:  Hold'em No Limit ($0.05/$0.10 USD) - 2022/08/26 1:32:44 PT [2022/08/26 4:32:44 ET]
Table 'Rollandia' 9-max Seat #2 is the button
Seat 1: soultee88 ($10.55 in chips) 
Seat 2: ACEHbKA777 ($13.84 in chips) 
Seat 3: Dorex2007 ($14.13 in chips) 
Seat 4: _ne katit_1 ($10.80 in chips) 
Seat 5: rookietm1978 ($13.44 in chips) 
Seat 6: MusaiT ($11.10 in chips) 
Seat 7: watersofain ($9.90 in chips) 
Seat 8: gizmondouk ($10.65 in chips) 
Seat 9: NEMESIS 5555 ($15.03 in chips) 
Dorex2007: posts small blind $0.05
_ne katit_1: posts big blind $0.10
*** HOLE CARDS ***
Dealt to Dorex2007 [5c 3c]
rookietm1978: folds 
MusaiT: folds 
watersofain: folds 
gizmondouk: folds 
NEMESIS 5555: folds 
soultee88: raises $0.30 to $0.40
ACEHbKA777: folds 
Dorex2007: folds 
_ne katit_1: folds 
Uncalled bet ($0.30) returned to soultee88
soultee88 collected $0.25 from pot
soultee88: doesn't show hand 
*** SUMMARY ***
Total pot $0.25 | Rake $0 
Seat 1: soultee88 collected ($0.25)
Seat 2: ACEHbKA777 (button) folded before Flop (didn't bet)
Seat 3: Dorex2007 (small blind) folded before Flop
Seat 4: _ne katit_1 (big blind) folded before Flop
Seat 5: rookietm1978 folded before Flop (didn't bet)
Seat 6: MusaiT folded before Flop (didn't bet)
Seat 7: watersofain folded before Flop (didn't bet)
Seat 8: gizmondouk folded before Flop (didn't bet)
Seat 9: NEMESIS 5555 folded before Flop (didn't bet)



PokerStars Hand #238222561408:  Hold'em No Limit ($0.05/$0.10 USD) - 2022/08/26 1:33:02 PT [2022/08/26 4:33:02 ET]
Table 'Rollandia' 9-max Seat #3 is the button
Seat 1: soultee88 ($10.70 in chips) 
Seat 2: ACEHbKA777 ($13.84 in chips) 
Seat 3: Dorex2007 ($14.08 in chips) 
Seat 4: _ne katit_1 ($10.70 in chips) 
Seat 5: rookietm1978 ($13.44 in chips) 
Seat 6: MusaiT ($11.10 in chips) 
Seat 7: watersofain ($9.90 in chips) 
Seat 8: gizmondouk ($10.65 in chips) 
Seat 9: NEMESIS 5555 ($15.03 in chips) 
_ne katit_1: posts small blind $0.05
rookietm1978: posts big blind $0.10
*** HOLE CARDS ***
Dealt to Dorex2007 [2d Ts]
MusaiT: folds 
watersofain: folds 
gizmondouk: folds 
NEMESIS 5555: calls $0.10
soultee88: folds 
ACEHbKA777: raises $0.15 to $0.25
Dorex2007: folds 
_ne katit_1: folds 
rookietm1978: folds 
NEMESIS 5555: calls $0.15
*** FLOP *** [Th 8s 4c]
NEMESIS 5555: bets $0.62
ACEHbKA777: folds 
Uncalled bet ($0.62) returned to NEMESIS 5555
NEMESIS 5555 collected $0.62 from pot
*** SUMMARY ***
Total pot $0.65 | Rake $0.03 
Board [Th 8s 4c]
Seat 1: soultee88 folded before Flop (didn't bet)
Seat 2: ACEHbKA777 folded on the Flop
Seat 3: Dorex2007 (button) folded before Flop (didn't bet)
Seat 4: _ne katit_1 (small blind) folded before Flop
Seat 5: rookietm1978 (big blind) folded before Flop
Seat 6: MusaiT folded before Flop (didn't bet)
Seat 7: watersofain folded before Flop (didn't bet)
Seat 8: gizmondouk folded before Flop (didn't bet)
Seat 9: NEMESIS 5555 collected ($0.62)



PokerStars Hand #238222564767:  Hold'em No Limit ($0.05/$0.10 USD) - 2022/08/26 1:33:28 PT [2022/08/26 4:33:28 ET]
Table 'Rollandia' 9-max Seat #4 is the button
Seat 1: soultee88 ($10.70 in chips) 
Seat 2: ACEHbKA777 ($13.59 in chips) 
Seat 3: Dorex2007 ($14.08 in chips) 
Seat 4: _ne katit_1 ($10.65 in chips) 
Seat 5: rookietm1978 ($13.34 in chips) 
Seat 6: MusaiT ($11.10 in chips) 
Seat 7: watersofain ($9.90 in chips) 
Seat 8: gizmondouk ($10.65 in chips) 
Seat 9: NEMESIS 5555 ($15.40 in chips) 
rookietm1978: posts small blind $0.05
MusaiT: posts big blind $0.10
*** HOLE CARDS ***
Dealt to Dorex2007 [6s Qs]
watersofain: folds 
gizmondouk: folds 
NEMESIS 5555: raises $0.10 to $0.20
soultee88: folds 
ACEHbKA777: folds 
Dorex2007: folds 
_ne katit_1: calls $0.20
rookietm1978: raises $0.40 to $0.60
MusaiT: folds 
NEMESIS 5555: calls $0.40
_ne katit_1: calls $0.40
*** FLOP *** [4d 2c Kh]
rookietm1978: bets $0.90
NEMESIS 5555: calls $0.90
_ne katit_1: folds 
*** TURN *** [4d 2c Kh] [7s]
rookietm1978: bets $1.76
NEMESIS 5555: calls $1.76
*** RIVER *** [4d 2c Kh 7s] [7h]
rookietm1978: bets $10.08 and is all-in
NEMESIS 5555: folds 
Uncalled bet ($10.08) returned to rookietm1978
rookietm1978 collected $6.82 from pot
rookietm1978: doesn't show hand 
*** SUMMARY ***
Total pot $7.22 | Rake $0.40 
Board [4d 2c Kh 7s 7h]
Seat 1: soultee88 folded before Flop (didn't bet)
Seat 2: ACEHbKA777 folded before Flop (didn't bet)
Seat 3: Dorex2007 folded before Flop (didn't bet)
Seat 4: _ne katit_1 (button) folded on the Flop
Seat 5: rookietm1978 (small blind) collected ($6.82)
Seat 6: MusaiT (big blind) folded before Flop
Seat 7: watersofain folded before Flop (didn't bet)
Seat 8: gizmondouk folded before Flop (didn't bet)
Seat 9: NEMESIS 5555 folded on the River



PokerStars Hand #238222572128:  Hold'em No Limit ($0.05/$0.10 USD) - 2022/08/26 1:34:25 PT [2022/08/26 4:34:25 ET]
Table 'Rollandia' 9-max Seat #5 is the button
Seat 1: soultee88 ($10.70 in chips) 
Seat 2: ACEHbKA777 ($13.59 in chips) 
Seat 3: Dorex2007 ($14.08 in chips) 
Seat 4: _ne katit_1 ($10.05 in chips) 
Seat 5: rookietm1978 ($16.90 in chips) 
Seat 6: MusaiT ($11 in chips) 
Seat 7: watersofain ($9.90 in chips) 
Seat 8: gizmondouk ($10.65 in chips) 
Seat 9: NEMESIS 5555 ($12.14 in chips) 
MusaiT: posts small blind $0.05
watersofain: posts big blind $0.10
*** HOLE CARDS ***
Dealt to Dorex2007 [Qh 7s]
gizmondouk: folds 
NEMESIS 5555: folds 
soultee88: folds 
ACEHbKA777: folds 
Dorex2007: folds 
_ne katit_1: folds 
rookietm1978: folds 
MusaiT: raises $0.20 to $0.30
watersofain: raises $0.60 to $0.90
MusaiT: raises $2.50 to $3.40
watersofain: folds 
Uncalled bet ($2.50) returned to MusaiT
MusaiT collected $1.80 from pot
MusaiT: doesn't show hand 
*** SUMMARY ***
Total pot $1.80 | Rake $0 
Seat 1: soultee88 folded before Flop (didn't bet)
Seat 2: ACEHbKA777 folded before Flop (didn't bet)
Seat 3: Dorex2007 folded before Flop (didn't bet)
Seat 4: _ne katit_1 folded before Flop (didn't bet)
Seat 5: rookietm1978 (button) folded before Flop (didn't bet)
Seat 6: MusaiT (small blind) collected ($1.80)
Seat 7: watersofain (big blind) folded before Flop
Seat 8: gizmondouk folded before Flop (didn't bet)
Seat 9: NEMESIS 5555 folded before Flop (didn't bet)



PokerStars Hand #238222576838:  Hold'em No Limit ($0.05/$0.10 USD) - 2022/08/26 1:35:02 PT [2022/08/26 4:35:02 ET]
Table 'Rollandia' 9-max Seat #6 is the button
Seat 1: soultee88 ($10.70 in chips) 
Seat 2: ACEHbKA777 ($13.59 in chips) 
Seat 3: Dorex2007 ($14.08 in chips) 
Seat 4: _ne katit_1 ($10.05 in chips) 
Seat 5: rookietm1978 ($16.90 in chips) 
Seat 6: MusaiT ($11.90 in chips) 
Seat 7: watersofain ($9 in chips) 
Seat 8: gizmondouk ($10.65 in chips) 
Seat 9: NEMESIS 5555 ($12.14 in chips) 
watersofain: posts small blind $0.05
gizmondouk: posts big blind $0.10
*** HOLE CARDS ***
Dealt to Dorex2007 [Jd 9s]
NEMESIS 5555: folds 
soultee88: folds 
ACEHbKA777: folds 
Dorex2007: folds 
_ne katit_1: folds 
rookietm1978: folds 
MusaiT: raises $0.15 to $0.25
watersofain: raises $0.75 to $1
gizmondouk: folds 
MusaiT: folds 
Uncalled bet ($0.75) returned to watersofain
watersofain collected $0.60 from pot
*** SUMMARY ***
Total pot $0.60 | Rake $0 
Seat 1: soultee88 folded before Flop (didn't bet)
Seat 2: ACEHbKA777 folded before Flop (didn't bet)
Seat 3: Dorex2007 folded before Flop (didn't bet)
Seat 4: _ne katit_1 folded before Flop (didn't bet)
Seat 5: rookietm1978 folded before Flop (didn't bet)
Seat 6: MusaiT (button) folded before Flop
Seat 7: watersofain (small blind) collected ($0.60)
Seat 8: gizmondouk (big blind) folded before Flop
Seat 9: NEMESIS 5555 folded before Flop (didn't bet)



PokerStars Hand #238222578952:  Hold'em No Limit ($0.05/$0.10 USD) - 2022/08/26 1:35:18 PT [2022/08/26 4:35:18 ET]
Table 'Rollandia' 9-max Seat #7 is the button
Seat 1: soultee88 ($10.70 in chips) 
Seat 2: ACEHbKA777 ($13.59 in chips) 
Seat 3: Dorex2007 ($14.08 in chips) 
Seat 4: _ne katit_1 ($10.05 in chips) 
Seat 5: rookietm1978 ($16.90 in chips) 
Seat 6: MusaiT ($11.65 in chips) 
Seat 7: watersofain ($9.35 in chips) 
Seat 8: gizmondouk ($10.55 in chips) 
Seat 9: NEMESIS 5555 ($12.14 in chips) 
gizmondouk: posts small blind $0.05
NEMESIS 5555: posts big blind $0.10
*** HOLE CARDS ***
Dealt to Dorex2007 [Jc 6s]
soultee88: folds 
ACEHbKA777: raises $0.10 to $0.20
Dorex2007: folds 
_ne katit_1: folds 
rookietm1978: folds 
MusaiT: folds 
watersofain: folds 
gizmondouk: folds 
NEMESIS 5555: calls $0.10
*** FLOP *** [5s 2c Kc]
NEMESIS 5555: checks 
ACEHbKA777: checks 
*** TURN *** [5s 2c Kc] [As]
NEMESIS 5555: checks 
ACEHbKA777: checks 
*** RIVER *** [5s 2c Kc As] [9s]
NEMESIS 5555: bets $0.21
ACEHbKA777: folds 
Uncalled bet ($0.21) returned to NEMESIS 5555
NEMESIS 5555 collected $0.43 from pot
*** SUMMARY ***
Total pot $0.45 | Rake $0.02 
Board [5s 2c Kc As 9s]
Seat 1: soultee88 folded before Flop (didn't bet)
Seat 2: ACEHbKA777 folded on the River
Seat 3: Dorex2007 folded before Flop (didn't bet)
Seat 4: _ne katit_1 folded before Flop (didn't bet)
Seat 5: rookietm1978 folded before Flop (didn't bet)
Seat 6: MusaiT folded before Flop (didn't bet)
Seat 7: watersofain (button) folded before Flop (didn't bet)
Seat 8: gizmondouk (small blind) folded before Flop
Seat 9: NEMESIS 5555 (big blind) collected ($0.43)



PokerStars Hand #238222585593:  Hold'em No Limit ($0.05/$0.10 USD) - 2022/08/26 1:36:10 PT [2022/08/26 4:36:10 ET]
Table 'Rollandia' 9-max Seat #8 is the button
Seat 1: soultee88 ($10.70 in chips) 
Seat 2: ACEHbKA777 ($13.39 in chips) 
Seat 3: Dorex2007 ($14.08 in chips) 
Seat 4: _ne katit_1 ($10.05 in chips) 
Seat 5: rookietm1978 ($16.90 in chips) 
Seat 6: MusaiT ($11.65 in chips) 
Seat 7: watersofain ($10 in chips) 
Seat 8: gizmondouk ($10.50 in chips) 
Seat 9: NEMESIS 5555 ($12.37 in chips) 
NEMESIS 5555: posts small blind $0.05
soultee88: posts big blind $0.10
*** HOLE CARDS ***
Dealt to Dorex2007 [Kd 7s]
ACEHbKA777: folds 
Dorex2007: folds 
_ne katit_1: folds 
rookietm1978: folds 
MusaiT: folds 
watersofain: folds 
gizmondouk: folds 
NEMESIS 5555: raises $0.10 to $0.20
soultee88: folds 
Uncalled bet ($0.10) returned to NEMESIS 5555
NEMESIS 5555 collected $0.20 from pot
*** SUMMARY ***
Total pot $0.20 | Rake $0 
Seat 1: soultee88 (big blind) folded before Flop
Seat 2: ACEHbKA777 folded before Flop (didn't bet)
Seat 3: Dorex2007 folded before Flop (didn't bet)
Seat 4: _ne katit_1 folded before Flop (didn't bet)
Seat 5: rookietm1978 folded before Flop (didn't bet)
Seat 6: MusaiT folded before Flop (didn't bet)
Seat 7: watersofain folded before Flop (didn't bet)
Seat 8: gizmondouk (button) folded before Flop (didn't bet)
Seat 9: NEMESIS 5555 (small blind) collected ($0.20)



PokerStars Hand #238222587545:  Hold'em No Limit ($0.05/$0.10 USD) - 2022/08/26 1:36:25 PT [2022/08/26 4:36:25 ET]
Table 'Rollandia' 9-max Seat #9 is the button
Seat 1: soultee88 ($10.60 in chips) 
Seat 2: ACEHbKA777 ($13.39 in chips) 
Seat 3: Dorex2007 ($14.08 in chips) 
Seat 4: _ne katit_1 ($10.05 in chips) 
Seat 5: rookietm1978 ($16.90 in chips) 
Seat 6: MusaiT ($11.65 in chips) 
Seat 7: watersofain ($10 in chips) 
Seat 8: gizmondouk ($10.50 in chips) 
Seat 9: NEMESIS 5555 ($12.47 in chips) 
soultee88: posts small blind $0.05
ACEHbKA777: posts big blind $0.10
*** HOLE CARDS ***
Dealt to Dorex2007 [Ah Kd]
Dorex2007: calls $0.10
_ne katit_1: folds 
rookietm1978: folds 
MusaiT: folds 
watersofain: folds 
gizmondouk: folds 
NEMESIS 5555: raises $0.35 to $0.45
soultee88: folds 
ACEHbKA777: folds 
Dorex2007: calls $0.35
*** FLOP *** [7d Jh Jc]
Dorex2007: checks 
NEMESIS 5555: bets $1
Dorex2007: calls $1
*** TURN *** [7d Jh Jc] [Tc]
Dorex2007: checks 
NEMESIS 5555: checks 
*** RIVER *** [7d Jh Jc Tc] [3h]
Dorex2007: bets $1.45
NEMESIS 5555: folds 
Uncalled bet ($1.45) returned to Dorex2007
Dorex2007 collected $2.91 from pot
Dorex2007: doesn't show hand 
*** SUMMARY ***
Total pot $3.05 | Rake $0.14 
Board [7d Jh Jc Tc 3h]
Seat 1: soultee88 (small blind) folded before Flop
Seat 2: ACEHbKA777 (big blind) folded before Flop
Seat 3: Dorex2007 collected ($2.91)
Seat 4: _ne katit_1 folded before Flop (didn't bet)
Seat 5: rookietm1978 folded before Flop (didn't bet)
Seat 6: MusaiT folded before Flop (didn't bet)
Seat 7: watersofain folded before Flop (didn't bet)
Seat 8: gizmondouk folded before Flop (didn't bet)
Seat 9: NEMESIS 5555 (button) folded on the River



PokerStars Hand #238222593205:  Hold'em No Limit ($0.05/$0.10 USD) - 2022/08/26 1:37:09 PT [2022/08/26 4:37:09 ET]
Table 'Rollandia' 9-max Seat #1 is the button
Seat 1: soultee88 ($10.55 in chips) 
Seat 2: ACEHbKA777 ($13.29 in chips) 
Seat 3: Dorex2007 ($15.54 in chips) 
Seat 4: _ne katit_1 ($10.05 in chips) 
Seat 5: rookietm1978 ($16.90 in chips) 
Seat 6: MusaiT ($11.65 in chips) 
Seat 7: watersofain ($10 in chips) 
Seat 8: gizmondouk ($10.50 in chips) 
Seat 9: NEMESIS 5555 ($11.02 in chips) 
ACEHbKA777: posts small blind $0.05
Dorex2007: posts big blind $0.10
*** HOLE CARDS ***
Dealt to Dorex2007 [Kd Qh]
_ne katit_1: folds 
rookietm1978: folds 
MusaiT: folds 
watersofain: folds 
gizmondouk: raises $0.20 to $0.30
NEMESIS 5555: folds 
soultee88: folds 
ACEHbKA777: folds 
Dorex2007: calls $0.20
*** FLOP *** [Ad 9h 6d]
Dorex2007: checks 
gizmondouk: bets $0.40
Dorex2007: folds 
Uncalled bet ($0.40) returned to gizmondouk
gizmondouk collected $0.62 from pot
gizmondouk: doesn't show hand 
*** SUMMARY ***
Total pot $0.65 | Rake $0.03 
Board [Ad 9h 6d]
Seat 1: soultee88 (button) folded before Flop (didn't bet)
Seat 2: ACEHbKA777 (small blind) folded before Flop
Seat 3: Dorex2007 (big blind) folded on the Flop
Seat 4: _ne katit_1 folded before Flop (didn't bet)
Seat 5: rookietm1978 folded before Flop (didn't bet)
Seat 6: MusaiT folded before Flop (didn't bet)
Seat 7: watersofain folded before Flop (didn't bet)
Seat 8: gizmondouk collected ($0.62)
Seat 9: NEMESIS 5555 folded before Flop (didn't bet)



PokerStars Hand #238222597626:  Hold'em No Limit ($0.05/$0.10 USD) - 2022/08/26 1:37:43 PT [2022/08/26 4:37:43 ET]
Table 'Rollandia' 9-max Seat #2 is the button
Seat 1: soultee88 ($10.55 in chips) 
Seat 2: ACEHbKA777 ($13.24 in chips) 
Seat 3: Dorex2007 ($15.24 in chips) 
Seat 4: _ne katit_1 ($10.05 in chips) 
Seat 5: rookietm1978 ($16.90 in chips) 
Seat 6: MusaiT ($11.65 in chips) 
Seat 7: watersofain ($10 in chips) 
Seat 8: gizmondouk ($10.82 in chips) 
Seat 9: NEMESIS 5555 ($11.02 in chips) 
Dorex2007: posts small blind $0.05
_ne katit_1: posts big blind $0.10
*** HOLE CARDS ***
Dealt to Dorex2007 [5h 4h]
rookietm1978: calls $0.10
MusaiT: folds 
watersofain: folds 
gizmondouk: raises $0.30 to $0.40
NEMESIS 5555: calls $0.40
soultee88: folds 
ACEHbKA777: folds 
Dorex2007: folds 
_ne katit_1: folds 
rookietm1978: raises $0.70 to $1.10
gizmondouk: folds 
NEMESIS 5555: calls $0.70
*** FLOP *** [5c Qh Qs]
rookietm1978: checks 
NEMESIS 5555: checks 
*** TURN *** [5c Qh Qs] [Qd]
rookietm1978: bets $1.31
NEMESIS 5555: folds 
Uncalled bet ($1.31) returned to rookietm1978
rookietm1978 collected $2.60 from pot
rookietm1978: doesn't show hand 
*** SUMMARY ***
Total pot $2.75 | Rake $0.15 
Board [5c Qh Qs Qd]
Seat 1: soultee88 folded before Flop (didn't bet)
Seat 2: ACEHbKA777 (button) folded before Flop (didn't bet)
Seat 3: Dorex2007 (small blind) folded before Flop
Seat 4: _ne katit_1 (big blind) folded before Flop
Seat 5: rookietm1978 collected ($2.60)
Seat 6: MusaiT folded before Flop (didn't bet)
Seat 7: watersofain folded before Flop (didn't bet)
Seat 8: gizmondouk folded before Flop
Seat 9: NEMESIS 5555 folded on the Turn



PokerStars Hand #238222602783:  Hold'em No Limit ($0.05/$0.10 USD) - 2022/08/26 1:38:22 PT [2022/08/26 4:38:22 ET]
Table 'Rollandia' 9-max Seat #3 is the button
Seat 1: soultee88 ($10.55 in chips) 
Seat 2: ACEHbKA777 ($13.24 in chips) 
Seat 3: Dorex2007 ($15.19 in chips) 
Seat 4: _ne katit_1 ($10 in chips) 
Seat 5: rookietm1978 ($18.40 in chips) 
Seat 6: MusaiT ($11.65 in chips) 
Seat 7: watersofain ($10 in chips) 
Seat 8: gizmondouk ($10.42 in chips) 
Seat 9: NEMESIS 5555 ($9.92 in chips) 
_ne katit_1: posts small blind $0.05
rookietm1978: posts big blind $0.10
*** HOLE CARDS ***
Dealt to Dorex2007 [Kh 7c]
MusaiT: folds 
watersofain: folds 
gizmondouk: folds 
NEMESIS 5555: raises $0.10 to $0.20
soultee88: folds 
ACEHbKA777: folds 
Dorex2007: folds 
_ne katit_1: folds 
rookietm1978: calls $0.10
*** FLOP *** [7h 6s 3c]
rookietm1978: checks 
NEMESIS 5555: bets $0.43
rookietm1978: folds 
Uncalled bet ($0.43) returned to NEMESIS 5555
NEMESIS 5555 collected $0.43 from pot
*** SUMMARY ***
Total pot $0.45 | Rake $0.02 
Board [7h 6s 3c]
Seat 1: soultee88 folded before Flop (didn't bet)
Seat 2: ACEHbKA777 folded before Flop (didn't bet)
Seat 3: Dorex2007 (button) folded before Flop (didn't bet)
Seat 4: _ne katit_1 (small blind) folded before Flop
Seat 5: rookietm1978 (big blind) folded on the Flop
Seat 6: MusaiT folded before Flop (didn't bet)
Seat 7: watersofain folded before Flop (didn't bet)
Seat 8: gizmondouk folded before Flop (didn't bet)
Seat 9: NEMESIS 5555 collected ($0.43)



PokerStars Hand #238222606849:  Hold'em No Limit ($0.05/$0.10 USD) - 2022/08/26 1:38:54 PT [2022/08/26 4:38:54 ET]
Table 'Rollandia' 9-max Seat #4 is the button
Seat 1: soultee88 ($10.55 in chips) 
Seat 2: ACEHbKA777 ($13.24 in chips) 
Seat 3: Dorex2007 ($15.19 in chips) 
Seat 4: _ne katit_1 ($10 in chips) 
Seat 5: rookietm1978 ($18.20 in chips) 
Seat 6: MusaiT ($11.65 in chips) 
Seat 7: watersofain ($10 in chips) 
Seat 8: gizmondouk ($10.42 in chips) 
Seat 9: NEMESIS 5555 ($10.15 in chips) 
rookietm1978: posts small blind $0.05
MusaiT: posts big blind $0.10
*** HOLE CARDS ***
Dealt to Dorex2007 [Ah 9c]
watersofain: folds 
gizmondouk: folds 
NEMESIS 5555: raises $0.25 to $0.35
soultee88: folds 
ACEHbKA777: folds 
Dorex2007: folds 
_ne katit_1: folds 
rookietm1978: calls $0.30
MusaiT: folds 
*** FLOP *** [Kh 6h 6s]
rookietm1978: checks 
NEMESIS 5555: bets $0.76
rookietm1978: calls $0.76
*** TURN *** [Kh 6h 6s] [Qs]
rookietm1978: checks 
NEMESIS 5555: checks 
*** RIVER *** [Kh 6h 6s Qs] [Ad]
rookietm1978: checks 
NEMESIS 5555: bets $1.11
rookietm1978: calls $1.11
*** SHOW DOWN ***
NEMESIS 5555: shows [3h 3d] (two pair, Sixes and Threes)
rookietm1978: shows [Qd As] (two pair, Aces and Queens)
rookietm1978 collected $4.29 from pot
*** SUMMARY ***
Total pot $4.54 | Rake $0.25 
Board [Kh 6h 6s Qs Ad]
Seat 1: soultee88 folded before Flop (didn't bet)
Seat 2: ACEHbKA777 folded before Flop (didn't bet)
Seat 3: Dorex2007 folded before Flop (didn't bet)
Seat 4: _ne katit_1 (button) folded before Flop (didn't bet)
Seat 5: rookietm1978 (small blind) showed [Qd As] and won ($4.29) with two pair, Aces and Queens
Seat 6: MusaiT (big blind) folded before Flop
Seat 7: watersofain folded before Flop (didn't bet)
Seat 8: gizmondouk folded before Flop (didn't bet)
Seat 9: NEMESIS 5555 showed [3h 3d] and lost with two pair, Sixes and Threes



PokerStars Hand #238222611457:  Hold'em No Limit ($0.05/$0.10 USD) - 2022/08/26 1:39:30 PT [2022/08/26 4:39:30 ET]
Table 'Rollandia' 9-max Seat #5 is the button
Seat 1: soultee88 ($10.55 in chips) 
Seat 2: ACEHbKA777 ($13.24 in chips) 
Seat 3: Dorex2007 ($15.19 in chips) 
Seat 4: _ne katit_1 ($10 in chips) 
Seat 5: rookietm1978 ($20.27 in chips) 
Seat 6: MusaiT ($11.55 in chips) 
Seat 7: watersofain ($10 in chips) 
Seat 8: gizmondouk ($10.42 in chips) 
Seat 9: NEMESIS 5555 ($7.93 in chips) 
MusaiT: posts small blind $0.05
watersofain: posts big blind $0.10
*** HOLE CARDS ***
Dealt to Dorex2007 [2c 4d]
gizmondouk: folds 
NEMESIS 5555: folds 
NEMESIS 5555 leaves the table
soultee88: folds 
ACEHbKA777: raises $0.10 to $0.20
raika14 joins the table at seat #9 
Dorex2007: folds 
_ne katit_1: folds 
rookietm1978: folds 
MusaiT: folds 
watersofain: calls $0.10
*** FLOP *** [Qc 5c 4c]
watersofain: checks 
ACEHbKA777: checks 
*** TURN *** [Qc 5c 4c] [Qs]
watersofain: bets $0.10
ACEHbKA777: calls $0.10
*** RIVER *** [Qc 5c 4c Qs] [Td]
watersofain: bets $0.10
ACEHbKA777: calls $0.10
*** SHOW DOWN ***
watersofain: shows [Jd Jh] (two pair, Queens and Jacks)
ACEHbKA777: mucks hand 
watersofain collected $0.81 from pot
*** SUMMARY ***
Total pot $0.85 | Rake $0.04 
Board [Qc 5c 4c Qs Td]
Seat 1: soultee88 folded before Flop (didn't bet)
Seat 2: ACEHbKA777 mucked [Js Ks]
Seat 3: Dorex2007 folded before Flop (didn't bet)
Seat 4: _ne katit_1 folded before Flop (didn't bet)
Seat 5: rookietm1978 (button) folded before Flop (didn't bet)
Seat 6: MusaiT (small blind) folded before Flop
Seat 7: watersofain (big blind) showed [Jd Jh] and won ($0.81) with two pair, Queens and Jacks
Seat 8: gizmondouk folded before Flop (didn't bet)
Seat 9: NEMESIS 5555 folded before Flop (didn't bet)



PokerStars Hand #238222617235:  Hold'em No Limit ($0.05/$0.10 USD) - 2022/08/26 1:40:14 PT [2022/08/26 4:40:14 ET]
Table 'Rollandia' 9-max Seat #6 is the button
Seat 1: soultee88 ($10.55 in chips) 
Seat 2: ACEHbKA777 ($12.84 in chips) 
Seat 3: Dorex2007 ($15.19 in chips) 
Seat 4: _ne katit_1 ($10 in chips) 
Seat 5: rookietm1978 ($20.27 in chips) 
Seat 6: MusaiT ($11.50 in chips) 
Seat 7: watersofain ($10.41 in chips) 
Seat 8: gizmondouk ($10.42 in chips) 
watersofain: posts small blind $0.05
gizmondouk: posts big blind $0.10
raika14: sits out 
*** HOLE CARDS ***
Dealt to Dorex2007 [4d 4h]
soultee88: folds 
ACEHbKA777: folds 
Dorex2007: calls $0.10
_ne katit_1: folds 
rookietm1978: folds 
MusaiT: folds 
watersofain: calls $0.05
gizmondouk: checks 
*** FLOP *** [Qc 8s Kc]
watersofain: checks 
gizmondouk: checks 
Dorex2007: checks 
*** TURN *** [Qc 8s Kc] [Ks]
watersofain: checks 
gizmondouk: checks 
Dorex2007: checks 
*** RIVER *** [Qc 8s Kc Ks] [3s]
watersofain: checks 
gizmondouk: checks 
Dorex2007: checks 
*** SHOW DOWN ***
watersofain: shows [6h 8h] (two pair, Kings and Eights)
gizmondouk: shows [Qh 3c] (two pair, Kings and Queens)
Dorex2007: mucks hand 
gizmondouk collected $0.29 from pot
*** SUMMARY ***
Total pot $0.30 | Rake $0.01 
Board [Qc 8s Kc Ks 3s]
Seat 1: soultee88 folded before Flop (didn't bet)
Seat 2: ACEHbKA777 folded before Flop (didn't bet)
Seat 3: Dorex2007 mucked [4d 4h]
Seat 4: _ne katit_1 folded before Flop (didn't bet)
Seat 5: rookietm1978 folded before Flop (didn't bet)
Seat 6: MusaiT (button) folded before Flop (didn't bet)
Seat 7: watersofain (small blind) showed [6h 8h] and lost with two pair, Kings and Eights
Seat 8: gizmondouk (big blind) showed [Qh 3c] and won ($0.29) with two pair, Kings and Queens



