PokerStars Hand #237373995494:  Hold'em No Limit ($0.01/$0.02 USD) - 2022/07/15 9:00:46 PT [2022/07/15 12:00:46 ET]
Table 'Appella II' 9-max Seat #9 is the button
Seat 1: Cannyjim ($2.67 in chips) 
Seat 2: rambooschi ($3.87 in chips) 
Seat 4: leomax100 ($2 in chips) 
Seat 5: stallo36 ($4.14 in chips) 
Seat 7: guiaoms ($2.28 in chips) 
Seat 8: Dorex2007 ($2 in chips) 
Seat 9: IuriPato ($2.17 in chips) 
Cannyjim: posts small blind $0.01
rambooschi: posts big blind $0.02
mkEmperor: sits out 
Dorex2007: posts big blind $0.02
*** HOLE CARDS ***
Dealt to Dorex2007 [Ts 9d]
leomax100: folds 
stallo36: folds 
guiaoms: folds 
Dorex2007: checks 
IuriPato: calls $0.02
Cannyjim: calls $0.01
rambooschi: checks 
*** FLOP *** [Qd 5c 7s]
Cannyjim: checks 
rambooschi: checks 
Dorex2007: checks 
IuriPato: bets $0.03
Cannyjim: folds 
rambooschi: folds 
Dorex2007: folds 
Uncalled bet ($0.03) returned to IuriPato
IuriPato collected $0.08 from pot
*** SUMMARY ***
Total pot $0.08 | Rake $0 
Board [Qd 5c 7s]
Seat 1: Cannyjim (small blind) folded on the Flop
Seat 2: rambooschi (big blind) folded on the Flop
Seat 4: leomax100 folded before Flop (didn't bet)
Seat 5: stallo36 folded before Flop (didn't bet)
Seat 7: guiaoms folded before Flop (didn't bet)
Seat 8: Dorex2007 folded on the Flop (didn't bet)
Seat 9: IuriPato (button) collected ($0.08)



PokerStars Hand #237374005186:  Hold'em No Limit ($0.01/$0.02 USD) - 2022/07/15 9:01:25 PT [2022/07/15 12:01:25 ET]
Table 'Appella II' 9-max Seat #1 is the button
Seat 1: Cannyjim ($2.65 in chips) 
Seat 2: rambooschi ($3.85 in chips) 
Seat 3: mkEmperor ($2 in chips) 
Seat 4: leomax100 ($2 in chips) 
Seat 5: stallo36 ($4.14 in chips) 
Seat 8: Dorex2007 ($2 in chips) 
Seat 9: IuriPato ($2.23 in chips) 
rambooschi: posts small blind $0.01
mkEmperor: posts big blind $0.02
*** HOLE CARDS ***
Dealt to Dorex2007 [8s Th]
leomax100: calls $0.02
stallo36: folds 
guiaoms is disconnected 
Dorex2007: folds 
IuriPato: folds 
Cannyjim: calls $0.02
rambooschi: calls $0.01
mkEmperor: checks 
*** FLOP *** [2d Ts 6s]
rambooschi: checks 
mkEmperor: checks 
leomax100: bets $0.02
Cannyjim: raises $0.06 to $0.08
rambooschi: folds 
mkEmperor: folds 
leomax100: calls $0.06
*** TURN *** [2d Ts 6s] [7s]
leomax100: checks 
Cannyjim: checks 
*** RIVER *** [2d Ts 6s 7s] [2s]
leomax100: checks 
Cannyjim: checks 
*** SHOW DOWN ***
leomax100: shows [Td Qd] (two pair, Tens and Deuces)
Cannyjim: mucks hand 
leomax100 collected $0.23 from pot
*** SUMMARY ***
Total pot $0.24 | Rake $0.01 
Board [2d Ts 6s 7s 2s]
Seat 1: Cannyjim (button) mucked [6c 5h]
Seat 2: rambooschi (small blind) folded on the Flop
Seat 3: mkEmperor (big blind) folded on the Flop
Seat 4: leomax100 showed [Td Qd] and won ($0.23) with two pair, Tens and Deuces
Seat 5: stallo36 folded before Flop (didn't bet)
Seat 8: Dorex2007 folded before Flop (didn't bet)
Seat 9: IuriPato folded before Flop (didn't bet)



PokerStars Hand #237374024239:  Hold'em No Limit ($0.01/$0.02 USD) - 2022/07/15 9:02:36 PT [2022/07/15 12:02:36 ET]
Table 'Appella II' 9-max Seat #2 is the button
Seat 1: Cannyjim ($2.55 in chips) 
Seat 2: rambooschi ($3.83 in chips) 
Seat 3: mkEmperor ($1.98 in chips) 
Seat 4: leomax100 ($2.13 in chips) 
Seat 5: stallo36 ($4.14 in chips) 
Seat 7: guiaoms ($2.28 in chips) 
Seat 8: Dorex2007 ($2 in chips) 
Seat 9: IuriPato ($2.23 in chips) 
mkEmperor: posts small blind $0.01
leomax100: posts big blind $0.02
*** HOLE CARDS ***
Dealt to Dorex2007 [6h 2c]
stallo36: calls $0.02
guiaoms is disconnected 
guiaoms has timed out while disconnected
guiaoms: folds 
Dorex2007: folds 
IuriPato: folds 
Cannyjim: calls $0.02
rambooschi: folds 
mkEmperor: folds 
leomax100: raises $2.11 to $2.13 and is all-in
stallo36: folds 
Cannyjim: folds 
Uncalled bet ($2.11) returned to leomax100
leomax100 collected $0.07 from pot
*** SUMMARY ***
Total pot $0.07 | Rake $0 
Seat 1: Cannyjim folded before Flop
Seat 2: rambooschi (button) folded before Flop (didn't bet)
Seat 3: mkEmperor (small blind) folded before Flop
Seat 4: leomax100 (big blind) collected ($0.07)
Seat 5: stallo36 folded before Flop
Seat 7: guiaoms folded before Flop (didn't bet)
Seat 8: Dorex2007 folded before Flop (didn't bet)
Seat 9: IuriPato folded before Flop (didn't bet)



PokerStars Hand #237374031782:  Hold'em No Limit ($0.01/$0.02 USD) - 2022/07/15 9:03:04 PT [2022/07/15 12:03:04 ET]
Table 'Appella II' 9-max Seat #3 is the button
Seat 1: Cannyjim ($2.53 in chips) 
Seat 2: rambooschi ($3.83 in chips) 
Seat 3: mkEmperor ($1.97 in chips) 
Seat 4: leomax100 ($2.18 in chips) 
Seat 5: stallo36 ($4.12 in chips) 
Seat 7: guiaoms ($2.28 in chips) 
Seat 8: Dorex2007 ($2 in chips) 
Seat 9: IuriPato ($2.23 in chips) 
leomax100: posts small blind $0.01
stallo36: posts big blind $0.02
*** HOLE CARDS ***
Dealt to Dorex2007 [6d 6c]
guiaoms: folds 
Dorex2007: calls $0.02
IuriPato: folds 
Cannyjim: raises $0.07 to $0.09
rambooschi: folds 
mkEmperor: folds 
leomax100: calls $0.08
stallo36: folds 
Dorex2007: calls $0.07
*** FLOP *** [2s 6s Qs]
leomax100: checks 
Dorex2007: bets $0.28
Cannyjim: folds 
leomax100: folds 
Uncalled bet ($0.28) returned to Dorex2007
Dorex2007 collected $0.28 from pot
*** SUMMARY ***
Total pot $0.29 | Rake $0.01 
Board [2s 6s Qs]
Seat 1: Cannyjim folded on the Flop
Seat 2: rambooschi folded before Flop (didn't bet)
Seat 3: mkEmperor (button) folded before Flop (didn't bet)
Seat 4: leomax100 (small blind) folded on the Flop
Seat 5: stallo36 (big blind) folded before Flop
Seat 7: guiaoms folded before Flop (didn't bet)
Seat 8: Dorex2007 collected ($0.28)
Seat 9: IuriPato folded before Flop (didn't bet)



PokerStars Hand #237374041791:  Hold'em No Limit ($0.01/$0.02 USD) - 2022/07/15 9:03:40 PT [2022/07/15 12:03:40 ET]
Table 'Appella II' 9-max Seat #4 is the button
Seat 1: Cannyjim ($2.44 in chips) 
Seat 2: rambooschi ($3.83 in chips) 
Seat 3: mkEmperor ($1.97 in chips) 
Seat 4: leomax100 ($2.09 in chips) 
Seat 5: stallo36 ($4.10 in chips) 
Seat 7: guiaoms ($2.28 in chips) 
Seat 8: Dorex2007 ($2.19 in chips) 
Seat 9: IuriPato ($2.23 in chips) 
stallo36: posts small blind $0.01
guiaoms: posts big blind $0.02
*** HOLE CARDS ***
Dealt to Dorex2007 [6d 2s]
Dorex2007: folds 
IuriPato: folds 
Cannyjim: calls $0.02
rambooschi: folds 
mkEmperor: calls $0.02
leomax100: raises $0.09 to $0.11
stallo36: folds 
guiaoms: folds 
Cannyjim: calls $0.09
mkEmperor: folds 
*** FLOP *** [5d 3d Kh]
Cannyjim: checks 
leomax100: bets $0.13
Cannyjim: folds 
Uncalled bet ($0.13) returned to leomax100
leomax100 collected $0.26 from pot
*** SUMMARY ***
Total pot $0.27 | Rake $0.01 
Board [5d 3d Kh]
Seat 1: Cannyjim folded on the Flop
Seat 2: rambooschi folded before Flop (didn't bet)
Seat 3: mkEmperor folded before Flop
Seat 4: leomax100 (button) collected ($0.26)
Seat 5: stallo36 (small blind) folded before Flop
Seat 7: guiaoms (big blind) folded before Flop
Seat 8: Dorex2007 folded before Flop (didn't bet)
Seat 9: IuriPato folded before Flop (didn't bet)



PokerStars Hand #237374053755:  Hold'em No Limit ($0.01/$0.02 USD) - 2022/07/15 9:04:24 PT [2022/07/15 12:04:24 ET]
Table 'Appella II' 9-max Seat #5 is the button
Seat 1: Cannyjim ($2.33 in chips) 
Seat 2: rambooschi ($3.83 in chips) 
Seat 3: mkEmperor ($1.95 in chips) 
Seat 4: leomax100 ($2.24 in chips) 
Seat 5: stallo36 ($4.09 in chips) 
Seat 7: guiaoms ($2.26 in chips) 
Seat 8: Dorex2007 ($2.19 in chips) 
Seat 9: IuriPato ($2.23 in chips) 
guiaoms: posts small blind $0.01
Dorex2007: posts big blind $0.02
*** HOLE CARDS ***
Dealt to Dorex2007 [Qc 2s]
IuriPato: folds 
Cannyjim: folds 
rambooschi: folds 
mkEmperor: folds 
leomax100: calls $0.02
stallo36: raises $0.02 to $0.04
guiaoms: folds 
Dorex2007: folds 
leomax100: raises $0.34 to $0.38
stallo36: calls $0.34
*** FLOP *** [Jc Kd 7s]
leomax100: bets $1.86 and is all-in
stallo36: calls $1.86
*** TURN *** [Jc Kd 7s] [Jh]
*** RIVER *** [Jc Kd 7s Jh] [9c]
*** SHOW DOWN ***
leomax100: shows [As Ah] (two pair, Aces and Jacks)
stallo36: shows [Kh Ac] (two pair, Kings and Jacks)
leomax100 cashed out the hand for $3.91 | Cash Out Fee $0.04
*** SUMMARY ***
Total pot $4.51 | Rake $0.16 
Board [Jc Kd 7s Jh 9c]
Seat 1: Cannyjim folded before Flop (didn't bet)
Seat 2: rambooschi folded before Flop (didn't bet)
Seat 3: mkEmperor folded before Flop (didn't bet)
Seat 4: leomax100 showed [As Ah] and won ($4.35) with two pair, Aces and Jacks (pot not awarded as player cashed out)
Seat 5: stallo36 (button) showed [Kh Ac] and lost with two pair, Kings and Jacks
Seat 7: guiaoms (small blind) folded before Flop
Seat 8: Dorex2007 (big blind) folded before Flop
Seat 9: IuriPato folded before Flop (didn't bet)



PokerStars Hand #237374067131:  Hold'em No Limit ($0.01/$0.02 USD) - 2022/07/15 9:05:13 PT [2022/07/15 12:05:13 ET]
Table 'Appella II' 9-max Seat #7 is the button
Seat 1: Cannyjim ($2.33 in chips) 
Seat 2: rambooschi ($3.83 in chips) 
Seat 3: mkEmperor ($1.95 in chips) 
Seat 4: leomax100 ($3.91 in chips) 
Seat 5: stallo36 ($1.85 in chips) 
Seat 7: guiaoms ($2.25 in chips) 
Seat 8: Dorex2007 ($2.17 in chips) 
Seat 9: IuriPato ($2.23 in chips) 
Dorex2007: posts small blind $0.01
IuriPato: posts big blind $0.02
*** HOLE CARDS ***
Dealt to Dorex2007 [6h Th]
Cannyjim: folds 
rambooschi: folds 
mkEmperor: calls $0.02
leomax100: raises $0.07 to $0.09
stallo36: folds 
guiaoms: folds 
Dorex2007: folds 
IuriPato: folds 
mkEmperor: folds 
Uncalled bet ($0.07) returned to leomax100
leomax100 collected $0.07 from pot
*** SUMMARY ***
Total pot $0.07 | Rake $0 
Seat 1: Cannyjim folded before Flop (didn't bet)
Seat 2: rambooschi folded before Flop (didn't bet)
Seat 3: mkEmperor folded before Flop
Seat 4: leomax100 collected ($0.07)
Seat 5: stallo36 folded before Flop (didn't bet)
Seat 7: guiaoms (button) folded before Flop (didn't bet)
Seat 8: Dorex2007 (small blind) folded before Flop
Seat 9: IuriPato (big blind) folded before Flop



PokerStars Hand #237374075517:  Hold'em No Limit ($0.01/$0.02 USD) - 2022/07/15 9:05:44 PT [2022/07/15 12:05:44 ET]
Table 'Appella II' 9-max Seat #8 is the button
Seat 1: Cannyjim ($2.33 in chips) 
Seat 2: rambooschi ($3.83 in chips) 
Seat 3: mkEmperor ($1.93 in chips) 
Seat 4: leomax100 ($3.96 in chips) 
Seat 5: stallo36 ($1.85 in chips) 
Seat 7: guiaoms ($2.25 in chips) 
Seat 8: Dorex2007 ($2.16 in chips) 
Seat 9: IuriPato ($2.21 in chips) 
IuriPato: posts small blind $0.01
Cannyjim: posts big blind $0.02
*** HOLE CARDS ***
Dealt to Dorex2007 [Th Jh]
rambooschi: calls $0.02
mkEmperor: folds 
leomax100: calls $0.02
stallo36: folds 
guiaoms: raises $0.04 to $0.06
Dorex2007: folds 
IuriPato: folds 
Cannyjim: calls $0.04
rambooschi: calls $0.04
leomax100: calls $0.04
*** FLOP *** [7s Td Jd]
Cannyjim: checks 
rambooschi: checks 
leomax100: checks 
guiaoms: checks 
*** TURN *** [7s Td Jd] [Ad]
Cannyjim: checks 
rambooschi: checks 
leomax100: checks 
guiaoms: checks 
*** RIVER *** [7s Td Jd Ad] [6c]
Cannyjim: checks 
rambooschi: bets $0.24
leomax100: calls $0.24
guiaoms: folds 
Cannyjim: folds 
*** SHOW DOWN ***
rambooschi: shows [6h 6d] (three of a kind, Sixes)
leomax100: shows [7c 7h] (three of a kind, Sevens)
leomax100 collected $0.70 from pot
*** SUMMARY ***
Total pot $0.73 | Rake $0.03 
Board [7s Td Jd Ad 6c]
Seat 1: Cannyjim (big blind) folded on the River
Seat 2: rambooschi showed [6h 6d] and lost with three of a kind, Sixes
Seat 3: mkEmperor folded before Flop (didn't bet)
Seat 4: leomax100 showed [7c 7h] and won ($0.70) with three of a kind, Sevens
Seat 5: stallo36 folded before Flop (didn't bet)
Seat 7: guiaoms folded on the River
Seat 8: Dorex2007 (button) folded before Flop (didn't bet)
Seat 9: IuriPato (small blind) folded before Flop



PokerStars Hand #237374096240:  Hold'em No Limit ($0.01/$0.02 USD) - 2022/07/15 9:06:59 PT [2022/07/15 12:06:59 ET]
Table 'Appella II' 9-max Seat #9 is the button
Seat 1: Cannyjim ($2.27 in chips) 
Seat 2: rambooschi ($3.53 in chips) 
Seat 3: mkEmperor ($1.93 in chips) 
Seat 4: leomax100 ($4.36 in chips) 
Seat 5: stallo36 ($1.85 in chips) 
Seat 7: guiaoms ($2.19 in chips) 
Seat 8: Dorex2007 ($2.16 in chips) 
Seat 9: IuriPato ($2.20 in chips) 
Cannyjim: posts small blind $0.01
rambooschi: posts big blind $0.02
*** HOLE CARDS ***
Dealt to Dorex2007 [Jc 9h]
mkEmperor: calls $0.02
leomax100: folds 
stallo36: folds 
guiaoms: folds 
Dorex2007: folds 
IuriPato: folds 
Cannyjim: folds 
rambooschi: checks 
*** FLOP *** [8d Kd Ah]
rambooschi: checks 
mkEmperor: bets $0.02
rambooschi: folds 
Uncalled bet ($0.02) returned to mkEmperor
mkEmperor collected $0.05 from pot
*** SUMMARY ***
Total pot $0.05 | Rake $0 
Board [8d Kd Ah]
Seat 1: Cannyjim (small blind) folded before Flop
Seat 2: rambooschi (big blind) folded on the Flop
Seat 3: mkEmperor collected ($0.05)
Seat 4: leomax100 folded before Flop (didn't bet)
Seat 5: stallo36 folded before Flop (didn't bet)
Seat 7: guiaoms folded before Flop (didn't bet)
Seat 8: Dorex2007 folded before Flop (didn't bet)
Seat 9: IuriPato (button) folded before Flop (didn't bet)



PokerStars Hand #237374103615:  Hold'em No Limit ($0.01/$0.02 USD) - 2022/07/15 9:07:26 PT [2022/07/15 12:07:26 ET]
Table 'Appella II' 9-max Seat #1 is the button
Seat 1: Cannyjim ($2.26 in chips) 
Seat 2: rambooschi ($3.51 in chips) 
Seat 3: mkEmperor ($1.96 in chips) 
Seat 4: leomax100 ($4.36 in chips) 
Seat 5: stallo36 ($1.85 in chips) 
Seat 7: guiaoms ($2.19 in chips) 
Seat 8: Dorex2007 ($2.16 in chips) 
Seat 9: IuriPato ($2.20 in chips) 
rambooschi: posts small blind $0.01
mkEmperor: posts big blind $0.02
*** HOLE CARDS ***
Dealt to Dorex2007 [Ad Th]
leomax100: calls $0.02
stallo36: folds 
guiaoms: folds 
Dorex2007: calls $0.02
IuriPato: folds 
Cannyjim: raises $0.04 to $0.06
rambooschi: folds 
mkEmperor: folds 
leomax100: calls $0.04
Dorex2007: calls $0.04
*** FLOP *** [6s 3h Tc]
leomax100: checks 
Dorex2007: bets $0.13
Cannyjim: calls $0.13
leomax100: calls $0.13
*** TURN *** [6s 3h Tc] [Ah]
leomax100: checks 
Dorex2007: bets $0.29
Cannyjim: folds 
leomax100: calls $0.29
*** RIVER *** [6s 3h Tc Ah] [Ts]
leomax100: checks 
Dorex2007: bets $0.57
leomax100: folds 
Uncalled bet ($0.57) returned to Dorex2007
Dorex2007 collected $1.14 from pot
*** SUMMARY ***
Total pot $1.18 | Rake $0.04 
Board [6s 3h Tc Ah Ts]
Seat 1: Cannyjim (button) folded on the Turn
Seat 2: rambooschi (small blind) folded before Flop
Seat 3: mkEmperor (big blind) folded before Flop
Seat 4: leomax100 folded on the River
Seat 5: stallo36 folded before Flop (didn't bet)
Seat 7: guiaoms folded before Flop (didn't bet)
Seat 8: Dorex2007 collected ($1.14)
Seat 9: IuriPato folded before Flop (didn't bet)



PokerStars Hand #237374132098:  Hold'em No Limit ($0.01/$0.02 USD) - 2022/07/15 9:08:43 PT [2022/07/15 12:08:43 ET]
Table 'Appella II' 9-max Seat #2 is the button
Seat 1: Cannyjim ($2.07 in chips) 
Seat 2: rambooschi ($3.50 in chips) 
Seat 3: mkEmperor ($1.94 in chips) 
Seat 5: stallo36 ($1.85 in chips) 
Seat 7: guiaoms ($2.19 in chips) 
Seat 8: Dorex2007 ($2.82 in chips) 
Seat 9: IuriPato ($2.20 in chips) 
mkEmperor: posts small blind $0.01
leomax100: is sitting out 
stallo36: posts big blind $0.02
monstrrrik: sits out 
*** HOLE CARDS ***
Dealt to Dorex2007 [4s 6c]
guiaoms: folds 
Dorex2007: folds 
IuriPato: raises $0.04 to $0.06
Cannyjim: calls $0.06
rambooschi: folds 
mkEmperor: folds 
stallo36: folds 
*** FLOP *** [Ad Qd 2s]
IuriPato: bets $0.05
Cannyjim: calls $0.05
*** TURN *** [Ad Qd 2s] [Qc]
IuriPato: checks 
monstrrrik is disconnected 
Cannyjim: bets $0.08
IuriPato: raises $0.14 to $0.22
Cannyjim: folds 
Uncalled bet ($0.14) returned to IuriPato
IuriPato collected $0.40 from pot
*** SUMMARY ***
Total pot $0.41 | Rake $0.01 
Board [Ad Qd 2s Qc]
Seat 1: Cannyjim folded on the Turn
Seat 2: rambooschi (button) folded before Flop (didn't bet)
Seat 3: mkEmperor (small blind) folded before Flop
Seat 5: stallo36 (big blind) folded before Flop
Seat 7: guiaoms folded before Flop (didn't bet)
Seat 8: Dorex2007 folded before Flop (didn't bet)
Seat 9: IuriPato collected ($0.40)



PokerStars Hand #237374149027:  Hold'em No Limit ($0.01/$0.02 USD) - 2022/07/15 9:09:46 PT [2022/07/15 12:09:46 ET]
Table 'Appella II' 9-max Seat #3 is the button
Seat 1: Cannyjim ($1.88 in chips) 
Seat 2: rambooschi ($3.50 in chips) 
Seat 3: mkEmperor ($1.93 in chips) 
Seat 5: stallo36 ($1.83 in chips) 
Seat 7: guiaoms ($2.19 in chips) 
Seat 8: Dorex2007 ($2.82 in chips) 
Seat 9: IuriPato ($2.41 in chips) 
stallo36: posts small blind $0.01
monstrrrik is connected 
monstrrrik has timed out
monstrrrik: is sitting out 
guiaoms: posts big blind $0.02
*** HOLE CARDS ***
Dealt to Dorex2007 [Qd 2s]
Dorex2007: folds 
IuriPato: folds 
Cannyjim: folds 
rambooschi: folds 
mkEmperor: folds 
leomax100 leaves the table
stallo36: folds 
Uncalled bet ($0.01) returned to guiaoms
guiaoms collected $0.02 from pot
*** SUMMARY ***
Total pot $0.02 | Rake $0 
Seat 1: Cannyjim folded before Flop (didn't bet)
Seat 2: rambooschi folded before Flop (didn't bet)
Seat 3: mkEmperor (button) folded before Flop (didn't bet)
Seat 5: stallo36 (small blind) folded before Flop
Seat 7: guiaoms (big blind) collected ($0.02)
Seat 8: Dorex2007 folded before Flop (didn't bet)
Seat 9: IuriPato folded before Flop (didn't bet)



PokerStars Hand #237374155339:  Hold'em No Limit ($0.01/$0.02 USD) - 2022/07/15 9:10:10 PT [2022/07/15 12:10:10 ET]
Table 'Appella II' 9-max Seat #5 is the button
Seat 1: Cannyjim ($1.88 in chips) 
Seat 2: rambooschi ($3.50 in chips) 
Seat 3: mkEmperor ($1.93 in chips) 
Seat 5: stallo36 ($1.82 in chips) 
Seat 7: guiaoms ($2.20 in chips) 
Seat 8: Dorex2007 ($2.82 in chips) 
Seat 9: IuriPato ($2.41 in chips) 
guiaoms: posts small blind $0.01
Dorex2007: posts big blind $0.02
*** HOLE CARDS ***
Dealt to Dorex2007 [Td Jh]
Buffaloon joins the table at seat #4 
IuriPato: folds 
Cannyjim: folds 
rambooschi: folds 
mkEmperor: folds 
stallo36: calls $0.02
guiaoms: folds 
Dorex2007: checks 
*** FLOP *** [6d 5d 2d]
Dorex2007: checks 
stallo36: bets $0.04
Dorex2007: calls $0.04
*** TURN *** [6d 5d 2d] [Kd]
Dorex2007: bets $0.13
stallo36: raises $0.13 to $0.26
Dorex2007: calls $0.13
*** RIVER *** [6d 5d 2d Kd] [4c]
Dorex2007: bets $0.18
stallo36: calls $0.18
*** SHOW DOWN ***
Dorex2007: shows [Td Jh] (a flush, King high)
stallo36: mucks hand 
Dorex2007 collected $0.97 from pot
*** SUMMARY ***
Total pot $1.01 | Rake $0.04 
Board [6d 5d 2d Kd 4c]
Seat 1: Cannyjim folded before Flop (didn't bet)
Seat 2: rambooschi folded before Flop (didn't bet)
Seat 3: mkEmperor folded before Flop (didn't bet)
Seat 5: stallo36 (button) mucked [4d Qs]
Seat 7: guiaoms (small blind) folded before Flop
Seat 8: Dorex2007 (big blind) showed [Td Jh] and won ($0.97) with a flush, King high
Seat 9: IuriPato folded before Flop (didn't bet)



PokerStars Hand #237374168780:  Hold'em No Limit ($0.01/$0.02 USD) - 2022/07/15 9:10:59 PT [2022/07/15 12:10:59 ET]
Table 'Appella II' 9-max Seat #7 is the button
Seat 1: Cannyjim ($1.88 in chips) 
Seat 2: rambooschi ($3.50 in chips) 
Seat 3: mkEmperor ($1.93 in chips) 
Seat 5: stallo36 ($1.32 in chips) 
Seat 7: guiaoms ($2.19 in chips) 
Seat 8: Dorex2007 ($3.29 in chips) 
Seat 9: IuriPato ($2.41 in chips) 
Dorex2007: posts small blind $0.01
IuriPato: posts big blind $0.02
Buffaloon: sits out 
monstrrrik: sits out 
*** HOLE CARDS ***
Dealt to Dorex2007 [2s Kc]
Cannyjim: folds 
rambooschi: calls $0.02
mkEmperor: folds 
stallo36: raises $0.02 to $0.04
guiaoms: folds 
Dorex2007: folds 
IuriPato: folds 
rambooschi: calls $0.02
*** FLOP *** [4h 2h 9h]
rambooschi: checks 
stallo36: bets $0.04
rambooschi: calls $0.04
*** TURN *** [4h 2h 9h] [4c]
rambooschi: bets $0.09
stallo36: raises $0.09 to $0.18
rambooschi: calls $0.09
*** RIVER *** [4h 2h 9h 4c] [8h]
rambooschi: checks 
stallo36: bets $0.16
rambooschi: folds 
Uncalled bet ($0.16) returned to stallo36
stallo36 collected $0.53 from pot
*** SUMMARY ***
Total pot $0.55 | Rake $0.02 
Board [4h 2h 9h 4c 8h]
Seat 1: Cannyjim folded before Flop (didn't bet)
Seat 2: rambooschi folded on the River
Seat 3: mkEmperor folded before Flop (didn't bet)
Seat 5: stallo36 collected ($0.53)
Seat 7: guiaoms (button) folded before Flop (didn't bet)
Seat 8: Dorex2007 (small blind) folded before Flop
Seat 9: IuriPato (big blind) folded before Flop



PokerStars Hand #237374181338:  Hold'em No Limit ($0.01/$0.02 USD) - 2022/07/15 9:11:44 PT [2022/07/15 12:11:44 ET]
Table 'Appella II' 9-max Seat #8 is the button
Seat 1: Cannyjim ($1.88 in chips) 
Seat 2: rambooschi ($3.24 in chips) 
Seat 3: mkEmperor ($1.93 in chips) 
Seat 5: stallo36 ($1.59 in chips) 
Seat 7: guiaoms ($2.19 in chips) 
Seat 8: Dorex2007 ($3.28 in chips) 
Seat 9: IuriPato ($2.39 in chips) 
IuriPato: posts small blind $0.01
Cannyjim: posts big blind $0.02
Buffaloon: sits out 
monstrrrik: sits out 
*** HOLE CARDS ***
Dealt to Dorex2007 [Jd 2c]
rambooschi: folds 
mkEmperor: folds 
stallo36: calls $0.02
guiaoms: folds 
Dorex2007: folds 
IuriPato: folds 
Cannyjim: checks 
*** FLOP *** [Qs Ks 7d]
Cannyjim: checks 
stallo36: checks 
*** TURN *** [Qs Ks 7d] [6d]
Cannyjim: checks 
stallo36: bets $0.08
Cannyjim: calls $0.08
*** RIVER *** [Qs Ks 7d 6d] [3c]
Cannyjim: checks 
stallo36: bets $0.08
Cannyjim: calls $0.08
*** SHOW DOWN ***
stallo36: shows [9s Td] (high card King)
Cannyjim: shows [6s 4s] (a pair of Sixes)
Cannyjim collected $0.36 from pot
*** SUMMARY ***
Total pot $0.37 | Rake $0.01 
Board [Qs Ks 7d 6d 3c]
Seat 1: Cannyjim (big blind) showed [6s 4s] and won ($0.36) with a pair of Sixes
Seat 2: rambooschi folded before Flop (didn't bet)
Seat 3: mkEmperor folded before Flop (didn't bet)
Seat 5: stallo36 showed [9s Td] and lost with high card King
Seat 7: guiaoms folded before Flop (didn't bet)
Seat 8: Dorex2007 (button) folded before Flop (didn't bet)
Seat 9: IuriPato (small blind) folded before Flop



PokerStars Hand #237374195524:  Hold'em No Limit ($0.01/$0.02 USD) - 2022/07/15 9:12:36 PT [2022/07/15 12:12:36 ET]
Table 'Appella II' 9-max Seat #9 is the button
Seat 1: Cannyjim ($2.06 in chips) 
Seat 2: rambooschi ($3.24 in chips) 
Seat 3: mkEmperor ($1.93 in chips) 
Seat 5: stallo36 ($1.41 in chips) 
Seat 7: guiaoms ($2.19 in chips) 
Seat 8: Dorex2007 ($3.28 in chips) 
Seat 9: IuriPato ($2.38 in chips) 
Cannyjim: posts small blind $0.01
rambooschi: posts big blind $0.02
Buffaloon: sits out 
monstrrrik: sits out 
*** HOLE CARDS ***
Dealt to Dorex2007 [7c Qh]
mkEmperor: folds 
stallo36: raises $0.06 to $0.08
guiaoms: folds 
Dorex2007: folds 
IuriPato: folds 
Cannyjim: folds 
rambooschi: folds 
Uncalled bet ($0.06) returned to stallo36
stallo36 collected $0.05 from pot
*** SUMMARY ***
Total pot $0.05 | Rake $0 
Seat 1: Cannyjim (small blind) folded before Flop
Seat 2: rambooschi (big blind) folded before Flop
Seat 3: mkEmperor folded before Flop (didn't bet)
Seat 5: stallo36 collected ($0.05)
Seat 7: guiaoms folded before Flop (didn't bet)
Seat 8: Dorex2007 folded before Flop (didn't bet)
Seat 9: IuriPato (button) folded before Flop (didn't bet)



PokerStars Hand #237374200038:  Hold'em No Limit ($0.01/$0.02 USD) - 2022/07/15 9:12:52 PT [2022/07/15 12:12:52 ET]
Table 'Appella II' 9-max Seat #1 is the button
Seat 1: Cannyjim ($2.05 in chips) 
Seat 2: rambooschi ($3.22 in chips) 
Seat 3: mkEmperor ($1.93 in chips) 
Seat 5: stallo36 ($1.44 in chips) 
Seat 7: guiaoms ($2.19 in chips) 
Seat 8: Dorex2007 ($3.28 in chips) 
Seat 9: IuriPato ($2.38 in chips) 
rambooschi: posts small blind $0.01
mkEmperor: posts big blind $0.02
Buffaloon: sits out 
monstrrrik: sits out 
*** HOLE CARDS ***
Dealt to Dorex2007 [7h Tc]
stallo36: calls $0.02
guiaoms: folds 
Dorex2007: folds 
IuriPato: folds 
Cannyjim: folds 
rambooschi: calls $0.01
mkEmperor: checks 
*** FLOP *** [4h 4d 3d]
rambooschi: checks 
mkEmperor: checks 
stallo36: bets $0.08
rambooschi: folds 
mkEmperor: folds 
Uncalled bet ($0.08) returned to stallo36
stallo36 collected $0.06 from pot
*** SUMMARY ***
Total pot $0.06 | Rake $0 
Board [4h 4d 3d]
Seat 1: Cannyjim (button) folded before Flop (didn't bet)
Seat 2: rambooschi (small blind) folded on the Flop
Seat 3: mkEmperor (big blind) folded on the Flop
Seat 5: stallo36 collected ($0.06)
Seat 7: guiaoms folded before Flop (didn't bet)
Seat 8: Dorex2007 folded before Flop (didn't bet)
Seat 9: IuriPato folded before Flop (didn't bet)



PokerStars Hand #237374211609:  Hold'em No Limit ($0.01/$0.02 USD) - 2022/07/15 9:13:34 PT [2022/07/15 12:13:34 ET]
Table 'Appella II' 9-max Seat #2 is the button
Seat 1: Cannyjim ($2.05 in chips) 
Seat 2: rambooschi ($3.20 in chips) 
Seat 3: mkEmperor ($1.91 in chips) 
Seat 4: Buffaloon ($2 in chips) 
Seat 5: stallo36 ($1.48 in chips) 
Seat 7: guiaoms ($2.19 in chips) 
Seat 8: Dorex2007 ($3.28 in chips) 
Seat 9: IuriPato ($2.38 in chips) 
mkEmperor: posts small blind $0.01
Buffaloon: posts big blind $0.02
monstrrrik: sits out 
*** HOLE CARDS ***
Dealt to Dorex2007 [Qc 4d]
stallo36: folds 
guiaoms: folds 
Dorex2007: folds 
IuriPato: folds 
Cannyjim: folds 
rambooschi: folds 
mkEmperor: calls $0.01
Buffaloon: checks 
*** FLOP *** [Ad Qh 6s]
mkEmperor: checks 
Buffaloon: bets $0.02
mkEmperor: folds 
Uncalled bet ($0.02) returned to Buffaloon
Buffaloon collected $0.04 from pot
*** SUMMARY ***
Total pot $0.04 | Rake $0 
Board [Ad Qh 6s]
Seat 1: Cannyjim folded before Flop (didn't bet)
Seat 2: rambooschi (button) folded before Flop (didn't bet)
Seat 3: mkEmperor (small blind) folded on the Flop
Seat 4: Buffaloon (big blind) collected ($0.04)
Seat 5: stallo36 folded before Flop (didn't bet)
Seat 7: guiaoms folded before Flop (didn't bet)
Seat 8: Dorex2007 folded before Flop (didn't bet)
Seat 9: IuriPato folded before Flop (didn't bet)



PokerStars Hand #237374221314:  Hold'em No Limit ($0.01/$0.02 USD) - 2022/07/15 9:14:09 PT [2022/07/15 12:14:09 ET]
Table 'Appella II' 9-max Seat #3 is the button
Seat 1: Cannyjim ($2.05 in chips) 
Seat 2: rambooschi ($3.20 in chips) 
Seat 3: mkEmperor ($1.89 in chips) 
Seat 4: Buffaloon ($2.02 in chips) 
Seat 5: stallo36 ($1.48 in chips) 
Seat 7: guiaoms ($2.19 in chips) 
Seat 8: Dorex2007 ($3.28 in chips) 
Seat 9: IuriPato ($2.38 in chips) 
Buffaloon: posts small blind $0.01
stallo36: posts big blind $0.02
monstrrrik: sits out 
*** HOLE CARDS ***
Dealt to Dorex2007 [7c 8h]
guiaoms: folds 
Dorex2007: folds 
IuriPato: folds 
Cannyjim: calls $0.02
rambooschi: calls $0.02
mkEmperor: folds 
Buffaloon: calls $0.01
stallo36: raises $0.04 to $0.06
Cannyjim: calls $0.04
rambooschi: calls $0.04
Buffaloon: calls $0.04
*** FLOP *** [7s 3c 3h]
Buffaloon: checks 
stallo36: bets $0.08
Cannyjim: folds 
rambooschi: folds 
Buffaloon: folds 
Uncalled bet ($0.08) returned to stallo36
stallo36 collected $0.23 from pot
*** SUMMARY ***
Total pot $0.24 | Rake $0.01 
Board [7s 3c 3h]
Seat 1: Cannyjim folded on the Flop
Seat 2: rambooschi folded on the Flop
Seat 3: mkEmperor (button) folded before Flop (didn't bet)
Seat 4: Buffaloon (small blind) folded on the Flop
Seat 5: stallo36 (big blind) collected ($0.23)
Seat 7: guiaoms folded before Flop (didn't bet)
Seat 8: Dorex2007 folded before Flop (didn't bet)
Seat 9: IuriPato folded before Flop (didn't bet)



PokerStars Hand #237374233700:  Hold'em No Limit ($0.01/$0.02 USD) - 2022/07/15 9:14:54 PT [2022/07/15 12:14:54 ET]
Table 'Appella II' 9-max Seat #4 is the button
Seat 1: Cannyjim ($1.99 in chips) 
Seat 2: rambooschi ($3.14 in chips) 
Seat 3: mkEmperor ($1.89 in chips) 
Seat 4: Buffaloon ($2 in chips) 
Seat 5: stallo36 ($1.65 in chips) 
Seat 6: monstrrrik ($2.42 in chips) 
Seat 7: guiaoms ($2.19 in chips) 
Seat 8: Dorex2007 ($3.28 in chips) 
Seat 9: IuriPato ($2.38 in chips) 
stallo36: posts small blind $0.01
monstrrrik: posts big blind $0.02
*** HOLE CARDS ***
Dealt to Dorex2007 [Ad 6s]
guiaoms: calls $0.02
Dorex2007: folds 
IuriPato: folds 
Cannyjim: folds 
rambooschi: folds 
mkEmperor: folds 
Buffaloon: folds 
stallo36: calls $0.01
monstrrrik: checks 
*** FLOP *** [2s Ah 8h]
stallo36: checks 
monstrrrik: checks 
guiaoms: bets $0.06
stallo36: folds 
monstrrrik: folds 
Uncalled bet ($0.06) returned to guiaoms
guiaoms collected $0.06 from pot
*** SUMMARY ***
Total pot $0.06 | Rake $0 
Board [2s Ah 8h]
Seat 1: Cannyjim folded before Flop (didn't bet)
Seat 2: rambooschi folded before Flop (didn't bet)
Seat 3: mkEmperor folded before Flop (didn't bet)
Seat 4: Buffaloon (button) folded before Flop (didn't bet)
Seat 5: stallo36 (small blind) folded on the Flop
Seat 6: monstrrrik (big blind) folded on the Flop
Seat 7: guiaoms collected ($0.06)
Seat 8: Dorex2007 folded before Flop (didn't bet)
Seat 9: IuriPato folded before Flop (didn't bet)



PokerStars Hand #237374244103:  Hold'em No Limit ($0.01/$0.02 USD) - 2022/07/15 9:15:31 PT [2022/07/15 12:15:31 ET]
Table 'Appella II' 9-max Seat #5 is the button
Seat 1: Cannyjim ($1.99 in chips) 
Seat 2: rambooschi ($3.14 in chips) 
Seat 3: mkEmperor ($1.89 in chips) 
Seat 4: Buffaloon ($2 in chips) 
Seat 5: stallo36 ($1.63 in chips) 
Seat 6: monstrrrik ($2.40 in chips) 
Seat 7: guiaoms ($2.23 in chips) 
Seat 8: Dorex2007 ($3.28 in chips) 
Seat 9: IuriPato ($2.38 in chips) 
monstrrrik: posts small blind $0.01
guiaoms: posts big blind $0.02
*** HOLE CARDS ***
Dealt to Dorex2007 [3h 7d]
Dorex2007: folds 
IuriPato: folds 
Cannyjim: folds 
rambooschi: folds 
mkEmperor: folds 
Buffaloon: folds 
stallo36: folds 
monstrrrik: raises $0.06 to $0.08
guiaoms: folds 
Uncalled bet ($0.06) returned to monstrrrik
monstrrrik collected $0.04 from pot
*** SUMMARY ***
Total pot $0.04 | Rake $0 
Seat 1: Cannyjim folded before Flop (didn't bet)
Seat 2: rambooschi folded before Flop (didn't bet)
Seat 3: mkEmperor folded before Flop (didn't bet)
Seat 4: Buffaloon folded before Flop (didn't bet)
Seat 5: stallo36 (button) folded before Flop (didn't bet)
Seat 6: monstrrrik (small blind) collected ($0.04)
Seat 7: guiaoms (big blind) folded before Flop
Seat 8: Dorex2007 folded before Flop (didn't bet)
Seat 9: IuriPato folded before Flop (didn't bet)



PokerStars Hand #237374250007:  Hold'em No Limit ($0.01/$0.02 USD) - 2022/07/15 9:15:53 PT [2022/07/15 12:15:53 ET]
Table 'Appella II' 9-max Seat #6 is the button
Seat 1: Cannyjim ($1.99 in chips) 
Seat 2: rambooschi ($3.14 in chips) 
Seat 3: mkEmperor ($1.89 in chips) 
Seat 4: Buffaloon ($2 in chips) 
Seat 5: stallo36 ($1.63 in chips) 
Seat 6: monstrrrik ($2.42 in chips) 
Seat 7: guiaoms ($2.21 in chips) 
Seat 8: Dorex2007 ($3.28 in chips) 
Seat 9: IuriPato ($2.38 in chips) 
guiaoms: posts small blind $0.01
Dorex2007: posts big blind $0.02
*** HOLE CARDS ***
Dealt to Dorex2007 [Qc Qd]
IuriPato: folds 
Cannyjim: folds 
rambooschi: calls $0.02
mkEmperor: folds 
Buffaloon: folds 
stallo36: raises $0.02 to $0.04
monstrrrik has timed out
monstrrrik: folds 
guiaoms: folds 
Dorex2007: raises $0.06 to $0.10
rambooschi: calls $0.08
stallo36: folds 
*** FLOP *** [9c 7h Ad]
Dorex2007: checks 
rambooschi: bets $0.12
Dorex2007: folds 
Uncalled bet ($0.12) returned to rambooschi
rambooschi collected $0.24 from pot
*** SUMMARY ***
Total pot $0.25 | Rake $0.01 
Board [9c 7h Ad]
Seat 1: Cannyjim folded before Flop (didn't bet)
Seat 2: rambooschi collected ($0.24)
Seat 3: mkEmperor folded before Flop (didn't bet)
Seat 4: Buffaloon folded before Flop (didn't bet)
Seat 5: stallo36 folded before Flop
Seat 6: monstrrrik (button) folded before Flop (didn't bet)
Seat 7: guiaoms (small blind) folded before Flop
Seat 8: Dorex2007 (big blind) folded on the Flop
Seat 9: IuriPato folded before Flop (didn't bet)



PokerStars Hand #237374270926:  Hold'em No Limit ($0.01/$0.02 USD) - 2022/07/15 9:17:00 PT [2022/07/15 12:17:00 ET]
Table 'Appella II' 9-max Seat #7 is the button
Seat 1: Cannyjim ($1.99 in chips) 
Seat 2: rambooschi ($3.28 in chips) 
Seat 3: mkEmperor ($1.89 in chips) 
Seat 4: Buffaloon ($2 in chips) 
Seat 5: stallo36 ($1.59 in chips) 
Seat 6: monstrrrik ($2.42 in chips) 
Seat 7: guiaoms ($2.20 in chips) 
Seat 8: Dorex2007 ($3.18 in chips) 
Seat 9: IuriPato ($2.38 in chips) 
Dorex2007: posts small blind $0.01
IuriPato: posts big blind $0.02
*** HOLE CARDS ***
Dealt to Dorex2007 [5d Ts]
Cannyjim: folds 
rambooschi: calls $0.02
mkEmperor: folds 
Buffaloon: folds 
stallo36: folds 
monstrrrik: folds 
guiaoms: folds 
Dorex2007: folds 
IuriPato: checks 
*** FLOP *** [Kd Td 4c]
IuriPato: checks 
rambooschi: bets $0.02
IuriPato: calls $0.02
*** TURN *** [Kd Td 4c] [9d]
IuriPato: checks 
rambooschi: checks 
*** RIVER *** [Kd Td 4c 9d] [8h]
IuriPato: bets $0.07
rambooschi: folds 
Uncalled bet ($0.07) returned to IuriPato
IuriPato collected $0.09 from pot
*** SUMMARY ***
Total pot $0.09 | Rake $0 
Board [Kd Td 4c 9d 8h]
Seat 1: Cannyjim folded before Flop (didn't bet)
Seat 2: rambooschi folded on the River
Seat 3: mkEmperor folded before Flop (didn't bet)
Seat 4: Buffaloon folded before Flop (didn't bet)
Seat 5: stallo36 folded before Flop (didn't bet)
Seat 6: monstrrrik folded before Flop (didn't bet)
Seat 7: guiaoms (button) folded before Flop (didn't bet)
Seat 8: Dorex2007 (small blind) folded before Flop
Seat 9: IuriPato (big blind) collected ($0.09)



PokerStars Hand #237374283237:  Hold'em No Limit ($0.01/$0.02 USD) - 2022/07/15 9:17:45 PT [2022/07/15 12:17:45 ET]
Table 'Appella II' 9-max Seat #8 is the button
Seat 1: Cannyjim ($1.99 in chips) 
Seat 2: rambooschi ($3.24 in chips) 
Seat 3: mkEmperor ($1.89 in chips) 
Seat 4: Buffaloon ($2 in chips) 
Seat 5: stallo36 ($1.59 in chips) 
Seat 6: monstrrrik ($2.42 in chips) 
Seat 7: guiaoms ($2.20 in chips) 
Seat 8: Dorex2007 ($3.17 in chips) 
Seat 9: IuriPato ($2.43 in chips) 
IuriPato: posts small blind $0.01
Cannyjim: posts big blind $0.02
*** HOLE CARDS ***
Dealt to Dorex2007 [Ah Ad]
rambooschi: calls $0.02
mkEmperor: folds 
Buffaloon: raises $0.06 to $0.08
stallo36: calls $0.08
monstrrrik: folds 
guiaoms: folds 
Dorex2007: raises $0.16 to $0.24
IuriPato: folds 
Cannyjim: folds 
rambooschi: folds 
Buffaloon: folds 
stallo36: calls $0.16
*** FLOP *** [Qs 3h Jd]
stallo36: checks 
Dorex2007: bets $0.29
stallo36: calls $0.29
*** TURN *** [Qs 3h Jd] [5s]
stallo36: checks 
Dorex2007: bets $2.64 and is all-in
stallo36: folds 
Uncalled bet ($2.64) returned to Dorex2007
Dorex2007 collected $1.15 from pot
*** SUMMARY ***
Total pot $1.19 | Rake $0.04 
Board [Qs 3h Jd 5s]
Seat 1: Cannyjim (big blind) folded before Flop
Seat 2: rambooschi folded before Flop
Seat 3: mkEmperor folded before Flop (didn't bet)
Seat 4: Buffaloon folded before Flop
Seat 5: stallo36 folded on the Turn
Seat 6: monstrrrik folded before Flop (didn't bet)
Seat 7: guiaoms folded before Flop (didn't bet)
Seat 8: Dorex2007 (button) collected ($1.15)
Seat 9: IuriPato (small blind) folded before Flop



PokerStars Hand #237374305495:  Hold'em No Limit ($0.01/$0.02 USD) - 2022/07/15 9:19:06 PT [2022/07/15 12:19:06 ET]
Table 'Appella II' 9-max Seat #9 is the button
Seat 1: Cannyjim ($1.97 in chips) 
Seat 2: rambooschi ($3.22 in chips) 
Seat 3: mkEmperor ($1.89 in chips) 
Seat 4: Buffaloon ($2 in chips) 
Seat 5: stallo36 ($1.06 in chips) 
Seat 6: monstrrrik ($2.42 in chips) 
Seat 7: guiaoms ($2.20 in chips) 
Seat 8: Dorex2007 ($3.79 in chips) 
Seat 9: IuriPato ($2.42 in chips) 
Cannyjim: posts small blind $0.01
rambooschi: posts big blind $0.02
*** HOLE CARDS ***
Dealt to Dorex2007 [Jh 5c]
mkEmperor: folds 
Buffaloon: folds 
stallo36: calls $0.02
monstrrrik: folds 
guiaoms: raises $0.04 to $0.06
Dorex2007: folds 
IuriPato: folds 
Cannyjim: folds 
rambooschi: calls $0.04
stallo36: calls $0.04
*** FLOP *** [3s 5d 7c]
rambooschi: checks 
stallo36: checks 
guiaoms: bets $0.04
rambooschi: folds 
stallo36: folds 
Uncalled bet ($0.04) returned to guiaoms
guiaoms collected $0.18 from pot
*** SUMMARY ***
Total pot $0.19 | Rake $0.01 
Board [3s 5d 7c]
Seat 1: Cannyjim (small blind) folded before Flop
Seat 2: rambooschi (big blind) folded on the Flop
Seat 3: mkEmperor folded before Flop (didn't bet)
Seat 4: Buffaloon folded before Flop (didn't bet)
Seat 5: stallo36 folded on the Flop
Seat 6: monstrrrik folded before Flop (didn't bet)
Seat 7: guiaoms collected ($0.18)
Seat 8: Dorex2007 folded before Flop (didn't bet)
Seat 9: IuriPato (button) folded before Flop (didn't bet)



PokerStars Hand #237374322736:  Hold'em No Limit ($0.01/$0.02 USD) - 2022/07/15 9:20:09 PT [2022/07/15 12:20:09 ET]
Table 'Appella II' 9-max Seat #1 is the button
Seat 1: Cannyjim ($1.96 in chips) 
Seat 2: rambooschi ($3.16 in chips) 
Seat 3: mkEmperor ($1.89 in chips) 
Seat 4: Buffaloon ($2 in chips) 
Seat 5: stallo36 ($1 in chips) 
Seat 6: monstrrrik ($2.42 in chips) 
Seat 7: guiaoms ($2.32 in chips) 
Seat 8: Dorex2007 ($3.79 in chips) 
Seat 9: IuriPato ($2.42 in chips) 
rambooschi: posts small blind $0.01
mkEmperor: posts big blind $0.02
*** HOLE CARDS ***
Dealt to Dorex2007 [5d Ah]
Buffaloon: folds 
stallo36: raises $0.02 to $0.04
monstrrrik: folds 
guiaoms: folds 
Dorex2007: folds 
IuriPato: folds 
Cannyjim: calls $0.04
rambooschi: folds 
mkEmperor: folds 
*** FLOP *** [6d Qs 7s]
stallo36: checks 
Cannyjim: bets $0.05
stallo36: calls $0.05
*** TURN *** [6d Qs 7s] [Qd]
stallo36: bets $0.14
Cannyjim: raises $1.73 to $1.87 and is all-in
stallo36: calls $0.77 and is all-in
Uncalled bet ($0.96) returned to Cannyjim
*** RIVER *** [6d Qs 7s Qd] [Ks]
*** SHOW DOWN ***
stallo36: shows [Th Ts] (two pair, Queens and Tens)
Cannyjim: shows [7d 7c] (a full house, Sevens full of Queens)
Cannyjim collected $1.96 from pot
*** SUMMARY ***
Total pot $2.03 | Rake $0.07 
Board [6d Qs 7s Qd Ks]
Seat 1: Cannyjim (button) showed [7d 7c] and won ($1.96) with a full house, Sevens full of Queens
Seat 2: rambooschi (small blind) folded before Flop
Seat 3: mkEmperor (big blind) folded before Flop
Seat 4: Buffaloon folded before Flop (didn't bet)
Seat 5: stallo36 showed [Th Ts] and lost with two pair, Queens and Tens
Seat 6: monstrrrik folded before Flop (didn't bet)
Seat 7: guiaoms folded before Flop (didn't bet)
Seat 8: Dorex2007 folded before Flop (didn't bet)
Seat 9: IuriPato folded before Flop (didn't bet)



PokerStars Hand #237374338613:  Hold'em No Limit ($0.01/$0.02 USD) - 2022/07/15 9:21:07 PT [2022/07/15 12:21:07 ET]
Table 'Appella II' 9-max Seat #2 is the button
Seat 1: Cannyjim ($2.92 in chips) 
Seat 2: rambooschi ($3.15 in chips) 
Seat 3: mkEmperor ($1.87 in chips) 
Seat 4: Buffaloon ($2 in chips) 
Seat 6: monstrrrik ($2.42 in chips) 
Seat 7: guiaoms ($2.32 in chips) 
Seat 8: Dorex2007 ($3.79 in chips) 
Seat 9: IuriPato ($2.42 in chips) 
mkEmperor: posts small blind $0.01
Buffaloon: posts big blind $0.02
*** HOLE CARDS ***
Dealt to Dorex2007 [Kc 4s]
monstrrrik: folds 
guiaoms: raises $0.02 to $0.04
Dorex2007: folds 
IuriPato: folds 
stallo36 leaves the table
Cannyjim: folds 
rambooschi: calls $0.04
mkEmperor: folds 
Buffaloon: calls $0.02
*** FLOP *** [2c 6c 7d]
Buffaloon: checks 
guiaoms: bets $0.04
pokerIman27 joins the table at seat #5 
rambooschi: raises $0.11 to $0.15
Buffaloon: folds 
guiaoms: folds 
Uncalled bet ($0.11) returned to rambooschi
rambooschi collected $0.20 from pot
*** SUMMARY ***
Total pot $0.21 | Rake $0.01 
Board [2c 6c 7d]
Seat 1: Cannyjim folded before Flop (didn't bet)
Seat 2: rambooschi (button) collected ($0.20)
Seat 3: mkEmperor (small blind) folded before Flop
Seat 4: Buffaloon (big blind) folded on the Flop
Seat 6: monstrrrik folded before Flop (didn't bet)
Seat 7: guiaoms folded on the Flop
Seat 8: Dorex2007 folded before Flop (didn't bet)
Seat 9: IuriPato folded before Flop (didn't bet)



PokerStars Hand #237374351236:  Hold'em No Limit ($0.01/$0.02 USD) - 2022/07/15 9:21:54 PT [2022/07/15 12:21:54 ET]
Table 'Appella II' 9-max Seat #3 is the button
Seat 1: Cannyjim ($2.92 in chips) 
Seat 2: rambooschi ($3.27 in chips) 
Seat 3: mkEmperor ($1.86 in chips) 
Seat 4: Buffaloon ($2 in chips) 
Seat 5: pokerIman27 ($1.60 in chips) 
Seat 6: monstrrrik ($2.42 in chips) 
Seat 7: guiaoms ($2.24 in chips) 
Seat 8: Dorex2007 ($3.79 in chips) 
Seat 9: IuriPato ($2.42 in chips) 
Buffaloon: posts small blind $0.01
pokerIman27: posts big blind $0.02
*** HOLE CARDS ***
Dealt to Dorex2007 [3s Ah]
monstrrrik: folds 
guiaoms: folds 
Dorex2007: folds 
IuriPato: folds 
Cannyjim: folds 
rambooschi: folds 
mkEmperor: folds 
Buffaloon: folds 
Uncalled bet ($0.01) returned to pokerIman27
pokerIman27 collected $0.02 from pot
*** SUMMARY ***
Total pot $0.02 | Rake $0 
Seat 1: Cannyjim folded before Flop (didn't bet)
Seat 2: rambooschi folded before Flop (didn't bet)
Seat 3: mkEmperor (button) folded before Flop (didn't bet)
Seat 4: Buffaloon (small blind) folded before Flop
Seat 5: pokerIman27 (big blind) collected ($0.02)
Seat 6: monstrrrik folded before Flop (didn't bet)
Seat 7: guiaoms folded before Flop (didn't bet)
Seat 8: Dorex2007 folded before Flop (didn't bet)
Seat 9: IuriPato folded before Flop (didn't bet)



PokerStars Hand #237374354603:  Hold'em No Limit ($0.01/$0.02 USD) - 2022/07/15 9:22:06 PT [2022/07/15 12:22:06 ET]
Table 'Appella II' 9-max Seat #4 is the button
Seat 1: Cannyjim ($2.92 in chips) 
Seat 2: rambooschi ($3.27 in chips) 
Seat 3: mkEmperor ($1.86 in chips) 
Seat 4: Buffaloon ($2 in chips) 
Seat 5: pokerIman27 ($1.61 in chips) 
Seat 6: monstrrrik ($2.42 in chips) 
Seat 7: guiaoms ($2.24 in chips) 
Seat 8: Dorex2007 ($3.79 in chips) 
Seat 9: IuriPato ($2.42 in chips) 
pokerIman27: posts small blind $0.01
monstrrrik: posts big blind $0.02
*** HOLE CARDS ***
Dealt to Dorex2007 [6d 7c]
guiaoms: folds 
Dorex2007: folds 
IuriPato: folds 
Cannyjim: folds 
rambooschi: folds 
mkEmperor: folds 
Buffaloon: raises $0.04 to $0.06
pokerIman27: calls $0.05
monstrrrik: folds 
*** FLOP *** [4d 8s 3s]
pokerIman27: checks 
Buffaloon: bets $0.07
pokerIman27: folds 
Uncalled bet ($0.07) returned to Buffaloon
Buffaloon collected $0.14 from pot
*** SUMMARY ***
Total pot $0.14 | Rake $0 
Board [4d 8s 3s]
Seat 1: Cannyjim folded before Flop (didn't bet)
Seat 2: rambooschi folded before Flop (didn't bet)
Seat 3: mkEmperor folded before Flop (didn't bet)
Seat 4: Buffaloon (button) collected ($0.14)
Seat 5: pokerIman27 (small blind) folded on the Flop
Seat 6: monstrrrik (big blind) folded before Flop
Seat 7: guiaoms folded before Flop (didn't bet)
Seat 8: Dorex2007 folded before Flop (didn't bet)
Seat 9: IuriPato folded before Flop (didn't bet)



PokerStars Hand #237374365002:  Hold'em No Limit ($0.01/$0.02 USD) - 2022/07/15 9:22:44 PT [2022/07/15 12:22:44 ET]
Table 'Appella II' 9-max Seat #5 is the button
Seat 1: Cannyjim ($2.92 in chips) 
Seat 2: rambooschi ($3.27 in chips) 
Seat 3: mkEmperor ($1.86 in chips) 
Seat 4: Buffaloon ($2.08 in chips) 
Seat 5: pokerIman27 ($1.55 in chips) 
Seat 6: monstrrrik ($2.40 in chips) 
Seat 7: guiaoms ($2.24 in chips) 
Seat 8: Dorex2007 ($3.79 in chips) 
Seat 9: IuriPato ($2.42 in chips) 
monstrrrik: posts small blind $0.01
guiaoms: posts big blind $0.02
*** HOLE CARDS ***
Dealt to Dorex2007 [Js 9d]
Dorex2007: folds 
IuriPato: folds 
Cannyjim: raises $0.02 to $0.04
rambooschi: folds 
mkEmperor: folds 
Buffaloon: folds 
pokerIman27: calls $0.04
monstrrrik: folds 
guiaoms: folds 
*** FLOP *** [As 7h Kc]
Cannyjim: bets $0.05
pokerIman27: folds 
Uncalled bet ($0.05) returned to Cannyjim
Cannyjim collected $0.11 from pot
*** SUMMARY ***
Total pot $0.11 | Rake $0 
Board [As 7h Kc]
Seat 1: Cannyjim collected ($0.11)
Seat 2: rambooschi folded before Flop (didn't bet)
Seat 3: mkEmperor folded before Flop (didn't bet)
Seat 4: Buffaloon folded before Flop (didn't bet)
Seat 5: pokerIman27 (button) folded on the Flop
Seat 6: monstrrrik (small blind) folded before Flop
Seat 7: guiaoms (big blind) folded before Flop
Seat 8: Dorex2007 folded before Flop (didn't bet)
Seat 9: IuriPato folded before Flop (didn't bet)



PokerStars Hand #237374375428:  Hold'em No Limit ($0.01/$0.02 USD) - 2022/07/15 9:23:23 PT [2022/07/15 12:23:23 ET]
Table 'Appella II' 9-max Seat #6 is the button
Seat 1: Cannyjim ($2.99 in chips) 
Seat 2: rambooschi ($3.27 in chips) 
Seat 3: mkEmperor ($1.86 in chips) 
Seat 4: Buffaloon ($2.08 in chips) 
Seat 5: pokerIman27 ($1.51 in chips) 
Seat 6: monstrrrik ($2.39 in chips) 
Seat 7: guiaoms ($2.22 in chips) 
Seat 8: Dorex2007 ($3.79 in chips) 
Seat 9: IuriPato ($2.42 in chips) 
guiaoms: posts small blind $0.01
Dorex2007: posts big blind $0.02
*** HOLE CARDS ***
Dealt to Dorex2007 [5d 9c]
IuriPato: folds 
Cannyjim: folds 
rambooschi: folds 
mkEmperor: calls $0.02
Buffaloon: raises $0.06 to $0.08
pokerIman27: folds 
monstrrrik: folds 
guiaoms: folds 
Dorex2007: folds 
mkEmperor: raises $1.78 to $1.86 and is all-in
Buffaloon: folds 
Uncalled bet ($1.78) returned to mkEmperor
mkEmperor collected $0.19 from pot
*** SUMMARY ***
Total pot $0.19 | Rake $0 
Seat 1: Cannyjim folded before Flop (didn't bet)
Seat 2: rambooschi folded before Flop (didn't bet)
Seat 3: mkEmperor collected ($0.19)
Seat 4: Buffaloon folded before Flop
Seat 5: pokerIman27 folded before Flop (didn't bet)
Seat 6: monstrrrik (button) folded before Flop (didn't bet)
Seat 7: guiaoms (small blind) folded before Flop
Seat 8: Dorex2007 (big blind) folded before Flop
Seat 9: IuriPato folded before Flop (didn't bet)



PokerStars Hand #237374381209:  Hold'em No Limit ($0.01/$0.02 USD) - 2022/07/15 9:23:44 PT [2022/07/15 12:23:44 ET]
Table 'Appella II' 9-max Seat #7 is the button
Seat 1: Cannyjim ($2.99 in chips) 
Seat 2: rambooschi ($3.27 in chips) 
Seat 3: mkEmperor ($1.97 in chips) 
Seat 4: Buffaloon ($2 in chips) 
Seat 5: pokerIman27 ($1.51 in chips) 
Seat 6: monstrrrik ($2.39 in chips) 
Seat 7: guiaoms ($2.21 in chips) 
Seat 8: Dorex2007 ($3.77 in chips) 
Seat 9: IuriPato ($2.42 in chips) 
Dorex2007: posts small blind $0.01
IuriPato: posts big blind $0.02
*** HOLE CARDS ***
Dealt to Dorex2007 [Ah Kh]
Cannyjim: raises $0.04 to $0.06
rambooschi: calls $0.06
mkEmperor: folds 
Buffaloon: folds 
pokerIman27: folds 
monstrrrik: folds 
guiaoms: folds 
Dorex2007: calls $0.05
IuriPato: folds 
*** FLOP *** [4d 8h 9c]
Dorex2007: checks 
Cannyjim: bets $0.09
rambooschi: folds 
Dorex2007: folds 
Uncalled bet ($0.09) returned to Cannyjim
Cannyjim collected $0.19 from pot
*** SUMMARY ***
Total pot $0.20 | Rake $0.01 
Board [4d 8h 9c]
Seat 1: Cannyjim collected ($0.19)
Seat 2: rambooschi folded on the Flop
Seat 3: mkEmperor folded before Flop (didn't bet)
Seat 4: Buffaloon folded before Flop (didn't bet)
Seat 5: pokerIman27 folded before Flop (didn't bet)
Seat 6: monstrrrik folded before Flop (didn't bet)
Seat 7: guiaoms (button) folded before Flop (didn't bet)
Seat 8: Dorex2007 (small blind) folded on the Flop
Seat 9: IuriPato (big blind) folded before Flop



PokerStars Hand #237374390334:  Hold'em No Limit ($0.01/$0.02 USD) - 2022/07/15 9:24:17 PT [2022/07/15 12:24:17 ET]
Table 'Appella II' 9-max Seat #8 is the button
Seat 1: Cannyjim ($3.12 in chips) 
Seat 2: rambooschi ($3.21 in chips) 
Seat 3: mkEmperor ($1.97 in chips) 
Seat 4: Buffaloon ($2 in chips) 
Seat 5: pokerIman27 ($1.51 in chips) 
Seat 6: monstrrrik ($2.39 in chips) 
Seat 7: guiaoms ($2.21 in chips) 
Seat 8: Dorex2007 ($3.71 in chips) 
Seat 9: IuriPato ($2.40 in chips) 
IuriPato: posts small blind $0.01
Cannyjim: posts big blind $0.02
*** HOLE CARDS ***
Dealt to Dorex2007 [9c Kd]
rambooschi: folds 
mkEmperor: folds 
Buffaloon: raises $0.04 to $0.06
pokerIman27: folds 
monstrrrik: folds 
guiaoms: folds 
Dorex2007: folds 
IuriPato: folds 
Cannyjim: folds 
Uncalled bet ($0.04) returned to Buffaloon
IuriPato leaves the table
Buffaloon collected $0.05 from pot
*** SUMMARY ***
Total pot $0.05 | Rake $0 
Seat 1: Cannyjim (big blind) folded before Flop
Seat 2: rambooschi folded before Flop (didn't bet)
Seat 3: mkEmperor folded before Flop (didn't bet)
Seat 4: Buffaloon collected ($0.05)
Seat 5: pokerIman27 folded before Flop (didn't bet)
Seat 6: monstrrrik folded before Flop (didn't bet)
Seat 7: guiaoms folded before Flop (didn't bet)
Seat 8: Dorex2007 (button) folded before Flop (didn't bet)
Seat 9: IuriPato (small blind) folded before Flop



PokerStars Hand #237374394653:  Hold'em No Limit ($0.01/$0.02 USD) - 2022/07/15 9:24:32 PT [2022/07/15 12:24:32 ET]
Table 'Appella II' 9-max Seat #1 is the button
Seat 1: Cannyjim ($3.10 in chips) 
Seat 2: rambooschi ($3.21 in chips) 
Seat 3: mkEmperor ($1.97 in chips) 
Seat 4: Buffaloon ($2.03 in chips) 
Seat 5: pokerIman27 ($1.51 in chips) 
Seat 6: monstrrrik ($2.39 in chips) 
Seat 7: guiaoms ($2.21 in chips) 
Seat 8: Dorex2007 ($3.71 in chips) 
rambooschi: posts small blind $0.01
mkEmperor: posts big blind $0.02
*** HOLE CARDS ***
Dealt to Dorex2007 [Td 7h]
Buffaloon: folds 
pokerIman27: folds 
monstrrrik: folds 
guiaoms: calls $0.02
Dorex2007: folds 
Cannyjim: calls $0.02
rambooschi: calls $0.01
mkEmperor: checks 
*** FLOP *** [8c 7d Ts]
SunTszu joins the table at seat #9 
rambooschi: checks 
mkEmperor: checks 
guiaoms: checks 
Cannyjim: checks 
*** TURN *** [8c 7d Ts] [Ad]
rambooschi: checks 
mkEmperor: checks 
guiaoms: checks 
Cannyjim: checks 
*** RIVER *** [8c 7d Ts Ad] [Qd]
rambooschi: checks 
mkEmperor: checks 
guiaoms: checks 
Cannyjim: bets $0.04
rambooschi: folds 
mkEmperor: folds 
guiaoms: folds 
Uncalled bet ($0.04) returned to Cannyjim
Cannyjim collected $0.08 from pot
*** SUMMARY ***
Total pot $0.08 | Rake $0 
Board [8c 7d Ts Ad Qd]
Seat 1: Cannyjim (button) collected ($0.08)
Seat 2: rambooschi (small blind) folded on the River
Seat 3: mkEmperor (big blind) folded on the River
Seat 4: Buffaloon folded before Flop (didn't bet)
Seat 5: pokerIman27 folded before Flop (didn't bet)
Seat 6: monstrrrik folded before Flop (didn't bet)
Seat 7: guiaoms folded on the River
Seat 8: Dorex2007 folded before Flop (didn't bet)



PokerStars Hand #237374417967:  Hold'em No Limit ($0.01/$0.02 USD) - 2022/07/15 9:25:55 PT [2022/07/15 12:25:55 ET]
Table 'Appella II' 9-max Seat #2 is the button
Seat 1: Cannyjim ($3.16 in chips) 
Seat 2: rambooschi ($3.19 in chips) 
Seat 3: mkEmperor ($1.95 in chips) 
Seat 4: Buffaloon ($2.03 in chips) 
Seat 5: pokerIman27 ($1.51 in chips) 
Seat 6: monstrrrik ($2.39 in chips) 
Seat 7: guiaoms ($2.19 in chips) 
Seat 8: Dorex2007 ($3.71 in chips) 
mkEmperor: posts small blind $0.01
Buffaloon: posts big blind $0.02
SunTszu: sits out 
*** HOLE CARDS ***
Dealt to Dorex2007 [4h Kd]
pokerIman27: folds 
monstrrrik: folds 
guiaoms: raises $0.04 to $0.06
Dorex2007: folds 
Cannyjim: folds 
rambooschi: calls $0.06
mkEmperor: folds 
Buffaloon: folds 
*** FLOP *** [2d Jd 7d]
guiaoms: bets $0.08
rambooschi: calls $0.08
*** TURN *** [2d Jd 7d] [2h]
guiaoms: bets $0.08
rambooschi: raises $0.08 to $0.16
guiaoms: calls $0.08
*** RIVER *** [2d Jd 7d 2h] [6h]
guiaoms: bets $0.08
rambooschi: calls $0.08
*** SHOW DOWN ***
guiaoms: shows [Ah Js] (two pair, Jacks and Deuces)
rambooschi: mucks hand 
guiaoms collected $0.76 from pot
*** SUMMARY ***
Total pot $0.79 | Rake $0.03 
Board [2d Jd 7d 2h 6h]
Seat 1: Cannyjim folded before Flop (didn't bet)
Seat 2: rambooschi (button) mucked [8h 8c]
Seat 3: mkEmperor (small blind) folded before Flop
Seat 4: Buffaloon (big blind) folded before Flop
Seat 5: pokerIman27 folded before Flop (didn't bet)
Seat 6: monstrrrik folded before Flop (didn't bet)
Seat 7: guiaoms showed [Ah Js] and won ($0.76) with two pair, Jacks and Deuces
Seat 8: Dorex2007 folded before Flop (didn't bet)



PokerStars Hand #237374431320:  Hold'em No Limit ($0.01/$0.02 USD) - 2022/07/15 9:26:42 PT [2022/07/15 12:26:42 ET]
Table 'Appella II' 9-max Seat #3 is the button
Seat 1: Cannyjim ($3.16 in chips) 
Seat 2: rambooschi ($2.81 in chips) 
Seat 3: mkEmperor ($1.94 in chips) 
Seat 4: Buffaloon ($2.01 in chips) 
Seat 5: pokerIman27 ($1.51 in chips) 
Seat 6: monstrrrik ($2.39 in chips) 
Seat 7: guiaoms ($2.57 in chips) 
Seat 8: Dorex2007 ($3.71 in chips) 
Seat 9: SunTszu ($2 in chips) 
Buffaloon: posts small blind $0.01
pokerIman27: posts big blind $0.02
SunTszu: posts big blind $0.02
*** HOLE CARDS ***
Dealt to Dorex2007 [5d 4s]
monstrrrik: folds 
guiaoms: folds 
Dorex2007: folds 
SunTszu: checks 
Cannyjim: raises $0.07 to $0.09
rambooschi: folds 
mkEmperor: folds 
Buffaloon: folds 
pokerIman27: folds 
SunTszu: folds 
Uncalled bet ($0.07) returned to Cannyjim
Cannyjim collected $0.07 from pot
*** SUMMARY ***
Total pot $0.07 | Rake $0 
Seat 1: Cannyjim collected ($0.07)
Seat 2: rambooschi folded before Flop (didn't bet)
Seat 3: mkEmperor (button) folded before Flop (didn't bet)
Seat 4: Buffaloon (small blind) folded before Flop
Seat 5: pokerIman27 (big blind) folded before Flop
Seat 6: monstrrrik folded before Flop (didn't bet)
Seat 7: guiaoms folded before Flop (didn't bet)
Seat 8: Dorex2007 folded before Flop (didn't bet)
Seat 9: SunTszu folded before Flop (didn't bet)



PokerStars Hand #237374440563:  Hold'em No Limit ($0.01/$0.02 USD) - 2022/07/15 9:27:15 PT [2022/07/15 12:27:15 ET]
Table 'Appella II' 9-max Seat #4 is the button
Seat 1: Cannyjim ($3.21 in chips) 
Seat 2: rambooschi ($2.81 in chips) 
Seat 3: mkEmperor ($1.94 in chips) 
Seat 4: Buffaloon ($2 in chips) 
Seat 5: pokerIman27 ($1.49 in chips) 
Seat 6: monstrrrik ($2.39 in chips) 
Seat 7: guiaoms ($2.57 in chips) 
Seat 8: Dorex2007 ($3.71 in chips) 
Seat 9: SunTszu ($1.98 in chips) 
pokerIman27: posts small blind $0.01
monstrrrik: posts big blind $0.02
*** HOLE CARDS ***
Dealt to Dorex2007 [Ts 9s]
guiaoms: raises $0.04 to $0.06
Dorex2007: folds 
SunTszu: folds 
Cannyjim: folds 
rambooschi: folds 
mkEmperor: folds 
Buffaloon: folds 
pokerIman27: folds 
monstrrrik: folds 
Uncalled bet ($0.04) returned to guiaoms
guiaoms collected $0.05 from pot
*** SUMMARY ***
Total pot $0.05 | Rake $0 
Seat 1: Cannyjim folded before Flop (didn't bet)
Seat 2: rambooschi folded before Flop (didn't bet)
Seat 3: mkEmperor folded before Flop (didn't bet)
Seat 4: Buffaloon (button) folded before Flop (didn't bet)
Seat 5: pokerIman27 (small blind) folded before Flop
Seat 6: monstrrrik (big blind) folded before Flop
Seat 7: guiaoms collected ($0.05)
Seat 8: Dorex2007 folded before Flop (didn't bet)
Seat 9: SunTszu folded before Flop (didn't bet)



PokerStars Hand #237374447057:  Hold'em No Limit ($0.01/$0.02 USD) - 2022/07/15 9:27:38 PT [2022/07/15 12:27:38 ET]
Table 'Appella II' 9-max Seat #5 is the button
Seat 1: Cannyjim ($3.21 in chips) 
Seat 2: rambooschi ($2.81 in chips) 
Seat 3: mkEmperor ($1.94 in chips) 
Seat 4: Buffaloon ($2 in chips) 
Seat 5: pokerIman27 ($1.48 in chips) 
Seat 6: monstrrrik ($2.37 in chips) 
Seat 7: guiaoms ($2.60 in chips) 
Seat 8: Dorex2007 ($3.71 in chips) 
Seat 9: SunTszu ($1.98 in chips) 
monstrrrik: posts small blind $0.01
guiaoms: posts big blind $0.02
*** HOLE CARDS ***
Dealt to Dorex2007 [Ad Ac]
Dorex2007: raises $0.02 to $0.04
SunTszu: folds 
Cannyjim: folds 
rambooschi: folds 
mkEmperor: folds 
Buffaloon: folds 
pokerIman27: folds 
monstrrrik: folds 
guiaoms: folds 
Uncalled bet ($0.02) returned to Dorex2007
Dorex2007 collected $0.05 from pot
*** SUMMARY ***
Total pot $0.05 | Rake $0 
Seat 1: Cannyjim folded before Flop (didn't bet)
Seat 2: rambooschi folded before Flop (didn't bet)
Seat 3: mkEmperor folded before Flop (didn't bet)
Seat 4: Buffaloon folded before Flop (didn't bet)
Seat 5: pokerIman27 (button) folded before Flop (didn't bet)
Seat 6: monstrrrik (small blind) folded before Flop
Seat 7: guiaoms (big blind) folded before Flop
Seat 8: Dorex2007 collected ($0.05)
Seat 9: SunTszu folded before Flop (didn't bet)



PokerStars Hand #237374456302:  Hold'em No Limit ($0.01/$0.02 USD) - 2022/07/15 9:28:10 PT [2022/07/15 12:28:10 ET]
Table 'Appella II' 9-max Seat #6 is the button
Seat 1: Cannyjim ($3.21 in chips) 
Seat 2: rambooschi ($2.81 in chips) 
Seat 3: mkEmperor ($1.94 in chips) 
Seat 4: Buffaloon ($2 in chips) 
Seat 5: pokerIman27 ($1.48 in chips) 
Seat 6: monstrrrik ($2.36 in chips) 
Seat 7: guiaoms ($2.58 in chips) 
Seat 8: Dorex2007 ($3.74 in chips) 
Seat 9: SunTszu ($1.98 in chips) 
guiaoms: posts small blind $0.01
Dorex2007: posts big blind $0.02
*** HOLE CARDS ***
Dealt to Dorex2007 [4c 9s]
SunTszu: folds 
Cannyjim: folds 
rambooschi: folds 
mkEmperor: folds 
Buffaloon: folds 
pokerIman27: folds 
monstrrrik: raises $0.06 to $0.08
guiaoms: calls $0.07
Dorex2007: folds 
*** FLOP *** [7d 2s Td]
guiaoms: bets $0.06
monstrrrik: folds 
Uncalled bet ($0.06) returned to guiaoms
guiaoms collected $0.17 from pot
*** SUMMARY ***
Total pot $0.18 | Rake $0.01 
Board [7d 2s Td]
Seat 1: Cannyjim folded before Flop (didn't bet)
Seat 2: rambooschi folded before Flop (didn't bet)
Seat 3: mkEmperor folded before Flop (didn't bet)
Seat 4: Buffaloon folded before Flop (didn't bet)
Seat 5: pokerIman27 folded before Flop (didn't bet)
Seat 6: monstrrrik (button) folded on the Flop
Seat 7: guiaoms (small blind) collected ($0.17)
Seat 8: Dorex2007 (big blind) folded before Flop
Seat 9: SunTszu folded before Flop (didn't bet)



PokerStars Hand #237374465311:  Hold'em No Limit ($0.01/$0.02 USD) - 2022/07/15 9:28:42 PT [2022/07/15 12:28:42 ET]
Table 'Appella II' 9-max Seat #7 is the button
Seat 1: Cannyjim ($3.21 in chips) 
Seat 2: rambooschi ($2.81 in chips) 
Seat 3: mkEmperor ($1.94 in chips) 
Seat 4: Buffaloon ($2 in chips) 
Seat 5: pokerIman27 ($1.48 in chips) 
Seat 6: monstrrrik ($2.28 in chips) 
Seat 7: guiaoms ($2.67 in chips) 
Seat 8: Dorex2007 ($3.72 in chips) 
Seat 9: SunTszu ($1.98 in chips) 
Dorex2007: posts small blind $0.01
SunTszu: posts big blind $0.02
*** HOLE CARDS ***
Dealt to Dorex2007 [Ks 6c]
Cannyjim: folds 
rambooschi: calls $0.02
mkEmperor: folds 
Buffaloon: folds 
pokerIman27: folds 
monstrrrik: folds 
guiaoms: folds 
Dorex2007: folds 
SunTszu: checks 
*** FLOP *** [2s 9h Kd]
SunTszu: checks 
rambooschi: checks 
*** TURN *** [2s 9h Kd] [6s]
SunTszu: checks 
rambooschi: checks 
*** RIVER *** [2s 9h Kd 6s] [3h]
SunTszu: checks 
rambooschi: checks 
*** SHOW DOWN ***
SunTszu: shows [7s 5c] (high card King)
rambooschi: shows [Ah 4h] (high card Ace)
rambooschi collected $0.05 from pot
*** SUMMARY ***
Total pot $0.05 | Rake $0 
Board [2s 9h Kd 6s 3h]
Seat 1: Cannyjim folded before Flop (didn't bet)
Seat 2: rambooschi showed [Ah 4h] and won ($0.05) with high card Ace
Seat 3: mkEmperor folded before Flop (didn't bet)
Seat 4: Buffaloon folded before Flop (didn't bet)
Seat 5: pokerIman27 folded before Flop (didn't bet)
Seat 6: monstrrrik folded before Flop (didn't bet)
Seat 7: guiaoms (button) folded before Flop (didn't bet)
Seat 8: Dorex2007 (small blind) folded before Flop
Seat 9: SunTszu (big blind) showed [7s 5c] and lost with high card King



PokerStars Hand #237374475116:  Hold'em No Limit ($0.01/$0.02 USD) - 2022/07/15 9:29:16 PT [2022/07/15 12:29:16 ET]
Table 'Appella II' 9-max Seat #8 is the button
Seat 1: Cannyjim ($3.21 in chips) 
Seat 2: rambooschi ($2.84 in chips) 
Seat 3: mkEmperor ($1.94 in chips) 
Seat 4: Buffaloon ($2 in chips) 
Seat 5: pokerIman27 ($1.48 in chips) 
Seat 6: monstrrrik ($2.28 in chips) 
Seat 7: guiaoms ($2.67 in chips) 
Seat 8: Dorex2007 ($3.71 in chips) 
Seat 9: SunTszu ($1.96 in chips) 
SunTszu: posts small blind $0.01
Cannyjim: posts big blind $0.02
*** HOLE CARDS ***
Dealt to Dorex2007 [6s 7c]
rambooschi: folds 
mkEmperor: raises $0.04 to $0.06
Buffaloon: folds 
pokerIman27: calls $0.06
monstrrrik: folds 
guiaoms: folds 
Dorex2007: folds 
SunTszu: folds 
Cannyjim: folds 
*** FLOP *** [7h 9h Td]
mkEmperor: bets $0.06
pokerIman27: calls $0.06
*** TURN *** [7h 9h Td] [Jd]
mkEmperor: checks 
pokerIman27: bets $0.26
mkEmperor: calls $0.26
*** RIVER *** [7h 9h Td Jd] [Jc]
mkEmperor: checks 
pokerIman27: bets $0.76
mkEmperor: calls $0.76
*** SHOW DOWN ***
pokerIman27: shows [Js Kc] (three of a kind, Jacks)
mkEmperor: mucks hand 
pokerIman27 collected $2.23 from pot
*** SUMMARY ***
Total pot $2.31 | Rake $0.08 
Board [7h 9h Td Jd Jc]
Seat 1: Cannyjim (big blind) folded before Flop
Seat 2: rambooschi folded before Flop (didn't bet)
Seat 3: mkEmperor mucked [Qd Qc]
Seat 4: Buffaloon folded before Flop (didn't bet)
Seat 5: pokerIman27 showed [Js Kc] and won ($2.23) with three of a kind, Jacks
Seat 6: monstrrrik folded before Flop (didn't bet)
Seat 7: guiaoms folded before Flop (didn't bet)
Seat 8: Dorex2007 (button) folded before Flop (didn't bet)
Seat 9: SunTszu (small blind) folded before Flop



PokerStars Hand #237374495638:  Hold'em No Limit ($0.01/$0.02 USD) - 2022/07/15 9:30:22 PT [2022/07/15 12:30:22 ET]
Table 'Appella II' 9-max Seat #9 is the button
Seat 1: Cannyjim ($3.19 in chips) 
Seat 2: rambooschi ($2.84 in chips) 
Seat 3: mkEmperor ($0.80 in chips) 
Seat 4: Buffaloon ($2 in chips) 
Seat 5: pokerIman27 ($2.57 in chips) 
Seat 7: guiaoms ($2.67 in chips) 
Seat 8: Dorex2007 ($3.71 in chips) 
Seat 9: SunTszu ($1.95 in chips) 
Cannyjim: posts small blind $0.01
rambooschi: posts big blind $0.02
*** HOLE CARDS ***
Dealt to Dorex2007 [8c Kd]
mkEmperor: folds 
Buffaloon: folds 
pokerIman27: calls $0.02
guiaoms: folds 
Dorex2007: folds 
SunTszu: raises $0.04 to $0.06
Cannyjim: calls $0.05
rambooschi: calls $0.04
pokerIman27 has timed out
pokerIman27: folds 
*** FLOP *** [2s 8d 3c]
Cannyjim: bets $0.09
rambooschi: folds 
SunTszu: calls $0.09
*** TURN *** [2s 8d 3c] [As]
Cannyjim: bets $0.18
SunTszu: folds 
Uncalled bet ($0.18) returned to Cannyjim
Cannyjim collected $0.37 from pot
*** SUMMARY ***
Total pot $0.38 | Rake $0.01 
Board [2s 8d 3c As]
Seat 1: Cannyjim (small blind) collected ($0.37)
Seat 2: rambooschi (big blind) folded on the Flop
Seat 3: mkEmperor folded before Flop (didn't bet)
Seat 4: Buffaloon folded before Flop (didn't bet)
Seat 5: pokerIman27 folded before Flop
Seat 7: guiaoms folded before Flop (didn't bet)
Seat 8: Dorex2007 folded before Flop (didn't bet)
Seat 9: SunTszu (button) folded on the Turn



PokerStars Hand #237374523624:  Hold'em No Limit ($0.01/$0.02 USD) - 2022/07/15 9:31:59 PT [2022/07/15 12:31:59 ET]
Table 'Appella II' 9-max Seat #1 is the button
Seat 1: Cannyjim ($3.41 in chips) 
Seat 2: rambooschi ($2.78 in chips) 
Seat 3: mkEmperor ($2 in chips) 
Seat 4: Buffaloon ($2 in chips) 
Seat 5: pokerIman27 ($2.55 in chips) 
Seat 7: guiaoms ($2.67 in chips) 
Seat 8: Dorex2007 ($3.71 in chips) 
Seat 9: SunTszu ($1.80 in chips) 
rambooschi: posts small blind $0.01
mkEmperor: posts big blind $0.02
*** HOLE CARDS ***
Dealt to Dorex2007 [7d 3d]
Buffaloon: folds 
pokerIman27: folds 
guiaoms: folds 
Dorex2007: folds 
SunTszu: folds 
Cannyjim: raises $0.04 to $0.06
rambooschi: calls $0.05
mkEmperor: folds 
*** FLOP *** [3h 8c 7h]
rambooschi: checks 
Cannyjim: bets $0.07
rambooschi: calls $0.07
*** TURN *** [3h 8c 7h] [2h]
rambooschi: checks 
Cannyjim: bets $0.13
rambooschi: calls $0.13
*** RIVER *** [3h 8c 7h 2h] [Qc]
rambooschi: bets $0.52
Cannyjim: folds 
Uncalled bet ($0.52) returned to rambooschi
rambooschi collected $0.52 from pot
*** SUMMARY ***
Total pot $0.54 | Rake $0.02 
Board [3h 8c 7h 2h Qc]
Seat 1: Cannyjim (button) folded on the River
Seat 2: rambooschi (small blind) collected ($0.52)
Seat 3: mkEmperor (big blind) folded before Flop
Seat 4: Buffaloon folded before Flop (didn't bet)
Seat 5: pokerIman27 folded before Flop (didn't bet)
Seat 7: guiaoms folded before Flop (didn't bet)
Seat 8: Dorex2007 folded before Flop (didn't bet)
Seat 9: SunTszu folded before Flop (didn't bet)



PokerStars Hand #237374538687:  Hold'em No Limit ($0.01/$0.02 USD) - 2022/07/15 9:32:51 PT [2022/07/15 12:32:51 ET]
Table 'Appella II' 9-max Seat #2 is the button
Seat 1: Cannyjim ($3.15 in chips) 
Seat 2: rambooschi ($3.04 in chips) 
Seat 3: mkEmperor ($1.98 in chips) 
Seat 4: Buffaloon ($2 in chips) 
Seat 5: pokerIman27 ($2.55 in chips) 
Seat 7: guiaoms ($2.67 in chips) 
Seat 8: Dorex2007 ($3.71 in chips) 
Seat 9: SunTszu ($1.80 in chips) 
mkEmperor: posts small blind $0.01
Buffaloon: posts big blind $0.02
*** HOLE CARDS ***
Dealt to Dorex2007 [2s 3h]
pokerIman27: folds 
guiaoms: raises $0.04 to $0.06
Dorex2007: folds 
SunTszu: folds 
Cannyjim: calls $0.06
rambooschi: folds 
mkEmperor: folds 
Buffaloon: calls $0.04
*** FLOP *** [Ks Kh 2c]
Buffaloon: checks 
guiaoms: checks 
Cannyjim: bets $0.09
Buffaloon: folds 
guiaoms: calls $0.09
*** TURN *** [Ks Kh 2c] [Ts]
guiaoms: checks 
Cannyjim: checks 
*** RIVER *** [Ks Kh 2c Ts] [Th]
guiaoms: bets $0.36
Cannyjim: folds 
Uncalled bet ($0.36) returned to guiaoms
guiaoms collected $0.36 from pot
*** SUMMARY ***
Total pot $0.37 | Rake $0.01 
Board [Ks Kh 2c Ts Th]
Seat 1: Cannyjim folded on the River
Seat 2: rambooschi (button) folded before Flop (didn't bet)
Seat 3: mkEmperor (small blind) folded before Flop
Seat 4: Buffaloon (big blind) folded on the Flop
Seat 5: pokerIman27 folded before Flop (didn't bet)
Seat 7: guiaoms collected ($0.36)
Seat 8: Dorex2007 folded before Flop (didn't bet)
Seat 9: SunTszu folded before Flop (didn't bet)



PokerStars Hand #237374553193:  Hold'em No Limit ($0.01/$0.02 USD) - 2022/07/15 9:33:41 PT [2022/07/15 12:33:41 ET]
Table 'Appella II' 9-max Seat #3 is the button
Seat 1: Cannyjim ($3 in chips) 
Seat 2: rambooschi ($3.04 in chips) 
Seat 3: mkEmperor ($1.97 in chips) 
Seat 4: Buffaloon ($2 in chips) 
Seat 5: pokerIman27 ($2.55 in chips) 
Seat 7: guiaoms ($2.88 in chips) 
Seat 8: Dorex2007 ($3.71 in chips) 
Seat 9: SunTszu ($1.80 in chips) 
Buffaloon: posts small blind $0.01
pokerIman27: posts big blind $0.02
*** HOLE CARDS ***
Dealt to Dorex2007 [Kh Qc]
guiaoms: folds 
Dorex2007: raises $0.04 to $0.06
SunTszu: folds 
Cannyjim: folds 
rambooschi: folds 
mkEmperor: folds 
Buffaloon: calls $0.05
pokerIman27: calls $0.04
*** FLOP *** [2c 5s 3h]
Buffaloon: checks 
pokerIman27: checks 
Dorex2007: bets $0.11
Buffaloon: calls $0.11
pokerIman27: calls $0.11
*** TURN *** [2c 5s 3h] [6s]
Buffaloon: checks 
pokerIman27: checks 
Dorex2007: checks 
*** RIVER *** [2c 5s 3h 6s] [Ad]
Buffaloon: checks 
pokerIman27: checks 
Dorex2007: bets $0.10
Buffaloon: folds 
pokerIman27: calls $0.10
*** SHOW DOWN ***
Dorex2007: shows [Kh Qc] (high card Ace)
pokerIman27: shows [Ks Ah] (a pair of Aces)
pokerIman27 collected $0.69 from pot
*** SUMMARY ***
Total pot $0.71 | Rake $0.02 
Board [2c 5s 3h 6s Ad]
Seat 1: Cannyjim folded before Flop (didn't bet)
Seat 2: rambooschi folded before Flop (didn't bet)
Seat 3: mkEmperor (button) folded before Flop (didn't bet)
Seat 4: Buffaloon (small blind) folded on the River
Seat 5: pokerIman27 (big blind) showed [Ks Ah] and won ($0.69) with a pair of Aces
Seat 7: guiaoms folded before Flop (didn't bet)
Seat 8: Dorex2007 showed [Kh Qc] and lost with high card Ace
Seat 9: SunTszu folded before Flop (didn't bet)



PokerStars Hand #237374570482:  Hold'em No Limit ($0.01/$0.02 USD) - 2022/07/15 9:34:40 PT [2022/07/15 12:34:40 ET]
Table 'Appella II' 9-max Seat #4 is the button
Seat 1: Cannyjim ($3 in chips) 
Seat 2: rambooschi ($3.04 in chips) 
Seat 3: mkEmperor ($1.97 in chips) 
Seat 4: Buffaloon ($2 in chips) 
Seat 5: pokerIman27 ($2.97 in chips) 
Seat 7: guiaoms ($2.88 in chips) 
Seat 8: Dorex2007 ($3.44 in chips) 
Seat 9: SunTszu ($1.80 in chips) 
pokerIman27: posts small blind $0.01
guiaoms: posts big blind $0.02
*** HOLE CARDS ***
Dealt to Dorex2007 [As Jc]
Dorex2007: raises $0.02 to $0.04
SunTszu: folds 
Cannyjim: calls $0.04
rambooschi: folds 
mkEmperor: folds 
Buffaloon: folds 
pokerIman27: folds 
guiaoms: folds 
*** FLOP *** [Qc Tc 5h]
Dorex2007: checks 
Cannyjim: checks 
*** TURN *** [Qc Tc 5h] [Kh]
Dorex2007: bets $0.11
Cannyjim: calls $0.11
*** RIVER *** [Qc Tc 5h Kh] [2s]
Dorex2007: bets $0.32
Cannyjim: folds 
Uncalled bet ($0.32) returned to Dorex2007
Dorex2007 collected $0.32 from pot
*** SUMMARY ***
Total pot $0.33 | Rake $0.01 
Board [Qc Tc 5h Kh 2s]
Seat 1: Cannyjim folded on the River
Seat 2: rambooschi folded before Flop (didn't bet)
Seat 3: mkEmperor folded before Flop (didn't bet)
Seat 4: Buffaloon (button) folded before Flop (didn't bet)
Seat 5: pokerIman27 (small blind) folded before Flop
Seat 7: guiaoms (big blind) folded before Flop
Seat 8: Dorex2007 collected ($0.32)
Seat 9: SunTszu folded before Flop (didn't bet)



PokerStars Hand #237374585064:  Hold'em No Limit ($0.01/$0.02 USD) - 2022/07/15 9:35:30 PT [2022/07/15 12:35:30 ET]
Table 'Appella II' 9-max Seat #5 is the button
Seat 1: Cannyjim ($2.85 in chips) 
Seat 2: rambooschi ($3.04 in chips) 
Seat 3: mkEmperor ($1.97 in chips) 
Seat 4: Buffaloon ($2 in chips) 
Seat 5: pokerIman27 ($2.96 in chips) 
Seat 7: guiaoms ($2.86 in chips) 
Seat 8: Dorex2007 ($3.61 in chips) 
Seat 9: SunTszu ($1.80 in chips) 
guiaoms: posts small blind $0.01
Dorex2007: posts big blind $0.02
*** HOLE CARDS ***
Dealt to Dorex2007 [Qc 3h]
SunTszu: raises $0.08 to $0.10
Cannyjim: folds 
rambooschi: folds 
mkEmperor: folds 
Buffaloon: folds 
pokerIman27: folds 
guiaoms: folds 
Dorex2007: folds 
Uncalled bet ($0.08) returned to SunTszu
SunTszu collected $0.05 from pot
*** SUMMARY ***
Total pot $0.05 | Rake $0 
Seat 1: Cannyjim folded before Flop (didn't bet)
Seat 2: rambooschi folded before Flop (didn't bet)
Seat 3: mkEmperor folded before Flop (didn't bet)
Seat 4: Buffaloon folded before Flop (didn't bet)
Seat 5: pokerIman27 (button) folded before Flop (didn't bet)
Seat 7: guiaoms (small blind) folded before Flop
Seat 8: Dorex2007 (big blind) folded before Flop
Seat 9: SunTszu collected ($0.05)



PokerStars Hand #237374592338:  Hold'em No Limit ($0.01/$0.02 USD) - 2022/07/15 9:35:49 PT [2022/07/15 12:35:49 ET]
Table 'Appella II' 9-max Seat #7 is the button
Seat 1: Cannyjim ($2.85 in chips) 
Seat 2: rambooschi ($3.04 in chips) 
Seat 3: mkEmperor ($1.97 in chips) 
Seat 4: Buffaloon ($2 in chips) 
Seat 5: pokerIman27 ($2.96 in chips) 
Seat 7: guiaoms ($2.85 in chips) 
Seat 8: Dorex2007 ($3.59 in chips) 
Seat 9: SunTszu ($1.83 in chips) 
Dorex2007: posts small blind $0.01
SunTszu: posts big blind $0.02
*** HOLE CARDS ***
Dealt to Dorex2007 [Js As]
Cannyjim: folds 
rambooschi: folds 
mkEmperor has timed out
mkEmperor: folds 
Buffaloon: folds 
pokerIman27: folds 
guiaoms: folds 
Dorex2007: raises $0.04 to $0.06
SunTszu: folds 
Uncalled bet ($0.04) returned to Dorex2007
Dorex2007 collected $0.04 from pot
*** SUMMARY ***
Total pot $0.04 | Rake $0 
Seat 1: Cannyjim folded before Flop (didn't bet)
Seat 2: rambooschi folded before Flop (didn't bet)
Seat 3: mkEmperor folded before Flop (didn't bet)
Seat 4: Buffaloon folded before Flop (didn't bet)
Seat 5: pokerIman27 folded before Flop (didn't bet)
Seat 7: guiaoms (button) folded before Flop (didn't bet)
Seat 8: Dorex2007 (small blind) collected ($0.04)
Seat 9: SunTszu (big blind) folded before Flop



PokerStars Hand #237374600698:  Hold'em No Limit ($0.01/$0.02 USD) - 2022/07/15 9:36:17 PT [2022/07/15 12:36:17 ET]
Table 'Appella II' 9-max Seat #8 is the button
Seat 1: Cannyjim ($2.85 in chips) 
Seat 2: rambooschi ($3.04 in chips) 
Seat 3: mkEmperor ($1.97 in chips) 
Seat 4: Buffaloon ($2 in chips) 
Seat 5: pokerIman27 ($2.96 in chips) 
Seat 7: guiaoms ($2.85 in chips) 
Seat 8: Dorex2007 ($3.61 in chips) 
Seat 9: SunTszu ($1.81 in chips) 
SunTszu: posts small blind $0.01
Cannyjim: posts big blind $0.02
*** HOLE CARDS ***
Dealt to Dorex2007 [5d 4s]
rambooschi: folds 
mkEmperor: folds 
Buffaloon: folds 
pokerIman27: calls $0.02
guiaoms: folds 
Dorex2007: folds 
SunTszu: folds 
Cannyjim: checks 
*** FLOP *** [Th Qc Ts]
Cannyjim: checks 
pokerIman27: checks 
*** TURN *** [Th Qc Ts] [Td]
Cannyjim: checks 
pokerIman27: bets $0.02
Cannyjim: calls $0.02
*** RIVER *** [Th Qc Ts Td] [3h]
Cannyjim: checks 
pokerIman27: bets $0.02
Cannyjim: raises $0.02 to $0.04
pokerIman27: calls $0.02
*** SHOW DOWN ***
Cannyjim: shows [Qd 8s] (a full house, Tens full of Queens)
pokerIman27: mucks hand 
Cannyjim collected $0.16 from pot
*** SUMMARY ***
Total pot $0.17 | Rake $0.01 
Board [Th Qc Ts Td 3h]
Seat 1: Cannyjim (big blind) showed [Qd 8s] and won ($0.16) with a full house, Tens full of Queens
Seat 2: rambooschi folded before Flop (didn't bet)
Seat 3: mkEmperor folded before Flop (didn't bet)
Seat 4: Buffaloon folded before Flop (didn't bet)
Seat 5: pokerIman27 mucked [6c 6d]
Seat 7: guiaoms folded before Flop (didn't bet)
Seat 8: Dorex2007 (button) folded before Flop (didn't bet)
Seat 9: SunTszu (small blind) folded before Flop



PokerStars Hand #237374616480:  Hold'em No Limit ($0.01/$0.02 USD) - 2022/07/15 9:37:11 PT [2022/07/15 12:37:11 ET]
Table 'Appella II' 9-max Seat #9 is the button
Seat 1: Cannyjim ($2.93 in chips) 
Seat 2: rambooschi ($3.04 in chips) 
Seat 3: mkEmperor ($1.97 in chips) 
Seat 4: Buffaloon ($2 in chips) 
Seat 5: pokerIman27 ($2.88 in chips) 
Seat 7: guiaoms ($2.85 in chips) 
Seat 8: Dorex2007 ($3.61 in chips) 
Seat 9: SunTszu ($1.80 in chips) 
Cannyjim: posts small blind $0.01
rambooschi: posts big blind $0.02
*** HOLE CARDS ***
Dealt to Dorex2007 [5c 5d]
mkEmperor: folds 
Buffaloon: folds 
pokerIman27: folds 
guiaoms: folds 
Dorex2007: calls $0.02
SunTszu: raises $0.06 to $0.08
Cannyjim: calls $0.07
rambooschi: folds 
Dorex2007: calls $0.06
*** FLOP *** [Th Qc 2d]
Cannyjim: checks 
Dorex2007: checks 
SunTszu: bets $0.10
Cannyjim: calls $0.10
Dorex2007: folds 
*** TURN *** [Th Qc 2d] [As]
Cannyjim: checks 
SunTszu: bets $0.33
Cannyjim: calls $0.33
*** RIVER *** [Th Qc 2d As] [2s]
Cannyjim: checks 
SunTszu: bets $1
Cannyjim: folds 
Uncalled bet ($1) returned to SunTszu
SunTszu collected $1.08 from pot
*** SUMMARY ***
Total pot $1.12 | Rake $0.04 
Board [Th Qc 2d As 2s]
Seat 1: Cannyjim (small blind) folded on the River
Seat 2: rambooschi (big blind) folded before Flop
Seat 3: mkEmperor folded before Flop (didn't bet)
Seat 4: Buffaloon folded before Flop (didn't bet)
Seat 5: pokerIman27 folded before Flop (didn't bet)
Seat 7: guiaoms folded before Flop (didn't bet)
Seat 8: Dorex2007 folded on the Flop
Seat 9: SunTszu (button) collected ($1.08)



PokerStars Hand #237374635704:  Hold'em No Limit ($0.01/$0.02 USD) - 2022/07/15 9:38:16 PT [2022/07/15 12:38:16 ET]
Table 'Appella II' 9-max Seat #1 is the button
Seat 1: Cannyjim ($2.42 in chips) 
Seat 2: rambooschi ($3.02 in chips) 
Seat 3: mkEmperor ($1.97 in chips) 
Seat 4: Buffaloon ($2 in chips) 
Seat 5: pokerIman27 ($2.88 in chips) 
Seat 7: guiaoms ($2.85 in chips) 
Seat 8: Dorex2007 ($3.53 in chips) 
Seat 9: SunTszu ($2.37 in chips) 
rambooschi: posts small blind $0.01
mkEmperor: posts big blind $0.02
*** HOLE CARDS ***
Dealt to Dorex2007 [5h 8c]
Buffaloon: folds 
pokerIman27: folds 
guiaoms: folds 
Dorex2007: folds 
SunTszu: folds 
Cannyjim: raises $0.02 to $0.04
rambooschi: calls $0.03
mkEmperor: folds 
*** FLOP *** [4d Qd 3c]
rambooschi: checks 
Cannyjim: checks 
*** TURN *** [4d Qd 3c] [5c]
rambooschi: bets $0.05
Cannyjim: calls $0.05
*** RIVER *** [4d Qd 3c 5c] [8h]
rambooschi: bets $0.09
Cannyjim: folds 
Uncalled bet ($0.09) returned to rambooschi
rambooschi collected $0.19 from pot
*** SUMMARY ***
Total pot $0.20 | Rake $0.01 
Board [4d Qd 3c 5c 8h]
Seat 1: Cannyjim (button) folded on the River
Seat 2: rambooschi (small blind) collected ($0.19)
Seat 3: mkEmperor (big blind) folded before Flop
Seat 4: Buffaloon folded before Flop (didn't bet)
Seat 5: pokerIman27 folded before Flop (didn't bet)
Seat 7: guiaoms folded before Flop (didn't bet)
Seat 8: Dorex2007 folded before Flop (didn't bet)
Seat 9: SunTszu folded before Flop (didn't bet)



PokerStars Hand #237374649410:  Hold'em No Limit ($0.01/$0.02 USD) - 2022/07/15 9:39:02 PT [2022/07/15 12:39:02 ET]
Table 'Appella II' 9-max Seat #2 is the button
Seat 1: Cannyjim ($2.33 in chips) 
Seat 2: rambooschi ($3.12 in chips) 
Seat 3: mkEmperor ($1.95 in chips) 
Seat 4: Buffaloon ($2 in chips) 
Seat 5: pokerIman27 ($2.88 in chips) 
Seat 7: guiaoms ($2.85 in chips) 
Seat 8: Dorex2007 ($3.53 in chips) 
Seat 9: SunTszu ($2.37 in chips) 
mkEmperor: posts small blind $0.01
Buffaloon: posts big blind $0.02
*** HOLE CARDS ***
Dealt to Dorex2007 [9d 2s]
pokerIman27: folds 
guiaoms: folds 
Dorex2007: folds 
SunTszu: folds 
Cannyjim: folds 
rambooschi: folds 
mkEmperor: folds 
Uncalled bet ($0.01) returned to Buffaloon
Buffaloon collected $0.02 from pot
*** SUMMARY ***
Total pot $0.02 | Rake $0 
Seat 1: Cannyjim folded before Flop (didn't bet)
Seat 2: rambooschi (button) folded before Flop (didn't bet)
Seat 3: mkEmperor (small blind) folded before Flop
Seat 4: Buffaloon (big blind) collected ($0.02)
Seat 5: pokerIman27 folded before Flop (didn't bet)
Seat 7: guiaoms folded before Flop (didn't bet)
Seat 8: Dorex2007 folded before Flop (didn't bet)
Seat 9: SunTszu folded before Flop (didn't bet)



PokerStars Hand #237374652654:  Hold'em No Limit ($0.01/$0.02 USD) - 2022/07/15 9:39:13 PT [2022/07/15 12:39:13 ET]
Table 'Appella II' 9-max Seat #3 is the button
Seat 1: Cannyjim ($2.33 in chips) 
Seat 2: rambooschi ($3.12 in chips) 
Seat 3: mkEmperor ($1.94 in chips) 
Seat 4: Buffaloon ($2.01 in chips) 
Seat 5: pokerIman27 ($2.88 in chips) 
Seat 7: guiaoms ($2.85 in chips) 
Seat 8: Dorex2007 ($3.53 in chips) 
Seat 9: SunTszu ($2.37 in chips) 
Buffaloon: posts small blind $0.01
pokerIman27: posts big blind $0.02
*** HOLE CARDS ***
Dealt to Dorex2007 [Js 4h]
guiaoms: calls $0.02
Dorex2007 has timed out
Dorex2007: folds 
SunTszu: raises $0.06 to $0.08
Cannyjim: folds 
rambooschi: folds 
mkEmperor: folds 
Buffaloon: folds 
pokerIman27: folds 
guiaoms: calls $0.06
*** FLOP *** [8h 2h Th]
guiaoms: bets $0.02
SunTszu: raises $0.10 to $0.12
guiaoms: folds 
Uncalled bet ($0.10) returned to SunTszu
SunTszu collected $0.22 from pot
*** SUMMARY ***
Total pot $0.23 | Rake $0.01 
Board [8h 2h Th]
Seat 1: Cannyjim folded before Flop (didn't bet)
Seat 2: rambooschi folded before Flop (didn't bet)
Seat 3: mkEmperor (button) folded before Flop (didn't bet)
Seat 4: Buffaloon (small blind) folded before Flop
Seat 5: pokerIman27 (big blind) folded before Flop
Seat 7: guiaoms folded on the Flop
Seat 8: Dorex2007 folded before Flop (didn't bet)
Seat 9: SunTszu collected ($0.22)



PokerStars Hand #237374667825:  Hold'em No Limit ($0.01/$0.02 USD) - 2022/07/15 9:40:03 PT [2022/07/15 12:40:03 ET]
Table 'Appella II' 9-max Seat #4 is the button
Seat 1: Cannyjim ($2.33 in chips) 
Seat 2: rambooschi ($3.12 in chips) 
Seat 3: mkEmperor ($1.94 in chips) 
Seat 4: Buffaloon ($2 in chips) 
Seat 5: pokerIman27 ($2.86 in chips) 
Seat 7: guiaoms ($2.75 in chips) 
Seat 8: Dorex2007 ($3.53 in chips) 
Seat 9: SunTszu ($2.49 in chips) 
pokerIman27: posts small blind $0.01
guiaoms: posts big blind $0.02
*** HOLE CARDS ***
Dealt to Dorex2007 [6s Td]
Dorex2007: folds 
SunTszu: folds 
Cannyjim: folds 
rambooschi: folds 
mkEmperor: folds 
Buffaloon: folds 
pokerIman27: calls $0.01
guiaoms: checks 
*** FLOP *** [2s 2d 3s]
pokerIman27: checks 
guiaoms: checks 
*** TURN *** [2s 2d 3s] [6c]
pokerIman27: checks 
guiaoms: checks 
*** RIVER *** [2s 2d 3s 6c] [6h]
pokerIman27: bets $0.02
guiaoms: calls $0.02
*** SHOW DOWN ***
pokerIman27: shows [9d Ah] (two pair, Sixes and Deuces)
guiaoms: shows [Ac 7d] (two pair, Sixes and Deuces)
pokerIman27 collected $0.04 from pot
guiaoms collected $0.04 from pot
*** SUMMARY ***
Total pot $0.08 | Rake $0 
Board [2s 2d 3s 6c 6h]
Seat 1: Cannyjim folded before Flop (didn't bet)
Seat 2: rambooschi folded before Flop (didn't bet)
Seat 3: mkEmperor folded before Flop (didn't bet)
Seat 4: Buffaloon (button) folded before Flop (didn't bet)
Seat 5: pokerIman27 (small blind) showed [9d Ah] and won ($0.04) with two pair, Sixes and Deuces
Seat 7: guiaoms (big blind) showed [Ac 7d] and won ($0.04) with two pair, Sixes and Deuces
Seat 8: Dorex2007 folded before Flop (didn't bet)
Seat 9: SunTszu folded before Flop (didn't bet)



PokerStars Hand #237374679931:  Hold'em No Limit ($0.01/$0.02 USD) - 2022/07/15 9:40:44 PT [2022/07/15 12:40:44 ET]
Table 'Appella II' 9-max Seat #5 is the button
Seat 1: Cannyjim ($2.33 in chips) 
Seat 2: rambooschi ($3.12 in chips) 
Seat 3: mkEmperor ($1.94 in chips) 
Seat 4: Buffaloon ($2 in chips) 
Seat 5: pokerIman27 ($2.86 in chips) 
Seat 7: guiaoms ($2.75 in chips) 
Seat 8: Dorex2007 ($3.53 in chips) 
Seat 9: SunTszu ($2.49 in chips) 
guiaoms: posts small blind $0.01
Dorex2007: posts big blind $0.02
*** HOLE CARDS ***
Dealt to Dorex2007 [8c 5s]
SunTszu: folds 
Cannyjim: calls $0.02
rambooschi: calls $0.02
mkEmperor: folds 
Buffaloon: calls $0.02
pokerIman27: folds 
guiaoms: folds 
Dorex2007: checks 
*** FLOP *** [Td 9d 9h]
Dorex2007: checks 
Cannyjim: checks 
rambooschi: checks 
Buffaloon: checks 
*** TURN *** [Td 9d 9h] [Jd]
Dorex2007: checks 
Cannyjim: checks 
rambooschi: checks 
Buffaloon: checks 
*** RIVER *** [Td 9d 9h Jd] [8d]
Dorex2007: checks 
Cannyjim: checks 
rambooschi: checks 
Buffaloon: checks 
*** SHOW DOWN ***
Dorex2007: shows [8c 5s] (two pair, Nines and Eights)
Cannyjim: mucks hand 
rambooschi: mucks hand 
Buffaloon: mucks hand 
Dorex2007 collected $0.09 from pot
*** SUMMARY ***
Total pot $0.09 | Rake $0 
Board [Td 9d 9h Jd 8d]
Seat 1: Cannyjim mucked [4h 4c]
Seat 2: rambooschi mucked [5c Ac]
Seat 3: mkEmperor folded before Flop (didn't bet)
Seat 4: Buffaloon mucked [2s 2h]
Seat 5: pokerIman27 (button) folded before Flop (didn't bet)
Seat 7: guiaoms (small blind) folded before Flop
Seat 8: Dorex2007 (big blind) showed [8c 5s] and won ($0.09) with two pair, Nines and Eights
Seat 9: SunTszu folded before Flop (didn't bet)



PokerStars Hand #237374699520:  Hold'em No Limit ($0.01/$0.02 USD) - 2022/07/15 9:41:50 PT [2022/07/15 12:41:50 ET]
Table 'Appella II' 9-max Seat #7 is the button
Seat 1: Cannyjim ($2.31 in chips) 
Seat 2: rambooschi ($3.10 in chips) 
Seat 3: mkEmperor ($1.94 in chips) 
Seat 4: Buffaloon ($2 in chips) 
Seat 5: pokerIman27 ($2.86 in chips) 
Seat 7: guiaoms ($2.74 in chips) 
Seat 8: Dorex2007 ($3.60 in chips) 
Seat 9: SunTszu ($2.49 in chips) 
Dorex2007: posts small blind $0.01
SunTszu: posts big blind $0.02
*** HOLE CARDS ***
Dealt to Dorex2007 [4c 7c]
Cannyjim: folds 
rambooschi: folds 
mkEmperor: folds 
Buffaloon: folds 
pokerIman27: folds 
guiaoms: folds 
Dorex2007: folds 
Uncalled bet ($0.01) returned to SunTszu
SunTszu collected $0.02 from pot
*** SUMMARY ***
Total pot $0.02 | Rake $0 
Seat 1: Cannyjim folded before Flop (didn't bet)
Seat 2: rambooschi folded before Flop (didn't bet)
Seat 3: mkEmperor folded before Flop (didn't bet)
Seat 4: Buffaloon folded before Flop (didn't bet)
Seat 5: pokerIman27 folded before Flop (didn't bet)
Seat 7: guiaoms (button) folded before Flop (didn't bet)
Seat 8: Dorex2007 (small blind) folded before Flop
Seat 9: SunTszu (big blind) collected ($0.02)



PokerStars Hand #237374704606:  Hold'em No Limit ($0.01/$0.02 USD) - 2022/07/15 9:42:07 PT [2022/07/15 12:42:07 ET]
Table 'Appella II' 9-max Seat #8 is the button
Seat 1: Cannyjim ($2.31 in chips) 
Seat 2: rambooschi ($3.10 in chips) 
Seat 3: mkEmperor ($1.94 in chips) 
Seat 4: Buffaloon ($2 in chips) 
Seat 5: pokerIman27 ($2.86 in chips) 
Seat 7: guiaoms ($2.74 in chips) 
Seat 8: Dorex2007 ($3.59 in chips) 
Seat 9: SunTszu ($2.50 in chips) 
SunTszu: posts small blind $0.01
Cannyjim: posts big blind $0.02
*** HOLE CARDS ***
Dealt to Dorex2007 [Ks As]
rambooschi: raises $0.02 to $0.04
mkEmperor: folds 
Buffaloon: folds 
pokerIman27: folds 
guiaoms: folds 
Dorex2007: calls $0.04
SunTszu: folds 
Cannyjim: folds 
*** FLOP *** [2h 9s Kh]
rambooschi: checks 
Dorex2007: bets $0.11
rambooschi: calls $0.11
*** TURN *** [2h 9s Kh] [6h]
rambooschi: checks 
Dorex2007: bets $0.16
rambooschi: raises $0.16 to $0.32
Dorex2007: calls $0.16
*** RIVER *** [2h 9s Kh 6h] [9h]
rambooschi: bets $0.94
Dorex2007: folds 
Uncalled bet ($0.94) returned to rambooschi
rambooschi collected $0.93 from pot
*** SUMMARY ***
Total pot $0.97 | Rake $0.04 
Board [2h 9s Kh 6h 9h]
Seat 1: Cannyjim (big blind) folded before Flop
Seat 2: rambooschi collected ($0.93)
Seat 3: mkEmperor folded before Flop (didn't bet)
Seat 4: Buffaloon folded before Flop (didn't bet)
Seat 5: pokerIman27 folded before Flop (didn't bet)
Seat 7: guiaoms folded before Flop (didn't bet)
Seat 8: Dorex2007 (button) folded on the River
Seat 9: SunTszu (small blind) folded before Flop



PokerStars Hand #237374725539:  Hold'em No Limit ($0.01/$0.02 USD) - 2022/07/15 9:43:04 PT [2022/07/15 12:43:04 ET]
Table 'Appella II' 9-max Seat #9 is the button
Seat 1: Cannyjim ($2.29 in chips) 
Seat 2: rambooschi ($3.56 in chips) 
Seat 3: mkEmperor ($1.94 in chips) 
Seat 4: Buffaloon ($2 in chips) 
Seat 5: pokerIman27 ($2.86 in chips) 
Seat 7: guiaoms ($2.74 in chips) 
Seat 8: Dorex2007 ($3.12 in chips) 
Seat 9: SunTszu ($2.49 in chips) 
Cannyjim: posts small blind $0.01
rambooschi: posts big blind $0.02
*** HOLE CARDS ***
Dealt to Dorex2007 [Js 8d]
mkEmperor: folds 
Buffaloon: raises $0.04 to $0.06
pokerIman27: folds 
guiaoms: folds 
Dorex2007: folds 
SunTszu: folds 
Cannyjim: folds 
rambooschi: folds 
Uncalled bet ($0.04) returned to Buffaloon
Buffaloon collected $0.05 from pot
*** SUMMARY ***
Total pot $0.05 | Rake $0 
Seat 1: Cannyjim (small blind) folded before Flop
Seat 2: rambooschi (big blind) folded before Flop
Seat 3: mkEmperor folded before Flop (didn't bet)
Seat 4: Buffaloon collected ($0.05)
Seat 5: pokerIman27 folded before Flop (didn't bet)
Seat 7: guiaoms folded before Flop (didn't bet)
Seat 8: Dorex2007 folded before Flop (didn't bet)
Seat 9: SunTszu (button) folded before Flop (didn't bet)



PokerStars Hand #237374731847:  Hold'em No Limit ($0.01/$0.02 USD) - 2022/07/15 9:43:25 PT [2022/07/15 12:43:25 ET]
Table 'Appella II' 9-max Seat #1 is the button
Seat 1: Cannyjim ($2.28 in chips) 
Seat 2: rambooschi ($3.54 in chips) 
Seat 3: mkEmperor ($1.94 in chips) 
Seat 4: Buffaloon ($2.03 in chips) 
Seat 5: pokerIman27 ($2.86 in chips) 
Seat 7: guiaoms ($2.74 in chips) 
Seat 8: Dorex2007 ($3.12 in chips) 
Seat 9: SunTszu ($2.49 in chips) 
rambooschi: posts small blind $0.01
mkEmperor: posts big blind $0.02
*** HOLE CARDS ***
Dealt to Dorex2007 [8d 3d]
Buffaloon: folds 
pokerIman27: folds 
guiaoms: folds 
Dorex2007: folds 
SunTszu has timed out
SunTszu: folds 
Cannyjim: folds 
rambooschi: folds 
Uncalled bet ($0.01) returned to mkEmperor
mkEmperor collected $0.02 from pot
*** SUMMARY ***
Total pot $0.02 | Rake $0 
Seat 1: Cannyjim (button) folded before Flop (didn't bet)
Seat 2: rambooschi (small blind) folded before Flop
Seat 3: mkEmperor (big blind) collected ($0.02)
Seat 4: Buffaloon folded before Flop (didn't bet)
Seat 5: pokerIman27 folded before Flop (didn't bet)
Seat 7: guiaoms folded before Flop (didn't bet)
Seat 8: Dorex2007 folded before Flop (didn't bet)
Seat 9: SunTszu folded before Flop (didn't bet)



PokerStars Hand #237374738105:  Hold'em No Limit ($0.01/$0.02 USD) - 2022/07/15 9:43:46 PT [2022/07/15 12:43:46 ET]
Table 'Appella II' 9-max Seat #2 is the button
Seat 1: Cannyjim ($2.28 in chips) 
Seat 2: rambooschi ($3.53 in chips) 
Seat 3: mkEmperor ($1.95 in chips) 
Seat 4: Buffaloon ($2.03 in chips) 
Seat 5: pokerIman27 ($2.86 in chips) 
Seat 7: guiaoms ($2.74 in chips) 
Seat 8: Dorex2007 ($3.12 in chips) 
mkEmperor: posts small blind $0.01
Buffaloon: posts big blind $0.02
*** HOLE CARDS ***
Dealt to Dorex2007 [9h 7s]
pokerIman27: folds 
guiaoms: folds 
Dorex2007: folds 
Cannyjim: raises $0.04 to $0.06
rambooschi: folds 
mkEmperor: folds 
Buffaloon: folds 
Uncalled bet ($0.04) returned to Cannyjim
Cannyjim collected $0.05 from pot
*** SUMMARY ***
Total pot $0.05 | Rake $0 
Seat 1: Cannyjim collected ($0.05)
Seat 2: rambooschi (button) folded before Flop (didn't bet)
Seat 3: mkEmperor (small blind) folded before Flop
Seat 4: Buffaloon (big blind) folded before Flop
Seat 5: pokerIman27 folded before Flop (didn't bet)
Seat 7: guiaoms folded before Flop (didn't bet)
Seat 8: Dorex2007 folded before Flop (didn't bet)



PokerStars Hand #237374745103:  Hold'em No Limit ($0.01/$0.02 USD) - 2022/07/15 9:44:09 PT [2022/07/15 12:44:09 ET]
Table 'Appella II' 9-max Seat #3 is the button
Seat 1: Cannyjim ($2.31 in chips) 
Seat 2: rambooschi ($3.53 in chips) 
Seat 3: mkEmperor ($1.94 in chips) 
Seat 4: Buffaloon ($2.01 in chips) 
Seat 5: pokerIman27 ($2.86 in chips) 
Seat 7: guiaoms ($2.74 in chips) 
Seat 8: Dorex2007 ($3.12 in chips) 
Seat 9: SunTszu ($2.49 in chips) 
Buffaloon: posts small blind $0.01
pokerIman27: posts big blind $0.02
*** HOLE CARDS ***
Dealt to Dorex2007 [3d 2d]
guiaoms: folds 
Dorex2007: folds 
SunTszu: raises $0.04 to $0.06
Cannyjim: calls $0.06
rambooschi: folds 
mkEmperor: folds 
Buffaloon: calls $0.05
pokerIman27: folds 
*** FLOP *** [Tc Js 6d]
Buffaloon: checks 
SunTszu: bets $0.10
Cannyjim: calls $0.10
Buffaloon: calls $0.10
*** TURN *** [Tc Js 6d] [7d]
Buffaloon: checks 
SunTszu: bets $0.26
Cannyjim: calls $0.26
Buffaloon: folds 
*** RIVER *** [Tc Js 6d 7d] [4c]
SunTszu: bets $0.38
Cannyjim: folds 
Uncalled bet ($0.38) returned to SunTszu
SunTszu collected $0.98 from pot
*** SUMMARY ***
Total pot $1.02 | Rake $0.04 
Board [Tc Js 6d 7d 4c]
Seat 1: Cannyjim folded on the River
Seat 2: rambooschi folded before Flop (didn't bet)
Seat 3: mkEmperor (button) folded before Flop (didn't bet)
Seat 4: Buffaloon (small blind) folded on the Turn
Seat 5: pokerIman27 (big blind) folded before Flop
Seat 7: guiaoms folded before Flop (didn't bet)
Seat 8: Dorex2007 folded before Flop (didn't bet)
Seat 9: SunTszu collected ($0.98)



PokerStars Hand #237374770239:  Hold'em No Limit ($0.01/$0.02 USD) - 2022/07/15 9:45:34 PT [2022/07/15 12:45:34 ET]
Table 'Appella II' 9-max Seat #4 is the button
Seat 1: Cannyjim ($1.89 in chips) 
Seat 2: rambooschi ($3.53 in chips) 
Seat 3: mkEmperor ($1.94 in chips) 
Seat 4: Buffaloon ($2 in chips) 
Seat 5: pokerIman27 ($2.84 in chips) 
Seat 7: guiaoms ($2.74 in chips) 
Seat 8: Dorex2007 ($3.12 in chips) 
Seat 9: SunTszu ($3.05 in chips) 
pokerIman27: posts small blind $0.01
guiaoms: posts big blind $0.02
*** HOLE CARDS ***
Dealt to Dorex2007 [5c As]
Dorex2007: folds 
SunTszu: raises $0.02 to $0.04
Cannyjim: folds 
rambooschi: calls $0.04
mkEmperor: folds 
Buffaloon: calls $0.04
pokerIman27: calls $0.03
guiaoms: folds 
*** FLOP *** [Qs 9d 9s]
pokerIman27: checks 
SunTszu: bets $0.10
rambooschi: folds 
Buffaloon: calls $0.10
pokerIman27: calls $0.10
*** TURN *** [Qs 9d 9s] [3h]
pokerIman27: checks 
SunTszu: checks 
Buffaloon: bets $0.20
pokerIman27: folds 
SunTszu: calls $0.20
*** RIVER *** [Qs 9d 9s 3h] [6d]
SunTszu: checks 
Buffaloon: checks 
*** SHOW DOWN ***
SunTszu: shows [Ts Ks] (a pair of Nines)
Buffaloon: mucks hand 
SunTszu collected $0.85 from pot
*** SUMMARY ***
Total pot $0.88 | Rake $0.03 
Board [Qs 9d 9s 3h 6d]
Seat 1: Cannyjim folded before Flop (didn't bet)
Seat 2: rambooschi folded on the Flop
Seat 3: mkEmperor folded before Flop (didn't bet)
Seat 4: Buffaloon (button) mucked [8h Jc]
Seat 5: pokerIman27 (small blind) folded on the Turn
Seat 7: guiaoms (big blind) folded before Flop
Seat 8: Dorex2007 folded before Flop (didn't bet)
Seat 9: SunTszu showed [Ts Ks] and won ($0.85) with a pair of Nines



PokerStars Hand #237374792685:  Hold'em No Limit ($0.01/$0.02 USD) - 2022/07/15 9:46:50 PT [2022/07/15 12:46:50 ET]
Table 'Appella II' 9-max Seat #5 is the button
Seat 1: Cannyjim ($1.89 in chips) 
Seat 2: rambooschi ($3.49 in chips) 
Seat 3: mkEmperor ($1.94 in chips) 
Seat 4: Buffaloon ($2 in chips) 
Seat 5: pokerIman27 ($2.70 in chips) 
Seat 7: guiaoms ($2.72 in chips) 
Seat 8: Dorex2007 ($3.12 in chips) 
Seat 9: SunTszu ($3.56 in chips) 
guiaoms: posts small blind $0.01
Dorex2007: posts big blind $0.02
*** HOLE CARDS ***
Dealt to Dorex2007 [Kh 6h]
SunTszu: raises $0.04 to $0.06
Cannyjim: folds 
rambooschi: folds 
mkEmperor: folds 
Buffaloon: folds 
pokerIman27: folds 
guiaoms: folds 
Dorex2007: folds 
Uncalled bet ($0.04) returned to SunTszu
SunTszu collected $0.05 from pot
*** SUMMARY ***
Total pot $0.05 | Rake $0 
Seat 1: Cannyjim folded before Flop (didn't bet)
Seat 2: rambooschi folded before Flop (didn't bet)
Seat 3: mkEmperor folded before Flop (didn't bet)
Seat 4: Buffaloon folded before Flop (didn't bet)
Seat 5: pokerIman27 (button) folded before Flop (didn't bet)
Seat 7: guiaoms (small blind) folded before Flop
Seat 8: Dorex2007 (big blind) folded before Flop
Seat 9: SunTszu collected ($0.05)



PokerStars Hand #237374797682:  Hold'em No Limit ($0.01/$0.02 USD) - 2022/07/15 9:47:07 PT [2022/07/15 12:47:07 ET]
Table 'Appella II' 9-max Seat #7 is the button
Seat 1: Cannyjim ($1.89 in chips) 
Seat 2: rambooschi ($3.49 in chips) 
Seat 3: mkEmperor ($1.94 in chips) 
Seat 4: Buffaloon ($2 in chips) 
Seat 5: pokerIman27 ($2.70 in chips) 
Seat 7: guiaoms ($2.71 in chips) 
Seat 8: Dorex2007 ($3.10 in chips) 
Seat 9: SunTszu ($3.59 in chips) 
Dorex2007: posts small blind $0.01
SunTszu: posts big blind $0.02
monstrrrik: sits out 
*** HOLE CARDS ***
Dealt to Dorex2007 [6s 7c]
Cannyjim: folds 
rambooschi: folds 
mkEmperor: calls $0.02
Buffaloon: folds 
pokerIman27: folds 
guiaoms: folds 
Dorex2007: folds 
SunTszu: checks 
*** FLOP *** [Ts 7d 2s]
SunTszu: checks 
mkEmperor: checks 
*** TURN *** [Ts 7d 2s] [As]
SunTszu: checks 
mkEmperor: bets $0.02
SunTszu: calls $0.02
*** RIVER *** [Ts 7d 2s As] [6d]
SunTszu: checks 
mkEmperor: checks 
*** SHOW DOWN ***
SunTszu: shows [4d 3h] (high card Ace)
mkEmperor: shows [9h 9c] (a pair of Nines)
mkEmperor collected $0.09 from pot
*** SUMMARY ***
Total pot $0.09 | Rake $0 
Board [Ts 7d 2s As 6d]
Seat 1: Cannyjim folded before Flop (didn't bet)
Seat 2: rambooschi folded before Flop (didn't bet)
Seat 3: mkEmperor showed [9h 9c] and won ($0.09) with a pair of Nines
Seat 4: Buffaloon folded before Flop (didn't bet)
Seat 5: pokerIman27 folded before Flop (didn't bet)
Seat 7: guiaoms (button) folded before Flop (didn't bet)
Seat 8: Dorex2007 (small blind) folded before Flop
Seat 9: SunTszu (big blind) showed [4d 3h] and lost with high card Ace



PokerStars Hand #237374813571:  Hold'em No Limit ($0.01/$0.02 USD) - 2022/07/15 9:48:01 PT [2022/07/15 12:48:01 ET]
Table 'Appella II' 9-max Seat #8 is the button
Seat 1: Cannyjim ($1.89 in chips) 
Seat 2: rambooschi ($3.49 in chips) 
Seat 3: mkEmperor ($1.99 in chips) 
Seat 4: Buffaloon ($2 in chips) 
Seat 5: pokerIman27 ($2.70 in chips) 
Seat 7: guiaoms ($2.71 in chips) 
Seat 8: Dorex2007 ($3.09 in chips) 
Seat 9: SunTszu ($3.55 in chips) 
SunTszu: posts small blind $0.01
Cannyjim: posts big blind $0.02
monstrrrik: sits out 
*** HOLE CARDS ***
Dealt to Dorex2007 [6h 8h]
rambooschi has timed out
rambooschi: folds 
mkEmperor: folds 
Buffaloon: folds 
pokerIman27: calls $0.02
guiaoms: folds 
Dorex2007: folds 
SunTszu: folds 
Cannyjim: checks 
*** FLOP *** [Td 3d Qh]
Cannyjim: checks 
pokerIman27: checks 
*** TURN *** [Td 3d Qh] [8s]
Cannyjim: checks 
pokerIman27: checks 
*** RIVER *** [Td 3d Qh 8s] [3h]
Cannyjim: checks 
pokerIman27: checks 
*** SHOW DOWN ***
Cannyjim: shows [5d Tc] (two pair, Tens and Threes)
pokerIman27: mucks hand 
Cannyjim collected $0.05 from pot
*** SUMMARY ***
Total pot $0.05 | Rake $0 
Board [Td 3d Qh 8s 3h]
Seat 1: Cannyjim (big blind) showed [5d Tc] and won ($0.05) with two pair, Tens and Threes
Seat 2: rambooschi folded before Flop (didn't bet)
Seat 3: mkEmperor folded before Flop (didn't bet)
Seat 4: Buffaloon folded before Flop (didn't bet)
Seat 5: pokerIman27 mucked [7d 7c]
Seat 7: guiaoms folded before Flop (didn't bet)
Seat 8: Dorex2007 (button) folded before Flop (didn't bet)
Seat 9: SunTszu (small blind) folded before Flop



PokerStars Hand #237374827040:  Hold'em No Limit ($0.01/$0.02 USD) - 2022/07/15 9:48:47 PT [2022/07/15 12:48:47 ET]
Table 'Appella II' 9-max Seat #9 is the button
Seat 1: Cannyjim ($1.92 in chips) 
Seat 2: rambooschi ($3.49 in chips) 
Seat 3: mkEmperor ($1.99 in chips) 
Seat 4: Buffaloon ($2 in chips) 
Seat 5: pokerIman27 ($2.68 in chips) 
Seat 7: guiaoms ($2.71 in chips) 
Seat 8: Dorex2007 ($3.09 in chips) 
Seat 9: SunTszu ($3.54 in chips) 
Cannyjim: posts small blind $0.01
rambooschi: posts big blind $0.02
monstrrrik: sits out 
*** HOLE CARDS ***
Dealt to Dorex2007 [Kh 4s]
mkEmperor: folds 
Buffaloon: folds 
pokerIman27: raises $0.04 to $0.06
monstrrrik leaves the table
guiaoms: folds 
Dorex2007: folds 
SunTszu: folds 
Cannyjim: calls $0.05
rambooschi: folds 
*** FLOP *** [2s As 8s]
lucascarneseca joins the table at seat #6 
Cannyjim: checks 
pokerIman27: bets $0.14
Cannyjim: calls $0.14
*** TURN *** [2s As 8s] [Qd]
Cannyjim: checks 
pokerIman27: bets $0.41
Cannyjim: calls $0.41
*** RIVER *** [2s As 8s Qd] [2d]
Cannyjim: checks 
pokerIman27: bets $1.20
Cannyjim: folds 
Uncalled bet ($1.20) returned to pokerIman27
pokerIman27 collected $1.20 from pot
*** SUMMARY ***
Total pot $1.24 | Rake $0.04 
Board [2s As 8s Qd 2d]
Seat 1: Cannyjim (small blind) folded on the River
Seat 2: rambooschi (big blind) folded before Flop
Seat 3: mkEmperor folded before Flop (didn't bet)
Seat 4: Buffaloon folded before Flop (didn't bet)
Seat 5: pokerIman27 collected ($1.20)
Seat 7: guiaoms folded before Flop (didn't bet)
Seat 8: Dorex2007 folded before Flop (didn't bet)
Seat 9: SunTszu (button) folded before Flop (didn't bet)



PokerStars Hand #237374841432:  Hold'em No Limit ($0.01/$0.02 USD) - 2022/07/15 9:49:36 PT [2022/07/15 12:49:36 ET]
Table 'Appella II' 9-max Seat #1 is the button
Seat 1: Cannyjim ($1.31 in chips) 
Seat 2: rambooschi ($3.47 in chips) 
Seat 3: mkEmperor ($1.99 in chips) 
Seat 4: Buffaloon ($2 in chips) 
Seat 5: pokerIman27 ($3.27 in chips) 
Seat 7: guiaoms ($2.71 in chips) 
Seat 8: Dorex2007 ($3.09 in chips) 
Seat 9: SunTszu ($3.54 in chips) 
rambooschi: posts small blind $0.01
mkEmperor: posts big blind $0.02
lucascarneseca: sits out 
*** HOLE CARDS ***
Dealt to Dorex2007 [Jd 7c]
Buffaloon: folds 
pokerIman27: calls $0.02
guiaoms: folds 
Dorex2007: folds 
SunTszu: raises $0.02 to $0.04
Cannyjim: calls $0.04
rambooschi: calls $0.03
mkEmperor: calls $0.02
pokerIman27: calls $0.02
*** FLOP *** [Tc Kh Jc]
rambooschi: checks 
mkEmperor: checks 
pokerIman27: checks 
SunTszu: bets $0.08
Cannyjim: folds 
rambooschi: calls $0.08
mkEmperor: folds 
pokerIman27: calls $0.08
*** TURN *** [Tc Kh Jc] [8c]
rambooschi: checks 
pokerIman27: checks 
SunTszu: checks 
*** RIVER *** [Tc Kh Jc 8c] [7h]
rambooschi: bets $0.42
pokerIman27: folds 
SunTszu: folds 
Uncalled bet ($0.42) returned to rambooschi
rambooschi collected $0.42 from pot
*** SUMMARY ***
Total pot $0.44 | Rake $0.02 
Board [Tc Kh Jc 8c 7h]
Seat 1: Cannyjim (button) folded on the Flop
Seat 2: rambooschi (small blind) collected ($0.42)
Seat 3: mkEmperor (big blind) folded on the Flop
Seat 4: Buffaloon folded before Flop (didn't bet)
Seat 5: pokerIman27 folded on the River
Seat 7: guiaoms folded before Flop (didn't bet)
Seat 8: Dorex2007 folded before Flop (didn't bet)
Seat 9: SunTszu folded on the River



PokerStars Hand #237374865453:  Hold'em No Limit ($0.01/$0.02 USD) - 2022/07/15 9:50:57 PT [2022/07/15 12:50:57 ET]
Table 'Appella II' 9-max Seat #2 is the button
Seat 1: Cannyjim ($1.27 in chips) 
Seat 2: rambooschi ($3.77 in chips) 
Seat 3: mkEmperor ($1.95 in chips) 
Seat 4: Buffaloon ($2 in chips) 
Seat 5: pokerIman27 ($3.15 in chips) 
Seat 6: lucascarneseca ($1.60 in chips) 
Seat 7: guiaoms ($2.71 in chips) 
Seat 8: Dorex2007 ($3.09 in chips) 
Seat 9: SunTszu ($3.42 in chips) 
mkEmperor: posts small blind $0.01
Buffaloon: posts big blind $0.02
lucascarneseca: posts big blind $0.02
*** HOLE CARDS ***
Dealt to Dorex2007 [7h Tc]
pokerIman27: calls $0.02
lucascarneseca: checks 
guiaoms: folds 
Dorex2007: folds 
SunTszu: raises $0.04 to $0.06
Cannyjim: folds 
rambooschi: folds 
mkEmperor: folds 
Buffaloon: folds 
pokerIman27: calls $0.04
lucascarneseca: calls $0.04
*** FLOP *** [9c Kd Ac]
pokerIman27: checks 
lucascarneseca: checks 
SunTszu: bets $0.08
pokerIman27: calls $0.08
lucascarneseca: calls $0.08
*** TURN *** [9c Kd Ac] [2d]
pokerIman27: checks 
lucascarneseca: checks 
SunTszu: bets $0.24
pokerIman27: folds 
lucascarneseca: folds 
Uncalled bet ($0.24) returned to SunTszu
SunTszu collected $0.43 from pot
*** SUMMARY ***
Total pot $0.45 | Rake $0.02 
Board [9c Kd Ac 2d]
Seat 1: Cannyjim folded before Flop (didn't bet)
Seat 2: rambooschi (button) folded before Flop (didn't bet)
Seat 3: mkEmperor (small blind) folded before Flop
Seat 4: Buffaloon (big blind) folded before Flop
Seat 5: pokerIman27 folded on the Turn
Seat 6: lucascarneseca folded on the Turn
Seat 7: guiaoms folded before Flop (didn't bet)
Seat 8: Dorex2007 folded before Flop (didn't bet)
Seat 9: SunTszu collected ($0.43)



PokerStars Hand #237374890064:  Hold'em No Limit ($0.01/$0.02 USD) - 2022/07/15 9:52:20 PT [2022/07/15 12:52:20 ET]
Table 'Appella II' 9-max Seat #3 is the button
Seat 1: Cannyjim ($1.27 in chips) 
Seat 2: rambooschi ($3.77 in chips) 
Seat 3: mkEmperor ($1.94 in chips) 
Seat 4: Buffaloon ($2 in chips) 
Seat 5: pokerIman27 ($3.01 in chips) 
Seat 6: lucascarneseca ($1.46 in chips) 
Seat 7: guiaoms ($2.71 in chips) 
Seat 8: Dorex2007 ($3.09 in chips) 
Seat 9: SunTszu ($3.71 in chips) 
Buffaloon: posts small blind $0.01
pokerIman27: posts big blind $0.02
*** HOLE CARDS ***
Dealt to Dorex2007 [2c Kd]
lucascarneseca: calls $0.02
guiaoms: folds 
Dorex2007: folds 
SunTszu: folds 
Cannyjim: calls $0.02
rambooschi: folds 
mkEmperor: folds 
Buffaloon: calls $0.01
pokerIman27: checks 
*** FLOP *** [Qh Kc 8h]
Buffaloon: checks 
pokerIman27: checks 
lucascarneseca: checks 
Cannyjim: bets $0.04
Buffaloon: folds 
pokerIman27: folds 
lucascarneseca: folds 
Uncalled bet ($0.04) returned to Cannyjim
Cannyjim collected $0.08 from pot
*** SUMMARY ***
Total pot $0.08 | Rake $0 
Board [Qh Kc 8h]
Seat 1: Cannyjim collected ($0.08)
Seat 2: rambooschi folded before Flop (didn't bet)
Seat 3: mkEmperor (button) folded before Flop (didn't bet)
Seat 4: Buffaloon (small blind) folded on the Flop
Seat 5: pokerIman27 (big blind) folded on the Flop
Seat 6: lucascarneseca folded on the Flop
Seat 7: guiaoms folded before Flop (didn't bet)
Seat 8: Dorex2007 folded before Flop (didn't bet)
Seat 9: SunTszu folded before Flop (didn't bet)



PokerStars Hand #237374907318:  Hold'em No Limit ($0.01/$0.02 USD) - 2022/07/15 9:53:17 PT [2022/07/15 12:53:17 ET]
Table 'Appella II' 9-max Seat #4 is the button
Seat 1: Cannyjim ($1.33 in chips) 
Seat 2: rambooschi ($3.77 in chips) 
Seat 3: mkEmperor ($1.94 in chips) 
Seat 4: Buffaloon ($2 in chips) 
Seat 5: pokerIman27 ($2.99 in chips) 
Seat 6: lucascarneseca ($1.44 in chips) 
Seat 7: guiaoms ($2.71 in chips) 
Seat 8: Dorex2007 ($3.09 in chips) 
Seat 9: SunTszu ($3.71 in chips) 
pokerIman27: posts small blind $0.01
lucascarneseca: posts big blind $0.02
*** HOLE CARDS ***
Dealt to Dorex2007 [Qc Ah]
guiaoms: folds 
Dorex2007: folds 
SunTszu: folds 
Cannyjim: calls $0.02
rambooschi: raises $0.04 to $0.06
mkEmperor: folds 
Buffaloon: folds 
pokerIman27: folds 
lucascarneseca: folds 
Cannyjim: calls $0.04
*** FLOP *** [8h 7d 2c]
Cannyjim: checks 
rambooschi: checks 
*** TURN *** [8h 7d 2c] [6s]
Cannyjim: bets $0.14
rambooschi: folds 
Uncalled bet ($0.14) returned to Cannyjim
Cannyjim collected $0.14 from pot
*** SUMMARY ***
Total pot $0.15 | Rake $0.01 
Board [8h 7d 2c 6s]
Seat 1: Cannyjim collected ($0.14)
Seat 2: rambooschi folded on the Turn
Seat 3: mkEmperor folded before Flop (didn't bet)
Seat 4: Buffaloon (button) folded before Flop (didn't bet)
Seat 5: pokerIman27 (small blind) folded before Flop
Seat 6: lucascarneseca (big blind) folded before Flop
Seat 7: guiaoms folded before Flop (didn't bet)
Seat 8: Dorex2007 folded before Flop (didn't bet)
Seat 9: SunTszu folded before Flop (didn't bet)



PokerStars Hand #237374919909:  Hold'em No Limit ($0.01/$0.02 USD) - 2022/07/15 9:54:00 PT [2022/07/15 12:54:00 ET]
Table 'Appella II' 9-max Seat #5 is the button
Seat 1: Cannyjim ($1.41 in chips) 
Seat 2: rambooschi ($3.71 in chips) 
Seat 3: mkEmperor ($1.94 in chips) 
Seat 4: Buffaloon ($2 in chips) 
Seat 5: pokerIman27 ($2.98 in chips) 
Seat 6: lucascarneseca ($1.42 in chips) 
Seat 7: guiaoms ($2.71 in chips) 
Seat 8: Dorex2007 ($3.09 in chips) 
Seat 9: SunTszu ($3.71 in chips) 
lucascarneseca: posts small blind $0.01
guiaoms: posts big blind $0.02
*** HOLE CARDS ***
Dealt to Dorex2007 [Ad Ks]
Dorex2007: raises $0.02 to $0.04
SunTszu: folds 
Cannyjim: calls $0.04
rambooschi: folds 
mkEmperor: folds 
SunTszu leaves the table
Buffaloon: folds 
pokerIman27: folds 
lucascarneseca: raises $0.02 to $0.06
guiaoms: folds 
Dorex2007: calls $0.02
Cannyjim: calls $0.02
*** FLOP *** [Kh Qd As]
lucascarneseca: bets $0.06
Dorex2007: raises $0.12 to $0.18
Cannyjim: folds 
lucascarneseca: calls $0.12
*** TURN *** [Kh Qd As] [8d]
lucascarneseca: checks 
Dorex2007: bets $0.54
lucascarneseca: calls $0.54
*** RIVER *** [Kh Qd As 8d] [3h]
Nico55KQ joins the table at seat #9 
lucascarneseca: checks 
Dorex2007: checks 
*** SHOW DOWN ***
lucascarneseca: shows [Ah Th] (a pair of Aces)
Dorex2007: shows [Ad Ks] (two pair, Aces and Kings)
Dorex2007 collected $1.58 from pot
*** SUMMARY ***
Total pot $1.64 | Rake $0.06 
Board [Kh Qd As 8d 3h]
Seat 1: Cannyjim folded on the Flop
Seat 2: rambooschi folded before Flop (didn't bet)
Seat 3: mkEmperor folded before Flop (didn't bet)
Seat 4: Buffaloon folded before Flop (didn't bet)
Seat 5: pokerIman27 (button) folded before Flop (didn't bet)
Seat 6: lucascarneseca (small blind) showed [Ah Th] and lost with a pair of Aces
Seat 7: guiaoms (big blind) folded before Flop
Seat 8: Dorex2007 showed [Ad Ks] and won ($1.58) with two pair, Aces and Kings
Seat 9: SunTszu folded before Flop (didn't bet)



PokerStars Hand #237374940360:  Hold'em No Limit ($0.01/$0.02 USD) - 2022/07/15 9:55:09 PT [2022/07/15 12:55:09 ET]
Table 'Appella II' 9-max Seat #6 is the button
Seat 1: Cannyjim ($1.35 in chips) 
Seat 2: rambooschi ($3.71 in chips) 
Seat 3: mkEmperor ($1.94 in chips) 
Seat 4: Buffaloon ($2 in chips) 
Seat 5: pokerIman27 ($2.98 in chips) 
Seat 6: lucascarneseca ($0.64 in chips) 
Seat 7: guiaoms ($2.69 in chips) 
Seat 8: Dorex2007 ($3.89 in chips) 
guiaoms: posts small blind $0.01
Dorex2007: posts big blind $0.02
Nico55KQ: sits out 
*** HOLE CARDS ***
Dealt to Dorex2007 [Th Jc]
Cannyjim: folds 
rambooschi: raises $0.02 to $0.04
mkEmperor: folds 
Buffaloon: folds 
pokerIman27: folds 
lucascarneseca: calls $0.04
guiaoms: calls $0.03
Dorex2007: calls $0.02
*** FLOP *** [5h 2s Kd]
guiaoms: checks 
Dorex2007: checks 
rambooschi: checks 
lucascarneseca: checks 
*** TURN *** [5h 2s Kd] [8s]
guiaoms: checks 
Dorex2007: checks 
rambooschi: checks 
lucascarneseca: checks 
*** RIVER *** [5h 2s Kd 8s] [2c]
guiaoms: checks 
Dorex2007: checks 
rambooschi: bets $0.02
lucascarneseca: folds 
guiaoms: calls $0.02
Dorex2007: folds 
*** SHOW DOWN ***
rambooschi: shows [Jd Jh] (two pair, Jacks and Deuces)
guiaoms: mucks hand 
rambooschi collected $0.19 from pot
*** SUMMARY ***
Total pot $0.20 | Rake $0.01 
Board [5h 2s Kd 8s 2c]
Seat 1: Cannyjim folded before Flop (didn't bet)
Seat 2: rambooschi showed [Jd Jh] and won ($0.19) with two pair, Jacks and Deuces
Seat 3: mkEmperor folded before Flop (didn't bet)
Seat 4: Buffaloon folded before Flop (didn't bet)
Seat 5: pokerIman27 folded before Flop (didn't bet)
Seat 6: lucascarneseca (button) folded on the River
Seat 7: guiaoms (small blind) mucked [7c 7d]
Seat 8: Dorex2007 (big blind) folded on the River



PokerStars Hand #237374954931:  Hold'em No Limit ($0.01/$0.02 USD) - 2022/07/15 9:56:12 PT [2022/07/15 12:56:12 ET]
Table 'Appella II' 9-max Seat #7 is the button
Seat 1: Cannyjim ($1.35 in chips) 
Seat 2: rambooschi ($3.84 in chips) 
Seat 3: mkEmperor ($1.94 in chips) 
Seat 4: Buffaloon ($2 in chips) 
Seat 5: pokerIman27 ($2.98 in chips) 
Seat 6: lucascarneseca ($0.60 in chips) 
Seat 7: guiaoms ($2.63 in chips) 
Seat 8: Dorex2007 ($3.85 in chips) 
Seat 9: Nico55KQ ($2 in chips) 
Dorex2007: posts small blind $0.01
Nico55KQ: posts big blind $0.02
*** HOLE CARDS ***
Dealt to Dorex2007 [9s Ts]
Cannyjim: calls $0.02
rambooschi: raises $0.04 to $0.06
mkEmperor: folds 
Buffaloon: folds 
pokerIman27: folds 
lucascarneseca: calls $0.06
guiaoms: folds 
Dorex2007: calls $0.05
Nico55KQ: folds 
Cannyjim: calls $0.04
*** FLOP *** [Jc 4h Jd]
Dorex2007: checks 
Cannyjim: checks 
rambooschi: checks 
lucascarneseca: checks 
*** TURN *** [Jc 4h Jd] [3d]
Dorex2007: checks 
Cannyjim: checks 
rambooschi: checks 
lucascarneseca: checks 
*** RIVER *** [Jc 4h Jd 3d] [Th]
Dorex2007: bets $0.12
Cannyjim: folds 
rambooschi: folds 
lucascarneseca: folds 
Uncalled bet ($0.12) returned to Dorex2007
Dorex2007 collected $0.25 from pot
*** SUMMARY ***
Total pot $0.26 | Rake $0.01 
Board [Jc 4h Jd 3d Th]
Seat 1: Cannyjim folded on the River
Seat 2: rambooschi folded on the River
Seat 3: mkEmperor folded before Flop (didn't bet)
Seat 4: Buffaloon folded before Flop (didn't bet)
Seat 5: pokerIman27 folded before Flop (didn't bet)
Seat 6: lucascarneseca folded on the River
Seat 7: guiaoms (button) folded before Flop (didn't bet)
Seat 8: Dorex2007 (small blind) collected ($0.25)
Seat 9: Nico55KQ (big blind) folded before Flop



PokerStars Hand #237374974435:  Hold'em No Limit ($0.01/$0.02 USD) - 2022/07/15 9:57:12 PT [2022/07/15 12:57:12 ET]
Table 'Appella II' 9-max Seat #8 is the button
Seat 1: Cannyjim ($1.29 in chips) 
Seat 2: rambooschi ($3.78 in chips) 
Seat 3: mkEmperor ($1.94 in chips) 
Seat 4: Buffaloon ($2 in chips) 
Seat 5: pokerIman27 ($2.98 in chips) 
Seat 6: lucascarneseca ($0.54 in chips) 
Seat 7: guiaoms ($2.63 in chips) 
Seat 8: Dorex2007 ($4.04 in chips) 
Seat 9: Nico55KQ ($1.98 in chips) 
Nico55KQ: posts small blind $0.01
Cannyjim: posts big blind $0.02
*** HOLE CARDS ***
Dealt to Dorex2007 [8c 2c]
rambooschi: folds 
mkEmperor: folds 
Buffaloon: folds 
pokerIman27: calls $0.02
lucascarneseca: folds 
guiaoms: folds 
Dorex2007: folds 
Nico55KQ: calls $0.01
Cannyjim: checks 
*** FLOP *** [6h 4d Kh]
Nico55KQ: checks 
Cannyjim: checks 
pokerIman27: checks 
*** TURN *** [6h 4d Kh] [Kd]
Nico55KQ: bets $0.04
Cannyjim: calls $0.04
pokerIman27: calls $0.04
*** RIVER *** [6h 4d Kh Kd] [9c]
Nico55KQ: bets $0.04
Cannyjim: calls $0.04
pokerIman27: folds 
*** SHOW DOWN ***
Nico55KQ: shows [4h 6c] (two pair, Kings and Sixes)
Cannyjim: shows [7h 6d] (two pair, Kings and Sixes)
Nico55KQ collected $0.13 from pot
Cannyjim collected $0.12 from pot
*** SUMMARY ***
Total pot $0.26 | Rake $0.01 
Board [6h 4d Kh Kd 9c]
Seat 1: Cannyjim (big blind) showed [7h 6d] and won ($0.12) with two pair, Kings and Sixes
Seat 2: rambooschi folded before Flop (didn't bet)
Seat 3: mkEmperor folded before Flop (didn't bet)
Seat 4: Buffaloon folded before Flop (didn't bet)
Seat 5: pokerIman27 folded on the River
Seat 6: lucascarneseca folded before Flop (didn't bet)
Seat 7: guiaoms folded before Flop (didn't bet)
Seat 8: Dorex2007 (button) folded before Flop (didn't bet)
Seat 9: Nico55KQ (small blind) showed [4h 6c] and won ($0.13) with two pair, Kings and Sixes



PokerStars Hand #237374986207:  Hold'em No Limit ($0.01/$0.02 USD) - 2022/07/15 9:58:02 PT [2022/07/15 12:58:02 ET]
Table 'Appella II' 9-max Seat #9 is the button
Seat 1: Cannyjim ($1.31 in chips) 
Seat 2: rambooschi ($3.78 in chips) 
Seat 3: mkEmperor ($1.94 in chips) 
Seat 4: Buffaloon ($2 in chips) 
Seat 5: pokerIman27 ($2.92 in chips) 
Seat 6: lucascarneseca ($0.54 in chips) 
Seat 7: guiaoms ($2.63 in chips) 
Seat 8: Dorex2007 ($4.04 in chips) 
Seat 9: Nico55KQ ($2.01 in chips) 
Cannyjim: posts small blind $0.01
rambooschi: posts big blind $0.02
*** HOLE CARDS ***
Dealt to Dorex2007 [3d 2d]
mkEmperor: folds 
Buffaloon: folds 
pokerIman27: raises $0.04 to $0.06
lucascarneseca: calls $0.06
guiaoms: raises $0.04 to $0.10
Dorex2007: folds 
Nico55KQ: folds 
Cannyjim: folds 
rambooschi: folds 
pokerIman27: calls $0.04
lucascarneseca: calls $0.04
*** FLOP *** [8c 5h 8h]
pokerIman27: checks 
lucascarneseca: bets $0.06
guiaoms: calls $0.06
pokerIman27: calls $0.06
*** TURN *** [8c 5h 8h] [6c]
pokerIman27: checks 
lucascarneseca: bets $0.10
guiaoms: raises $0.10 to $0.20
pokerIman27: calls $0.20
lucascarneseca: calls $0.10
*** RIVER *** [8c 5h 8h 6c] [Jc]
pokerIman27: bets $1.07
lucascarneseca: folds 
guiaoms: folds 
Uncalled bet ($1.07) returned to pokerIman27
pokerIman27 collected $1.07 from pot
*** SUMMARY ***
Total pot $1.11 | Rake $0.04 
Board [8c 5h 8h 6c Jc]
Seat 1: Cannyjim (small blind) folded before Flop
Seat 2: rambooschi (big blind) folded before Flop
Seat 3: mkEmperor folded before Flop (didn't bet)
Seat 4: Buffaloon folded before Flop (didn't bet)
Seat 5: pokerIman27 collected ($1.07)
Seat 6: lucascarneseca folded on the River
Seat 7: guiaoms folded on the River
Seat 8: Dorex2007 folded before Flop (didn't bet)
Seat 9: Nico55KQ (button) folded before Flop (didn't bet)



PokerStars Hand #237375011503:  Hold'em No Limit ($0.01/$0.02 USD) - 2022/07/15 9:59:37 PT [2022/07/15 12:59:37 ET]
Table 'Appella II' 9-max Seat #1 is the button
Seat 1: Cannyjim ($1.30 in chips) 
Seat 2: rambooschi ($3.76 in chips) 
Seat 3: mkEmperor ($1.94 in chips) 
Seat 4: Buffaloon ($2 in chips) 
Seat 5: pokerIman27 ($3.63 in chips) 
Seat 6: lucascarneseca ($0.18 in chips) 
Seat 7: guiaoms ($2.27 in chips) 
Seat 8: Dorex2007 ($4.04 in chips) 
Seat 9: Nico55KQ ($2.01 in chips) 
rambooschi: posts small blind $0.01
mkEmperor: posts big blind $0.02
*** HOLE CARDS ***
Dealt to Dorex2007 [3h Ad]
Buffaloon: folds 
pokerIman27: raises $0.04 to $0.06
lucascarneseca: folds 
guiaoms: folds 
Dorex2007: folds 
Nico55KQ: folds 
Cannyjim: folds 
rambooschi: folds 
mkEmperor: folds 
Uncalled bet ($0.04) returned to pokerIman27
pokerIman27 collected $0.05 from pot
*** SUMMARY ***
Total pot $0.05 | Rake $0 
Seat 1: Cannyjim (button) folded before Flop (didn't bet)
Seat 2: rambooschi (small blind) folded before Flop
Seat 3: mkEmperor (big blind) folded before Flop
Seat 4: Buffaloon folded before Flop (didn't bet)
Seat 5: pokerIman27 collected ($0.05)
Seat 6: lucascarneseca folded before Flop (didn't bet)
Seat 7: guiaoms folded before Flop (didn't bet)
Seat 8: Dorex2007 folded before Flop (didn't bet)
Seat 9: Nico55KQ folded before Flop (didn't bet)



PokerStars Hand #237375017077:  Hold'em No Limit ($0.01/$0.02 USD) - 2022/07/15 10:00:01 PT [2022/07/15 13:00:01 ET]
Table 'Appella II' 9-max Seat #2 is the button
Seat 2: rambooschi ($3.75 in chips) 
Seat 3: mkEmperor ($1.92 in chips) 
Seat 5: pokerIman27 ($3.66 in chips) 
Seat 6: lucascarneseca ($0.18 in chips) 
Seat 7: guiaoms ($2.27 in chips) 
Seat 8: Dorex2007 ($4.04 in chips) 
Seat 9: Nico55KQ ($2.01 in chips) 
mkEmperor: posts small blind $0.01
Buffaloon: is sitting out 
pokerIman27: posts big blind $0.02
*** HOLE CARDS ***
Dealt to Dorex2007 [6d 3c]
Buffaloon leaves the table
lucascarneseca: calls $0.02
guiaoms: folds 
Dorex2007: folds 
prizrak_162 joins the table at seat #1 
Nico55KQ: calls $0.02
rambooschi: folds 
mkEmperor: calls $0.01
pokerIman27: checks 
*** FLOP *** [Ah 9h 3s]
roma19765 joins the table at seat #4 
mkEmperor: bets $0.02
pokerIman27: folds 
lucascarneseca: calls $0.02
Nico55KQ: folds 
*** TURN *** [Ah 9h 3s] [7s]
mkEmperor: bets $0.02
lucascarneseca: calls $0.02
*** RIVER *** [Ah 9h 3s 7s] [8d]
mkEmperor: checks 
lucascarneseca: checks 
*** SHOW DOWN ***
mkEmperor: shows [Ac 2d] (a pair of Aces)
lucascarneseca: shows [4s Ad] (a pair of Aces)
mkEmperor collected $0.08 from pot
lucascarneseca collected $0.07 from pot
*** SUMMARY ***
Total pot $0.16 | Rake $0.01 
Board [Ah 9h 3s 7s 8d]
Seat 2: rambooschi (button) folded before Flop (didn't bet)
Seat 3: mkEmperor (small blind) showed [Ac 2d] and won ($0.08) with a pair of Aces
Seat 5: pokerIman27 (big blind) folded on the Flop
Seat 6: lucascarneseca showed [4s Ad] and won ($0.07) with a pair of Aces
Seat 7: guiaoms folded before Flop (didn't bet)
Seat 8: Dorex2007 folded before Flop (didn't bet)
Seat 9: Nico55KQ folded on the Flop



PokerStars Hand #237375027236:  Hold'em No Limit ($0.01/$0.02 USD) - 2022/07/15 10:00:43 PT [2022/07/15 13:00:43 ET]
Table 'Appella II' 9-max Seat #3 is the button
Seat 2: rambooschi ($3.75 in chips) 
Seat 3: mkEmperor ($1.94 in chips) 
Seat 5: pokerIman27 ($3.64 in chips) 
Seat 7: guiaoms ($2.27 in chips) 
Seat 8: Dorex2007 ($4.04 in chips) 
Seat 9: Nico55KQ ($1.99 in chips) 
pokerIman27: posts small blind $0.01
guiaoms: posts big blind $0.02
prizrak_162: sits out 
*** HOLE CARDS ***
Dealt to Dorex2007 [Td Js]
Dorex2007: folds 
Nico55KQ: calls $0.02
rambooschi: folds 
mkEmperor: folds 
pokerIman27: calls $0.01
guiaoms: checks 
*** FLOP *** [Kc 9d Kd]
lucascarneseca leaves the table
pokerIman27: checks 
guiaoms: checks 
Nico55KQ: bets $0.04
pokerIman27: folds 
guiaoms: folds 
Uncalled bet ($0.04) returned to Nico55KQ
Nico55KQ collected $0.06 from pot
*** SUMMARY ***
Total pot $0.06 | Rake $0 
Board [Kc 9d Kd]
Seat 2: rambooschi folded before Flop (didn't bet)
Seat 3: mkEmperor (button) folded before Flop (didn't bet)
Seat 5: pokerIman27 (small blind) folded on the Flop
Seat 7: guiaoms (big blind) folded on the Flop
Seat 8: Dorex2007 folded before Flop (didn't bet)
Seat 9: Nico55KQ collected ($0.06)



PokerStars Hand #237375035782:  Hold'em No Limit ($0.01/$0.02 USD) - 2022/07/15 10:01:15 PT [2022/07/15 13:01:15 ET]
Table 'Appella II' 9-max Seat #5 is the button
Seat 2: rambooschi ($3.75 in chips) 
Seat 3: mkEmperor ($1.94 in chips) 
Seat 4: roma19765 ($1.60 in chips) 
Seat 5: pokerIman27 ($3.62 in chips) 
Seat 7: guiaoms ($2.25 in chips) 
Seat 8: Dorex2007 ($4.04 in chips) 
Seat 9: Nico55KQ ($2.03 in chips) 
guiaoms: posts small blind $0.01
Dorex2007: posts big blind $0.02
prizrak_162: sits out 
roma19765: posts big blind $0.02
*** HOLE CARDS ***
Dealt to Dorex2007 [9s 5d]
Nico55KQ: folds 
rambooschi: folds 
mkEmperor: folds 
roma19765: checks 
pokerIman27: folds 
guiaoms: folds 
Dorex2007: checks 
*** FLOP *** [2c 8s Qs]
Dorex2007: checks 
roma19765: checks 
*** TURN *** [2c 8s Qs] [Jd]
Dorex2007: checks 
roma19765: checks 
*** RIVER *** [2c 8s Qs Jd] [Qd]
Dorex2007: checks 
roma19765: checks 
*** SHOW DOWN ***
Dorex2007: shows [9s 5d] (a pair of Queens)
roma19765: shows [Kh 4c] (a pair of Queens - King kicker)
roma19765 collected $0.05 from pot
*** SUMMARY ***
Total pot $0.05 | Rake $0 
Board [2c 8s Qs Jd Qd]
Seat 2: rambooschi folded before Flop (didn't bet)
Seat 3: mkEmperor folded before Flop (didn't bet)
Seat 4: roma19765 showed [Kh 4c] and won ($0.05) with a pair of Queens
Seat 5: pokerIman27 (button) folded before Flop (didn't bet)
Seat 7: guiaoms (small blind) folded before Flop
Seat 8: Dorex2007 (big blind) showed [9s 5d] and lost with a pair of Queens
Seat 9: Nico55KQ folded before Flop (didn't bet)



PokerStars Hand #237375045010:  Hold'em No Limit ($0.01/$0.02 USD) - 2022/07/15 10:01:49 PT [2022/07/15 13:01:49 ET]
Table 'Appella II' 9-max Seat #7 is the button
Seat 2: rambooschi ($3.75 in chips) 
Seat 3: mkEmperor ($1.94 in chips) 
Seat 4: roma19765 ($1.63 in chips) 
Seat 5: pokerIman27 ($3.62 in chips) 
Seat 7: guiaoms ($2.24 in chips) 
Seat 8: Dorex2007 ($4.02 in chips) 
Seat 9: Nico55KQ ($2.03 in chips) 
Dorex2007: posts small blind $0.01
Nico55KQ: posts big blind $0.02
prizrak_162: sits out 
*** HOLE CARDS ***
Dealt to Dorex2007 [2s Tc]
rambooschi has timed out
rambooschi: folds 
mkEmperor: folds 
roma19765: folds 
pokerIman27: folds 
guiaoms: calls $0.02
Dorex2007: folds 
Nico55KQ: raises $0.06 to $0.08
guiaoms: folds 
Uncalled bet ($0.06) returned to Nico55KQ
Nico55KQ collected $0.05 from pot
*** SUMMARY ***
Total pot $0.05 | Rake $0 
Seat 2: rambooschi folded before Flop (didn't bet)
Seat 3: mkEmperor folded before Flop (didn't bet)
Seat 4: roma19765 folded before Flop (didn't bet)
Seat 5: pokerIman27 folded before Flop (didn't bet)
Seat 7: guiaoms (button) folded before Flop
Seat 8: Dorex2007 (small blind) folded before Flop
Seat 9: Nico55KQ (big blind) collected ($0.05)



PokerStars Hand #237375053232:  Hold'em No Limit ($0.01/$0.02 USD) - 2022/07/15 10:02:18 PT [2022/07/15 13:02:18 ET]
Table 'Appella II' 9-max Seat #8 is the button
Seat 1: prizrak_162 ($0.80 in chips) 
Seat 3: mkEmperor ($1.94 in chips) 
Seat 4: roma19765 ($1.63 in chips) 
Seat 5: pokerIman27 ($3.62 in chips) 
Seat 7: guiaoms ($2.22 in chips) 
Seat 8: Dorex2007 ($4.01 in chips) 
Seat 9: Nico55KQ ($2.06 in chips) 
Nico55KQ: posts small blind $0.01
prizrak_162: posts big blind $0.02
*** HOLE CARDS ***
Dealt to Dorex2007 [2s Qc]
mkEmperor: folds 
roma19765: folds 
pokerIman27: folds 
guiaoms: folds 
Dorex2007: folds 
Nico55KQ: raises $0.04 to $0.06
prizrak_162: folds 
Uncalled bet ($0.04) returned to Nico55KQ
Nico55KQ collected $0.04 from pot
*** SUMMARY ***
Total pot $0.04 | Rake $0 
Seat 1: prizrak_162 (big blind) folded before Flop
Seat 3: mkEmperor folded before Flop (didn't bet)
Seat 4: roma19765 folded before Flop (didn't bet)
Seat 5: pokerIman27 folded before Flop (didn't bet)
Seat 7: guiaoms folded before Flop (didn't bet)
Seat 8: Dorex2007 (button) folded before Flop (didn't bet)
Seat 9: Nico55KQ (small blind) collected ($0.04)



PokerStars Hand #237375058006:  Hold'em No Limit ($0.01/$0.02 USD) - 2022/07/15 10:02:35 PT [2022/07/15 13:02:35 ET]
Table 'Appella II' 9-max Seat #9 is the button
Seat 1: prizrak_162 ($0.78 in chips) 
Seat 3: mkEmperor ($1.94 in chips) 
Seat 4: roma19765 ($1.63 in chips) 
Seat 5: pokerIman27 ($3.62 in chips) 
Seat 7: guiaoms ($2.22 in chips) 
Seat 8: Dorex2007 ($4.01 in chips) 
Seat 9: Nico55KQ ($2.08 in chips) 
prizrak_162: posts small blind $0.01
mkEmperor: posts big blind $0.02
*** HOLE CARDS ***
Dealt to Dorex2007 [Qs As]
roma19765: folds 
pokerIman27: folds 
guiaoms: folds 
andybruseth99 joins the table at seat #6 
Dorex2007: raises $0.04 to $0.06
Nico55KQ: calls $0.06
prizrak_162: folds 
mkEmperor: folds 
*** FLOP *** [3s Qd 2c]
Dorex2007: bets $0.14
Nico55KQ: folds 
Uncalled bet ($0.14) returned to Dorex2007
Dorex2007 collected $0.14 from pot
*** SUMMARY ***
Total pot $0.15 | Rake $0.01 
Board [3s Qd 2c]
Seat 1: prizrak_162 (small blind) folded before Flop
Seat 3: mkEmperor (big blind) folded before Flop
Seat 4: roma19765 folded before Flop (didn't bet)
Seat 5: pokerIman27 folded before Flop (didn't bet)
Seat 7: guiaoms folded before Flop (didn't bet)
Seat 8: Dorex2007 collected ($0.14)
Seat 9: Nico55KQ (button) folded on the Flop



PokerStars Hand #237375066100:  Hold'em No Limit ($0.01/$0.02 USD) - 2022/07/15 10:03:02 PT [2022/07/15 13:03:02 ET]
Table 'Appella II' 9-max Seat #1 is the button
Seat 1: prizrak_162 ($0.77 in chips) 
Seat 3: mkEmperor ($1.92 in chips) 
Seat 4: roma19765 ($1.63 in chips) 
Seat 5: pokerIman27 ($3.62 in chips) 
Seat 6: andybruseth99 ($1.60 in chips) 
Seat 7: guiaoms ($2.22 in chips) 
Seat 8: Dorex2007 ($4.09 in chips) 
Seat 9: Nico55KQ ($2.02 in chips) 
mkEmperor: posts small blind $0.01
roma19765: posts big blind $0.02
andybruseth99: posts big blind $0.02
*** HOLE CARDS ***
Dealt to Dorex2007 [Qd 6s]
pokerIman27: folds 
andybruseth99: checks 
guiaoms: folds 
Dorex2007: folds 
pokerIman27 leaves the table
Nico55KQ: raises $0.04 to $0.06
prizrak_162: folds 
mkEmperor: folds 
roma19765: calls $0.04
andybruseth99: calls $0.04
*** FLOP *** [6d Ac Qc]
roma19765: checks 
andybruseth99: checks 
Nico55KQ: bets $0.08
roma19765: folds 
andybruseth99: folds 
Uncalled bet ($0.08) returned to Nico55KQ
Nico55KQ collected $0.18 from pot
*** SUMMARY ***
Total pot $0.19 | Rake $0.01 
Board [6d Ac Qc]
Seat 1: prizrak_162 (button) folded before Flop (didn't bet)
Seat 3: mkEmperor (small blind) folded before Flop
Seat 4: roma19765 (big blind) folded on the Flop
Seat 5: pokerIman27 folded before Flop (didn't bet)
Seat 6: andybruseth99 folded on the Flop
Seat 7: guiaoms folded before Flop (didn't bet)
Seat 8: Dorex2007 folded before Flop (didn't bet)
Seat 9: Nico55KQ collected ($0.18)



PokerStars Hand #237375075777:  Hold'em No Limit ($0.01/$0.02 USD) - 2022/07/15 10:03:34 PT [2022/07/15 13:03:34 ET]
Table 'Appella II' 9-max Seat #3 is the button
Seat 1: prizrak_162 ($0.77 in chips) 
Seat 3: mkEmperor ($1.91 in chips) 
Seat 4: roma19765 ($1.57 in chips) 
Seat 6: andybruseth99 ($1.54 in chips) 
Seat 7: guiaoms ($2.22 in chips) 
Seat 8: Dorex2007 ($4.09 in chips) 
Seat 9: Nico55KQ ($2.14 in chips) 
roma19765: posts small blind $0.01
andybruseth99: posts big blind $0.02
rambooschi: sits out 
*** HOLE CARDS ***
Dealt to Dorex2007 [5h Qc]
guiaoms: folds 
Dorex2007: folds 
Nico55KQ: raises $0.04 to $0.06
prizrak_162: raises $0.06 to $0.12
mkEmperor: calls $0.12
roma19765: folds 
andybruseth99: calls $0.10
Nico55KQ: calls $0.06
*** FLOP *** [6c Jc Ts]
andybruseth99: checks 
Nico55KQ: bets $0.08
rambooschi leaves the table
prizrak_162: raises $0.14 to $0.22
mkEmperor: folds 
andybruseth99: calls $0.22
Nico55KQ: calls $0.14
*** TURN *** [6c Jc Ts] [4s]
andybruseth99: checks 
Nico55KQ: checks 
prizrak_162: bets $0.43 and is all-in
andybruseth99: folds 
Nico55KQ: calls $0.43
*** RIVER *** [6c Jc Ts 4s] [6h]
*** SHOW DOWN ***
Nico55KQ: shows [Kd Qd] (a pair of Sixes)
prizrak_162: shows [Ac Ah] (two pair, Aces and Sixes)
prizrak_162 collected $1.94 from pot
*** SUMMARY ***
Total pot $2.01 | Rake $0.07 
Board [6c Jc Ts 4s 6h]
Seat 1: prizrak_162 showed [Ac Ah] and won ($1.94) with two pair, Aces and Sixes
Seat 3: mkEmperor (button) folded on the Flop
Seat 4: roma19765 (small blind) folded before Flop
Seat 6: andybruseth99 (big blind) folded on the Turn
Seat 7: guiaoms folded before Flop (didn't bet)
Seat 8: Dorex2007 folded before Flop (didn't bet)
Seat 9: Nico55KQ showed [Kd Qd] and lost with a pair of Sixes



PokerStars Hand #237375098431:  Hold'em No Limit ($0.01/$0.02 USD) - 2022/07/15 10:04:52 PT [2022/07/15 13:04:52 ET]
Table 'Appella II' 9-max Seat #4 is the button
Seat 1: prizrak_162 ($1.94 in chips) 
Seat 3: mkEmperor ($2 in chips) 
Seat 4: roma19765 ($1.56 in chips) 
Seat 6: andybruseth99 ($1.20 in chips) 
Seat 7: guiaoms ($2.22 in chips) 
Seat 8: Dorex2007 ($4.09 in chips) 
Seat 9: Nico55KQ ($1.37 in chips) 
andybruseth99: posts small blind $0.01
guiaoms: posts big blind $0.02
*** HOLE CARDS ***
Dealt to Dorex2007 [7c 3c]
Dorex2007: folds 
Nico55KQ: calls $0.02
prizrak_162: folds 
mkEmperor: folds 
roma19765: raises $0.06 to $0.08
andybruseth99: calls $0.07
guiaoms: folds 
Nico55KQ: calls $0.06
*** FLOP *** [2h 2s Ac]
andybruseth99: checks 
Nico55KQ: checks 
roma19765: bets $0.12
andybruseth99: calls $0.12
Nico55KQ: folds 
*** TURN *** [2h 2s Ac] [8h]
andybruseth99: checks 
roma19765: checks 
*** RIVER *** [2h 2s Ac 8h] [4c]
andybruseth99: checks 
roma19765: checks 
*** SHOW DOWN ***
andybruseth99: shows [8d 3d] (two pair, Eights and Deuces)
roma19765: shows [Qs Qc] (two pair, Queens and Deuces)
roma19765 collected $0.48 from pot
*** SUMMARY ***
Total pot $0.50 | Rake $0.02 
Board [2h 2s Ac 8h 4c]
Seat 1: prizrak_162 folded before Flop (didn't bet)
Seat 3: mkEmperor folded before Flop (didn't bet)
Seat 4: roma19765 (button) showed [Qs Qc] and won ($0.48) with two pair, Queens and Deuces
Seat 6: andybruseth99 (small blind) showed [8d 3d] and lost with two pair, Eights and Deuces
Seat 7: guiaoms (big blind) folded before Flop
Seat 8: Dorex2007 folded before Flop (didn't bet)
Seat 9: Nico55KQ folded on the Flop



PokerStars Hand #237375111013:  Hold'em No Limit ($0.01/$0.02 USD) - 2022/07/15 10:05:34 PT [2022/07/15 13:05:34 ET]
Table 'Appella II' 9-max Seat #6 is the button
Seat 1: prizrak_162 ($1.94 in chips) 
Seat 3: mkEmperor ($2 in chips) 
Seat 4: roma19765 ($1.84 in chips) 
Seat 6: andybruseth99 ($1 in chips) 
Seat 7: guiaoms ($2.20 in chips) 
Seat 8: Dorex2007 ($4.09 in chips) 
Seat 9: Nico55KQ ($1.29 in chips) 
guiaoms: posts small blind $0.01
Dorex2007: posts big blind $0.02
*** HOLE CARDS ***
Dealt to Dorex2007 [Ah Ks]
Nico55KQ: calls $0.02
adkoslitko joins the table at seat #2 
prizrak_162: folds 
mkEmperor: folds 
roma19765: folds 
andybruseth99: calls $0.02
guiaoms: folds 
roma19765 leaves the table
Dorex2007: raises $0.10 to $0.12
Nico55KQ: calls $0.10
andybruseth99: calls $0.10
*** FLOP *** [6s 9c 9d]
Dorex2007: bets $0.18
Nico55KQ: calls $0.18
andybruseth99: calls $0.18
*** TURN *** [6s 9c 9d] [Kc]
Dorex2007: bets $0.88
Nico55KQ: raises $0.11 to $0.99 and is all-in
andybruseth99: folds 
Dorex2007: calls $0.11
*** RIVER *** [6s 9c 9d Kc] [7c]
*** SHOW DOWN ***
Dorex2007: shows [Ah Ks] (two pair, Kings and Nines)
Nico55KQ: shows [8h 9s] (three of a kind, Nines)
Nico55KQ collected $2.77 from pot
Dorex2007 cashed out the hand for $0.13
*** SUMMARY ***
Total pot $2.89 | Rake $0.12 
Board [6s 9c 9d Kc 7c]
Seat 1: prizrak_162 folded before Flop (didn't bet)
Seat 3: mkEmperor folded before Flop (didn't bet)
Seat 4: roma19765 folded before Flop (didn't bet)
Seat 6: andybruseth99 (button) folded on the Turn
Seat 7: guiaoms (small blind) folded before Flop
Seat 8: Dorex2007 (big blind) showed [Ah Ks] and lost with two pair, Kings and Nines (cashed out).
Seat 9: Nico55KQ showed [8h 9s] and won ($2.77) with three of a kind, Nines



PokerStars Hand #237375129030:  Hold'em No Limit ($0.01/$0.02 USD) - 2022/07/15 10:06:35 PT [2022/07/15 13:06:35 ET]
Table 'Appella II' 9-max Seat #7 is the button
Seat 1: prizrak_162 ($1.94 in chips) 
Seat 3: mkEmperor ($2 in chips) 
Seat 6: andybruseth99 ($0.70 in chips) 
Seat 7: guiaoms ($2.19 in chips) 
Seat 8: Dorex2007 ($2.93 in chips) 
Seat 9: Nico55KQ ($2.77 in chips) 
Dorex2007: posts small blind $0.01
Nico55KQ: posts big blind $0.02
adkoslitko: sits out 
*** HOLE CARDS ***
Dealt to Dorex2007 [Kd 5c]
prizrak_162: folds 
mkEmperor: folds 
andybruseth99: calls $0.02
guiaoms: folds 
Dorex2007: folds 
Nico55KQ: raises $0.04 to $0.06
ll_n4no_ll joins the table at seat #4 
andybruseth99: calls $0.04
*** FLOP *** [6s Ah Qs]
Nico55KQ: bets $0.06
andybruseth99: calls $0.06
*** TURN *** [6s Ah Qs] [Kh]
webmarrr joins the table at seat #5 
Nico55KQ: bets $0.08
webmarrr leaves the table
andybruseth99: calls $0.08
*** RIVER *** [6s Ah Qs Kh] [8h]
Nico55KQ: bets $0.40
Murari_Mauro joins the table at seat #5 
andybruseth99: folds 
Uncalled bet ($0.40) returned to Nico55KQ
Nico55KQ collected $0.40 from pot
*** SUMMARY ***
Total pot $0.41 | Rake $0.01 
Board [6s Ah Qs Kh 8h]
Seat 1: prizrak_162 folded before Flop (didn't bet)
Seat 3: mkEmperor folded before Flop (didn't bet)
Seat 6: andybruseth99 folded on the River
Seat 7: guiaoms (button) folded before Flop (didn't bet)
Seat 8: Dorex2007 (small blind) folded before Flop
Seat 9: Nico55KQ (big blind) collected ($0.40)



PokerStars Hand #237375141540:  Hold'em No Limit ($0.01/$0.02 USD) - 2022/07/15 10:07:17 PT [2022/07/15 13:07:17 ET]
Table 'Appella II' 9-max Seat #8 is the button
Seat 1: prizrak_162 ($1.94 in chips) 
Seat 3: mkEmperor ($2 in chips) 
Seat 6: andybruseth99 ($0.50 in chips) 
Seat 7: guiaoms ($2.19 in chips) 
Seat 8: Dorex2007 ($2.92 in chips) 
Seat 9: Nico55KQ ($2.97 in chips) 
Nico55KQ: posts small blind $0.01
prizrak_162: posts big blind $0.02
adkoslitko: sits out 
ll_n4no_ll: sits out 
Murari_Mauro: sits out 
*** HOLE CARDS ***
Dealt to Dorex2007 [Qh 4s]
mkEmperor: folds 
andybruseth99: calls $0.02
guiaoms: folds 
Dorex2007: folds 
Nico55KQ: raises $0.06 to $0.08
prizrak_162: folds 
andybruseth99: calls $0.06
*** FLOP *** [Ac Th Qd]
Nico55KQ: bets $0.06
andybruseth99: calls $0.06
*** TURN *** [Ac Th Qd] [Jd]
Nico55KQ: checks 
andybruseth99: checks 
*** RIVER *** [Ac Th Qd Jd] [8s]
Nico55KQ: bets $0.04
andybruseth99: raises $0.32 to $0.36 and is all-in
Nico55KQ: calls $0.32
*** SHOW DOWN ***
andybruseth99: shows [3s Kd] (a straight, Ten to Ace)
Nico55KQ: shows [Jc Jh] (three of a kind, Jacks)
andybruseth99 collected $0.98 from pot
*** SUMMARY ***
Total pot $1.02 | Rake $0.04 
Board [Ac Th Qd Jd 8s]
Seat 1: prizrak_162 (big blind) folded before Flop
Seat 3: mkEmperor folded before Flop (didn't bet)
Seat 6: andybruseth99 showed [3s Kd] and won ($0.98) with a straight, Ten to Ace
Seat 7: guiaoms folded before Flop (didn't bet)
Seat 8: Dorex2007 (button) folded before Flop (didn't bet)
Seat 9: Nico55KQ (small blind) showed [Jc Jh] and lost with three of a kind, Jacks



PokerStars Hand #237375153819:  Hold'em No Limit ($0.01/$0.02 USD) - 2022/07/15 10:07:59 PT [2022/07/15 13:07:59 ET]
Table 'Appella II' 9-max Seat #9 is the button
Seat 1: prizrak_162 ($1.92 in chips) 
Seat 2: adkoslitko ($1.60 in chips) 
Seat 3: mkEmperor ($2 in chips) 
Seat 6: andybruseth99 ($0.98 in chips) 
Seat 7: guiaoms ($2.19 in chips) 
Seat 8: Dorex2007 ($2.92 in chips) 
Seat 9: Nico55KQ ($2.47 in chips) 
prizrak_162: posts small blind $0.01
adkoslitko: posts big blind $0.02
ll_n4no_ll: sits out 
Murari_Mauro: sits out 
*** HOLE CARDS ***
Dealt to Dorex2007 [2d Ac]
mkEmperor: folds 
andybruseth99: calls $0.02
guiaoms: calls $0.02
Dorex2007: folds 
Nico55KQ: calls $0.02
prizrak_162: folds 
adkoslitko: raises $0.05 to $0.07
andybruseth99: calls $0.05
guiaoms: calls $0.05
Nico55KQ: calls $0.05
*** FLOP *** [4s 6d Qc]
adkoslitko: checks 
andybruseth99: bets $0.02
guiaoms: calls $0.02
Nico55KQ: raises $0.08 to $0.10
adkoslitko: folds 
andybruseth99: calls $0.08
guiaoms: calls $0.08
*** TURN *** [4s 6d Qc] [Jc]
andybruseth99: checks 
guiaoms: checks 
Nico55KQ: bets $0.14
andybruseth99: folds 
guiaoms: raises $0.14 to $0.28
Nico55KQ: calls $0.14
*** RIVER *** [4s 6d Qc Jc] [9d]
guiaoms: bets $0.20
Nico55KQ: calls $0.20
*** SHOW DOWN ***
guiaoms: shows [6s 6c] (three of a kind, Sixes)
Nico55KQ: mucks hand 
guiaoms collected $1.50 from pot
*** SUMMARY ***
Total pot $1.55 | Rake $0.05 
Board [4s 6d Qc Jc 9d]
Seat 1: prizrak_162 (small blind) folded before Flop
Seat 2: adkoslitko (big blind) folded on the Flop
Seat 3: mkEmperor folded before Flop (didn't bet)
Seat 6: andybruseth99 folded on the Turn
Seat 7: guiaoms showed [6s 6c] and won ($1.50) with three of a kind, Sixes
Seat 8: Dorex2007 folded before Flop (didn't bet)
Seat 9: Nico55KQ (button) mucked [Qd 5d]



PokerStars Hand #237375176316:  Hold'em No Limit ($0.01/$0.02 USD) - 2022/07/15 10:09:16 PT [2022/07/15 13:09:16 ET]
Table 'Appella II' 9-max Seat #1 is the button
Seat 1: prizrak_162 ($1.91 in chips) 
Seat 2: adkoslitko ($1.53 in chips) 
Seat 3: mkEmperor ($2 in chips) 
Seat 6: andybruseth99 ($0.81 in chips) 
Seat 7: guiaoms ($3.04 in chips) 
Seat 8: Dorex2007 ($2.92 in chips) 
Seat 9: Nico55KQ ($1.82 in chips) 
adkoslitko: posts small blind $0.01
mkEmperor: posts big blind $0.02
ll_n4no_ll: sits out 
Murari_Mauro: sits out 
*** HOLE CARDS ***
Dealt to Dorex2007 [6c Ts]
andybruseth99: calls $0.02
guiaoms: folds 
Dorex2007: folds 
Nico55KQ: folds 
prizrak_162: folds 
adkoslitko: raises $0.02 to $0.04
mkEmperor: folds 
andybruseth99: calls $0.02
*** FLOP *** [Qd Ac 8c]
adkoslitko: bets $0.02
andybruseth99: calls $0.02
*** TURN *** [Qd Ac 8c] [5s]
adkoslitko: bets $0.02
andybruseth99: calls $0.02
*** RIVER *** [Qd Ac 8c 5s] [Kc]
adkoslitko: bets $0.02
andybruseth99: calls $0.02
*** SHOW DOWN ***
adkoslitko: shows [4c Ad] (a pair of Aces)
andybruseth99: mucks hand 
adkoslitko collected $0.21 from pot
*** SUMMARY ***
Total pot $0.22 | Rake $0.01 
Board [Qd Ac 8c 5s Kc]
Seat 1: prizrak_162 (button) folded before Flop (didn't bet)
Seat 2: adkoslitko (small blind) showed [4c Ad] and won ($0.21) with a pair of Aces
Seat 3: mkEmperor (big blind) folded before Flop
Seat 6: andybruseth99 mucked [2s 9s]
Seat 7: guiaoms folded before Flop (didn't bet)
Seat 8: Dorex2007 folded before Flop (didn't bet)
Seat 9: Nico55KQ folded before Flop (didn't bet)



PokerStars Hand #237375184691:  Hold'em No Limit ($0.01/$0.02 USD) - 2022/07/15 10:09:44 PT [2022/07/15 13:09:44 ET]
Table 'Appella II' 9-max Seat #2 is the button
Seat 1: prizrak_162 ($1.91 in chips) 
Seat 2: adkoslitko ($1.64 in chips) 
Seat 3: mkEmperor ($1.98 in chips) 
Seat 4: ll_n4no_ll ($2 in chips) 
Seat 6: andybruseth99 ($0.71 in chips) 
Seat 7: guiaoms ($3.04 in chips) 
Seat 8: Dorex2007 ($2.92 in chips) 
Seat 9: Nico55KQ ($1.82 in chips) 
mkEmperor: posts small blind $0.01
ll_n4no_ll: posts big blind $0.02
Murari_Mauro: sits out 
*** HOLE CARDS ***
Dealt to Dorex2007 [4s 9d]
andybruseth99: calls $0.02
guiaoms: folds 
Dorex2007: folds 
Nico55KQ: raises $0.04 to $0.06
prizrak_162: folds 
adkoslitko: folds 
mkEmperor: folds 
ll_n4no_ll: folds 
andybruseth99: calls $0.04
*** FLOP *** [5c Jh 4d]
andybruseth99: checks 
Nico55KQ: bets $0.07
andybruseth99: folds 
Uncalled bet ($0.07) returned to Nico55KQ
Nico55KQ collected $0.14 from pot
*** SUMMARY ***
Total pot $0.15 | Rake $0.01 
Board [5c Jh 4d]
Seat 1: prizrak_162 folded before Flop (didn't bet)
Seat 2: adkoslitko (button) folded before Flop (didn't bet)
Seat 3: mkEmperor (small blind) folded before Flop
Seat 4: ll_n4no_ll (big blind) folded before Flop
Seat 6: andybruseth99 folded on the Flop
Seat 7: guiaoms folded before Flop (didn't bet)
Seat 8: Dorex2007 folded before Flop (didn't bet)
Seat 9: Nico55KQ collected ($0.14)



PokerStars Hand #237375197941:  Hold'em No Limit ($0.01/$0.02 USD) - 2022/07/15 10:10:29 PT [2022/07/15 13:10:29 ET]
Table 'Appella II' 9-max Seat #3 is the button
Seat 1: prizrak_162 ($1.91 in chips) 
Seat 2: adkoslitko ($1.64 in chips) 
Seat 3: mkEmperor ($1.97 in chips) 
Seat 4: ll_n4no_ll ($1.98 in chips) 
Seat 5: Murari_Mauro ($2 in chips) 
Seat 6: andybruseth99 ($0.65 in chips) 
Seat 7: guiaoms ($3.04 in chips) 
Seat 8: Dorex2007 ($2.92 in chips) 
Seat 9: Nico55KQ ($1.90 in chips) 
ll_n4no_ll: posts small blind $0.01
Murari_Mauro: posts big blind $0.02
*** HOLE CARDS ***
Dealt to Dorex2007 [Tc Kc]
andybruseth99: raises $0.06 to $0.08
guiaoms: folds 
Dorex2007: calls $0.08
Nico55KQ: folds 
prizrak_162: folds 
adkoslitko: folds 
mkEmperor: folds 
ll_n4no_ll: folds 
Murari_Mauro: folds 
*** FLOP *** [4d 4h 5c]
andybruseth99: bets $0.06
Dorex2007: folds 
Uncalled bet ($0.06) returned to andybruseth99
andybruseth99 collected $0.18 from pot
*** SUMMARY ***
Total pot $0.19 | Rake $0.01 
Board [4d 4h 5c]
Seat 1: prizrak_162 folded before Flop (didn't bet)
Seat 2: adkoslitko folded before Flop (didn't bet)
Seat 3: mkEmperor (button) folded before Flop (didn't bet)
Seat 4: ll_n4no_ll (small blind) folded before Flop
Seat 5: Murari_Mauro (big blind) folded before Flop
Seat 6: andybruseth99 collected ($0.18)
Seat 7: guiaoms folded before Flop (didn't bet)
Seat 8: Dorex2007 folded on the Flop
Seat 9: Nico55KQ folded before Flop (didn't bet)



PokerStars Hand #237375207220:  Hold'em No Limit ($0.01/$0.02 USD) - 2022/07/15 10:11:00 PT [2022/07/15 13:11:00 ET]
Table 'Appella II' 9-max Seat #4 is the button
Seat 1: prizrak_162 ($1.91 in chips) 
Seat 2: adkoslitko ($1.64 in chips) 
Seat 3: mkEmperor ($1.97 in chips) 
Seat 4: ll_n4no_ll ($1.97 in chips) 
Seat 5: Murari_Mauro ($2 in chips) 
Seat 6: andybruseth99 ($0.75 in chips) 
Seat 7: guiaoms ($3.04 in chips) 
Seat 8: Dorex2007 ($2.84 in chips) 
Seat 9: Nico55KQ ($1.90 in chips) 
Murari_Mauro: posts small blind $0.01
andybruseth99: posts big blind $0.02
*** HOLE CARDS ***
Dealt to Dorex2007 [Jd 6d]
guiaoms: folds 
Dorex2007: folds 
Nico55KQ: folds 
prizrak_162: calls $0.02
adkoslitko: raises $0.03 to $0.05
mkEmperor: folds 
ll_n4no_ll: folds 
Murari_Mauro: folds 
andybruseth99: raises $0.03 to $0.08
prizrak_162: folds 
adkoslitko: calls $0.03
*** FLOP *** [6h Td 9s]
andybruseth99: bets $0.04
adkoslitko: raises $0.12 to $0.16
andybruseth99: calls $0.12
*** TURN *** [6h Td 9s] [3c]
andybruseth99: bets $0.02
adkoslitko: raises $0.14 to $0.16
andybruseth99: folds 
Uncalled bet ($0.14) returned to adkoslitko
adkoslitko collected $0.53 from pot
*** SUMMARY ***
Total pot $0.55 | Rake $0.02 
Board [6h Td 9s 3c]
Seat 1: prizrak_162 folded before Flop
Seat 2: adkoslitko collected ($0.53)
Seat 3: mkEmperor folded before Flop (didn't bet)
Seat 4: ll_n4no_ll (button) folded before Flop (didn't bet)
Seat 5: Murari_Mauro (small blind) folded before Flop
Seat 6: andybruseth99 (big blind) folded on the Turn
Seat 7: guiaoms folded before Flop (didn't bet)
Seat 8: Dorex2007 folded before Flop (didn't bet)
Seat 9: Nico55KQ folded before Flop (didn't bet)



PokerStars Hand #237375227462:  Hold'em No Limit ($0.01/$0.02 USD) - 2022/07/15 10:12:08 PT [2022/07/15 13:12:08 ET]
Table 'Appella II' 9-max Seat #5 is the button
Seat 1: prizrak_162 ($1.89 in chips) 
Seat 2: adkoslitko ($1.91 in chips) 
Seat 3: mkEmperor ($1.97 in chips) 
Seat 4: ll_n4no_ll ($1.97 in chips) 
Seat 5: Murari_Mauro ($2 in chips) 
Seat 6: andybruseth99 ($0.49 in chips) 
Seat 7: guiaoms ($3.04 in chips) 
Seat 8: Dorex2007 ($2.84 in chips) 
Seat 9: Nico55KQ ($1.90 in chips) 
andybruseth99: posts small blind $0.01
guiaoms: posts big blind $0.02
*** HOLE CARDS ***
Dealt to Dorex2007 [6d 5h]
Dorex2007: folds 
Nico55KQ: folds 
prizrak_162: raises $0.07 to $0.09
adkoslitko: folds 
mkEmperor: folds 
ll_n4no_ll: folds 
Murari_Mauro: folds 
andybruseth99: calls $0.08
guiaoms: folds 
*** FLOP *** [6c 6h 7h]
andybruseth99: bets $0.06
prizrak_162: raises $0.08 to $0.14
andybruseth99: calls $0.08
*** TURN *** [6c 6h 7h] [3h]
andybruseth99: bets $0.02
prizrak_162: raises $0.14 to $0.16
andybruseth99: calls $0.14
*** RIVER *** [6c 6h 7h 3h] [Th]
andybruseth99: bets $0.02
prizrak_162: raises $0.06 to $0.08
andybruseth99: calls $0.06
*** SHOW DOWN ***
prizrak_162: shows [Kh Ah] (a flush, Ace high)
andybruseth99: mucks hand 
prizrak_162 collected $0.93 from pot
*** SUMMARY ***
Total pot $0.96 | Rake $0.03 
Board [6c 6h 7h 3h Th]
Seat 1: prizrak_162 showed [Kh Ah] and won ($0.93) with a flush, Ace high
Seat 2: adkoslitko folded before Flop (didn't bet)
Seat 3: mkEmperor folded before Flop (didn't bet)
Seat 4: ll_n4no_ll folded before Flop (didn't bet)
Seat 5: Murari_Mauro (button) folded before Flop (didn't bet)
Seat 6: andybruseth99 (small blind) mucked [7s 9c]
Seat 7: guiaoms (big blind) folded before Flop
Seat 8: Dorex2007 folded before Flop (didn't bet)
Seat 9: Nico55KQ folded before Flop (didn't bet)



PokerStars Hand #237375245527:  Hold'em No Limit ($0.01/$0.02 USD) - 2022/07/15 10:13:09 PT [2022/07/15 13:13:09 ET]
Table 'Appella II' 9-max Seat #6 is the button
Seat 1: prizrak_162 ($2.35 in chips) 
Seat 2: adkoslitko ($1.91 in chips) 
Seat 3: mkEmperor ($1.97 in chips) 
Seat 4: ll_n4no_ll ($1.97 in chips) 
Seat 5: Murari_Mauro ($2 in chips) 
Seat 6: andybruseth99 ($0.02 in chips) 
Seat 7: guiaoms ($3.02 in chips) 
Seat 8: Dorex2007 ($2.84 in chips) 
Seat 9: Nico55KQ ($1.90 in chips) 
guiaoms: posts small blind $0.01
Dorex2007: posts big blind $0.02
*** HOLE CARDS ***
Dealt to Dorex2007 [3d As]
Nico55KQ: folds 
prizrak_162: folds 
adkoslitko: calls $0.02
mkEmperor has timed out
mkEmperor: folds 
ll_n4no_ll: folds 
Murari_Mauro: folds 
andybruseth99: calls $0.02 and is all-in
guiaoms: folds 
Dorex2007: checks 
*** FLOP *** [8s 2c 4h]
Dorex2007: checks 
adkoslitko: bets $0.02
Dorex2007: calls $0.02
*** TURN *** [8s 2c 4h] [2h]
Dorex2007: bets $0.05
adkoslitko: folds 
Uncalled bet ($0.05) returned to Dorex2007
*** RIVER *** [8s 2c 4h 2h] [Ac]
*** SHOW DOWN ***
Dorex2007: shows [3d As] (two pair, Aces and Deuces)
Dorex2007 collected $0.04 from side pot
andybruseth99: shows [6d 6h] (two pair, Sixes and Deuces)
Dorex2007 collected $0.07 from main pot
*** SUMMARY ***
Total pot $0.11 Main pot $0.07. Side pot $0.04. | Rake $0 
Board [8s 2c 4h 2h Ac]
Seat 1: prizrak_162 folded before Flop (didn't bet)
Seat 2: adkoslitko folded on the Turn
Seat 3: mkEmperor folded before Flop (didn't bet)
Seat 4: ll_n4no_ll folded before Flop (didn't bet)
Seat 5: Murari_Mauro folded before Flop (didn't bet)
Seat 6: andybruseth99 (button) showed [6d 6h] and lost with two pair, Sixes and Deuces
Seat 7: guiaoms (small blind) folded before Flop
Seat 8: Dorex2007 (big blind) showed [3d As] and won ($0.11) with two pair, Aces and Deuces
Seat 9: Nico55KQ folded before Flop (didn't bet)



PokerStars Hand #237375274037:  Hold'em No Limit ($0.01/$0.02 USD) - 2022/07/15 10:14:25 PT [2022/07/15 13:14:25 ET]
Table 'Appella II' 9-max Seat #7 is the button
Seat 1: prizrak_162 ($2.35 in chips) 
Seat 2: adkoslitko ($1.87 in chips) 
Seat 3: mkEmperor ($1.97 in chips) 
Seat 4: ll_n4no_ll ($1.97 in chips) 
Seat 5: Murari_Mauro ($2 in chips) 
Seat 6: andybruseth99 ($1.98 in chips) 
Seat 7: guiaoms ($3.01 in chips) 
Seat 8: Dorex2007 ($2.91 in chips) 
Seat 9: Nico55KQ ($1.90 in chips) 
Dorex2007: posts small blind $0.01
Nico55KQ: posts big blind $0.02
*** HOLE CARDS ***
Dealt to Dorex2007 [Qc Ts]
prizrak_162: folds 
adkoslitko: folds 
mkEmperor: folds 
ll_n4no_ll: calls $0.02
Murari_Mauro: folds 
andybruseth99: calls $0.02
guiaoms: folds 
Dorex2007: calls $0.01
Nico55KQ: checks 
*** FLOP *** [2d 2h 4c]
Dorex2007: checks 
Nico55KQ: bets $0.08
ll_n4no_ll: folds 
andybruseth99: calls $0.08
Dorex2007: folds 
*** TURN *** [2d 2h 4c] [9s]
Nico55KQ: checks 
andybruseth99: checks 
*** RIVER *** [2d 2h 4c 9s] [Tc]
Nico55KQ: bets $0.04
andybruseth99: folds 
Uncalled bet ($0.04) returned to Nico55KQ
Nico55KQ collected $0.23 from pot
*** SUMMARY ***
Total pot $0.24 | Rake $0.01 
Board [2d 2h 4c 9s Tc]
Seat 1: prizrak_162 folded before Flop (didn't bet)
Seat 2: adkoslitko folded before Flop (didn't bet)
Seat 3: mkEmperor folded before Flop (didn't bet)
Seat 4: ll_n4no_ll folded on the Flop
Seat 5: Murari_Mauro folded before Flop (didn't bet)
Seat 6: andybruseth99 folded on the River
Seat 7: guiaoms (button) folded before Flop (didn't bet)
Seat 8: Dorex2007 (small blind) folded on the Flop
Seat 9: Nico55KQ (big blind) collected ($0.23)



PokerStars Hand #237375287361:  Hold'em No Limit ($0.01/$0.02 USD) - 2022/07/15 10:15:08 PT [2022/07/15 13:15:08 ET]
Table 'Appella II' 9-max Seat #8 is the button
Seat 1: prizrak_162 ($2.35 in chips) 
Seat 2: adkoslitko ($1.87 in chips) 
Seat 3: mkEmperor ($1.97 in chips) 
Seat 4: ll_n4no_ll ($1.95 in chips) 
Seat 5: Murari_Mauro ($2 in chips) 
Seat 6: andybruseth99 ($1.88 in chips) 
Seat 7: guiaoms ($3.01 in chips) 
Seat 8: Dorex2007 ($2.89 in chips) 
Seat 9: Nico55KQ ($2.03 in chips) 
Nico55KQ: posts small blind $0.01
prizrak_162: posts big blind $0.02
*** HOLE CARDS ***
Dealt to Dorex2007 [3s 2h]
adkoslitko: raises $0.04 to $0.06
mkEmperor: folds 
ll_n4no_ll: folds 
Murari_Mauro: folds 
andybruseth99: calls $0.06
guiaoms: folds 
Dorex2007: folds 
Nico55KQ: folds 
prizrak_162: folds 
*** FLOP *** [Ad Qh 4s]
adkoslitko: checks 
andybruseth99: checks 
*** TURN *** [Ad Qh 4s] [2d]
adkoslitko: checks 
andybruseth99: checks 
*** RIVER *** [Ad Qh 4s 2d] [5c]
adkoslitko: checks 
andybruseth99: checks 
*** SHOW DOWN ***
adkoslitko: shows [Jh Kh] (high card Ace)
andybruseth99: mucks hand 
adkoslitko collected $0.14 from pot
*** SUMMARY ***
Total pot $0.15 | Rake $0.01 
Board [Ad Qh 4s 2d 5c]
Seat 1: prizrak_162 (big blind) folded before Flop
Seat 2: adkoslitko showed [Jh Kh] and won ($0.14) with high card Ace
Seat 3: mkEmperor folded before Flop (didn't bet)
Seat 4: ll_n4no_ll folded before Flop (didn't bet)
Seat 5: Murari_Mauro folded before Flop (didn't bet)
Seat 6: andybruseth99 mucked [7h Ts]
Seat 7: guiaoms folded before Flop (didn't bet)
Seat 8: Dorex2007 (button) folded before Flop (didn't bet)
Seat 9: Nico55KQ (small blind) folded before Flop



PokerStars Hand #237375300645:  Hold'em No Limit ($0.01/$0.02 USD) - 2022/07/15 10:15:52 PT [2022/07/15 13:15:52 ET]
Table 'Appella II' 9-max Seat #9 is the button
Seat 1: prizrak_162 ($2.33 in chips) 
Seat 2: adkoslitko ($1.95 in chips) 
Seat 3: mkEmperor ($1.97 in chips) 
Seat 4: ll_n4no_ll ($1.95 in chips) 
Seat 5: Murari_Mauro ($2 in chips) 
Seat 6: andybruseth99 ($1.82 in chips) 
Seat 7: guiaoms ($3.01 in chips) 
Seat 8: Dorex2007 ($2.89 in chips) 
Seat 9: Nico55KQ ($2.02 in chips) 
prizrak_162: posts small blind $0.01
adkoslitko: posts big blind $0.02
*** HOLE CARDS ***
Dealt to Dorex2007 [5c 4d]
mkEmperor: folds 
ll_n4no_ll: folds 
Murari_Mauro: folds 
andybruseth99: calls $0.02
guiaoms: folds 
Dorex2007: folds 
Nico55KQ: raises $0.06 to $0.08
prizrak_162: folds 
adkoslitko: folds 
andybruseth99: calls $0.06
*** FLOP *** [9s Kh As]
andybruseth99: checks 
Nico55KQ: bets $0.06
andybruseth99: folds 
Uncalled bet ($0.06) returned to Nico55KQ
Nico55KQ collected $0.18 from pot
*** SUMMARY ***
Total pot $0.19 | Rake $0.01 
Board [9s Kh As]
Seat 1: prizrak_162 (small blind) folded before Flop
Seat 2: adkoslitko (big blind) folded before Flop
Seat 3: mkEmperor folded before Flop (didn't bet)
Seat 4: ll_n4no_ll folded before Flop (didn't bet)
Seat 5: Murari_Mauro folded before Flop (didn't bet)
Seat 6: andybruseth99 folded on the Flop
Seat 7: guiaoms folded before Flop (didn't bet)
Seat 8: Dorex2007 folded before Flop (didn't bet)
Seat 9: Nico55KQ (button) collected ($0.18)



PokerStars Hand #237375309903:  Hold'em No Limit ($0.01/$0.02 USD) - 2022/07/15 10:16:23 PT [2022/07/15 13:16:23 ET]
Table 'Appella II' 9-max Seat #1 is the button
Seat 1: prizrak_162 ($2.32 in chips) 
Seat 2: adkoslitko ($1.93 in chips) 
Seat 3: mkEmperor ($1.97 in chips) 
Seat 4: ll_n4no_ll ($1.95 in chips) 
Seat 5: Murari_Mauro ($2 in chips) 
Seat 6: andybruseth99 ($1.74 in chips) 
Seat 7: guiaoms ($3.01 in chips) 
Seat 8: Dorex2007 ($2.89 in chips) 
Seat 9: Nico55KQ ($2.12 in chips) 
adkoslitko: posts small blind $0.01
mkEmperor: posts big blind $0.02
*** HOLE CARDS ***
Dealt to Dorex2007 [7s Js]
ll_n4no_ll: folds 
Murari_Mauro: folds 
andybruseth99: calls $0.02
guiaoms: calls $0.02
Dorex2007: folds 
Nico55KQ: folds 
prizrak_162: folds 
adkoslitko: raises $0.02 to $0.04
mkEmperor: folds 
andybruseth99: calls $0.02
guiaoms: calls $0.02
*** FLOP *** [Td Ad Qd]
adkoslitko: checks 
andybruseth99: bets $0.10
guiaoms: calls $0.10
adkoslitko: folds 
*** TURN *** [Td Ad Qd] [3c]
andybruseth99: checks 
guiaoms: checks 
*** RIVER *** [Td Ad Qd 3c] [6d]
andybruseth99: checks 
guiaoms: checks 
*** SHOW DOWN ***
andybruseth99: shows [Ts 9d] (a flush, Ace high)
guiaoms: mucks hand 
andybruseth99 collected $0.33 from pot
*** SUMMARY ***
Total pot $0.34 | Rake $0.01 
Board [Td Ad Qd 3c 6d]
Seat 1: prizrak_162 (button) folded before Flop (didn't bet)
Seat 2: adkoslitko (small blind) folded on the Flop
Seat 3: mkEmperor (big blind) folded before Flop
Seat 4: ll_n4no_ll folded before Flop (didn't bet)
Seat 5: Murari_Mauro folded before Flop (didn't bet)
Seat 6: andybruseth99 showed [Ts 9d] and won ($0.33) with a flush, Ace high
Seat 7: guiaoms mucked [Qh Tc]
Seat 8: Dorex2007 folded before Flop (didn't bet)
Seat 9: Nico55KQ folded before Flop (didn't bet)



PokerStars Hand #237375323354:  Hold'em No Limit ($0.01/$0.02 USD) - 2022/07/15 10:17:08 PT [2022/07/15 13:17:08 ET]
Table 'Appella II' 9-max Seat #2 is the button
Seat 1: prizrak_162 ($2.32 in chips) 
Seat 2: adkoslitko ($1.89 in chips) 
Seat 3: mkEmperor ($1.95 in chips) 
Seat 4: ll_n4no_ll ($1.95 in chips) 
Seat 5: Murari_Mauro ($2 in chips) 
Seat 6: andybruseth99 ($1.93 in chips) 
Seat 7: guiaoms ($2.87 in chips) 
Seat 8: Dorex2007 ($2.89 in chips) 
Seat 9: Nico55KQ ($2.12 in chips) 
mkEmperor: posts small blind $0.01
ll_n4no_ll: posts big blind $0.02
*** HOLE CARDS ***
Dealt to Dorex2007 [Kc 6h]
Murari_Mauro: raises $0.05 to $0.07
andybruseth99: calls $0.07
guiaoms: folds 
Dorex2007: folds 
Nico55KQ: calls $0.07
prizrak_162: folds 
adkoslitko: folds 
mkEmperor: folds 
ll_n4no_ll: calls $0.05
*** FLOP *** [5s Qh 9s]
ll_n4no_ll: checks 
Murari_Mauro: checks 
andybruseth99: checks 
Nico55KQ: bets $0.08
ll_n4no_ll: calls $0.08
Murari_Mauro: folds 
andybruseth99: raises $0.08 to $0.16
Nico55KQ: calls $0.08
ll_n4no_ll: calls $0.08
*** TURN *** [5s Qh 9s] [Tc]
ll_n4no_ll: checks 
andybruseth99: checks 
Nico55KQ: bets $0.74
ll_n4no_ll: folds 
andybruseth99: folds 
Uncalled bet ($0.74) returned to Nico55KQ
Nico55KQ collected $0.73 from pot
*** SUMMARY ***
Total pot $0.77 | Rake $0.04 
Board [5s Qh 9s Tc]
Seat 1: prizrak_162 folded before Flop (didn't bet)
Seat 2: adkoslitko (button) folded before Flop (didn't bet)
Seat 3: mkEmperor (small blind) folded before Flop
Seat 4: ll_n4no_ll (big blind) folded on the Turn
Seat 5: Murari_Mauro folded on the Flop
Seat 6: andybruseth99 folded on the Turn
Seat 7: guiaoms folded before Flop (didn't bet)
Seat 8: Dorex2007 folded before Flop (didn't bet)
Seat 9: Nico55KQ collected ($0.73)



PokerStars Hand #237375341185:  Hold'em No Limit ($0.01/$0.02 USD) - 2022/07/15 10:18:07 PT [2022/07/15 13:18:07 ET]
Table 'Appella II' 9-max Seat #3 is the button
Seat 1: prizrak_162 ($2.32 in chips) 
Seat 2: adkoslitko ($1.89 in chips) 
Seat 3: mkEmperor ($1.94 in chips) 
Seat 4: ll_n4no_ll ($1.72 in chips) 
Seat 5: Murari_Mauro ($2 in chips) 
Seat 6: andybruseth99 ($1.70 in chips) 
Seat 7: guiaoms ($2.87 in chips) 
Seat 8: Dorex2007 ($2.89 in chips) 
Seat 9: Nico55KQ ($2.62 in chips) 
ll_n4no_ll: posts small blind $0.01
Murari_Mauro: posts big blind $0.02
*** HOLE CARDS ***
Dealt to Dorex2007 [7s 7c]
andybruseth99 has timed out
andybruseth99: folds 
guiaoms: folds 
Dorex2007: calls $0.02
Nico55KQ: folds 
prizrak_162: folds 
adkoslitko: calls $0.02
mkEmperor: folds 
ll_n4no_ll: calls $0.01
Murari_Mauro: checks 
*** FLOP *** [7h 6d 9s]
ll_n4no_ll: checks 
Murari_Mauro: checks 
Dorex2007: bets $0.04
adkoslitko: folds 
ll_n4no_ll: calls $0.04
guiaoms leaves the table
Murari_Mauro: calls $0.04
*** TURN *** [7h 6d 9s] [7d]
ll_n4no_ll: checks 
Murari_Mauro: checks 
Dorex2007: checks 
*** RIVER *** [7h 6d 9s 7d] [Ts]
ll_n4no_ll: bets $0.08
Murari_Mauro: calls $0.08
meelis9 joins the table at seat #7 
Dorex2007: raises $0.43 to $0.51
ll_n4no_ll: calls $0.43
Murari_Mauro: folds 
*** SHOW DOWN ***
Dorex2007: shows [7s 7c] (four of a kind, Sevens)
ll_n4no_ll: mucks hand 
Dorex2007 collected $1.25 from pot
*** SUMMARY ***
Total pot $1.30 | Rake $0.05 
Board [7h 6d 9s 7d Ts]
Seat 1: prizrak_162 folded before Flop (didn't bet)
Seat 2: adkoslitko folded on the Flop
Seat 3: mkEmperor (button) folded before Flop (didn't bet)
Seat 4: ll_n4no_ll (small blind) mucked [9d 8d]
Seat 5: Murari_Mauro (big blind) folded on the River
Seat 6: andybruseth99 folded before Flop (didn't bet)
Seat 7: guiaoms folded before Flop (didn't bet)
Seat 8: Dorex2007 showed [7s 7c] and won ($1.25) with four of a kind, Sevens
Seat 9: Nico55KQ folded before Flop (didn't bet)



PokerStars Hand #237375370431:  Hold'em No Limit ($0.01/$0.02 USD) - 2022/07/15 10:19:44 PT [2022/07/15 13:19:44 ET]
Table 'Appella II' 9-max Seat #4 is the button
Seat 1: prizrak_162 ($2.32 in chips) 
Seat 2: adkoslitko ($1.87 in chips) 
Seat 3: mkEmperor ($1.94 in chips) 
Seat 4: ll_n4no_ll ($1.15 in chips) 
Seat 5: Murari_Mauro ($2 in chips) 
Seat 6: andybruseth99 ($1.70 in chips) 
Seat 8: Dorex2007 ($3.57 in chips) 
Seat 9: Nico55KQ ($2.62 in chips) 
Murari_Mauro: posts small blind $0.01
andybruseth99: posts big blind $0.02
meelis9: sits out 
*** HOLE CARDS ***
Dealt to Dorex2007 [9h Td]
Dorex2007: folds 
Nico55KQ: raises $0.04 to $0.06
prizrak_162: folds 
adkoslitko: calls $0.06
mkEmperor: folds 
ll_n4no_ll: folds 
Murari_Mauro: folds 
andybruseth99: calls $0.04
*** FLOP *** [5c 2c Qc]
andybruseth99: bets $0.06
Nico55KQ: folds 
adkoslitko: folds 
Uncalled bet ($0.06) returned to andybruseth99
andybruseth99 collected $0.18 from pot
*** SUMMARY ***
Total pot $0.19 | Rake $0.01 
Board [5c 2c Qc]
Seat 1: prizrak_162 folded before Flop (didn't bet)
Seat 2: adkoslitko folded on the Flop
Seat 3: mkEmperor folded before Flop (didn't bet)
Seat 4: ll_n4no_ll (button) folded before Flop (didn't bet)
Seat 5: Murari_Mauro (small blind) folded before Flop
Seat 6: andybruseth99 (big blind) collected ($0.18)
Seat 8: Dorex2007 folded before Flop (didn't bet)
Seat 9: Nico55KQ folded on the Flop



PokerStars Hand #237375383576:  Hold'em No Limit ($0.01/$0.02 USD) - 2022/07/15 10:20:28 PT [2022/07/15 13:20:28 ET]
Table 'Appella II' 9-max Seat #5 is the button
Seat 1: prizrak_162 ($2.32 in chips) 
Seat 2: adkoslitko ($1.81 in chips) 
Seat 3: mkEmperor ($1.94 in chips) 
Seat 4: ll_n4no_ll ($2 in chips) 
Seat 5: Murari_Mauro ($2 in chips) 
Seat 6: andybruseth99 ($1.82 in chips) 
Seat 7: meelis9 ($2 in chips) 
Seat 8: Dorex2007 ($3.57 in chips) 
Seat 9: Nico55KQ ($2.56 in chips) 
andybruseth99: posts small blind $0.01
meelis9: posts big blind $0.02
*** HOLE CARDS ***
Dealt to Dorex2007 [5c 9d]
Dorex2007: folds 
Nico55KQ: raises $0.04 to $0.06
prizrak_162: folds 
adkoslitko: folds 
mkEmperor: folds 
ll_n4no_ll: folds 
Murari_Mauro: folds 
andybruseth99: raises $0.04 to $0.10
meelis9: folds 
Nico55KQ: calls $0.04
*** FLOP *** [3h 7d 2s]
andybruseth99: bets $0.06
Nico55KQ: calls $0.06
*** TURN *** [3h 7d 2s] [8c]
andybruseth99: bets $0.06
Nico55KQ: raises $0.08 to $0.14
andybruseth99: calls $0.08
*** RIVER *** [3h 7d 2s 8c] [Kc]
andybruseth99: bets $0.06
Nico55KQ: calls $0.06
*** SHOW DOWN ***
andybruseth99: shows [9c 7c] (a pair of Sevens)
Nico55KQ: shows [8s 6s] (a pair of Eights)
Nico55KQ collected $0.70 from pot
*** SUMMARY ***
Total pot $0.74 | Rake $0.04 
Board [3h 7d 2s 8c Kc]
Seat 1: prizrak_162 folded before Flop (didn't bet)
Seat 2: adkoslitko folded before Flop (didn't bet)
Seat 3: mkEmperor folded before Flop (didn't bet)
Seat 4: ll_n4no_ll folded before Flop (didn't bet)
Seat 5: Murari_Mauro (button) folded before Flop (didn't bet)
Seat 6: andybruseth99 (small blind) showed [9c 7c] and lost with a pair of Sevens
Seat 7: meelis9 (big blind) folded before Flop
Seat 8: Dorex2007 folded before Flop (didn't bet)
Seat 9: Nico55KQ showed [8s 6s] and won ($0.70) with a pair of Eights



PokerStars Hand #237375400059:  Hold'em No Limit ($0.01/$0.02 USD) - 2022/07/15 10:21:23 PT [2022/07/15 13:21:23 ET]
Table 'Appella II' 9-max Seat #6 is the button
Seat 1: prizrak_162 ($2.32 in chips) 
Seat 2: adkoslitko ($1.81 in chips) 
Seat 3: mkEmperor ($1.94 in chips) 
Seat 4: ll_n4no_ll ($2 in chips) 
Seat 5: Murari_Mauro ($2 in chips) 
Seat 6: andybruseth99 ($1.46 in chips) 
Seat 7: meelis9 ($2 in chips) 
Seat 8: Dorex2007 ($3.57 in chips) 
Seat 9: Nico55KQ ($2.90 in chips) 
meelis9: posts small blind $0.01
Dorex2007: posts big blind $0.02
*** HOLE CARDS ***
Dealt to Dorex2007 [7c 7s]
Nico55KQ: folds 
prizrak_162: raises $0.02 to $0.04
adkoslitko: folds 
mkEmperor: folds 
ll_n4no_ll: folds 
Murari_Mauro: folds 
andybruseth99: calls $0.04
meelis9: folds 
Dorex2007: calls $0.02
*** FLOP *** [7d Ts Ah]
Dorex2007: bets $0.06
prizrak_162: calls $0.06
andybruseth99: calls $0.06
*** TURN *** [7d Ts Ah] [4h]
Dorex2007: bets $0.20
prizrak_162: calls $0.20
andybruseth99: folds 
*** RIVER *** [7d Ts Ah 4h] [2s]
Dorex2007: bets $0.69
prizrak_162: folds 
Uncalled bet ($0.69) returned to Dorex2007
Dorex2007 collected $0.69 from pot
*** SUMMARY ***
Total pot $0.71 | Rake $0.02 
Board [7d Ts Ah 4h 2s]
Seat 1: prizrak_162 folded on the River
Seat 2: adkoslitko folded before Flop (didn't bet)
Seat 3: mkEmperor folded before Flop (didn't bet)
Seat 4: ll_n4no_ll folded before Flop (didn't bet)
Seat 5: Murari_Mauro folded before Flop (didn't bet)
Seat 6: andybruseth99 (button) folded on the Turn
Seat 7: meelis9 (small blind) folded before Flop
Seat 8: Dorex2007 (big blind) collected ($0.69)
Seat 9: Nico55KQ folded before Flop (didn't bet)



PokerStars Hand #237375413426:  Hold'em No Limit ($0.01/$0.02 USD) - 2022/07/15 10:22:07 PT [2022/07/15 13:22:07 ET]
Table 'Appella II' 9-max Seat #7 is the button
Seat 1: prizrak_162 ($2.02 in chips) 
Seat 2: adkoslitko ($1.81 in chips) 
Seat 3: mkEmperor ($1.94 in chips) 
Seat 4: ll_n4no_ll ($2 in chips) 
Seat 5: Murari_Mauro ($2 in chips) 
Seat 6: andybruseth99 ($1.36 in chips) 
Seat 7: meelis9 ($2 in chips) 
Seat 8: Dorex2007 ($3.96 in chips) 
Seat 9: Nico55KQ ($2.90 in chips) 
Dorex2007: posts small blind $0.01
Nico55KQ: posts big blind $0.02
*** HOLE CARDS ***
Dealt to Dorex2007 [Qd 3c]
prizrak_162: folds 
adkoslitko: folds 
mkEmperor: folds 
ll_n4no_ll: folds 
Murari_Mauro: raises $0.05 to $0.07
andybruseth99: calls $0.07
meelis9: folds 
Dorex2007: folds 
Nico55KQ: calls $0.05
*** FLOP *** [2h Kc Th]
Nico55KQ: checks 
Murari_Mauro: bets $0.11
andybruseth99: calls $0.11
Nico55KQ: raises $0.54 to $0.65
Murari_Mauro: raises $1.28 to $1.93 and is all-in
andybruseth99: folds 
Nico55KQ: calls $1.28
*** TURN *** [2h Kc Th] [5c]
*** RIVER *** [2h Kc Th 5c] [8h]
*** SHOW DOWN ***
Nico55KQ: shows [Tc Kh] (two pair, Kings and Tens)
Murari_Mauro: shows [Jh 9h] (a flush, Jack high)
Murari_Mauro collected $4.04 from pot
*** SUMMARY ***
Total pot $4.19 | Rake $0.15 
Board [2h Kc Th 5c 8h]
Seat 1: prizrak_162 folded before Flop (didn't bet)
Seat 2: adkoslitko folded before Flop (didn't bet)
Seat 3: mkEmperor folded before Flop (didn't bet)
Seat 4: ll_n4no_ll folded before Flop (didn't bet)
Seat 5: Murari_Mauro showed [Jh 9h] and won ($4.04) with a flush, Jack high
Seat 6: andybruseth99 folded on the Flop
Seat 7: meelis9 (button) folded before Flop (didn't bet)
Seat 8: Dorex2007 (small blind) folded before Flop
Seat 9: Nico55KQ (big blind) showed [Tc Kh] and lost with two pair, Kings and Tens



PokerStars Hand #237375429607:  Hold'em No Limit ($0.01/$0.02 USD) - 2022/07/15 10:23:02 PT [2022/07/15 13:23:02 ET]
Table 'Appella II' 9-max Seat #8 is the button
Seat 1: prizrak_162 ($2.02 in chips) 
Seat 2: adkoslitko ($1.81 in chips) 
Seat 3: mkEmperor ($1.94 in chips) 
Seat 4: ll_n4no_ll ($2 in chips) 
Seat 5: Murari_Mauro ($4.04 in chips) 
Seat 6: andybruseth99 ($1.18 in chips) 
Seat 7: meelis9 ($2 in chips) 
Seat 8: Dorex2007 ($3.95 in chips) 
Seat 9: Nico55KQ ($0.90 in chips) 
Nico55KQ: posts small blind $0.01
prizrak_162: posts big blind $0.02
*** HOLE CARDS ***
Dealt to Dorex2007 [5c Td]
adkoslitko: folds 
mkEmperor: folds 
ll_n4no_ll: folds 
adkoslitko leaves the table
Murari_Mauro: raises $0.05 to $0.07
andybruseth99: folds 
meelis9: folds 
Dorex2007: folds 
Nico55KQ: folds 
Blackpoker65 joins the table at seat #2 
prizrak_162: calls $0.05
*** FLOP *** [4s Js 2s]
prizrak_162: checks 
Murari_Mauro: bets $0.06
prizrak_162: calls $0.06
*** TURN *** [4s Js 2s] [5h]
prizrak_162: checks 
Murari_Mauro: checks 
*** RIVER *** [4s Js 2s 5h] [3c]
prizrak_162: checks 
Murari_Mauro: checks 
*** SHOW DOWN ***
prizrak_162: shows [Jc Jd] (three of a kind, Jacks)
Murari_Mauro: mucks hand 
prizrak_162 collected $0.26 from pot
*** SUMMARY ***
Total pot $0.27 | Rake $0.01 
Board [4s Js 2s 5h 3c]
Seat 1: prizrak_162 (big blind) showed [Jc Jd] and won ($0.26) with three of a kind, Jacks
Seat 2: adkoslitko folded before Flop (didn't bet)
Seat 3: mkEmperor folded before Flop (didn't bet)
Seat 4: ll_n4no_ll folded before Flop (didn't bet)
Seat 5: Murari_Mauro mucked [8h 8s]
Seat 6: andybruseth99 folded before Flop (didn't bet)
Seat 7: meelis9 folded before Flop (didn't bet)
Seat 8: Dorex2007 (button) folded before Flop (didn't bet)
Seat 9: Nico55KQ (small blind) folded before Flop



PokerStars Hand #237375443704:  Hold'em No Limit ($0.01/$0.02 USD) - 2022/07/15 10:23:50 PT [2022/07/15 13:23:50 ET]
Table 'Appella II' 9-max Seat #9 is the button
Seat 1: prizrak_162 ($2.15 in chips) 
Seat 2: Blackpoker65 ($0.80 in chips) 
Seat 3: mkEmperor ($1.94 in chips) 
Seat 4: ll_n4no_ll ($2 in chips) 
Seat 5: Murari_Mauro ($3.91 in chips) 
Seat 6: andybruseth99 ($1.18 in chips) 
Seat 7: meelis9 ($2 in chips) 
Seat 8: Dorex2007 ($3.95 in chips) 
Seat 9: Nico55KQ ($2 in chips) 
prizrak_162: posts small blind $0.01
Blackpoker65: posts big blind $0.02
*** HOLE CARDS ***
Dealt to Dorex2007 [3d Kc]
mkEmperor: folds 
ll_n4no_ll: folds 
Murari_Mauro has timed out
Murari_Mauro: folds 
andybruseth99: calls $0.02
meelis9: raises $0.06 to $0.08
Dorex2007: folds 
Nico55KQ: folds 
prizrak_162: folds 
Blackpoker65: calls $0.06
andybruseth99: calls $0.06
*** FLOP *** [Qd 7c 6s]
Blackpoker65: checks 
andybruseth99: checks 
meelis9: bets $0.12
Blackpoker65: folds 
andybruseth99: calls $0.12
*** TURN *** [Qd 7c 6s] [5s]
andybruseth99: checks 
meelis9: checks 
*** RIVER *** [Qd 7c 6s 5s] [6h]
andybruseth99: checks 
meelis9: checks 
*** SHOW DOWN ***
andybruseth99: shows [4h Kh] (a pair of Sixes)
meelis9: shows [As Jd] (a pair of Sixes - Ace kicker)
meelis9 collected $0.47 from pot
*** SUMMARY ***
Total pot $0.49 | Rake $0.02 
Board [Qd 7c 6s 5s 6h]
Seat 1: prizrak_162 (small blind) folded before Flop
Seat 2: Blackpoker65 (big blind) folded on the Flop
Seat 3: mkEmperor folded before Flop (didn't bet)
Seat 4: ll_n4no_ll folded before Flop (didn't bet)
Seat 5: Murari_Mauro folded before Flop (didn't bet)
Seat 6: andybruseth99 showed [4h Kh] and lost with a pair of Sixes
Seat 7: meelis9 showed [As Jd] and won ($0.47) with a pair of Sixes
Seat 8: Dorex2007 folded before Flop (didn't bet)
Seat 9: Nico55KQ (button) folded before Flop (didn't bet)



PokerStars Hand #237375464031:  Hold'em No Limit ($0.01/$0.02 USD) - 2022/07/15 10:24:41 PT [2022/07/15 13:24:41 ET]
Table 'Appella II' 9-max Seat #1 is the button
Seat 1: prizrak_162 ($2.14 in chips) 
Seat 2: Blackpoker65 ($0.72 in chips) 
Seat 3: mkEmperor ($1.94 in chips) 
Seat 4: ll_n4no_ll ($2 in chips) 
Seat 5: Murari_Mauro ($3.91 in chips) 
Seat 6: andybruseth99 ($0.98 in chips) 
Seat 7: meelis9 ($2.27 in chips) 
Seat 8: Dorex2007 ($3.95 in chips) 
Seat 9: Nico55KQ ($2 in chips) 
Blackpoker65: posts small blind $0.01
mkEmperor: posts big blind $0.02
*** HOLE CARDS ***
Dealt to Dorex2007 [Js 7d]
ll_n4no_ll: folds 
Murari_Mauro: raises $0.05 to $0.07
andybruseth99: calls $0.07
meelis9: calls $0.07
Dorex2007: folds 
Nico55KQ: calls $0.07
prizrak_162: folds 
Blackpoker65: folds 
mkEmperor: folds 
*** FLOP *** [4s 3h Kh]
Murari_Mauro: checks 
andybruseth99: checks 
meelis9: checks 
Nico55KQ: checks 
*** TURN *** [4s 3h Kh] [Kc]
Murari_Mauro: bets $0.13
andybruseth99: folds 
meelis9: calls $0.13
Nico55KQ: folds 
*** RIVER *** [4s 3h Kh Kc] [2d]
Murari_Mauro: checks 
meelis9: checks 
*** SHOW DOWN ***
Murari_Mauro: shows [7h 7c] (two pair, Kings and Sevens)
meelis9: mucks hand 
Murari_Mauro collected $0.55 from pot
*** SUMMARY ***
Total pot $0.57 | Rake $0.02 
Board [4s 3h Kh Kc 2d]
Seat 1: prizrak_162 (button) folded before Flop (didn't bet)
Seat 2: Blackpoker65 (small blind) folded before Flop
Seat 3: mkEmperor (big blind) folded before Flop
Seat 4: ll_n4no_ll folded before Flop (didn't bet)
Seat 5: Murari_Mauro showed [7h 7c] and won ($0.55) with two pair, Kings and Sevens
Seat 6: andybruseth99 folded on the Turn
Seat 7: meelis9 mucked [8h Th]
Seat 8: Dorex2007 folded before Flop (didn't bet)
Seat 9: Nico55KQ folded on the Turn



PokerStars Hand #237375483224:  Hold'em No Limit ($0.01/$0.02 USD) - 2022/07/15 10:25:45 PT [2022/07/15 13:25:45 ET]
Table 'Appella II' 9-max Seat #2 is the button
Seat 1: prizrak_162 ($2.14 in chips) 
Seat 2: Blackpoker65 ($0.71 in chips) 
Seat 3: mkEmperor ($1.92 in chips) 
Seat 4: ll_n4no_ll ($2 in chips) 
Seat 5: Murari_Mauro ($4.26 in chips) 
Seat 6: andybruseth99 ($0.91 in chips) 
Seat 7: meelis9 ($2.07 in chips) 
Seat 8: Dorex2007 ($3.95 in chips) 
Seat 9: Nico55KQ ($1.93 in chips) 
mkEmperor: posts small blind $0.01
ll_n4no_ll: posts big blind $0.02
*** HOLE CARDS ***
Dealt to Dorex2007 [4d Qh]
Murari_Mauro: folds 
Murari_Mauro leaves the table
andybruseth99: calls $0.02
meelis9: folds 
Dorex2007: folds 
Nico55KQ: folds 
prizrak_162: folds 
Blackpoker65: folds 
Eltonn112 joins the table at seat #5 
mkEmperor: calls $0.01
ll_n4no_ll: checks 
*** FLOP *** [Ac Qc Ad]
mkEmperor: checks 
ll_n4no_ll: checks 
andybruseth99: checks 
*** TURN *** [Ac Qc Ad] [6c]
mkEmperor: checks 
ll_n4no_ll: checks 
andybruseth99: checks 
*** RIVER *** [Ac Qc Ad 6c] [Kc]
mkEmperor: checks 
ll_n4no_ll: checks 
andybruseth99: checks 
*** SHOW DOWN ***
mkEmperor: shows [4h 5h] (a pair of Aces)
ll_n4no_ll: shows [Qs 9c] (a flush, Ace high)
andybruseth99: mucks hand 
ll_n4no_ll collected $0.06 from pot
*** SUMMARY ***
Total pot $0.06 | Rake $0 
Board [Ac Qc Ad 6c Kc]
Seat 1: prizrak_162 folded before Flop (didn't bet)
Seat 2: Blackpoker65 (button) folded before Flop (didn't bet)
Seat 3: mkEmperor (small blind) showed [4h 5h] and lost with a pair of Aces
Seat 4: ll_n4no_ll (big blind) showed [Qs 9c] and won ($0.06) with a flush, Ace high
Seat 5: Murari_Mauro folded before Flop (didn't bet)
Seat 6: andybruseth99 mucked [5d Js]
Seat 7: meelis9 folded before Flop (didn't bet)
Seat 8: Dorex2007 folded before Flop (didn't bet)
Seat 9: Nico55KQ folded before Flop (didn't bet)



PokerStars Hand #237375501151:  Hold'em No Limit ($0.01/$0.02 USD) - 2022/07/15 10:26:45 PT [2022/07/15 13:26:45 ET]
Table 'Appella II' 9-max Seat #3 is the button
Seat 1: prizrak_162 ($2.14 in chips) 
Seat 2: Blackpoker65 ($0.71 in chips) 
Seat 3: mkEmperor ($1.90 in chips) 
Seat 4: ll_n4no_ll ($2.04 in chips) 
Seat 5: Eltonn112 ($1 in chips) 
Seat 6: andybruseth99 ($0.89 in chips) 
Seat 7: meelis9 ($2.07 in chips) 
Seat 8: Dorex2007 ($3.95 in chips) 
Seat 9: Nico55KQ ($1.93 in chips) 
ll_n4no_ll: posts small blind $0.01
Eltonn112: posts big blind $0.02
*** HOLE CARDS ***
Dealt to Dorex2007 [6d 5h]
andybruseth99: calls $0.02
meelis9: folds 
Dorex2007: folds 
Nico55KQ: calls $0.02
prizrak_162: folds 
Blackpoker65: raises $0.06 to $0.08
mkEmperor: folds 
ll_n4no_ll: folds 
Eltonn112: folds 
andybruseth99: calls $0.06
Nico55KQ: calls $0.06
*** FLOP *** [5d Ks Qh]
andybruseth99: checks 
Nico55KQ: bets $0.06
Blackpoker65: calls $0.06
andybruseth99: folds 
*** TURN *** [5d Ks Qh] [As]
Nico55KQ: checks 
Blackpoker65: bets $0.19
Nico55KQ: folds [Kc]
Uncalled bet ($0.19) returned to Blackpoker65
Blackpoker65 collected $0.38 from pot
*** SUMMARY ***
Total pot $0.39 | Rake $0.01 
Board [5d Ks Qh As]
Seat 1: prizrak_162 folded before Flop (didn't bet)
Seat 2: Blackpoker65 collected ($0.38)
Seat 3: mkEmperor (button) folded before Flop (didn't bet)
Seat 4: ll_n4no_ll (small blind) folded before Flop
Seat 5: Eltonn112 (big blind) folded before Flop
Seat 6: andybruseth99 folded on the Flop
Seat 7: meelis9 folded before Flop (didn't bet)
Seat 8: Dorex2007 folded before Flop (didn't bet)
Seat 9: Nico55KQ folded on the Turn



PokerStars Hand #237375518970:  Hold'em No Limit ($0.01/$0.02 USD) - 2022/07/15 10:27:44 PT [2022/07/15 13:27:44 ET]
Table 'Appella II' 9-max Seat #4 is the button
Seat 1: prizrak_162 ($2.14 in chips) 
Seat 2: Blackpoker65 ($0.95 in chips) 
Seat 3: mkEmperor ($1.90 in chips) 
Seat 4: ll_n4no_ll ($2.03 in chips) 
Seat 5: Eltonn112 ($0.98 in chips) 
Seat 6: andybruseth99 ($0.81 in chips) 
Seat 7: meelis9 ($2.07 in chips) 
Seat 8: Dorex2007 ($3.95 in chips) 
Seat 9: Nico55KQ ($1.79 in chips) 
Eltonn112: posts small blind $0.01
andybruseth99: posts big blind $0.02
*** HOLE CARDS ***
Dealt to Dorex2007 [2s 9d]
meelis9: raises $0.04 to $0.06
Dorex2007: folds 
Nico55KQ: calls $0.06
prizrak_162: folds 
Blackpoker65: folds 
mkEmperor: folds 
ll_n4no_ll: raises $0.10 to $0.16
Eltonn112: folds 
andybruseth99: calls $0.14
meelis9: calls $0.10
Nico55KQ: calls $0.10
*** FLOP *** [5c 4s 4d]
andybruseth99: bets $0.06
meelis9: calls $0.06
Nico55KQ: folds 
ll_n4no_ll: raises $0.30 to $0.36
andybruseth99: calls $0.30
meelis9: folds 
*** TURN *** [5c 4s 4d] [6h]
andybruseth99: bets $0.06
ll_n4no_ll: raises $0.28 to $0.34
andybruseth99: calls $0.23 and is all-in
Uncalled bet ($0.05) returned to ll_n4no_ll
*** RIVER *** [5c 4s 4d 6h] [8c]
*** SHOW DOWN ***
andybruseth99: shows [Kd 5d] (two pair, Fives and Fours)
ll_n4no_ll: shows [Kc Kh] (two pair, Kings and Fours)
ll_n4no_ll collected $1.94 from pot
andybruseth99 cashed out the hand for $0.09
*** SUMMARY ***
Total pot $2.01 | Rake $0.07 
Board [5c 4s 4d 6h 8c]
Seat 1: prizrak_162 folded before Flop (didn't bet)
Seat 2: Blackpoker65 folded before Flop (didn't bet)
Seat 3: mkEmperor folded before Flop (didn't bet)
Seat 4: ll_n4no_ll (button) showed [Kc Kh] and won ($1.94) with two pair, Kings and Fours
Seat 5: Eltonn112 (small blind) folded before Flop
Seat 6: andybruseth99 (big blind) showed [Kd 5d] and lost with two pair, Fives and Fours (cashed out).
Seat 7: meelis9 folded on the Flop
Seat 8: Dorex2007 folded before Flop (didn't bet)
Seat 9: Nico55KQ folded on the Flop



PokerStars Hand #237375542664:  Hold'em No Limit ($0.01/$0.02 USD) - 2022/07/15 10:29:04 PT [2022/07/15 13:29:04 ET]
Table 'Appella II' 9-max Seat #5 is the button
Seat 1: prizrak_162 ($2.14 in chips) 
Seat 2: Blackpoker65 ($0.95 in chips) 
Seat 3: mkEmperor ($1.90 in chips) 
Seat 4: ll_n4no_ll ($3.16 in chips) 
Seat 5: Eltonn112 ($0.97 in chips) 
Seat 6: andybruseth99 ($0.09 in chips) 
Seat 7: meelis9 ($2 in chips) 
Seat 8: Dorex2007 ($3.95 in chips) 
Seat 9: Nico55KQ ($1.63 in chips) 
andybruseth99: posts small blind $0.01
meelis9: posts big blind $0.02
*** HOLE CARDS ***
Dealt to Dorex2007 [4c 3s]
Dorex2007: folds 
Nico55KQ: raises $0.06 to $0.08
prizrak_162: raises $0.10 to $0.18
Blackpoker65: folds 
mkEmperor: folds 
ll_n4no_ll: folds 
Eltonn112: folds 
andybruseth99: folds 
meelis9: folds 
Nico55KQ: calls $0.10
*** FLOP *** [9s 8s 6h]
andybruseth99 leaves the table
Nico55KQ: checks 
Zzzanderman joins the table at seat #6 
prizrak_162: bets $0.26
Nico55KQ: calls $0.26
*** TURN *** [9s 8s 6h] [9c]
Nico55KQ: bets $0.14
prizrak_162: raises $0.58 to $0.72
Nico55KQ: folds 
Uncalled bet ($0.58) returned to prizrak_162
prizrak_162 collected $1.15 from pot
*** SUMMARY ***
Total pot $1.19 | Rake $0.04 
Board [9s 8s 6h 9c]
Seat 1: prizrak_162 collected ($1.15)
Seat 2: Blackpoker65 folded before Flop (didn't bet)
Seat 3: mkEmperor folded before Flop (didn't bet)
Seat 4: ll_n4no_ll folded before Flop (didn't bet)
Seat 5: Eltonn112 (button) folded before Flop (didn't bet)
Seat 6: andybruseth99 (small blind) folded before Flop
Seat 7: meelis9 (big blind) folded before Flop
Seat 8: Dorex2007 folded before Flop (didn't bet)
Seat 9: Nico55KQ folded on the Turn



PokerStars Hand #237375561115:  Hold'em No Limit ($0.01/$0.02 USD) - 2022/07/15 10:30:05 PT [2022/07/15 13:30:05 ET]
Table 'Appella II' 9-max Seat #7 is the button
Seat 1: prizrak_162 ($2.71 in chips) 
Seat 2: Blackpoker65 ($0.95 in chips) 
Seat 3: mkEmperor ($1.90 in chips) 
Seat 4: ll_n4no_ll ($3.16 in chips) 
Seat 5: Eltonn112 ($0.97 in chips) 
Seat 7: meelis9 ($2 in chips) 
Seat 8: Dorex2007 ($3.95 in chips) 
Seat 9: Nico55KQ ($1.05 in chips) 
Dorex2007: posts small blind $0.01
Nico55KQ: posts big blind $0.02
Zzzanderman: sits out 
*** HOLE CARDS ***
Dealt to Dorex2007 [Td Ad]
prizrak_162: folds 
Blackpoker65: folds 
mkEmperor: folds 
ll_n4no_ll: folds 
Eltonn112: folds 
meelis9: folds 
Dorex2007: raises $0.04 to $0.06
Nico55KQ: calls $0.04
*** FLOP *** [4c 4d 8d]
Dorex2007: bets $0.08
Nico55KQ: folds 
Uncalled bet ($0.08) returned to Dorex2007
Dorex2007 collected $0.12 from pot
*** SUMMARY ***
Total pot $0.12 | Rake $0 
Board [4c 4d 8d]
Seat 1: prizrak_162 folded before Flop (didn't bet)
Seat 2: Blackpoker65 folded before Flop (didn't bet)
Seat 3: mkEmperor folded before Flop (didn't bet)
Seat 4: ll_n4no_ll folded before Flop (didn't bet)
Seat 5: Eltonn112 folded before Flop (didn't bet)
Seat 7: meelis9 (button) folded before Flop (didn't bet)
Seat 8: Dorex2007 (small blind) collected ($0.12)
Seat 9: Nico55KQ (big blind) folded on the Flop



PokerStars Hand #237375568552:  Hold'em No Limit ($0.01/$0.02 USD) - 2022/07/15 10:30:28 PT [2022/07/15 13:30:28 ET]
Table 'Appella II' 9-max Seat #8 is the button
Seat 1: prizrak_162 ($2.71 in chips) 
Seat 2: Blackpoker65 ($0.95 in chips) 
Seat 3: mkEmperor ($1.90 in chips) 
Seat 4: ll_n4no_ll ($3.16 in chips) 
Seat 5: Eltonn112 ($0.97 in chips) 
Seat 6: Zzzanderman ($2 in chips) 
Seat 7: meelis9 ($2 in chips) 
Seat 8: Dorex2007 ($4.01 in chips) 
Seat 9: Nico55KQ ($0.99 in chips) 
Nico55KQ: posts small blind $0.01
prizrak_162: posts big blind $0.02
Zzzanderman: posts big blind $0.02
*** HOLE CARDS ***
Dealt to Dorex2007 [2c 4c]
Blackpoker65: folds 
mkEmperor: folds 
ll_n4no_ll has timed out
ll_n4no_ll: folds 
Eltonn112: calls $0.02
Zzzanderman: checks 
meelis9: raises $0.08 to $0.10
Dorex2007: folds 
Nico55KQ: calls $0.09
prizrak_162: folds 
Eltonn112: folds 
Zzzanderman: folds 
*** FLOP *** [3c Kc 8h]
Nico55KQ: checks 
meelis9: bets $0.12
Nico55KQ: folds 
Uncalled bet ($0.12) returned to meelis9
meelis9 collected $0.25 from pot
*** SUMMARY ***
Total pot $0.26 | Rake $0.01 
Board [3c Kc 8h]
Seat 1: prizrak_162 (big blind) folded before Flop
Seat 2: Blackpoker65 folded before Flop (didn't bet)
Seat 3: mkEmperor folded before Flop (didn't bet)
Seat 4: ll_n4no_ll folded before Flop (didn't bet)
Seat 5: Eltonn112 folded before Flop
Seat 6: Zzzanderman folded before Flop (didn't bet)
Seat 7: meelis9 collected ($0.25)
Seat 8: Dorex2007 (button) folded before Flop (didn't bet)
Seat 9: Nico55KQ (small blind) folded on the Flop



PokerStars Hand #237375581803:  Hold'em No Limit ($0.01/$0.02 USD) - 2022/07/15 10:31:12 PT [2022/07/15 13:31:12 ET]
Table 'Appella II' 9-max Seat #9 is the button
Seat 1: prizrak_162 ($2.69 in chips) 
Seat 2: Blackpoker65 ($0.95 in chips) 
Seat 3: mkEmperor ($1.90 in chips) 
Seat 4: ll_n4no_ll ($3.16 in chips) 
Seat 5: Eltonn112 ($0.95 in chips) 
Seat 6: Zzzanderman ($1.98 in chips) 
Seat 7: meelis9 ($2.15 in chips) 
Seat 8: Dorex2007 ($4.01 in chips) 
Seat 9: Nico55KQ ($0.89 in chips) 
prizrak_162: posts small blind $0.01
Blackpoker65: posts big blind $0.02
*** HOLE CARDS ***
Dealt to Dorex2007 [Qs 8c]
mkEmperor: folds 
ll_n4no_ll: folds 
Eltonn112: calls $0.02
Zzzanderman has timed out
Zzzanderman: folds 
meelis9: folds 
Dorex2007: folds 
Nico55KQ: folds 
prizrak_162: folds 
Blackpoker65: checks 
*** FLOP *** [4h Ks 9h]
Blackpoker65: checks 
Eltonn112: checks 
*** TURN *** [4h Ks 9h] [5h]
Blackpoker65: checks 
Eltonn112: checks 
*** RIVER *** [4h Ks 9h 5h] [2c]
Blackpoker65: bets $0.05
Eltonn112: folds 
Uncalled bet ($0.05) returned to Blackpoker65
Blackpoker65 collected $0.05 from pot
*** SUMMARY ***
Total pot $0.05 | Rake $0 
Board [4h Ks 9h 5h 2c]
Seat 1: prizrak_162 (small blind) folded before Flop
Seat 2: Blackpoker65 (big blind) collected ($0.05)
Seat 3: mkEmperor folded before Flop (didn't bet)
Seat 4: ll_n4no_ll folded before Flop (didn't bet)
Seat 5: Eltonn112 folded on the River
Seat 6: Zzzanderman folded before Flop (didn't bet)
Seat 7: meelis9 folded before Flop (didn't bet)
Seat 8: Dorex2007 folded before Flop (didn't bet)
Seat 9: Nico55KQ (button) folded before Flop (didn't bet)



PokerStars Hand #237375603528:  Hold'em No Limit ($0.01/$0.02 USD) - 2022/07/15 10:32:07 PT [2022/07/15 13:32:07 ET]
Table 'Appella II' 9-max Seat #1 is the button
Seat 1: prizrak_162 ($2.68 in chips) 
Seat 2: Blackpoker65 ($0.98 in chips) 
Seat 3: mkEmperor ($1.90 in chips) 
Seat 4: ll_n4no_ll ($3.16 in chips) 
Seat 5: Eltonn112 ($0.93 in chips) 
Seat 6: Zzzanderman ($1.98 in chips) 
Seat 7: meelis9 ($2.15 in chips) 
Seat 8: Dorex2007 ($4.01 in chips) 
Seat 9: Nico55KQ ($0.89 in chips) 
Blackpoker65: posts small blind $0.01
mkEmperor: posts big blind $0.02
*** HOLE CARDS ***
Dealt to Dorex2007 [Ac 4c]
ll_n4no_ll: folds 
Eltonn112: calls $0.02
Zzzanderman: raises $0.07 to $0.09
meelis9: folds 
Dorex2007: folds 
Nico55KQ: calls $0.09
prizrak_162: calls $0.09
Blackpoker65: folds 
mkEmperor: folds 
Eltonn112: folds 
*** FLOP *** [7c 5s 4s]
Zzzanderman: bets $0.06
Nico55KQ: calls $0.06
prizrak_162: folds 
*** TURN *** [7c 5s 4s] [8h]
Zzzanderman: bets $0.04
Nico55KQ: calls $0.04
*** RIVER *** [7c 5s 4s 8h] [8d]
Zzzanderman: bets $0.06
Nico55KQ: raises $0.20 to $0.26
Zzzanderman: calls $0.20
*** SHOW DOWN ***
Nico55KQ: shows [Ad Td] (a pair of Eights)
Zzzanderman: shows [Qh Qc] (two pair, Queens and Eights)
Zzzanderman collected $1 from pot
*** SUMMARY ***
Total pot $1.04 | Rake $0.04 
Board [7c 5s 4s 8h 8d]
Seat 1: prizrak_162 (button) folded on the Flop
Seat 2: Blackpoker65 (small blind) folded before Flop
Seat 3: mkEmperor (big blind) folded before Flop
Seat 4: ll_n4no_ll folded before Flop (didn't bet)
Seat 5: Eltonn112 folded before Flop
Seat 6: Zzzanderman showed [Qh Qc] and won ($1) with two pair, Queens and Eights
Seat 7: meelis9 folded before Flop (didn't bet)
Seat 8: Dorex2007 folded before Flop (didn't bet)
Seat 9: Nico55KQ showed [Ad Td] and lost with a pair of Eights



PokerStars Hand #237375628823:  Hold'em No Limit ($0.01/$0.02 USD) - 2022/07/15 10:33:29 PT [2022/07/15 13:33:29 ET]
Table 'Appella II' 9-max Seat #2 is the button
Seat 1: prizrak_162 ($2.59 in chips) 
Seat 2: Blackpoker65 ($0.97 in chips) 
Seat 3: mkEmperor ($1.88 in chips) 
Seat 4: ll_n4no_ll ($3.16 in chips) 
Seat 5: Eltonn112 ($0.91 in chips) 
Seat 6: Zzzanderman ($2.53 in chips) 
Seat 8: Dorex2007 ($4.01 in chips) 
Seat 9: Nico55KQ ($0.44 in chips) 
mkEmperor: posts small blind $0.01
ll_n4no_ll: posts big blind $0.02
*** HOLE CARDS ***
Dealt to Dorex2007 [2c Qd]
Eltonn112: folds 
Zzzanderman: folds 
Dorex2007 has timed out
Dorex2007: folds 
Nico55KQ: raises $0.04 to $0.06
prizrak_162: folds 
Blackpoker65: calls $0.06
mkEmperor: folds 
ll_n4no_ll: calls $0.04
*** FLOP *** [5c Kc Kh]
ll_n4no_ll: checks 
Nico55KQ: bets $0.06
Blackpoker65: calls $0.06
ll_n4no_ll: folds 
*** TURN *** [5c Kc Kh] [Th]
Nico55KQ: checks 
Blackpoker65: checks 
*** RIVER *** [5c Kc Kh Th] [6c]
Nico55KQ: bets $0.32 and is all-in
Blackpoker65: calls $0.32
*** SHOW DOWN ***
Nico55KQ: shows [Td Ks] (a full house, Kings full of Tens)
Blackpoker65: shows [9c 3c] (a flush, King high)
Nico55KQ collected $0.91 from pot
*** SUMMARY ***
Total pot $0.95 | Rake $0.04 
Board [5c Kc Kh Th 6c]
Seat 1: prizrak_162 folded before Flop (didn't bet)
Seat 2: Blackpoker65 (button) showed [9c 3c] and lost with a flush, King high
Seat 3: mkEmperor (small blind) folded before Flop
Seat 4: ll_n4no_ll (big blind) folded on the Flop
Seat 5: Eltonn112 folded before Flop (didn't bet)
Seat 6: Zzzanderman folded before Flop (didn't bet)
Seat 8: Dorex2007 folded before Flop (didn't bet)
Seat 9: Nico55KQ showed [Td Ks] and won ($0.91) with a full house, Kings full of Tens



PokerStars Hand #237375648128:  Hold'em No Limit ($0.01/$0.02 USD) - 2022/07/15 10:34:32 PT [2022/07/15 13:34:32 ET]
Table 'Appella II' 9-max Seat #3 is the button
Seat 1: prizrak_162 ($2.59 in chips) 
Seat 2: Blackpoker65 ($0.53 in chips) 
Seat 3: mkEmperor ($1.87 in chips) 
Seat 4: ll_n4no_ll ($3.10 in chips) 
Seat 5: Eltonn112 ($0.91 in chips) 
Seat 6: Zzzanderman ($2.53 in chips) 
Seat 8: Dorex2007 ($4.01 in chips) 
Seat 9: Nico55KQ ($0.91 in chips) 
ll_n4no_ll: posts small blind $0.01
Eltonn112: posts big blind $0.02
*** HOLE CARDS ***
Dealt to Dorex2007 [Js 2d]
Zzzanderman: folds 
Dorex2007: folds 
Nico55KQ: folds 
prizrak_162: folds 
Blackpoker65: calls $0.02
mkEmperor: folds 
ll_n4no_ll: calls $0.01
Eltonn112: checks 
*** FLOP *** [9c 9h 4d]
ll_n4no_ll: checks 
Eltonn112: checks 
Blackpoker65: checks 
*** TURN *** [9c 9h 4d] [3c]
ll_n4no_ll: checks 
Eltonn112: bets $0.10
Blackpoker65: folds 
ll_n4no_ll: folds 
Uncalled bet ($0.10) returned to Eltonn112
Eltonn112 collected $0.06 from pot
*** SUMMARY ***
Total pot $0.06 | Rake $0 
Board [9c 9h 4d 3c]
Seat 1: prizrak_162 folded before Flop (didn't bet)
Seat 2: Blackpoker65 folded on the Turn
Seat 3: mkEmperor (button) folded before Flop (didn't bet)
Seat 4: ll_n4no_ll (small blind) folded on the Turn
Seat 5: Eltonn112 (big blind) collected ($0.06)
Seat 6: Zzzanderman folded before Flop (didn't bet)
Seat 8: Dorex2007 folded before Flop (didn't bet)
Seat 9: Nico55KQ folded before Flop (didn't bet)



PokerStars Hand #237375659046:  Hold'em No Limit ($0.01/$0.02 USD) - 2022/07/15 10:35:07 PT [2022/07/15 13:35:07 ET]
Table 'Appella II' 9-max Seat #4 is the button
Seat 1: prizrak_162 ($2.59 in chips) 
Seat 2: Blackpoker65 ($0.51 in chips) 
Seat 3: mkEmperor ($1.87 in chips) 
Seat 4: ll_n4no_ll ($3.08 in chips) 
Seat 5: Eltonn112 ($0.95 in chips) 
Seat 6: Zzzanderman ($2.53 in chips) 
Seat 8: Dorex2007 ($4.01 in chips) 
Seat 9: Nico55KQ ($0.91 in chips) 
Eltonn112: posts small blind $0.01
Zzzanderman: posts big blind $0.02
*** HOLE CARDS ***
Dealt to Dorex2007 [4h 5h]
Dorex2007: folds 
Nico55KQ: calls $0.02
prizrak_162: folds 
Blackpoker65: folds 
mkEmperor: folds 
ll_n4no_ll: folds 
Eltonn112: calls $0.01
Zzzanderman: checks 
*** FLOP *** [2h Ad 5s]
Eltonn112: bets $0.08
Zzzanderman: folds 
Nico55KQ: calls $0.08
*** TURN *** [2h Ad 5s] [3c]
Eltonn112: bets $0.08
Nico55KQ: calls $0.08
*** RIVER *** [2h Ad 5s 3c] [5c]
Eltonn112: bets $0.12
Nico55KQ: calls $0.12
*** SHOW DOWN ***
Eltonn112: shows [8c 2s] (two pair, Fives and Deuces)
Nico55KQ: shows [8d As] (two pair, Aces and Fives)
Nico55KQ collected $0.60 from pot
*** SUMMARY ***
Total pot $0.62 | Rake $0.02 
Board [2h Ad 5s 3c 5c]
Seat 1: prizrak_162 folded before Flop (didn't bet)
Seat 2: Blackpoker65 folded before Flop (didn't bet)
Seat 3: mkEmperor folded before Flop (didn't bet)
Seat 4: ll_n4no_ll (button) folded before Flop (didn't bet)
Seat 5: Eltonn112 (small blind) showed [8c 2s] and lost with two pair, Fives and Deuces
Seat 6: Zzzanderman (big blind) folded on the Flop
Seat 8: Dorex2007 folded before Flop (didn't bet)
Seat 9: Nico55KQ showed [8d As] and won ($0.60) with two pair, Aces and Fives



PokerStars Hand #237375673768:  Hold'em No Limit ($0.01/$0.02 USD) - 2022/07/15 10:35:54 PT [2022/07/15 13:35:54 ET]
Table 'Appella II' 9-max Seat #5 is the button
Seat 1: prizrak_162 ($2.59 in chips) 
Seat 2: Blackpoker65 ($0.51 in chips) 
Seat 3: mkEmperor ($1.87 in chips) 
Seat 4: ll_n4no_ll ($3.08 in chips) 
Seat 5: Eltonn112 ($0.65 in chips) 
Seat 6: Zzzanderman ($2.51 in chips) 
Seat 7: meelis9 ($2.15 in chips) 
Seat 8: Dorex2007 ($4.01 in chips) 
Seat 9: Nico55KQ ($1.21 in chips) 
Zzzanderman: posts small blind $0.01
meelis9: posts big blind $0.02
*** HOLE CARDS ***
Dealt to Dorex2007 [2d Tc]
Dorex2007: folds 
Nico55KQ: calls $0.02
prizrak_162: folds 
Blackpoker65: folds 
mkEmperor: calls $0.02
ll_n4no_ll: folds 
Eltonn112: folds 
Zzzanderman: folds 
meelis9: checks 
*** FLOP *** [4c 7h Ts]
meelis9: checks 
Nico55KQ: checks 
mkEmperor: bets $0.04
meelis9: folds 
Nico55KQ: calls $0.04
*** TURN *** [4c 7h Ts] [7d]
Nico55KQ: checks 
mkEmperor: bets $0.04
Nico55KQ: folds 
Uncalled bet ($0.04) returned to mkEmperor
mkEmperor collected $0.14 from pot
*** SUMMARY ***
Total pot $0.15 | Rake $0.01 
Board [4c 7h Ts 7d]
Seat 1: prizrak_162 folded before Flop (didn't bet)
Seat 2: Blackpoker65 folded before Flop (didn't bet)
Seat 3: mkEmperor collected ($0.14)
Seat 4: ll_n4no_ll folded before Flop (didn't bet)
Seat 5: Eltonn112 (button) folded before Flop (didn't bet)
Seat 6: Zzzanderman (small blind) folded before Flop
Seat 7: meelis9 (big blind) folded on the Flop
Seat 8: Dorex2007 folded before Flop (didn't bet)
Seat 9: Nico55KQ folded on the Turn



PokerStars Hand #237375689761:  Hold'em No Limit ($0.01/$0.02 USD) - 2022/07/15 10:36:46 PT [2022/07/15 13:36:46 ET]
Table 'Appella II' 9-max Seat #6 is the button
Seat 1: prizrak_162 ($2.59 in chips) 
Seat 2: Blackpoker65 ($0.51 in chips) 
Seat 3: mkEmperor ($1.95 in chips) 
Seat 4: ll_n4no_ll ($3.08 in chips) 
Seat 5: Eltonn112 ($0.65 in chips) 
Seat 6: Zzzanderman ($2.50 in chips) 
Seat 7: meelis9 ($2.13 in chips) 
Seat 8: Dorex2007 ($4.01 in chips) 
Seat 9: Nico55KQ ($1.15 in chips) 
meelis9: posts small blind $0.01
Dorex2007: posts big blind $0.02
*** HOLE CARDS ***
Dealt to Dorex2007 [Kd 4c]
Nico55KQ: calls $0.02
prizrak_162: folds 
Blackpoker65: folds 
mkEmperor: folds 
ll_n4no_ll: folds 
Eltonn112: calls $0.02
Zzzanderman: folds 
meelis9: folds 
Dorex2007: checks 
*** FLOP *** [4h 8d Kh]
Dorex2007: bets $0.08
Nico55KQ: folds 
Eltonn112: calls $0.08
*** TURN *** [4h 8d Kh] [5c]
Dorex2007: bets $3.91 and is all-in
Eltonn112: folds 
Uncalled bet ($3.91) returned to Dorex2007
Dorex2007 collected $0.22 from pot
*** SUMMARY ***
Total pot $0.23 | Rake $0.01 
Board [4h 8d Kh 5c]
Seat 1: prizrak_162 folded before Flop (didn't bet)
Seat 2: Blackpoker65 folded before Flop (didn't bet)
Seat 3: mkEmperor folded before Flop (didn't bet)
Seat 4: ll_n4no_ll folded before Flop (didn't bet)
Seat 5: Eltonn112 folded on the Turn
Seat 6: Zzzanderman (button) folded before Flop (didn't bet)
Seat 7: meelis9 (small blind) folded before Flop
Seat 8: Dorex2007 (big blind) collected ($0.22)
Seat 9: Nico55KQ folded on the Flop



PokerStars Hand #237375705151:  Hold'em No Limit ($0.01/$0.02 USD) - 2022/07/15 10:37:36 PT [2022/07/15 13:37:36 ET]
Table 'Appella II' 9-max Seat #7 is the button
Seat 1: prizrak_162 ($2.59 in chips) 
Seat 2: Blackpoker65 ($0.51 in chips) 
Seat 3: mkEmperor ($1.95 in chips) 
Seat 4: ll_n4no_ll ($3.08 in chips) 
Seat 5: Eltonn112 ($0.55 in chips) 
Seat 6: Zzzanderman ($2.50 in chips) 
Seat 7: meelis9 ($2.12 in chips) 
Seat 8: Dorex2007 ($4.13 in chips) 
Seat 9: Nico55KQ ($1.13 in chips) 
Dorex2007: posts small blind $0.01
Nico55KQ: posts big blind $0.02
*** HOLE CARDS ***
Dealt to Dorex2007 [8d 7c]
prizrak_162: folds 
Blackpoker65: folds 
mkEmperor: folds 
ll_n4no_ll: folds 
Eltonn112: calls $0.02
Zzzanderman: folds 
meelis9: folds 
Dorex2007: folds 
Nico55KQ: raises $0.06 to $0.08
Eltonn112: folds 
Uncalled bet ($0.06) returned to Nico55KQ
Nico55KQ collected $0.05 from pot
*** SUMMARY ***
Total pot $0.05 | Rake $0 
Seat 1: prizrak_162 folded before Flop (didn't bet)
Seat 2: Blackpoker65 folded before Flop (didn't bet)
Seat 3: mkEmperor folded before Flop (didn't bet)
Seat 4: ll_n4no_ll folded before Flop (didn't bet)
Seat 5: Eltonn112 folded before Flop
Seat 6: Zzzanderman folded before Flop (didn't bet)
Seat 7: meelis9 (button) folded before Flop (didn't bet)
Seat 8: Dorex2007 (small blind) folded before Flop
Seat 9: Nico55KQ (big blind) collected ($0.05)



PokerStars Hand #237375712029:  Hold'em No Limit ($0.01/$0.02 USD) - 2022/07/15 10:37:59 PT [2022/07/15 13:37:59 ET]
Table 'Appella II' 9-max Seat #8 is the button
Seat 1: prizrak_162 ($2.59 in chips) 
Seat 2: Blackpoker65 ($0.51 in chips) 
Seat 3: mkEmperor ($1.95 in chips) 
Seat 4: ll_n4no_ll ($3.08 in chips) 
Seat 5: Eltonn112 ($0.53 in chips) 
Seat 6: Zzzanderman ($2.50 in chips) 
Seat 7: meelis9 ($2.12 in chips) 
Seat 8: Dorex2007 ($4.12 in chips) 
Seat 9: Nico55KQ ($1.16 in chips) 
Nico55KQ: posts small blind $0.01
prizrak_162: posts big blind $0.02
*** HOLE CARDS ***
Dealt to Dorex2007 [Qs Qh]
Blackpoker65 has timed out
Blackpoker65: folds 
mkEmperor: folds 
ll_n4no_ll: folds 
Eltonn112: folds 
Zzzanderman: folds 
meelis9: folds 
Dorex2007: raises $0.06 to $0.08
Nico55KQ: calls $0.07
prizrak_162: folds 
*** FLOP *** [Kh 6h 8h]
Nico55KQ: checks 
Dorex2007: bets $0.08
Nico55KQ: raises $0.08 to $0.16
Dorex2007: calls $0.08
*** TURN *** [Kh 6h 8h] [Kc]
Nico55KQ: checks 
Dorex2007: checks 
*** RIVER *** [Kh 6h 8h Kc] [4d]
Nico55KQ: bets $0.24
Dorex2007: folds 
Uncalled bet ($0.24) returned to Nico55KQ
Nico55KQ collected $0.48 from pot
*** SUMMARY ***
Total pot $0.50 | Rake $0.02 
Board [Kh 6h 8h Kc 4d]
Seat 1: prizrak_162 (big blind) folded before Flop
Seat 2: Blackpoker65 folded before Flop (didn't bet)
Seat 3: mkEmperor folded before Flop (didn't bet)
Seat 4: ll_n4no_ll folded before Flop (didn't bet)
Seat 5: Eltonn112 folded before Flop (didn't bet)
Seat 6: Zzzanderman folded before Flop (didn't bet)
Seat 7: meelis9 folded before Flop (didn't bet)
Seat 8: Dorex2007 (button) folded on the River
Seat 9: Nico55KQ (small blind) collected ($0.48)



PokerStars Hand #237375730269:  Hold'em No Limit ($0.01/$0.02 USD) - 2022/07/15 10:38:57 PT [2022/07/15 13:38:57 ET]
Table 'Appella II' 9-max Seat #9 is the button
Seat 1: prizrak_162 ($2.57 in chips) 
Seat 2: Blackpoker65 ($0.51 in chips) 
Seat 3: mkEmperor ($1.95 in chips) 
Seat 4: ll_n4no_ll ($3.08 in chips) 
Seat 5: Eltonn112 ($0.53 in chips) 
Seat 6: Zzzanderman ($2.50 in chips) 
Seat 7: meelis9 ($2.12 in chips) 
Seat 8: Dorex2007 ($3.88 in chips) 
Seat 9: Nico55KQ ($1.40 in chips) 
prizrak_162: posts small blind $0.01
Blackpoker65: posts big blind $0.02
*** HOLE CARDS ***
Dealt to Dorex2007 [4c 6h]
mkEmperor: folds 
mkEmperor leaves the table
ll_n4no_ll has timed out
ll_n4no_ll: folds 
Eltonn112: folds 
Zzzanderman: calls $0.02
meelis9: raises $0.06 to $0.08
Dorex2007: folds 
Nico55KQ: folds 
prizrak_162: folds 
Blackpoker65: folds 
Zzzanderman: calls $0.06
*** FLOP *** [5h Ad Ac]
Zzzanderman: checks 
meelis9: bets $0.09
Zzzanderman: folds 
Uncalled bet ($0.09) returned to meelis9
meelis9 collected $0.18 from pot
*** SUMMARY ***
Total pot $0.19 | Rake $0.01 
Board [5h Ad Ac]
Seat 1: prizrak_162 (small blind) folded before Flop
Seat 2: Blackpoker65 (big blind) folded before Flop
Seat 3: mkEmperor folded before Flop (didn't bet)
Seat 4: ll_n4no_ll folded before Flop (didn't bet)
Seat 5: Eltonn112 folded before Flop (didn't bet)
Seat 6: Zzzanderman folded on the Flop
Seat 7: meelis9 collected ($0.18)
Seat 8: Dorex2007 folded before Flop (didn't bet)
Seat 9: Nico55KQ (button) folded before Flop (didn't bet)



PokerStars Hand #237375745644:  Hold'em No Limit ($0.01/$0.02 USD) - 2022/07/15 10:39:46 PT [2022/07/15 13:39:46 ET]
Table 'Appella II' 9-max Seat #1 is the button
Seat 1: prizrak_162 ($2.56 in chips) 
Seat 2: Blackpoker65 ($0.49 in chips) 
Seat 4: ll_n4no_ll ($3.08 in chips) 
Seat 5: Eltonn112 ($0.53 in chips) 
Seat 6: Zzzanderman ($2.42 in chips) 
Seat 7: meelis9 ($2.22 in chips) 
Seat 8: Dorex2007 ($3.88 in chips) 
Seat 9: Nico55KQ ($1.40 in chips) 
Blackpoker65: posts small blind $0.01
ll_n4no_ll: posts big blind $0.02
*** HOLE CARDS ***
Dealt to Dorex2007 [6c Kc]
Eltonn112: folds 
Zzzanderman: folds 
meelis9: folds 
Dorex2007: calls $0.02
miffay joins the table at seat #3 
Nico55KQ: calls $0.02
prizrak_162: folds 
Blackpoker65: calls $0.01
miffay leaves the table
ll_n4no_ll: checks 
*** FLOP *** [Ah As Tc]
Blackpoker65: checks 
ll_n4no_ll: checks 
Dorex2007: checks 
Nico55KQ: checks 
*** TURN *** [Ah As Tc] [2c]
Blackpoker65: checks 
ll_n4no_ll: checks 
Dorex2007: checks 
Nico55KQ: checks 
*** RIVER *** [Ah As Tc 2c] [3s]
Blackpoker65: checks 
ll_n4no_ll: checks 
Dorex2007: checks 
Radiergummi0 joins the table at seat #3 
Nico55KQ: bets $0.04
Blackpoker65: folds 
ll_n4no_ll: folds 
Dorex2007: folds 
Uncalled bet ($0.04) returned to Nico55KQ
Nico55KQ collected $0.08 from pot
*** SUMMARY ***
Total pot $0.08 | Rake $0 
Board [Ah As Tc 2c 3s]
Seat 1: prizrak_162 (button) folded before Flop (didn't bet)
Seat 2: Blackpoker65 (small blind) folded on the River
Seat 4: ll_n4no_ll (big blind) folded on the River
Seat 5: Eltonn112 folded before Flop (didn't bet)
Seat 6: Zzzanderman folded before Flop (didn't bet)
Seat 7: meelis9 folded before Flop (didn't bet)
Seat 8: Dorex2007 folded on the River
Seat 9: Nico55KQ collected ($0.08)



PokerStars Hand #237375758795:  Hold'em No Limit ($0.01/$0.02 USD) - 2022/07/15 10:40:29 PT [2022/07/15 13:40:29 ET]
Table 'Appella II' 9-max Seat #2 is the button
Seat 1: prizrak_162 ($2.56 in chips) 
Seat 2: Blackpoker65 ($0.47 in chips) 
Seat 4: ll_n4no_ll ($3.06 in chips) 
Seat 5: Eltonn112 ($0.53 in chips) 
Seat 7: meelis9 ($2.22 in chips) 
Seat 8: Dorex2007 ($3.86 in chips) 
Seat 9: Nico55KQ ($1.46 in chips) 
ll_n4no_ll: posts small blind $0.01
Eltonn112: posts big blind $0.02
*** HOLE CARDS ***
Dealt to Dorex2007 [3d 6c]
meelis9: raises $0.04 to $0.06
Dorex2007: folds 
Nico55KQ: calls $0.06
prizrak_162: calls $0.06
Blackpoker65: calls $0.06
ll_n4no_ll: folds 
Eltonn112: folds 
*** FLOP *** [8h Ad 9d]
meelis9: checks 
Nico55KQ: checks 
prizrak_162: checks 
Blackpoker65: bets $0.26
meelis9: folds 
Nico55KQ: folds 
prizrak_162: raises $0.26 to $0.52
Blackpoker65: calls $0.15 and is all-in
Uncalled bet ($0.11) returned to prizrak_162
*** TURN *** [8h Ad 9d] [4s]
*** RIVER *** [8h Ad 9d 4s] [3s]
*** SHOW DOWN ***
prizrak_162: shows [5h Ah] (a pair of Aces)
Blackpoker65: shows [5c 8c] (a pair of Eights)
prizrak_162 collected $1.05 from pot
*** SUMMARY ***
Total pot $1.09 | Rake $0.04 
Board [8h Ad 9d 4s 3s]
Seat 1: prizrak_162 showed [5h Ah] and won ($1.05) with a pair of Aces
Seat 2: Blackpoker65 (button) showed [5c 8c] and lost with a pair of Eights
Seat 4: ll_n4no_ll (small blind) folded before Flop
Seat 5: Eltonn112 (big blind) folded before Flop
Seat 7: meelis9 folded on the Flop
Seat 8: Dorex2007 folded before Flop (didn't bet)
Seat 9: Nico55KQ folded on the Flop



PokerStars Hand #237375777111:  Hold'em No Limit ($0.01/$0.02 USD) - 2022/07/15 10:41:28 PT [2022/07/15 13:41:28 ET]
Table 'Appella II' 9-max Seat #4 is the button
Seat 1: prizrak_162 ($3.14 in chips) 
Seat 4: ll_n4no_ll ($3.05 in chips) 
Seat 5: Eltonn112 ($0.51 in chips) 
Seat 7: meelis9 ($2.16 in chips) 
Seat 8: Dorex2007 ($3.86 in chips) 
Seat 9: Nico55KQ ($1.40 in chips) 
Eltonn112: posts small blind $0.01
meelis9: posts big blind $0.02
Radiergummi0: sits out 
*** HOLE CARDS ***
Dealt to Dorex2007 [Ts Qd]
Blackpoker65 leaves the table
Dorex2007: calls $0.02
Nico55KQ: folds 
prizrak_162: calls $0.02
ll_n4no_ll: folds 
Eltonn112: calls $0.01
meelis9: checks 
*** FLOP *** [4s 4c 5d]
Eltonn112: bets $0.10
meelis9: folds 
Dorex2007: folds 
prizrak_162: folds 
Uncalled bet ($0.10) returned to Eltonn112
Eltonn112 collected $0.08 from pot
*** SUMMARY ***
Total pot $0.08 | Rake $0 
Board [4s 4c 5d]
Seat 1: prizrak_162 folded on the Flop
Seat 4: ll_n4no_ll (button) folded before Flop (didn't bet)
Seat 5: Eltonn112 (small blind) collected ($0.08)
Seat 7: meelis9 (big blind) folded on the Flop
Seat 8: Dorex2007 folded on the Flop
Seat 9: Nico55KQ folded before Flop (didn't bet)



PokerStars Hand #237375787234:  Hold'em No Limit ($0.01/$0.02 USD) - 2022/07/15 10:42:01 PT [2022/07/15 13:42:01 ET]
Table 'Appella II' 9-max Seat #5 is the button
Seat 1: prizrak_162 ($3.12 in chips) 
Seat 4: ll_n4no_ll ($3.05 in chips) 
Seat 5: Eltonn112 ($0.57 in chips) 
Seat 7: meelis9 ($2.14 in chips) 
Seat 8: Dorex2007 ($3.84 in chips) 
Seat 9: Nico55KQ ($1.40 in chips) 
meelis9: posts small blind $0.01
Dorex2007: posts big blind $0.02
Radiergummi0: sits out 
*** HOLE CARDS ***
Dealt to Dorex2007 [Qc 9c]
Nico55KQ: calls $0.02
Fabio.BR.sjc joins the table at seat #2 
prizrak_162: folds 
ll_n4no_ll: folds 
Eltonn112: folds 
meelis9: folds 
Dorex2007: checks 
*** FLOP *** [3s 6h Qs]
Dorex2007: bets $0.05
Nico55KQ: folds 
Uncalled bet ($0.05) returned to Dorex2007
Dorex2007 collected $0.05 from pot
*** SUMMARY ***
Total pot $0.05 | Rake $0 
Board [3s 6h Qs]
Seat 1: prizrak_162 folded before Flop (didn't bet)
Seat 4: ll_n4no_ll folded before Flop (didn't bet)
Seat 5: Eltonn112 (button) folded before Flop (didn't bet)
Seat 7: meelis9 (small blind) folded before Flop
Seat 8: Dorex2007 (big blind) collected ($0.05)
Seat 9: Nico55KQ folded on the Flop



PokerStars Hand #237375797644:  Hold'em No Limit ($0.01/$0.02 USD) - 2022/07/15 10:42:34 PT [2022/07/15 13:42:34 ET]
Table 'Appella II' 9-max Seat #7 is the button
Seat 1: prizrak_162 ($3.12 in chips) 
Seat 2: Fabio.BR.sjc ($1.60 in chips) 
Seat 4: ll_n4no_ll ($3.05 in chips) 
Seat 5: Eltonn112 ($0.57 in chips) 
Seat 7: meelis9 ($2.13 in chips) 
Seat 8: Dorex2007 ($3.87 in chips) 
Seat 9: Nico55KQ ($1.38 in chips) 
Dorex2007: posts small blind $0.01
Nico55KQ: posts big blind $0.02
Fabio.BR.sjc: posts big blind $0.02
Radiergummi0: sits out 
*** HOLE CARDS ***
Dealt to Dorex2007 [Tc Th]
prizrak_162: folds 
Fabio.BR.sjc: raises $0.02 to $0.04
ll_n4no_ll: folds 
Eltonn112: calls $0.04
meelis9: folds 
Dorex2007: raises $0.12 to $0.16
Nico55KQ: folds 
Fabio.BR.sjc: calls $0.12
Eltonn112: folds 
*** FLOP *** [Jh Qd 7s]
Nico55KQ leaves the table
Dorex2007: bets $0.25
Fabio.BR.sjc: raises $0.25 to $0.50
Dorex2007: folds 
Uncalled bet ($0.25) returned to Fabio.BR.sjc
Fabio.BR.sjc collected $0.85 from pot
*** SUMMARY ***
Total pot $0.88 | Rake $0.03 
Board [Jh Qd 7s]
Seat 1: prizrak_162 folded before Flop (didn't bet)
Seat 2: Fabio.BR.sjc collected ($0.85)
Seat 4: ll_n4no_ll folded before Flop (didn't bet)
Seat 5: Eltonn112 folded before Flop
Seat 7: meelis9 (button) folded before Flop (didn't bet)
Seat 8: Dorex2007 (small blind) folded on the Flop
Seat 9: Nico55KQ (big blind) folded before Flop



PokerStars Hand #237375813152:  Hold'em No Limit ($0.01/$0.02 USD) - 2022/07/15 10:43:25 PT [2022/07/15 13:43:25 ET]
Table 'Appella II' 9-max Seat #8 is the button
Seat 1: prizrak_162 ($3.12 in chips) 
Seat 2: Fabio.BR.sjc ($2.04 in chips) 
Seat 4: ll_n4no_ll ($3.05 in chips) 
Seat 5: Eltonn112 ($0.53 in chips) 
Seat 6: Zzzanderman ($2.42 in chips) 
Seat 7: meelis9 ($2.13 in chips) 
Seat 8: Dorex2007 ($3.46 in chips) 
prizrak_162: posts small blind $0.01
Fabio.BR.sjc: posts big blind $0.02
Radiergummi0: sits out 
Zzzanderman: posts small & big blinds $0.03
*** HOLE CARDS ***
Dealt to Dorex2007 [7c Kc]
ll_n4no_ll: folds 
Eltonn112: folds 
Lymnhades joins the table at seat #9 
Zzzanderman has timed out
Zzzanderman: checks 
meelis9: folds 
Dorex2007: calls $0.02
prizrak_162: folds 
Fabio.BR.sjc: checks 
*** FLOP *** [5d 4h As]
Fabio.BR.sjc: bets $0.04
Zzzanderman: folds 
Dorex2007: folds 
Uncalled bet ($0.04) returned to Fabio.BR.sjc
Fabio.BR.sjc collected $0.08 from pot
*** SUMMARY ***
Total pot $0.08 | Rake $0 
Board [5d 4h As]
Seat 1: prizrak_162 (small blind) folded before Flop
Seat 2: Fabio.BR.sjc (big blind) collected ($0.08)
Seat 4: ll_n4no_ll folded before Flop (didn't bet)
Seat 5: Eltonn112 folded before Flop (didn't bet)
Seat 6: Zzzanderman folded on the Flop (didn't bet)
Seat 7: meelis9 folded before Flop (didn't bet)
Seat 8: Dorex2007 (button) folded on the Flop



PokerStars Hand #237375827724:  Hold'em No Limit ($0.01/$0.02 USD) - 2022/07/15 10:44:11 PT [2022/07/15 13:44:11 ET]
Table 'Appella II' 9-max Seat #1 is the button
Seat 1: prizrak_162 ($3.11 in chips) 
Seat 2: Fabio.BR.sjc ($2.10 in chips) 
Seat 3: Radiergummi0 ($1 in chips) 
Seat 4: ll_n4no_ll ($3.05 in chips) 
Seat 5: Eltonn112 ($0.53 in chips) 
Seat 6: Zzzanderman ($2.39 in chips) 
Seat 7: meelis9 ($2.13 in chips) 
Seat 8: Dorex2007 ($3.44 in chips) 
Seat 9: Lymnhades ($2 in chips) 
Fabio.BR.sjc: posts small blind $0.01
Radiergummi0: posts big blind $0.02
Lymnhades: posts big blind $0.02
*** HOLE CARDS ***
Dealt to Dorex2007 [As 2h]
ll_n4no_ll: folds 
Eltonn112: calls $0.02
Zzzanderman: folds 
meelis9: folds 
Dorex2007: folds 
Lymnhades: checks 
prizrak_162: folds 
Fabio.BR.sjc: raises $0.02 to $0.04
Radiergummi0: calls $0.02
Eltonn112: calls $0.02
Lymnhades: calls $0.02
*** FLOP *** [3h 4c 2c]
Fabio.BR.sjc: checks 
Radiergummi0: checks 
Eltonn112: bets $0.18
Lymnhades: folds 
Fabio.BR.sjc: folds 
Radiergummi0: raises $0.18 to $0.36
Eltonn112: raises $0.13 to $0.49 and is all-in
Radiergummi0: calls $0.13
*** TURN *** [3h 4c 2c] [5c]
*** RIVER *** [3h 4c 2c 5c] [7h]
*** SHOW DOWN ***
Radiergummi0: shows [Ad 5d] (a straight, Ace to Five)
Eltonn112: shows [Jh 9d] (high card Jack)
Radiergummi0 cashed out the hand for $1.08 | Cash Out Fee $0.01
*** SUMMARY ***
Total pot $1.14 | Rake $0.04 
Board [3h 4c 2c 5c 7h]
Seat 1: prizrak_162 (button) folded before Flop (didn't bet)
Seat 2: Fabio.BR.sjc (small blind) folded on the Flop
Seat 3: Radiergummi0 (big blind) showed [Ad 5d] and won ($1.10) with a straight, Ace to Five (pot not awarded as player cashed out)
Seat 4: ll_n4no_ll folded before Flop (didn't bet)
Seat 5: Eltonn112 showed [Jh 9d] and lost with high card Jack
Seat 6: Zzzanderman folded before Flop (didn't bet)
Seat 7: meelis9 folded before Flop (didn't bet)
Seat 8: Dorex2007 folded before Flop (didn't bet)
Seat 9: Lymnhades folded on the Flop



PokerStars Hand #237375854868:  Hold'em No Limit ($0.01/$0.02 USD) - 2022/07/15 10:45:40 PT [2022/07/15 13:45:40 ET]
Table 'Appella II' 9-max Seat #2 is the button
Seat 1: prizrak_162 ($3.11 in chips) 
Seat 2: Fabio.BR.sjc ($2.06 in chips) 
Seat 3: Radiergummi0 ($1.55 in chips) 
Seat 4: ll_n4no_ll ($3.05 in chips) 
Seat 6: Zzzanderman ($2.39 in chips) 
Seat 7: meelis9 ($2.13 in chips) 
Seat 8: Dorex2007 ($3.44 in chips) 
Seat 9: Lymnhades ($1.96 in chips) 
Radiergummi0: posts small blind $0.01
ll_n4no_ll: posts big blind $0.02
*** HOLE CARDS ***
Dealt to Dorex2007 [4h Kh]
Zzzanderman: folds 
meelis9: raises $0.04 to $0.06
Dorex2007: folds 
Lymnhades: folds 
prizrak_162: folds 
Fabio.BR.sjc: folds 
Radiergummi0: folds 
ll_n4no_ll: calls $0.04
*** FLOP *** [4s 8d 9s]
ll_n4no_ll: bets $0.08
meelis9: calls $0.08
*** TURN *** [4s 8d 9s] [Qd]
ll_n4no_ll: checks 
meelis9: bets $0.14
ll_n4no_ll: calls $0.14
*** RIVER *** [4s 8d 9s Qd] [2s]
ll_n4no_ll: checks 
meelis9: checks 
*** SHOW DOWN ***
ll_n4no_ll: shows [Jd Js] (a pair of Jacks)
meelis9: mucks hand 
ll_n4no_ll collected $0.55 from pot
*** SUMMARY ***
Total pot $0.57 | Rake $0.02 
Board [4s 8d 9s Qd 2s]
Seat 1: prizrak_162 folded before Flop (didn't bet)
Seat 2: Fabio.BR.sjc (button) folded before Flop (didn't bet)
Seat 3: Radiergummi0 (small blind) folded before Flop
Seat 4: ll_n4no_ll (big blind) showed [Jd Js] and won ($0.55) with a pair of Jacks
Seat 6: Zzzanderman folded before Flop (didn't bet)
Seat 7: meelis9 mucked [6c 6d]
Seat 8: Dorex2007 folded before Flop (didn't bet)
Seat 9: Lymnhades folded before Flop (didn't bet)



PokerStars Hand #237375868559:  Hold'em No Limit ($0.01/$0.02 USD) - 2022/07/15 10:46:24 PT [2022/07/15 13:46:24 ET]
Table 'Appella II' 9-max Seat #3 is the button
Seat 1: prizrak_162 ($3.11 in chips) 
Seat 2: Fabio.BR.sjc ($2.06 in chips) 
Seat 3: Radiergummi0 ($1.54 in chips) 
Seat 4: ll_n4no_ll ($3.32 in chips) 
Seat 6: Zzzanderman ($2.39 in chips) 
Seat 7: meelis9 ($2 in chips) 
Seat 8: Dorex2007 ($3.44 in chips) 
Seat 9: Lymnhades ($1.96 in chips) 
ll_n4no_ll: posts small blind $0.01
Zzzanderman: posts big blind $0.02
*** HOLE CARDS ***
Dealt to Dorex2007 [2d 4s]
meelis9: folds 
Eltonn112 leaves the table
Dorex2007: folds 
Lymnhades: raises $0.04 to $0.06
Shahta-16 joins the table at seat #5 
prizrak_162: folds 
Fabio.BR.sjc: calls $0.06
Radiergummi0: folds 
ll_n4no_ll: folds 
Zzzanderman: calls $0.04
*** FLOP *** [Qh Tc Qc]
Zzzanderman: checks 
Lymnhades: bets $0.09
Fabio.BR.sjc: folds 
Zzzanderman: folds 
Uncalled bet ($0.09) returned to Lymnhades
Lymnhades collected $0.18 from pot
*** SUMMARY ***
Total pot $0.19 | Rake $0.01 
Board [Qh Tc Qc]
Seat 1: prizrak_162 folded before Flop (didn't bet)
Seat 2: Fabio.BR.sjc folded on the Flop
Seat 3: Radiergummi0 (button) folded before Flop (didn't bet)
Seat 4: ll_n4no_ll (small blind) folded before Flop
Seat 6: Zzzanderman (big blind) folded on the Flop
Seat 7: meelis9 folded before Flop (didn't bet)
Seat 8: Dorex2007 folded before Flop (didn't bet)
Seat 9: Lymnhades collected ($0.18)



PokerStars Hand #237375882664:  Hold'em No Limit ($0.01/$0.02 USD) - 2022/07/15 10:47:10 PT [2022/07/15 13:47:10 ET]
Table 'Appella II' 9-max Seat #4 is the button
Seat 1: prizrak_162 ($3.11 in chips) 
Seat 2: Fabio.BR.sjc ($2 in chips) 
Seat 3: Radiergummi0 ($1.54 in chips) 
Seat 4: ll_n4no_ll ($3.31 in chips) 
Seat 6: Zzzanderman ($2.33 in chips) 
Seat 7: meelis9 ($2 in chips) 
Seat 8: Dorex2007 ($3.44 in chips) 
Seat 9: Lymnhades ($2.08 in chips) 
Zzzanderman: posts small blind $0.01
meelis9: posts big blind $0.02
*** HOLE CARDS ***
Dealt to Dorex2007 [3d Ah]
Dorex2007: folds 
Lymnhades: folds 
prizrak_162: folds 
Fabio.BR.sjc: raises $0.02 to $0.04
Radiergummi0: folds 
ll_n4no_ll: folds 
Zzzanderman: calls $0.03
meelis9: folds 
*** FLOP *** [4c Ts 8h]
Zzzanderman: bets $2.29 and is all-in
Fabio.BR.sjc: folds 
Uncalled bet ($2.29) returned to Zzzanderman
Zzzanderman collected $0.10 from pot
*** SUMMARY ***
Total pot $0.10 | Rake $0 
Board [4c Ts 8h]
Seat 1: prizrak_162 folded before Flop (didn't bet)
Seat 2: Fabio.BR.sjc folded on the Flop
Seat 3: Radiergummi0 folded before Flop (didn't bet)
Seat 4: ll_n4no_ll (button) folded before Flop (didn't bet)
Seat 6: Zzzanderman (small blind) collected ($0.10)
Seat 7: meelis9 (big blind) folded before Flop
Seat 8: Dorex2007 folded before Flop (didn't bet)
Seat 9: Lymnhades folded before Flop (didn't bet)



PokerStars Hand #237375898665:  Hold'em No Limit ($0.01/$0.02 USD) - 2022/07/15 10:48:03 PT [2022/07/15 13:48:03 ET]
Table 'Appella II' 9-max Seat #6 is the button
Seat 1: prizrak_162 ($3.11 in chips) 
Seat 2: Fabio.BR.sjc ($1.96 in chips) 
Seat 3: Radiergummi0 ($1.54 in chips) 
Seat 4: ll_n4no_ll ($3.31 in chips) 
Seat 6: Zzzanderman ($2.39 in chips) 
Seat 7: meelis9 ($2 in chips) 
Seat 8: Dorex2007 ($3.44 in chips) 
Seat 9: Lymnhades ($2.08 in chips) 
meelis9: posts small blind $0.01
Dorex2007: posts big blind $0.02
Shahta-16: sits out 
*** HOLE CARDS ***
Dealt to Dorex2007 [Kh 9s]
Lymnhades: folds 
prizrak_162: folds 
Fabio.BR.sjc: folds 
Radiergummi0: folds 
ll_n4no_ll: folds 
Zzzanderman: folds 
meelis9: folds 
Uncalled bet ($0.01) returned to Dorex2007
Dorex2007 collected $0.02 from pot
*** SUMMARY ***
Total pot $0.02 | Rake $0 
Seat 1: prizrak_162 folded before Flop (didn't bet)
Seat 2: Fabio.BR.sjc folded before Flop (didn't bet)
Seat 3: Radiergummi0 folded before Flop (didn't bet)
Seat 4: ll_n4no_ll folded before Flop (didn't bet)
Seat 6: Zzzanderman (button) folded before Flop (didn't bet)
Seat 7: meelis9 (small blind) folded before Flop
Seat 8: Dorex2007 (big blind) collected ($0.02)
Seat 9: Lymnhades folded before Flop (didn't bet)



PokerStars Hand #237375903635:  Hold'em No Limit ($0.01/$0.02 USD) - 2022/07/15 10:48:19 PT [2022/07/15 13:48:19 ET]
Table 'Appella II' 9-max Seat #7 is the button
Seat 1: prizrak_162 ($3.11 in chips) 
Seat 2: Fabio.BR.sjc ($1.96 in chips) 
Seat 3: Radiergummi0 ($1.54 in chips) 
Seat 4: ll_n4no_ll ($3.31 in chips) 
Seat 6: Zzzanderman ($2.39 in chips) 
Seat 7: meelis9 ($2 in chips) 
Seat 8: Dorex2007 ($3.45 in chips) 
Seat 9: Lymnhades ($2.08 in chips) 
Dorex2007: posts small blind $0.01
Lymnhades: posts big blind $0.02
Shahta-16: sits out 
*** HOLE CARDS ***
Dealt to Dorex2007 [9c Ts]
prizrak_162: folds 
Fabio.BR.sjc: calls $0.02
Radiergummi0: raises $0.06 to $0.08
ll_n4no_ll: folds 
Zzzanderman: folds 
meelis9: calls $0.08
Dorex2007: folds 
Lymnhades: folds 
Fabio.BR.sjc: folds 
*** FLOP *** [3s 7s Qs]
Radiergummi0: checks 
meelis9: checks 
*** TURN *** [3s 7s Qs] [4h]
Radiergummi0: checks 
meelis9: checks 
*** RIVER *** [3s 7s Qs 4h] [5h]
Radiergummi0: checks 
meelis9: checks 
*** SHOW DOWN ***
Radiergummi0: shows [3d 3h] (three of a kind, Threes)
meelis9: mucks hand 
Radiergummi0 collected $0.20 from pot
*** SUMMARY ***
Total pot $0.21 | Rake $0.01 
Board [3s 7s Qs 4h 5h]
Seat 1: prizrak_162 folded before Flop (didn't bet)
Seat 2: Fabio.BR.sjc folded before Flop
Seat 3: Radiergummi0 showed [3d 3h] and won ($0.20) with three of a kind, Threes
Seat 4: ll_n4no_ll folded before Flop (didn't bet)
Seat 6: Zzzanderman folded before Flop (didn't bet)
Seat 7: meelis9 (button) mucked [Jd Kd]
Seat 8: Dorex2007 (small blind) folded before Flop
Seat 9: Lymnhades (big blind) folded before Flop



PokerStars Hand #237375921646:  Hold'em No Limit ($0.01/$0.02 USD) - 2022/07/15 10:49:18 PT [2022/07/15 13:49:18 ET]
Table 'Appella II' 9-max Seat #8 is the button
Seat 1: prizrak_162 ($3.11 in chips) 
Seat 2: Fabio.BR.sjc ($1.94 in chips) 
Seat 3: Radiergummi0 ($1.66 in chips) 
Seat 4: ll_n4no_ll ($3.31 in chips) 
Seat 6: Zzzanderman ($2.39 in chips) 
Seat 7: meelis9 ($2 in chips) 
Seat 8: Dorex2007 ($3.44 in chips) 
Seat 9: Lymnhades ($2.06 in chips) 
Lymnhades: posts small blind $0.01
prizrak_162: posts big blind $0.02
Shahta-16: sits out 
*** HOLE CARDS ***
Dealt to Dorex2007 [3c Td]
Fabio.BR.sjc: raises $0.02 to $0.04
Radiergummi0: folds 
ll_n4no_ll: folds 
Zzzanderman: calls $0.04
meelis9: calls $0.04
Dorex2007: folds 
Lymnhades: folds 
prizrak_162: folds 
*** FLOP *** [Kd 6d Jd]
Fabio.BR.sjc: bets $0.04
Zzzanderman: folds 
meelis9: folds 
Uncalled bet ($0.04) returned to Fabio.BR.sjc
Fabio.BR.sjc collected $0.14 from pot
*** SUMMARY ***
Total pot $0.15 | Rake $0.01 
Board [Kd 6d Jd]
Seat 1: prizrak_162 (big blind) folded before Flop
Seat 2: Fabio.BR.sjc collected ($0.14)
Seat 3: Radiergummi0 folded before Flop (didn't bet)
Seat 4: ll_n4no_ll folded before Flop (didn't bet)
Seat 6: Zzzanderman folded on the Flop
Seat 7: meelis9 folded on the Flop
Seat 8: Dorex2007 (button) folded before Flop (didn't bet)
Seat 9: Lymnhades (small blind) folded before Flop



PokerStars Hand #237375932065:  Hold'em No Limit ($0.01/$0.02 USD) - 2022/07/15 10:49:52 PT [2022/07/15 13:49:52 ET]
Table 'Appella II' 9-max Seat #9 is the button
Seat 1: prizrak_162 ($3.09 in chips) 
Seat 2: Fabio.BR.sjc ($2.04 in chips) 
Seat 3: Radiergummi0 ($1.66 in chips) 
Seat 4: ll_n4no_ll ($3.31 in chips) 
Seat 6: Zzzanderman ($2.35 in chips) 
Seat 7: meelis9 ($2 in chips) 
Seat 8: Dorex2007 ($3.44 in chips) 
Seat 9: Lymnhades ($2.05 in chips) 
prizrak_162: posts small blind $0.01
Fabio.BR.sjc: posts big blind $0.02
Shahta-16: sits out 
*** HOLE CARDS ***
Dealt to Dorex2007 [5c 4s]
Radiergummi0: folds 
ll_n4no_ll: folds 
Zzzanderman: folds 
meelis9: folds 
Dorex2007: folds 
Lymnhades: folds 
prizrak_162: folds 
Uncalled bet ($0.01) returned to Fabio.BR.sjc
Fabio.BR.sjc collected $0.02 from pot
*** SUMMARY ***
Total pot $0.02 | Rake $0 
Seat 1: prizrak_162 (small blind) folded before Flop
Seat 2: Fabio.BR.sjc (big blind) collected ($0.02)
Seat 3: Radiergummi0 folded before Flop (didn't bet)
Seat 4: ll_n4no_ll folded before Flop (didn't bet)
Seat 6: Zzzanderman folded before Flop (didn't bet)
Seat 7: meelis9 folded before Flop (didn't bet)
Seat 8: Dorex2007 folded before Flop (didn't bet)
Seat 9: Lymnhades (button) folded before Flop (didn't bet)



PokerStars Hand #237375936533:  Hold'em No Limit ($0.01/$0.02 USD) - 2022/07/15 10:50:07 PT [2022/07/15 13:50:07 ET]
Table 'Appella II' 9-max Seat #1 is the button
Seat 1: prizrak_162 ($3.08 in chips) 
Seat 2: Fabio.BR.sjc ($2.05 in chips) 
Seat 3: Radiergummi0 ($1.66 in chips) 
Seat 4: ll_n4no_ll ($3.31 in chips) 
Seat 6: Zzzanderman ($2.35 in chips) 
Seat 7: meelis9 ($2 in chips) 
Seat 8: Dorex2007 ($3.44 in chips) 
Seat 9: Lymnhades ($2.05 in chips) 
Fabio.BR.sjc: posts small blind $0.01
Radiergummi0: posts big blind $0.02
Shahta-16: sits out 
*** HOLE CARDS ***
Dealt to Dorex2007 [As Kc]
ll_n4no_ll: folds 
Zzzanderman: folds 
meelis9: folds 
Dorex2007: raises $0.04 to $0.06
Lymnhades: folds 
prizrak_162: folds 
Fabio.BR.sjc: calls $0.05
Radiergummi0: folds 
*** FLOP *** [2c 9d 8d]
Fabio.BR.sjc: checks 
Dorex2007: checks 
*** TURN *** [2c 9d 8d] [7s]
Fabio.BR.sjc: bets $0.02
Dorex2007: calls $0.02
*** RIVER *** [2c 9d 8d 7s] [Qd]
Fabio.BR.sjc: bets $0.06
Dorex2007: folds 
Uncalled bet ($0.06) returned to Fabio.BR.sjc
Fabio.BR.sjc collected $0.17 from pot
*** SUMMARY ***
Total pot $0.18 | Rake $0.01 
Board [2c 9d 8d 7s Qd]
Seat 1: prizrak_162 (button) folded before Flop (didn't bet)
Seat 2: Fabio.BR.sjc (small blind) collected ($0.17)
Seat 3: Radiergummi0 (big blind) folded before Flop
Seat 4: ll_n4no_ll folded before Flop (didn't bet)
Seat 6: Zzzanderman folded before Flop (didn't bet)
Seat 7: meelis9 folded before Flop (didn't bet)
Seat 8: Dorex2007 folded on the River
Seat 9: Lymnhades folded before Flop (didn't bet)



PokerStars Hand #237375950532:  Hold'em No Limit ($0.01/$0.02 USD) - 2022/07/15 10:50:53 PT [2022/07/15 13:50:53 ET]
Table 'Appella II' 9-max Seat #2 is the button
Seat 1: prizrak_162 ($3.08 in chips) 
Seat 2: Fabio.BR.sjc ($2.14 in chips) 
Seat 3: Radiergummi0 ($1.64 in chips) 
Seat 4: ll_n4no_ll ($3.31 in chips) 
Seat 6: Zzzanderman ($2.35 in chips) 
Seat 7: meelis9 ($2 in chips) 
Seat 8: Dorex2007 ($3.36 in chips) 
Seat 9: Lymnhades ($2.05 in chips) 
Radiergummi0: posts small blind $0.01
ll_n4no_ll: posts big blind $0.02
Shahta-16: sits out 
*** HOLE CARDS ***
Dealt to Dorex2007 [3s Ks]
Zzzanderman: folds 
meelis9: raises $0.06 to $0.08
Dorex2007: folds 
Lymnhades: folds 
prizrak_162: folds 
Fabio.BR.sjc: folds 
Radiergummi0: folds 
ll_n4no_ll: folds 
Uncalled bet ($0.06) returned to meelis9
meelis9 collected $0.05 from pot
*** SUMMARY ***
Total pot $0.05 | Rake $0 
Seat 1: prizrak_162 folded before Flop (didn't bet)
Seat 2: Fabio.BR.sjc (button) folded before Flop (didn't bet)
Seat 3: Radiergummi0 (small blind) folded before Flop
Seat 4: ll_n4no_ll (big blind) folded before Flop
Seat 6: Zzzanderman folded before Flop (didn't bet)
Seat 7: meelis9 collected ($0.05)
Seat 8: Dorex2007 folded before Flop (didn't bet)
Seat 9: Lymnhades folded before Flop (didn't bet)



PokerStars Hand #237375958324:  Hold'em No Limit ($0.01/$0.02 USD) - 2022/07/15 10:51:18 PT [2022/07/15 13:51:18 ET]
Table 'Appella II' 9-max Seat #3 is the button
Seat 1: prizrak_162 ($3.08 in chips) 
Seat 2: Fabio.BR.sjc ($2.14 in chips) 
Seat 3: Radiergummi0 ($1.63 in chips) 
Seat 4: ll_n4no_ll ($3.29 in chips) 
Seat 5: Shahta-16 ($2 in chips) 
Seat 6: Zzzanderman ($2.35 in chips) 
Seat 7: meelis9 ($2.03 in chips) 
Seat 8: Dorex2007 ($3.36 in chips) 
Seat 9: Lymnhades ($2.05 in chips) 
ll_n4no_ll: posts small blind $0.01
Shahta-16: posts big blind $0.02
*** HOLE CARDS ***
Dealt to Dorex2007 [3h 3c]
Zzzanderman: calls $0.02
meelis9: folds 
Dorex2007: calls $0.02
Lymnhades: folds 
prizrak_162: folds 
Fabio.BR.sjc: calls $0.02
Radiergummi0: calls $0.02
ll_n4no_ll: folds 
Shahta-16: checks 
*** FLOP *** [8c As Ts]
Shahta-16: checks 
Zzzanderman: checks 
Dorex2007: checks 
Fabio.BR.sjc: checks 
Radiergummi0: bets $0.04
Shahta-16: raises $0.12 to $0.16
Zzzanderman: calls $0.16
Dorex2007: folds 
Fabio.BR.sjc: folds 
Radiergummi0: raises $1.45 to $1.61 and is all-in
Shahta-16: folds 
Zzzanderman: folds 
Uncalled bet ($1.45) returned to Radiergummi0
Radiergummi0 collected $0.57 from pot
*** SUMMARY ***
Total pot $0.59 | Rake $0.02 
Board [8c As Ts]
Seat 1: prizrak_162 folded before Flop (didn't bet)
Seat 2: Fabio.BR.sjc folded on the Flop
Seat 3: Radiergummi0 (button) collected ($0.57)
Seat 4: ll_n4no_ll (small blind) folded before Flop
Seat 5: Shahta-16 (big blind) folded on the Flop
Seat 6: Zzzanderman folded on the Flop
Seat 7: meelis9 folded before Flop (didn't bet)
Seat 8: Dorex2007 folded on the Flop
Seat 9: Lymnhades folded before Flop (didn't bet)



PokerStars Hand #237375977469:  Hold'em No Limit ($0.01/$0.02 USD) - 2022/07/15 10:52:21 PT [2022/07/15 13:52:21 ET]
Table 'Appella II' 9-max Seat #4 is the button
Seat 1: prizrak_162 ($3.08 in chips) 
Seat 2: Fabio.BR.sjc ($2.12 in chips) 
Seat 3: Radiergummi0 ($2.02 in chips) 
Seat 4: ll_n4no_ll ($3.28 in chips) 
Seat 5: Shahta-16 ($2 in chips) 
Seat 6: Zzzanderman ($2.17 in chips) 
Seat 7: meelis9 ($2.03 in chips) 
Seat 8: Dorex2007 ($3.34 in chips) 
Seat 9: Lymnhades ($2.05 in chips) 
Shahta-16: posts small blind $0.01
Zzzanderman: posts big blind $0.02
*** HOLE CARDS ***
Dealt to Dorex2007 [Td 2d]
meelis9: folds 
Dorex2007: folds 
Lymnhades: folds 
prizrak_162: folds 
Fabio.BR.sjc: raises $0.02 to $0.04
Radiergummi0: folds 
ll_n4no_ll: folds 
Shahta-16: folds 
Zzzanderman: calls $0.02
*** FLOP *** [Kh Ts 3c]
Zzzanderman: checks 
Fabio.BR.sjc: bets $0.02
Zzzanderman: calls $0.02
*** TURN *** [Kh Ts 3c] [3s]
Zzzanderman: checks 
Fabio.BR.sjc: bets $0.02
Zzzanderman: calls $0.02
*** RIVER *** [Kh Ts 3c 3s] [5h]
Zzzanderman: checks 
Fabio.BR.sjc: bets $0.06
Zzzanderman: calls $0.06
*** SHOW DOWN ***
Fabio.BR.sjc: shows [Kc Ac] (two pair, Kings and Threes)
Zzzanderman: mucks hand 
Fabio.BR.sjc collected $0.28 from pot
*** SUMMARY ***
Total pot $0.29 | Rake $0.01 
Board [Kh Ts 3c 3s 5h]
Seat 1: prizrak_162 folded before Flop (didn't bet)
Seat 2: Fabio.BR.sjc showed [Kc Ac] and won ($0.28) with two pair, Kings and Threes
Seat 3: Radiergummi0 folded before Flop (didn't bet)
Seat 4: ll_n4no_ll (button) folded before Flop (didn't bet)
Seat 5: Shahta-16 (small blind) folded before Flop
Seat 6: Zzzanderman (big blind) mucked [Jd Ks]
Seat 7: meelis9 folded before Flop (didn't bet)
Seat 8: Dorex2007 folded before Flop (didn't bet)
Seat 9: Lymnhades folded before Flop (didn't bet)



PokerStars Hand #237375999919:  Hold'em No Limit ($0.01/$0.02 USD) - 2022/07/15 10:53:04 PT [2022/07/15 13:53:04 ET]
Table 'Appella II' 9-max Seat #5 is the button
Seat 1: prizrak_162 ($3.08 in chips) 
Seat 2: Fabio.BR.sjc ($2.26 in chips) 
Seat 3: Radiergummi0 ($2.02 in chips) 
Seat 4: ll_n4no_ll ($3.28 in chips) 
Seat 5: Shahta-16 ($2 in chips) 
Seat 6: Zzzanderman ($2.03 in chips) 
Seat 7: meelis9 ($2.03 in chips) 
Seat 8: Dorex2007 ($3.34 in chips) 
Seat 9: Lymnhades ($2.05 in chips) 
Zzzanderman: posts small blind $0.01
meelis9: posts big blind $0.02
*** HOLE CARDS ***
Dealt to Dorex2007 [Ts Ac]
Dorex2007: folds 
Lymnhades: folds 
prizrak_162: folds 
Fabio.BR.sjc: calls $0.02
Radiergummi0: raises $0.06 to $0.08
ll_n4no_ll: folds 
Shahta-16: folds 
Zzzanderman: calls $0.07
meelis9: folds 
Fabio.BR.sjc: folds 
*** FLOP *** [8h Td 9h]
Zzzanderman: checks 
Radiergummi0: bets $0.06
Zzzanderman: calls $0.06
*** TURN *** [8h Td 9h] [Qh]
Zzzanderman: checks 
Radiergummi0: checks 
*** RIVER *** [8h Td 9h Qh] [6s]
Zzzanderman: checks 
Radiergummi0: bets $0.15
Zzzanderman: folds 
Uncalled bet ($0.15) returned to Radiergummi0
Radiergummi0 collected $0.31 from pot
*** SUMMARY ***
Total pot $0.32 | Rake $0.01 
Board [8h Td 9h Qh 6s]
Seat 1: prizrak_162 folded before Flop (didn't bet)
Seat 2: Fabio.BR.sjc folded before Flop
Seat 3: Radiergummi0 collected ($0.31)
Seat 4: ll_n4no_ll folded before Flop (didn't bet)
Seat 5: Shahta-16 (button) folded before Flop (didn't bet)
Seat 6: Zzzanderman (small blind) folded on the River
Seat 7: meelis9 (big blind) folded before Flop
Seat 8: Dorex2007 folded before Flop (didn't bet)
Seat 9: Lymnhades folded before Flop (didn't bet)



PokerStars Hand #237376016973:  Hold'em No Limit ($0.01/$0.02 USD) - 2022/07/15 10:54:00 PT [2022/07/15 13:54:00 ET]
Table 'Appella II' 9-max Seat #6 is the button
Seat 1: prizrak_162 ($3.08 in chips) 
Seat 2: Fabio.BR.sjc ($2.24 in chips) 
Seat 3: Radiergummi0 ($2.19 in chips) 
Seat 4: ll_n4no_ll ($3.28 in chips) 
Seat 5: Shahta-16 ($2 in chips) 
Seat 6: Zzzanderman ($1.89 in chips) 
Seat 7: meelis9 ($2.01 in chips) 
Seat 8: Dorex2007 ($3.34 in chips) 
Seat 9: Lymnhades ($2.05 in chips) 
meelis9: posts small blind $0.01
Dorex2007: posts big blind $0.02
*** HOLE CARDS ***
Dealt to Dorex2007 [8h Jc]
Lymnhades: folds 
prizrak_162: folds 
Fabio.BR.sjc: calls $0.02
Radiergummi0: folds 
ll_n4no_ll: folds 
Shahta-16: folds 
Zzzanderman: folds 
meelis9: raises $0.04 to $0.06
Dorex2007: folds 
Fabio.BR.sjc: folds 
Uncalled bet ($0.04) returned to meelis9
meelis9 collected $0.06 from pot
*** SUMMARY ***
Total pot $0.06 | Rake $0 
Seat 1: prizrak_162 folded before Flop (didn't bet)
Seat 2: Fabio.BR.sjc folded before Flop
Seat 3: Radiergummi0 folded before Flop (didn't bet)
Seat 4: ll_n4no_ll folded before Flop (didn't bet)
Seat 5: Shahta-16 folded before Flop (didn't bet)
Seat 6: Zzzanderman (button) folded before Flop (didn't bet)
Seat 7: meelis9 (small blind) collected ($0.06)
Seat 8: Dorex2007 (big blind) folded before Flop
Seat 9: Lymnhades folded before Flop (didn't bet)



PokerStars Hand #237376024451:  Hold'em No Limit ($0.01/$0.02 USD) - 2022/07/15 10:54:24 PT [2022/07/15 13:54:24 ET]
Table 'Appella II' 9-max Seat #7 is the button
Seat 1: prizrak_162 ($3.08 in chips) 
Seat 2: Fabio.BR.sjc ($2.22 in chips) 
Seat 3: Radiergummi0 ($2.19 in chips) 
Seat 4: ll_n4no_ll ($3.28 in chips) 
Seat 5: Shahta-16 ($2 in chips) 
Seat 6: Zzzanderman ($1.89 in chips) 
Seat 7: meelis9 ($2.05 in chips) 
Seat 8: Dorex2007 ($3.32 in chips) 
Seat 9: Lymnhades ($2.05 in chips) 
Dorex2007: posts small blind $0.01
Lymnhades: posts big blind $0.02
*** HOLE CARDS ***
Dealt to Dorex2007 [2d As]
prizrak_162: folds 
Fabio.BR.sjc: raises $0.02 to $0.04
Radiergummi0: folds 
ll_n4no_ll: folds 
Shahta-16: folds 
Zzzanderman: calls $0.04
meelis9: raises $0.08 to $0.12
Dorex2007: folds 
Lymnhades: folds 
Fabio.BR.sjc: folds 
Zzzanderman: calls $0.08
*** FLOP *** [9h 8h 7d]
Zzzanderman: bets $0.04
meelis9: calls $0.04
*** TURN *** [9h 8h 7d] [Ah]
Zzzanderman: checks 
meelis9: bets $0.19
Zzzanderman: folds 
Uncalled bet ($0.19) returned to meelis9
meelis9 collected $0.38 from pot
*** SUMMARY ***
Total pot $0.39 | Rake $0.01 
Board [9h 8h 7d Ah]
Seat 1: prizrak_162 folded before Flop (didn't bet)
Seat 2: Fabio.BR.sjc folded before Flop
Seat 3: Radiergummi0 folded before Flop (didn't bet)
Seat 4: ll_n4no_ll folded before Flop (didn't bet)
Seat 5: Shahta-16 folded before Flop (didn't bet)
Seat 6: Zzzanderman folded on the Turn
Seat 7: meelis9 (button) collected ($0.38)
Seat 8: Dorex2007 (small blind) folded before Flop
Seat 9: Lymnhades (big blind) folded before Flop



PokerStars Hand #237376039252:  Hold'em No Limit ($0.01/$0.02 USD) - 2022/07/15 10:55:09 PT [2022/07/15 13:55:09 ET]
Table 'Appella II' 9-max Seat #8 is the button
Seat 1: prizrak_162 ($3.08 in chips) 
Seat 2: Fabio.BR.sjc ($2.18 in chips) 
Seat 3: Radiergummi0 ($2.19 in chips) 
Seat 4: ll_n4no_ll ($3.28 in chips) 
Seat 5: Shahta-16 ($2 in chips) 
Seat 7: meelis9 ($2.27 in chips) 
Seat 8: Dorex2007 ($3.31 in chips) 
Seat 9: Lymnhades ($2.03 in chips) 
Lymnhades: posts small blind $0.01
prizrak_162: posts big blind $0.02
*** HOLE CARDS ***
Dealt to Dorex2007 [Jd 2c]
Fabio.BR.sjc: folds 
Radiergummi0: folds 
ll_n4no_ll: folds 
Shahta-16: folds 
meelis9: folds 
Dorex2007: folds 
Lymnhades: raises $0.04 to $0.06
prizrak_162: folds 
Uncalled bet ($0.04) returned to Lymnhades
Lymnhades collected $0.04 from pot
*** SUMMARY ***
Total pot $0.04 | Rake $0 
Seat 1: prizrak_162 (big blind) folded before Flop
Seat 2: Fabio.BR.sjc folded before Flop (didn't bet)
Seat 3: Radiergummi0 folded before Flop (didn't bet)
Seat 4: ll_n4no_ll folded before Flop (didn't bet)
Seat 5: Shahta-16 folded before Flop (didn't bet)
Seat 7: meelis9 folded before Flop (didn't bet)
Seat 8: Dorex2007 (button) folded before Flop (didn't bet)
Seat 9: Lymnhades (small blind) collected ($0.04)



PokerStars Hand #237376045688:  Hold'em No Limit ($0.01/$0.02 USD) - 2022/07/15 10:55:36 PT [2022/07/15 13:55:36 ET]
Table 'Appella II' 9-max Seat #9 is the button
Seat 1: prizrak_162 ($3.06 in chips) 
Seat 2: Fabio.BR.sjc ($2.18 in chips) 
Seat 3: Radiergummi0 ($2.19 in chips) 
Seat 4: ll_n4no_ll ($3.28 in chips) 
Seat 5: Shahta-16 ($2 in chips) 
Seat 6: Zzzanderman ($1.73 in chips) 
Seat 7: meelis9 ($2.27 in chips) 
Seat 8: Dorex2007 ($3.31 in chips) 
Seat 9: Lymnhades ($2.05 in chips) 
prizrak_162: posts small blind $0.01
Fabio.BR.sjc: posts big blind $0.02
*** HOLE CARDS ***
Dealt to Dorex2007 [Qc Kc]
Radiergummi0: folds 
ll_n4no_ll: folds 
Shahta-16: folds 
Zzzanderman: calls $0.02
meelis9: folds 
Dorex2007: raises $0.04 to $0.06
Lymnhades: folds 
prizrak_162: calls $0.05
Fabio.BR.sjc: folds 
Zzzanderman: calls $0.04
*** FLOP *** [8s 7c Qd]
prizrak_162: checks 
Zzzanderman: bets $0.04
Dorex2007: raises $0.14 to $0.18
prizrak_162: folds 
Zzzanderman: folds 
Uncalled bet ($0.14) returned to Dorex2007
Dorex2007 collected $0.27 from pot
*** SUMMARY ***
Total pot $0.28 | Rake $0.01 
Board [8s 7c Qd]
Seat 1: prizrak_162 (small blind) folded on the Flop
Seat 2: Fabio.BR.sjc (big blind) folded before Flop
Seat 3: Radiergummi0 folded before Flop (didn't bet)
Seat 4: ll_n4no_ll folded before Flop (didn't bet)
Seat 5: Shahta-16 folded before Flop (didn't bet)
Seat 6: Zzzanderman folded on the Flop
Seat 7: meelis9 folded before Flop (didn't bet)
Seat 8: Dorex2007 collected ($0.27)
Seat 9: Lymnhades (button) folded before Flop (didn't bet)



PokerStars Hand #237376054630:  Hold'em No Limit ($0.01/$0.02 USD) - 2022/07/15 10:56:14 PT [2022/07/15 13:56:14 ET]
Table 'Appella II' 9-max Seat #1 is the button
Seat 1: prizrak_162 ($3 in chips) 
Seat 2: Fabio.BR.sjc ($2.16 in chips) 
Seat 3: Radiergummi0 ($2.19 in chips) 
Seat 4: ll_n4no_ll ($3.28 in chips) 
Seat 5: Shahta-16 ($2 in chips) 
Seat 6: Zzzanderman ($1.63 in chips) 
Seat 7: meelis9 ($2.27 in chips) 
Seat 8: Dorex2007 ($3.48 in chips) 
Seat 9: Lymnhades ($2.05 in chips) 
Fabio.BR.sjc: posts small blind $0.01
Radiergummi0: posts big blind $0.02
*** HOLE CARDS ***
Dealt to Dorex2007 [Tc Jd]
ll_n4no_ll: raises $0.04 to $0.06
Shahta-16: folds 
Zzzanderman: folds 
meelis9: folds 
Dorex2007: folds 
Lymnhades: folds 
prizrak_162: calls $0.06
Fabio.BR.sjc: calls $0.05
Radiergummi0: calls $0.04
*** FLOP *** [Jc Qh 4d]
Fabio.BR.sjc: bets $0.02
Radiergummi0: calls $0.02
ll_n4no_ll: raises $0.04 to $0.06
prizrak_162: calls $0.06
Fabio.BR.sjc: folds 
Radiergummi0: folds 
*** TURN *** [Jc Qh 4d] [9d]
ll_n4no_ll: bets $0.16
prizrak_162: folds 
Uncalled bet ($0.16) returned to ll_n4no_ll
ll_n4no_ll collected $0.39 from pot
*** SUMMARY ***
Total pot $0.40 | Rake $0.01 
Board [Jc Qh 4d 9d]
Seat 1: prizrak_162 (button) folded on the Turn
Seat 2: Fabio.BR.sjc (small blind) folded on the Flop
Seat 3: Radiergummi0 (big blind) folded on the Flop
Seat 4: ll_n4no_ll collected ($0.39)
Seat 5: Shahta-16 folded before Flop (didn't bet)
Seat 6: Zzzanderman folded before Flop (didn't bet)
Seat 7: meelis9 folded before Flop (didn't bet)
Seat 8: Dorex2007 folded before Flop (didn't bet)
Seat 9: Lymnhades folded before Flop (didn't bet)



PokerStars Hand #237376067900:  Hold'em No Limit ($0.01/$0.02 USD) - 2022/07/15 10:57:11 PT [2022/07/15 13:57:11 ET]
Table 'Appella II' 9-max Seat #2 is the button
Seat 1: prizrak_162 ($2.88 in chips) 
Seat 2: Fabio.BR.sjc ($2.08 in chips) 
Seat 3: Radiergummi0 ($2.11 in chips) 
Seat 4: ll_n4no_ll ($3.55 in chips) 
Seat 5: Shahta-16 ($2 in chips) 
Seat 6: Zzzanderman ($1.63 in chips) 
Seat 7: meelis9 ($2.27 in chips) 
Seat 8: Dorex2007 ($3.48 in chips) 
Seat 9: Lymnhades ($2.05 in chips) 
Radiergummi0: posts small blind $0.01
ll_n4no_ll: posts big blind $0.02
*** HOLE CARDS ***
Dealt to Dorex2007 [Td 2h]
Shahta-16: folds 
Zzzanderman: calls $0.02
meelis9: raises $0.04 to $0.06
Dorex2007: folds 
Lymnhades: calls $0.06
prizrak_162: folds 
Fabio.BR.sjc: folds 
Radiergummi0: folds 
prizrak_162 leaves the table
ll_n4no_ll: calls $0.04
Zzzanderman: calls $0.04
*** FLOP *** [7h 8s Js]
ll_n4no_ll: checks 
Zzzanderman: checks 
meelis9: checks 
Lymnhades: bets $0.16
ll_n4no_ll: folds 
Zzzanderman: calls $0.16
meelis9: folds 
*** TURN *** [7h 8s Js] [3c]
Zzzanderman: checks 
Lymnhades: bets $0.38
Zzzanderman: calls $0.38
*** RIVER *** [7h 8s Js 3c] [9s]
Zzzanderman: bets $1.03 and is all-in
Lymnhades: folds 
Uncalled bet ($1.03) returned to Zzzanderman
Zzzanderman collected $1.28 from pot
*** SUMMARY ***
Total pot $1.33 | Rake $0.05 
Board [7h 8s Js 3c 9s]
Seat 1: prizrak_162 folded before Flop (didn't bet)
Seat 2: Fabio.BR.sjc (button) folded before Flop (didn't bet)
Seat 3: Radiergummi0 (small blind) folded before Flop
Seat 4: ll_n4no_ll (big blind) folded on the Flop
Seat 5: Shahta-16 folded before Flop (didn't bet)
Seat 6: Zzzanderman collected ($1.28)
Seat 7: meelis9 folded on the Flop
Seat 8: Dorex2007 folded before Flop (didn't bet)
Seat 9: Lymnhades folded on the River



PokerStars Hand #237376084216:  Hold'em No Limit ($0.01/$0.02 USD) - 2022/07/15 10:58:21 PT [2022/07/15 13:58:21 ET]
Table 'Appella II' 9-max Seat #3 is the button
Seat 2: Fabio.BR.sjc ($2.08 in chips) 
Seat 3: Radiergummi0 ($2.10 in chips) 
Seat 4: ll_n4no_ll ($3.49 in chips) 
Seat 5: Shahta-16 ($2 in chips) 
Seat 6: Zzzanderman ($2.31 in chips) 
Seat 7: meelis9 ($2.21 in chips) 
Seat 8: Dorex2007 ($3.48 in chips) 
Seat 9: Lymnhades ($1.45 in chips) 
ll_n4no_ll: posts small blind $0.01
Shahta-16: posts big blind $0.02
*** HOLE CARDS ***
Dealt to Dorex2007 [9d Ks]
Zzzanderman: folds 
meelis9: folds 
Dorex2007: folds 
Lymnhades: raises $0.04 to $0.06
Fabio.BR.sjc: calls $0.06
Radiergummi0: raises $0.14 to $0.20
ll_n4no_ll: folds 
Shahta-16: folds 
Lymnhades: calls $0.14
Fabio.BR.sjc: folds 
*** FLOP *** [4s Td Js]
Lymnhades: checks 
FACCHETADE$ joins the table at seat #1 
Radiergummi0: bets $0.16
Lymnhades: calls $0.16
*** TURN *** [4s Td Js] [2s]
Lymnhades: checks 
Radiergummi0: checks 
*** RIVER *** [4s Td Js 2s] [3c]
Lymnhades: bets $0.16
Radiergummi0: calls $0.16
*** SHOW DOWN ***
Lymnhades: shows [7s 9s] (a flush, Jack high)
Radiergummi0: mucks hand 
Lymnhades collected $1.09 from pot
*** SUMMARY ***
Total pot $1.13 | Rake $0.04 
Board [4s Td Js 2s 3c]
Seat 2: Fabio.BR.sjc folded before Flop
Seat 3: Radiergummi0 (button) mucked [8h 4h]
Seat 4: ll_n4no_ll (small blind) folded before Flop
Seat 5: Shahta-16 (big blind) folded before Flop
Seat 6: Zzzanderman folded before Flop (didn't bet)
Seat 7: meelis9 folded before Flop (didn't bet)
Seat 8: Dorex2007 folded before Flop (didn't bet)
Seat 9: Lymnhades showed [7s 9s] and won ($1.09) with a flush, Jack high



PokerStars Hand #237376102138:  Hold'em No Limit ($0.01/$0.02 USD) - 2022/07/15 10:59:38 PT [2022/07/15 13:59:38 ET]
Table 'Appella II' 9-max Seat #4 is the button
Seat 1: FACCHETADE$ ($2 in chips) 
Seat 2: Fabio.BR.sjc ($2.02 in chips) 
Seat 3: Radiergummi0 ($1.58 in chips) 
Seat 4: ll_n4no_ll ($3.48 in chips) 
Seat 5: Shahta-16 ($2 in chips) 
Seat 6: Zzzanderman ($2.31 in chips) 
Seat 7: meelis9 ($2.21 in chips) 
Seat 8: Dorex2007 ($3.48 in chips) 
Seat 9: Lymnhades ($2.02 in chips) 
Shahta-16: posts small blind $0.01
Zzzanderman: posts big blind $0.02
FACCHETADE$: posts big blind $0.02
*** HOLE CARDS ***
Dealt to Dorex2007 [Qh 3d]
meelis9: folds 
Dorex2007: folds 
Lymnhades: folds 
FACCHETADE$: raises $1.98 to $2 and is all-in
Fabio.BR.sjc: folds 
Radiergummi0: folds 
ll_n4no_ll: folds 
Shahta-16: folds 
Zzzanderman: folds 
Uncalled bet ($1.98) returned to FACCHETADE$
FACCHETADE$ collected $0.05 from pot
*** SUMMARY ***
Total pot $0.05 | Rake $0 
Seat 1: FACCHETADE$ collected ($0.05)
Seat 2: Fabio.BR.sjc folded before Flop (didn't bet)
Seat 3: Radiergummi0 folded before Flop (didn't bet)
Seat 4: ll_n4no_ll (button) folded before Flop (didn't bet)
Seat 5: Shahta-16 (small blind) folded before Flop
Seat 6: Zzzanderman (big blind) folded before Flop
Seat 7: meelis9 folded before Flop (didn't bet)
Seat 8: Dorex2007 folded before Flop (didn't bet)
Seat 9: Lymnhades folded before Flop (didn't bet)



PokerStars Hand #237376107982:  Hold'em No Limit ($0.01/$0.02 USD) - 2022/07/15 11:00:03 PT [2022/07/15 14:00:03 ET]
Table 'Appella II' 9-max Seat #5 is the button
Seat 1: FACCHETADE$ ($2.03 in chips) 
Seat 2: Fabio.BR.sjc ($2.02 in chips) 
Seat 3: Radiergummi0 ($1.58 in chips) 
Seat 4: ll_n4no_ll ($3.48 in chips) 
Seat 5: Shahta-16 ($2 in chips) 
Seat 6: Zzzanderman ($2.29 in chips) 
Seat 7: meelis9 ($2.21 in chips) 
Seat 8: Dorex2007 ($3.48 in chips) 
Seat 9: Lymnhades ($2.02 in chips) 
Zzzanderman: posts small blind $0.01
meelis9: posts big blind $0.02
*** HOLE CARDS ***
Dealt to Dorex2007 [Td Qc]
Dorex2007: folds 
Lymnhades: folds 
FACCHETADE$: calls $0.02
Fabio.BR.sjc: calls $0.02
Radiergummi0: folds 
ll_n4no_ll: folds 
Shahta-16: folds 
Zzzanderman: folds 
meelis9: checks 
*** FLOP *** [6d 9c 7h]
meelis9: bets $0.04
FACCHETADE$: calls $0.04
Fabio.BR.sjc: calls $0.04
*** TURN *** [6d 9c 7h] [4s]
meelis9: bets $0.12
FACCHETADE$: folds 
Fabio.BR.sjc: calls $0.12
*** RIVER *** [6d 9c 7h 4s] [8h]
meelis9: bets $0.30
Fabio.BR.sjc: folds 
Uncalled bet ($0.30) returned to meelis9
meelis9 collected $0.41 from pot
*** SUMMARY ***
Total pot $0.43 | Rake $0.02 
Board [6d 9c 7h 4s 8h]
Seat 1: FACCHETADE$ folded on the Turn
Seat 2: Fabio.BR.sjc folded on the River
Seat 3: Radiergummi0 folded before Flop (didn't bet)
Seat 4: ll_n4no_ll folded before Flop (didn't bet)
Seat 5: Shahta-16 (button) folded before Flop (didn't bet)
Seat 6: Zzzanderman (small blind) folded before Flop
Seat 7: meelis9 (big blind) collected ($0.41)
Seat 8: Dorex2007 folded before Flop (didn't bet)
Seat 9: Lymnhades folded before Flop (didn't bet)



PokerStars Hand #237376123157:  Hold'em No Limit ($0.01/$0.02 USD) - 2022/07/15 11:01:02 PT [2022/07/15 14:01:02 ET]
Table 'Appella II' 9-max Seat #6 is the button
Seat 1: FACCHETADE$ ($1.97 in chips) 
Seat 2: Fabio.BR.sjc ($1.84 in chips) 
Seat 3: Radiergummi0 ($1.58 in chips) 
Seat 4: ll_n4no_ll ($3.48 in chips) 
Seat 5: Shahta-16 ($2 in chips) 
Seat 6: Zzzanderman ($2.28 in chips) 
Seat 7: meelis9 ($2.44 in chips) 
Seat 8: Dorex2007 ($3.48 in chips) 
Seat 9: Lymnhades ($2.02 in chips) 
meelis9: posts small blind $0.01
Dorex2007: posts big blind $0.02
*** HOLE CARDS ***
Dealt to Dorex2007 [7c Jd]
Lymnhades: folds 
FACCHETADE$: folds 
Fabio.BR.sjc: folds 
Radiergummi0: folds 
ll_n4no_ll: folds 
Shahta-16: raises $0.03 to $0.05
Zzzanderman: folds 
meelis9: folds 
Dorex2007: folds 
Uncalled bet ($0.03) returned to Shahta-16
Shahta-16 collected $0.05 from pot
*** SUMMARY ***
Total pot $0.05 | Rake $0 
Seat 1: FACCHETADE$ folded before Flop (didn't bet)
Seat 2: Fabio.BR.sjc folded before Flop (didn't bet)
Seat 3: Radiergummi0 folded before Flop (didn't bet)
Seat 4: ll_n4no_ll folded before Flop (didn't bet)
Seat 5: Shahta-16 collected ($0.05)
Seat 6: Zzzanderman (button) folded before Flop (didn't bet)
Seat 7: meelis9 (small blind) folded before Flop
Seat 8: Dorex2007 (big blind) folded before Flop
Seat 9: Lymnhades folded before Flop (didn't bet)



PokerStars Hand #237376128326:  Hold'em No Limit ($0.01/$0.02 USD) - 2022/07/15 11:01:21 PT [2022/07/15 14:01:21 ET]
Table 'Appella II' 9-max Seat #7 is the button
Seat 1: FACCHETADE$ ($1.97 in chips) 
Seat 2: Fabio.BR.sjc ($1.84 in chips) 
Seat 3: Radiergummi0 ($1.58 in chips) 
Seat 4: ll_n4no_ll ($3.48 in chips) 
Seat 5: Shahta-16 ($2.03 in chips) 
Seat 6: Zzzanderman ($2.28 in chips) 
Seat 7: meelis9 ($2.43 in chips) 
Seat 8: Dorex2007 ($3.46 in chips) 
Seat 9: Lymnhades ($2.02 in chips) 
Dorex2007: posts small blind $0.01
Lymnhades: posts big blind $0.02
*** HOLE CARDS ***
Dealt to Dorex2007 [6h 7d]
FACCHETADE$: folds 
Fabio.BR.sjc: folds 
Radiergummi0: folds 
ll_n4no_ll: folds 
Shahta-16: folds 
Zzzanderman: folds 
meelis9: raises $0.04 to $0.06
Dorex2007: folds 
Lymnhades: raises $0.12 to $0.18
meelis9: folds 
Uncalled bet ($0.12) returned to Lymnhades
Lymnhades collected $0.13 from pot
*** SUMMARY ***
Total pot $0.13 | Rake $0 
Seat 1: FACCHETADE$ folded before Flop (didn't bet)
Seat 2: Fabio.BR.sjc folded before Flop (didn't bet)
Seat 3: Radiergummi0 folded before Flop (didn't bet)
Seat 4: ll_n4no_ll folded before Flop (didn't bet)
Seat 5: Shahta-16 folded before Flop (didn't bet)
Seat 6: Zzzanderman folded before Flop (didn't bet)
Seat 7: meelis9 (button) folded before Flop
Seat 8: Dorex2007 (small blind) folded before Flop
Seat 9: Lymnhades (big blind) collected ($0.13)



PokerStars Hand #237376140371:  Hold'em No Limit ($0.01/$0.02 USD) - 2022/07/15 11:02:02 PT [2022/07/15 14:02:02 ET]
Table 'Appella II' 9-max Seat #8 is the button
Seat 1: FACCHETADE$ ($1.97 in chips) 
Seat 2: Fabio.BR.sjc ($1.84 in chips) 
Seat 3: Radiergummi0 ($1.58 in chips) 
Seat 4: ll_n4no_ll ($3.48 in chips) 
Seat 5: Shahta-16 ($2.03 in chips) 
Seat 6: Zzzanderman ($2.28 in chips) 
Seat 7: meelis9 ($2.37 in chips) 
Seat 8: Dorex2007 ($3.45 in chips) 
Seat 9: Lymnhades ($2.09 in chips) 
Lymnhades: posts small blind $0.01
FACCHETADE$: posts big blind $0.02
*** HOLE CARDS ***
Dealt to Dorex2007 [8c Th]
Fabio.BR.sjc: raises $0.02 to $0.04
Radiergummi0: folds 
ll_n4no_ll: folds 
Shahta-16: folds 
Zzzanderman: folds 
meelis9: calls $0.04
Dorex2007: folds 
Lymnhades: folds 
FACCHETADE$: calls $0.02
*** FLOP *** [3h Ks 3s]
FACCHETADE$: checks 
Fabio.BR.sjc: bets $0.02
meelis9: raises $0.09 to $0.11
FACCHETADE$: folds 
Fabio.BR.sjc: folds 
Uncalled bet ($0.09) returned to meelis9
meelis9 collected $0.16 from pot
*** SUMMARY ***
Total pot $0.17 | Rake $0.01 
Board [3h Ks 3s]
Seat 1: FACCHETADE$ (big blind) folded on the Flop
Seat 2: Fabio.BR.sjc folded on the Flop
Seat 3: Radiergummi0 folded before Flop (didn't bet)
Seat 4: ll_n4no_ll folded before Flop (didn't bet)
Seat 5: Shahta-16 folded before Flop (didn't bet)
Seat 6: Zzzanderman folded before Flop (didn't bet)
Seat 7: meelis9 collected ($0.16)
Seat 8: Dorex2007 (button) folded before Flop (didn't bet)
Seat 9: Lymnhades (small blind) folded before Flop



PokerStars Hand #237376154085:  Hold'em No Limit ($0.01/$0.02 USD) - 2022/07/15 11:02:46 PT [2022/07/15 14:02:46 ET]
Table 'Appella II' 9-max Seat #9 is the button
Seat 1: FACCHETADE$ ($1.93 in chips) 
Seat 2: Fabio.BR.sjc ($1.78 in chips) 
Seat 3: Radiergummi0 ($1.58 in chips) 
Seat 4: ll_n4no_ll ($3.48 in chips) 
Seat 5: Shahta-16 ($2.03 in chips) 
Seat 6: Zzzanderman ($2.28 in chips) 
Seat 7: meelis9 ($2.47 in chips) 
Seat 8: Dorex2007 ($3.45 in chips) 
Seat 9: Lymnhades ($2.08 in chips) 
FACCHETADE$: posts small blind $0.01
Fabio.BR.sjc: posts big blind $0.02
*** HOLE CARDS ***
Dealt to Dorex2007 [3s 9h]
Radiergummi0: folds 
ll_n4no_ll: folds 
Shahta-16: folds 
Zzzanderman: folds 
meelis9: raises $0.04 to $0.06
Dorex2007: folds 
Lymnhades: folds 
FACCHETADE$: folds 
Fabio.BR.sjc: folds 
Uncalled bet ($0.04) returned to meelis9
meelis9 collected $0.05 from pot
*** SUMMARY ***
Total pot $0.05 | Rake $0 
Seat 1: FACCHETADE$ (small blind) folded before Flop
Seat 2: Fabio.BR.sjc (big blind) folded before Flop
Seat 3: Radiergummi0 folded before Flop (didn't bet)
Seat 4: ll_n4no_ll folded before Flop (didn't bet)
Seat 5: Shahta-16 folded before Flop (didn't bet)
Seat 6: Zzzanderman folded before Flop (didn't bet)
Seat 7: meelis9 collected ($0.05)
Seat 8: Dorex2007 folded before Flop (didn't bet)
Seat 9: Lymnhades (button) folded before Flop (didn't bet)



PokerStars Hand #237376160799:  Hold'em No Limit ($0.01/$0.02 USD) - 2022/07/15 11:03:09 PT [2022/07/15 14:03:09 ET]
Table 'Appella II' 9-max Seat #1 is the button
Seat 1: FACCHETADE$ ($1.92 in chips) 
Seat 2: Fabio.BR.sjc ($1.76 in chips) 
Seat 3: Radiergummi0 ($1.58 in chips) 
Seat 4: ll_n4no_ll ($3.48 in chips) 
Seat 5: Shahta-16 ($2.03 in chips) 
Seat 6: Zzzanderman ($2.28 in chips) 
Seat 7: meelis9 ($2.50 in chips) 
Seat 8: Dorex2007 ($3.45 in chips) 
Seat 9: Lymnhades ($2.08 in chips) 
Fabio.BR.sjc: posts small blind $0.01
Radiergummi0: posts big blind $0.02
*** HOLE CARDS ***
Dealt to Dorex2007 [Jc 3s]
ll_n4no_ll: folds 
Shahta-16: raises $0.04 to $0.06
Zzzanderman: folds 
meelis9: folds 
Dorex2007: folds 
Lymnhades: folds 
FACCHETADE$: folds 
Fabio.BR.sjc: folds 
Radiergummi0: calls $0.04
*** FLOP *** [8h 9h Ks]
Radiergummi0: bets $0.06
Shahta-16: calls $0.06
*** TURN *** [8h 9h Ks] [Kh]
Radiergummi0: bets $0.16
Shahta-16: raises $0.18 to $0.34
Radiergummi0: folds 
Uncalled bet ($0.18) returned to Shahta-16
Shahta-16 collected $0.55 from pot
*** SUMMARY ***
Total pot $0.57 | Rake $0.02 
Board [8h 9h Ks Kh]
Seat 1: FACCHETADE$ (button) folded before Flop (didn't bet)
Seat 2: Fabio.BR.sjc (small blind) folded before Flop
Seat 3: Radiergummi0 (big blind) folded on the Turn
Seat 4: ll_n4no_ll folded before Flop (didn't bet)
Seat 5: Shahta-16 collected ($0.55)
Seat 6: Zzzanderman folded before Flop (didn't bet)
Seat 7: meelis9 folded before Flop (didn't bet)
Seat 8: Dorex2007 folded before Flop (didn't bet)
Seat 9: Lymnhades folded before Flop (didn't bet)



PokerStars Hand #237376181548:  Hold'em No Limit ($0.01/$0.02 USD) - 2022/07/15 11:04:15 PT [2022/07/15 14:04:15 ET]
Table 'Appella II' 9-max Seat #2 is the button
Seat 1: FACCHETADE$ ($1.92 in chips) 
Seat 2: Fabio.BR.sjc ($1.75 in chips) 
Seat 3: Radiergummi0 ($1.30 in chips) 
Seat 5: Shahta-16 ($2.30 in chips) 
Seat 6: Zzzanderman ($2.28 in chips) 
Seat 7: meelis9 ($2.50 in chips) 
Seat 8: Dorex2007 ($3.45 in chips) 
Seat 9: Lymnhades ($2.08 in chips) 
Radiergummi0: posts small blind $0.01
ll_n4no_ll: is sitting out 
Shahta-16: posts big blind $0.02
*** HOLE CARDS ***
Dealt to Dorex2007 [Ts Tc]
Zzzanderman: folds 
meelis9: folds 
ll_n4no_ll leaves the table
Dorex2007: raises $0.04 to $0.06
Lymnhades: folds 
FACCHETADE$: folds 
Fabio.BR.sjc: folds 
Radiergummi0: folds 
Shahta-16: folds 
Uncalled bet ($0.04) returned to Dorex2007
Dorex2007 collected $0.05 from pot
*** SUMMARY ***
Total pot $0.05 | Rake $0 
Seat 1: FACCHETADE$ folded before Flop (didn't bet)
Seat 2: Fabio.BR.sjc (button) folded before Flop (didn't bet)
Seat 3: Radiergummi0 (small blind) folded before Flop
Seat 5: Shahta-16 (big blind) folded before Flop
Seat 6: Zzzanderman folded before Flop (didn't bet)
Seat 7: meelis9 folded before Flop (didn't bet)
Seat 8: Dorex2007 collected ($0.05)
Seat 9: Lymnhades folded before Flop (didn't bet)



PokerStars Hand #237376190089:  Hold'em No Limit ($0.01/$0.02 USD) - 2022/07/15 11:04:42 PT [2022/07/15 14:04:42 ET]
Table 'Appella II' 9-max Seat #3 is the button
Seat 1: FACCHETADE$ ($1.92 in chips) 
Seat 2: Fabio.BR.sjc ($1.75 in chips) 
Seat 3: Radiergummi0 ($1.29 in chips) 
Seat 5: Shahta-16 ($2.28 in chips) 
Seat 6: Zzzanderman ($2.28 in chips) 
Seat 7: meelis9 ($2.50 in chips) 
Seat 8: Dorex2007 ($3.48 in chips) 
Seat 9: Lymnhades ($2.08 in chips) 
Shahta-16: posts small blind $0.01
Zzzanderman: posts big blind $0.02
*** HOLE CARDS ***
Dealt to Dorex2007 [8s 5c]
meelis9: folds 
Dorex2007: folds 
Lymnhades: folds 
mayconmontaia joins the table at seat #4 
FACCHETADE$: folds 
Fabio.BR.sjc: calls $0.02
Radiergummi0: raises $0.06 to $0.08
Shahta-16: folds 
Zzzanderman: folds 
Fabio.BR.sjc: folds 
Uncalled bet ($0.06) returned to Radiergummi0
Radiergummi0 collected $0.07 from pot
*** SUMMARY ***
Total pot $0.07 | Rake $0 
Seat 1: FACCHETADE$ folded before Flop (didn't bet)
Seat 2: Fabio.BR.sjc folded before Flop
Seat 3: Radiergummi0 (button) collected ($0.07)
Seat 5: Shahta-16 (small blind) folded before Flop
Seat 6: Zzzanderman (big blind) folded before Flop
Seat 7: meelis9 folded before Flop (didn't bet)
Seat 8: Dorex2007 folded before Flop (didn't bet)
Seat 9: Lymnhades folded before Flop (didn't bet)



PokerStars Hand #237376201583:  Hold'em No Limit ($0.01/$0.02 USD) - 2022/07/15 11:05:19 PT [2022/07/15 14:05:19 ET]
Table 'Appella II' 9-max Seat #5 is the button
Seat 1: FACCHETADE$ ($2 in chips) 
Seat 2: Fabio.BR.sjc ($1.73 in chips) 
Seat 3: Radiergummi0 ($1.34 in chips) 
Seat 4: mayconmontaia ($2 in chips) 
Seat 5: Shahta-16 ($2.27 in chips) 
Seat 6: Zzzanderman ($2.26 in chips) 
Seat 7: meelis9 ($2.50 in chips) 
Seat 8: Dorex2007 ($3.48 in chips) 
Seat 9: Lymnhades ($2.08 in chips) 
Zzzanderman: posts small blind $0.01
meelis9: posts big blind $0.02
mayconmontaia: posts big blind $0.02
*** HOLE CARDS ***
Dealt to Dorex2007 [6d 8c]
Dorex2007: folds 
Lymnhades: folds 
FACCHETADE$: folds 
Fabio.BR.sjc: raises $0.02 to $0.04
Radiergummi0: raises $0.08 to $0.12
mayconmontaia: folds 
Shahta-16: folds 
Zzzanderman: folds 
meelis9: folds 
Fabio.BR.sjc: calls $0.08
*** FLOP *** [8s 5c 6c]
Fabio.BR.sjc: bets $0.14
Radiergummi0: folds 
Uncalled bet ($0.14) returned to Fabio.BR.sjc
Fabio.BR.sjc collected $0.28 from pot
*** SUMMARY ***
Total pot $0.29 | Rake $0.01 
Board [8s 5c 6c]
Seat 1: FACCHETADE$ folded before Flop (didn't bet)
Seat 2: Fabio.BR.sjc collected ($0.28)
Seat 3: Radiergummi0 folded on the Flop
Seat 4: mayconmontaia folded before Flop (didn't bet)
Seat 5: Shahta-16 (button) folded before Flop (didn't bet)
Seat 6: Zzzanderman (small blind) folded before Flop
Seat 7: meelis9 (big blind) folded before Flop
Seat 8: Dorex2007 folded before Flop (didn't bet)
Seat 9: Lymnhades folded before Flop (didn't bet)



PokerStars Hand #237376214400:  Hold'em No Limit ($0.01/$0.02 USD) - 2022/07/15 11:05:59 PT [2022/07/15 14:05:59 ET]
Table 'Appella II' 9-max Seat #6 is the button
Seat 1: FACCHETADE$ ($2 in chips) 
Seat 2: Fabio.BR.sjc ($1.89 in chips) 
Seat 3: Radiergummi0 ($1.22 in chips) 
Seat 4: mayconmontaia ($1.98 in chips) 
Seat 5: Shahta-16 ($2.27 in chips) 
Seat 6: Zzzanderman ($2.25 in chips) 
Seat 7: meelis9 ($2.48 in chips) 
Seat 8: Dorex2007 ($3.48 in chips) 
Seat 9: Lymnhades ($2.08 in chips) 
meelis9: posts small blind $0.01
Dorex2007: posts big blind $0.02
*** HOLE CARDS ***
Dealt to Dorex2007 [Tc As]
Lymnhades: folds 
FACCHETADE$: folds 
Fabio.BR.sjc: folds 
Radiergummi0: folds 
mayconmontaia: calls $0.02
Shahta-16: folds 
Zzzanderman: folds 
meelis9: folds 
Dorex2007: checks 
*** FLOP *** [4c 7s 5c]
Dorex2007: checks 
mayconmontaia: bets $0.02
Dorex2007: calls $0.02
*** TURN *** [4c 7s 5c] [8s]
Dorex2007: checks 
mayconmontaia: bets $0.02
Dorex2007: folds 
Uncalled bet ($0.02) returned to mayconmontaia
mayconmontaia collected $0.09 from pot
*** SUMMARY ***
Total pot $0.09 | Rake $0 
Board [4c 7s 5c 8s]
Seat 1: FACCHETADE$ folded before Flop (didn't bet)
Seat 2: Fabio.BR.sjc folded before Flop (didn't bet)
Seat 3: Radiergummi0 folded before Flop (didn't bet)
Seat 4: mayconmontaia collected ($0.09)
Seat 5: Shahta-16 folded before Flop (didn't bet)
Seat 6: Zzzanderman (button) folded before Flop (didn't bet)
Seat 7: meelis9 (small blind) folded before Flop
Seat 8: Dorex2007 (big blind) folded on the Turn
Seat 9: Lymnhades folded before Flop (didn't bet)



PokerStars Hand #237376231479:  Hold'em No Limit ($0.01/$0.02 USD) - 2022/07/15 11:06:37 PT [2022/07/15 14:06:37 ET]
Table 'Appella II' 9-max Seat #7 is the button
Seat 1: FACCHETADE$ ($2 in chips) 
Seat 2: Fabio.BR.sjc ($1.89 in chips) 
Seat 3: Radiergummi0 ($1.22 in chips) 
Seat 4: mayconmontaia ($2.03 in chips) 
Seat 5: Shahta-16 ($2.27 in chips) 
Seat 6: Zzzanderman ($2.25 in chips) 
Seat 7: meelis9 ($2.47 in chips) 
Seat 8: Dorex2007 ($3.44 in chips) 
Seat 9: Lymnhades ($2.08 in chips) 
Dorex2007: posts small blind $0.01
Lymnhades: posts big blind $0.02
*** HOLE CARDS ***
Dealt to Dorex2007 [Kh 9d]
FACCHETADE$: folds 
Fabio.BR.sjc: folds 
Radiergummi0: folds 
mayconmontaia: folds 
Shahta-16: folds 
Zzzanderman: folds 
meelis9: folds 
Dorex2007: calls $0.01
meelis9 leaves the table
Lymnhades: checks 
*** FLOP *** [Ac 4s 6c]
Dorex2007: checks 
Lymnhades: bets $0.04
Dorex2007: folds 
Uncalled bet ($0.04) returned to Lymnhades
Lymnhades collected $0.04 from pot
*** SUMMARY ***
Total pot $0.04 | Rake $0 
Board [Ac 4s 6c]
Seat 1: FACCHETADE$ folded before Flop (didn't bet)
Seat 2: Fabio.BR.sjc folded before Flop (didn't bet)
Seat 3: Radiergummi0 folded before Flop (didn't bet)
Seat 4: mayconmontaia folded before Flop (didn't bet)
Seat 5: Shahta-16 folded before Flop (didn't bet)
Seat 6: Zzzanderman folded before Flop (didn't bet)
Seat 7: meelis9 (button) folded before Flop (didn't bet)
Seat 8: Dorex2007 (small blind) folded on the Flop
Seat 9: Lymnhades (big blind) collected ($0.04)



PokerStars Hand #237376244302:  Hold'em No Limit ($0.01/$0.02 USD) - 2022/07/15 11:07:17 PT [2022/07/15 14:07:17 ET]
Table 'Appella II' 9-max Seat #8 is the button
Seat 1: FACCHETADE$ ($2 in chips) 
Seat 2: Fabio.BR.sjc ($1.89 in chips) 
Seat 3: Radiergummi0 ($1.22 in chips) 
Seat 4: mayconmontaia ($2.03 in chips) 
Seat 5: Shahta-16 ($2.27 in chips) 
Seat 6: Zzzanderman ($2.25 in chips) 
Seat 8: Dorex2007 ($3.42 in chips) 
Seat 9: Lymnhades ($2.10 in chips) 
Lymnhades: posts small blind $0.01
rurli 26 joins the table at seat #7 
FACCHETADE$: posts big blind $0.02
*** HOLE CARDS ***
Dealt to Dorex2007 [2s 2h]
Fabio.BR.sjc: raises $0.02 to $0.04
Radiergummi0: folds 
mayconmontaia: folds 
Shahta-16 has timed out
Shahta-16: folds 
Zzzanderman: folds 
Dorex2007: calls $0.04
Lymnhades: folds 
FACCHETADE$: folds 
*** FLOP *** [Kh Ks 7d]
Fabio.BR.sjc: checks 
Dorex2007: checks 
*** TURN *** [Kh Ks 7d] [9s]
Fabio.BR.sjc: bets $0.02
Dorex2007: calls $0.02
*** RIVER *** [Kh Ks 7d 9s] [Jc]
Fabio.BR.sjc: checks 
Dorex2007: checks 
*** SHOW DOWN ***
Fabio.BR.sjc: shows [6s As] (a pair of Kings)
Dorex2007: shows [2s 2h] (two pair, Kings and Deuces)
Dorex2007 collected $0.14 from pot
*** SUMMARY ***
Total pot $0.15 | Rake $0.01 
Board [Kh Ks 7d 9s Jc]
Seat 1: FACCHETADE$ (big blind) folded before Flop
Seat 2: Fabio.BR.sjc showed [6s As] and lost with a pair of Kings
Seat 3: Radiergummi0 folded before Flop (didn't bet)
Seat 4: mayconmontaia folded before Flop (didn't bet)
Seat 5: Shahta-16 folded before Flop (didn't bet)
Seat 6: Zzzanderman folded before Flop (didn't bet)
Seat 8: Dorex2007 (button) showed [2s 2h] and won ($0.14) with two pair, Kings and Deuces
Seat 9: Lymnhades (small blind) folded before Flop



PokerStars Hand #237376266116:  Hold'em No Limit ($0.01/$0.02 USD) - 2022/07/15 11:08:27 PT [2022/07/15 14:08:27 ET]
Table 'Appella II' 9-max Seat #9 is the button
Seat 1: FACCHETADE$ ($1.98 in chips) 
Seat 2: Fabio.BR.sjc ($1.83 in chips) 
Seat 3: Radiergummi0 ($1.22 in chips) 
Seat 4: mayconmontaia ($2.03 in chips) 
Seat 5: Shahta-16 ($2.27 in chips) 
Seat 6: Zzzanderman ($2.25 in chips) 
Seat 7: rurli 26 ($1.60 in chips) 
Seat 8: Dorex2007 ($3.50 in chips) 
Seat 9: Lymnhades ($2.09 in chips) 
FACCHETADE$: posts small blind $0.01
Fabio.BR.sjc: posts big blind $0.02
rurli 26: posts big blind $0.02
*** HOLE CARDS ***
Dealt to Dorex2007 [7s Jh]
Radiergummi0: folds 
mayconmontaia: folds 
Shahta-16: folds 
Zzzanderman: folds 
rurli 26: raises $0.05 to $0.07
Dorex2007: folds 
Lymnhades: folds 
FACCHETADE$: folds 
Fabio.BR.sjc: folds 
Uncalled bet ($0.05) returned to rurli 26
rurli 26 collected $0.05 from pot
*** SUMMARY ***
Total pot $0.05 | Rake $0 
Seat 1: FACCHETADE$ (small blind) folded before Flop
Seat 2: Fabio.BR.sjc (big blind) folded before Flop
Seat 3: Radiergummi0 folded before Flop (didn't bet)
Seat 4: mayconmontaia folded before Flop (didn't bet)
Seat 5: Shahta-16 folded before Flop (didn't bet)
Seat 6: Zzzanderman folded before Flop (didn't bet)
Seat 7: rurli 26 collected ($0.05)
Seat 8: Dorex2007 folded before Flop (didn't bet)
Seat 9: Lymnhades (button) folded before Flop (didn't bet)



PokerStars Hand #237376272558:  Hold'em No Limit ($0.01/$0.02 USD) - 2022/07/15 11:08:48 PT [2022/07/15 14:08:48 ET]
Table 'Appella II' 9-max Seat #1 is the button
Seat 1: FACCHETADE$ ($1.97 in chips) 
Seat 2: Fabio.BR.sjc ($1.81 in chips) 
Seat 3: Radiergummi0 ($1.22 in chips) 
Seat 4: mayconmontaia ($2.03 in chips) 
Seat 5: Shahta-16 ($2.27 in chips) 
Seat 6: Zzzanderman ($2.25 in chips) 
Seat 7: rurli 26 ($1.63 in chips) 
Seat 8: Dorex2007 ($3.50 in chips) 
Seat 9: Lymnhades ($2.09 in chips) 
Fabio.BR.sjc: posts small blind $0.01
Radiergummi0: posts big blind $0.02
*** HOLE CARDS ***
Dealt to Dorex2007 [Kh Ks]
mayconmontaia: folds 
Shahta-16: folds 
Zzzanderman: folds 
rurli 26: calls $0.02
Dorex2007: raises $0.04 to $0.06
Lymnhades: folds 
FACCHETADE$: calls $0.06
Fabio.BR.sjc: folds 
Radiergummi0: calls $0.04
rurli 26: calls $0.04
*** FLOP *** [Jh 5d 7d]
Radiergummi0: checks 
rurli 26: checks 
Dorex2007: bets $0.24
FACCHETADE$: folds 
Radiergummi0: folds 
rurli 26: folds 
Uncalled bet ($0.24) returned to Dorex2007
Dorex2007 collected $0.24 from pot
*** SUMMARY ***
Total pot $0.25 | Rake $0.01 
Board [Jh 5d 7d]
Seat 1: FACCHETADE$ (button) folded on the Flop
Seat 2: Fabio.BR.sjc (small blind) folded before Flop
Seat 3: Radiergummi0 (big blind) folded on the Flop
Seat 4: mayconmontaia folded before Flop (didn't bet)
Seat 5: Shahta-16 folded before Flop (didn't bet)
Seat 6: Zzzanderman folded before Flop (didn't bet)
Seat 7: rurli 26 folded on the Flop
Seat 8: Dorex2007 collected ($0.24)
Seat 9: Lymnhades folded before Flop (didn't bet)



PokerStars Hand #237376288471:  Hold'em No Limit ($0.01/$0.02 USD) - 2022/07/15 11:09:38 PT [2022/07/15 14:09:38 ET]
Table 'Appella II' 9-max Seat #2 is the button
Seat 1: FACCHETADE$ ($1.91 in chips) 
Seat 2: Fabio.BR.sjc ($1.80 in chips) 
Seat 3: Radiergummi0 ($1.16 in chips) 
Seat 4: mayconmontaia ($2.03 in chips) 
Seat 5: Shahta-16 ($2.27 in chips) 
Seat 6: Zzzanderman ($2.25 in chips) 
Seat 7: rurli 26 ($1.57 in chips) 
Seat 8: Dorex2007 ($3.68 in chips) 
Seat 9: Lymnhades ($2.09 in chips) 
Radiergummi0: posts small blind $0.01
mayconmontaia: posts big blind $0.02
*** HOLE CARDS ***
Dealt to Dorex2007 [Td Jh]
Shahta-16: folds 
Zzzanderman: folds 
rurli 26: calls $0.02
Dorex2007: folds 
Lymnhades: folds 
FACCHETADE$: folds 
Fabio.BR.sjc: calls $0.02
Radiergummi0: calls $0.01
mayconmontaia: checks 
*** FLOP *** [Jd 7h 3d]
Radiergummi0: checks 
mayconmontaia: checks 
rurli 26: checks 
Fabio.BR.sjc: checks 
*** TURN *** [Jd 7h 3d] [Tc]
Radiergummi0: checks 
mayconmontaia: checks 
rurli 26: checks 
Fabio.BR.sjc: checks 
*** RIVER *** [Jd 7h 3d Tc] [8d]
Radiergummi0: checks 
mayconmontaia: bets $0.02
rurli 26: folds 
Fabio.BR.sjc: folds 
Radiergummi0: folds 
Uncalled bet ($0.02) returned to mayconmontaia
mayconmontaia collected $0.08 from pot
*** SUMMARY ***
Total pot $0.08 | Rake $0 
Board [Jd 7h 3d Tc 8d]
Seat 1: FACCHETADE$ folded before Flop (didn't bet)
Seat 2: Fabio.BR.sjc (button) folded on the River
Seat 3: Radiergummi0 (small blind) folded on the River
Seat 4: mayconmontaia (big blind) collected ($0.08)
Seat 5: Shahta-16 folded before Flop (didn't bet)
Seat 6: Zzzanderman folded before Flop (didn't bet)
Seat 7: rurli 26 folded on the River
Seat 8: Dorex2007 folded before Flop (didn't bet)
Seat 9: Lymnhades folded before Flop (didn't bet)



PokerStars Hand #237376315435:  Hold'em No Limit ($0.01/$0.02 USD) - 2022/07/15 11:11:04 PT [2022/07/15 14:11:04 ET]
Table 'Appella II' 9-max Seat #3 is the button
Seat 1: FACCHETADE$ ($1.91 in chips) 
Seat 2: Fabio.BR.sjc ($1.78 in chips) 
Seat 3: Radiergummi0 ($1.14 in chips) 
Seat 4: mayconmontaia ($2.09 in chips) 
Seat 5: Shahta-16 ($2.27 in chips) 
Seat 6: Zzzanderman ($2.25 in chips) 
Seat 7: rurli 26 ($1.55 in chips) 
Seat 8: Dorex2007 ($3.68 in chips) 
Seat 9: Lymnhades ($2.09 in chips) 
mayconmontaia: posts small blind $0.01
Shahta-16: posts big blind $0.02
*** HOLE CARDS ***
Dealt to Dorex2007 [5c 9c]
Zzzanderman: folds 
rurli 26: folds 
Dorex2007: folds 
Lymnhades: folds 
FACCHETADE$: raises $0.02 to $0.04
Fabio.BR.sjc: folds 
Radiergummi0: calls $0.04
mayconmontaia: folds 
Shahta-16: folds 
*** FLOP *** [3s 6c 9s]
FACCHETADE$: checks 
Radiergummi0: bets $0.04
FACCHETADE$: calls $0.04
*** TURN *** [3s 6c 9s] [Ac]
FACCHETADE$: checks 
Radiergummi0: bets $0.09
FACCHETADE$: calls $0.09
*** RIVER *** [3s 6c 9s Ac] [5s]
FACCHETADE$: checks 
Radiergummi0: checks 
*** SHOW DOWN ***
FACCHETADE$: shows [2s As] (a flush, Ace high)
Radiergummi0: mucks hand 
FACCHETADE$ collected $0.36 from pot
*** SUMMARY ***
Total pot $0.37 | Rake $0.01 
Board [3s 6c 9s Ac 5s]
Seat 1: FACCHETADE$ showed [2s As] and won ($0.36) with a flush, Ace high
Seat 2: Fabio.BR.sjc folded before Flop (didn't bet)
Seat 3: Radiergummi0 (button) mucked [7c 6s]
Seat 4: mayconmontaia (small blind) folded before Flop
Seat 5: Shahta-16 (big blind) folded before Flop
Seat 6: Zzzanderman folded before Flop (didn't bet)
Seat 7: rurli 26 folded before Flop (didn't bet)
Seat 8: Dorex2007 folded before Flop (didn't bet)
Seat 9: Lymnhades folded before Flop (didn't bet)



PokerStars Hand #237376333630:  Hold'em No Limit ($0.01/$0.02 USD) - 2022/07/15 11:12:02 PT [2022/07/15 14:12:02 ET]
Table 'Appella II' 9-max Seat #4 is the button
Seat 1: FACCHETADE$ ($2.10 in chips) 
Seat 2: Fabio.BR.sjc ($1.78 in chips) 
Seat 3: Radiergummi0 ($1 in chips) 
Seat 4: mayconmontaia ($2.08 in chips) 
Seat 5: Shahta-16 ($2.25 in chips) 
Seat 6: Zzzanderman ($2.25 in chips) 
Seat 7: rurli 26 ($1.55 in chips) 
Seat 8: Dorex2007 ($3.68 in chips) 
Seat 9: Lymnhades ($2.09 in chips) 
Shahta-16: posts small blind $0.01
Zzzanderman: posts big blind $0.02
*** HOLE CARDS ***
Dealt to Dorex2007 [5c Qh]
rurli 26: folds 
Dorex2007: folds 
Lymnhades: folds 
FACCHETADE$: folds 
Fabio.BR.sjc: folds 
Radiergummi0: folds 
mayconmontaia: folds 
Shahta-16: folds 
Uncalled bet ($0.01) returned to Zzzanderman
Zzzanderman collected $0.02 from pot
*** SUMMARY ***
Total pot $0.02 | Rake $0 
Seat 1: FACCHETADE$ folded before Flop (didn't bet)
Seat 2: Fabio.BR.sjc folded before Flop (didn't bet)
Seat 3: Radiergummi0 folded before Flop (didn't bet)
Seat 4: mayconmontaia (button) folded before Flop (didn't bet)
Seat 5: Shahta-16 (small blind) folded before Flop
Seat 6: Zzzanderman (big blind) collected ($0.02)
Seat 7: rurli 26 folded before Flop (didn't bet)
Seat 8: Dorex2007 folded before Flop (didn't bet)
Seat 9: Lymnhades folded before Flop (didn't bet)



PokerStars Hand #237376341295:  Hold'em No Limit ($0.01/$0.02 USD) - 2022/07/15 11:12:26 PT [2022/07/15 14:12:26 ET]
Table 'Appella II' 9-max Seat #5 is the button
Seat 1: FACCHETADE$ ($2.10 in chips) 
Seat 2: Fabio.BR.sjc ($1.78 in chips) 
Seat 3: Radiergummi0 ($1 in chips) 
Seat 4: mayconmontaia ($2.08 in chips) 
Seat 5: Shahta-16 ($2.24 in chips) 
Seat 6: Zzzanderman ($2.26 in chips) 
Seat 7: rurli 26 ($1.55 in chips) 
Seat 8: Dorex2007 ($3.68 in chips) 
Seat 9: Lymnhades ($2.09 in chips) 
Zzzanderman: posts small blind $0.01
rurli 26: posts big blind $0.02
*** HOLE CARDS ***
Dealt to Dorex2007 [5s 5c]
Dorex2007 has timed out
Dorex2007: folds 
Lymnhades: folds 
FACCHETADE$: folds 
Fabio.BR.sjc: raises $0.02 to $0.04
Radiergummi0: calls $0.04
mayconmontaia: folds 
Shahta-16: folds 
Zzzanderman: calls $0.03
rurli 26: folds 
*** FLOP *** [4d 9c 9h]
Zzzanderman: checks 
Fabio.BR.sjc: checks 
Radiergummi0: checks 
*** TURN *** [4d 9c 9h] [8h]
Zzzanderman: checks 
Fabio.BR.sjc: checks 
Radiergummi0: checks 
*** RIVER *** [4d 9c 9h 8h] [Ad]
Zzzanderman: checks 
Fabio.BR.sjc: checks 
Radiergummi0: checks 
*** SHOW DOWN ***
Zzzanderman: shows [4h As] (two pair, Aces and Nines)
Fabio.BR.sjc: mucks hand 
Radiergummi0: mucks hand 
Zzzanderman collected $0.14 from pot
*** SUMMARY ***
Total pot $0.14 | Rake $0 
Board [4d 9c 9h 8h Ad]
Seat 1: FACCHETADE$ folded before Flop (didn't bet)
Seat 2: Fabio.BR.sjc mucked [Kd Jd]
Seat 3: Radiergummi0 mucked [6d 3d]
Seat 4: mayconmontaia folded before Flop (didn't bet)
Seat 5: Shahta-16 (button) folded before Flop (didn't bet)
Seat 6: Zzzanderman (small blind) showed [4h As] and won ($0.14) with two pair, Aces and Nines
Seat 7: rurli 26 (big blind) folded before Flop
Seat 8: Dorex2007 folded before Flop (didn't bet)
Seat 9: Lymnhades folded before Flop (didn't bet)



PokerStars Hand #237376366630:  Hold'em No Limit ($0.01/$0.02 USD) - 2022/07/15 11:13:48 PT [2022/07/15 14:13:48 ET]
Table 'Appella II' 9-max Seat #6 is the button
Seat 1: FACCHETADE$ ($2.10 in chips) 
Seat 2: Fabio.BR.sjc ($1.74 in chips) 
Seat 3: Radiergummi0 ($1 in chips) 
Seat 4: mayconmontaia ($2.08 in chips) 
Seat 5: Shahta-16 ($2.24 in chips) 
Seat 6: Zzzanderman ($2.36 in chips) 
Seat 7: rurli 26 ($1.53 in chips) 
Seat 8: Dorex2007 ($3.68 in chips) 
Seat 9: Lymnhades ($2.09 in chips) 
rurli 26: posts small blind $0.01
Dorex2007: posts big blind $0.02
*** HOLE CARDS ***
Dealt to Dorex2007 [6h Qh]
Lymnhades: folds 
FACCHETADE$: folds 
Fabio.BR.sjc: raises $0.02 to $0.04
Radiergummi0: calls $0.04
mayconmontaia: folds 
Shahta-16: folds 
Zzzanderman: folds 
rurli 26: calls $0.03
Dorex2007: folds 
*** FLOP *** [Kd Th 2h]
rurli 26: bets $0.14
Fabio.BR.sjc: raises $0.14 to $0.28
Radiergummi0: folds 
rurli 26: raises $0.70 to $0.98
Fabio.BR.sjc: raises $0.70 to $1.68
rurli 26: calls $0.51 and is all-in
Uncalled bet ($0.19) returned to Fabio.BR.sjc
*** TURN *** [Kd Th 2h] [Jc]
*** RIVER *** [Kd Th 2h Jc] [7d]
*** SHOW DOWN ***
rurli 26: shows [2s Ts] (two pair, Tens and Deuces)
Fabio.BR.sjc: shows [As Ah] (a pair of Aces)
rurli 26 collected $3.01 from pot
*** SUMMARY ***
Total pot $3.12 | Rake $0.11 
Board [Kd Th 2h Jc 7d]
Seat 1: FACCHETADE$ folded before Flop (didn't bet)
Seat 2: Fabio.BR.sjc showed [As Ah] and lost with a pair of Aces
Seat 3: Radiergummi0 folded on the Flop
Seat 4: mayconmontaia folded before Flop (didn't bet)
Seat 5: Shahta-16 folded before Flop (didn't bet)
Seat 6: Zzzanderman (button) folded before Flop (didn't bet)
Seat 7: rurli 26 (small blind) showed [2s Ts] and won ($3.01) with two pair, Tens and Deuces
Seat 8: Dorex2007 (big blind) folded before Flop
Seat 9: Lymnhades folded before Flop (didn't bet)



PokerStars Hand #237376397701:  Hold'em No Limit ($0.01/$0.02 USD) - 2022/07/15 11:14:59 PT [2022/07/15 14:14:59 ET]
Table 'Appella II' 9-max Seat #7 is the button
Seat 1: FACCHETADE$ ($2.10 in chips) 
Seat 2: Fabio.BR.sjc ($0.21 in chips) 
Seat 3: Radiergummi0 ($1 in chips) 
Seat 4: mayconmontaia ($2.08 in chips) 
Seat 5: Shahta-16 ($2.24 in chips) 
Seat 6: Zzzanderman ($2.36 in chips) 
Seat 7: rurli 26 ($3.01 in chips) 
Seat 8: Dorex2007 ($3.66 in chips) 
Seat 9: Lymnhades ($2.09 in chips) 
Dorex2007: posts small blind $0.01
Lymnhades: posts big blind $0.02
*** HOLE CARDS ***
Dealt to Dorex2007 [6c Kc]
FACCHETADE$: folds 
Fabio.BR.sjc: folds 
Radiergummi0: folds 
mayconmontaia: folds 
Shahta-16: folds 
Fabio.BR.sjc leaves the table
Zzzanderman: folds 
rurli 26: folds 
Dorex2007: folds 
Uncalled bet ($0.01) returned to Lymnhades
Lymnhades collected $0.02 from pot
*** SUMMARY ***
Total pot $0.02 | Rake $0 
Seat 1: FACCHETADE$ folded before Flop (didn't bet)
Seat 2: Fabio.BR.sjc folded before Flop (didn't bet)
Seat 3: Radiergummi0 folded before Flop (didn't bet)
Seat 4: mayconmontaia folded before Flop (didn't bet)
Seat 5: Shahta-16 folded before Flop (didn't bet)
Seat 6: Zzzanderman folded before Flop (didn't bet)
Seat 7: rurli 26 (button) folded before Flop (didn't bet)
Seat 8: Dorex2007 (small blind) folded before Flop
Seat 9: Lymnhades (big blind) collected ($0.02)



PokerStars Hand #237376402167:  Hold'em No Limit ($0.01/$0.02 USD) - 2022/07/15 11:15:14 PT [2022/07/15 14:15:14 ET]
Table 'Appella II' 9-max Seat #8 is the button
Seat 1: FACCHETADE$ ($2.10 in chips) 
Seat 3: Radiergummi0 ($1 in chips) 
Seat 4: mayconmontaia ($2.08 in chips) 
Seat 5: Shahta-16 ($2.24 in chips) 
Seat 6: Zzzanderman ($2.36 in chips) 
Seat 7: rurli 26 ($3.01 in chips) 
Seat 8: Dorex2007 ($3.65 in chips) 
Seat 9: Lymnhades ($2.10 in chips) 
Lymnhades: posts small blind $0.01
FACCHETADE$: posts big blind $0.02
*** HOLE CARDS ***
Dealt to Dorex2007 [6d As]
Radiergummi0: folds 
mayconmontaia: folds 
Shahta-16: raises $0.04 to $0.06
Zzzanderman: folds 
rurli 26: folds 
Dorex2007: folds 
Radiergummi0 leaves the table
Lymnhades: calls $0.05
murmuc1956 joins the table at seat #2 
FACCHETADE$: folds 
*** FLOP *** [2d Kh Jh]
7AVA joins the table at seat #3 
Lymnhades: checks 
Shahta-16: bets $0.09
Lymnhades: folds 
Uncalled bet ($0.09) returned to Shahta-16
Shahta-16 collected $0.14 from pot
*** SUMMARY ***
Total pot $0.14 | Rake $0 
Board [2d Kh Jh]
Seat 1: FACCHETADE$ (big blind) folded before Flop
Seat 3: Radiergummi0 folded before Flop (didn't bet)
Seat 4: mayconmontaia folded before Flop (didn't bet)
Seat 5: Shahta-16 collected ($0.14)
Seat 6: Zzzanderman folded before Flop (didn't bet)
Seat 7: rurli 26 folded before Flop (didn't bet)
Seat 8: Dorex2007 (button) folded before Flop (didn't bet)
Seat 9: Lymnhades (small blind) folded on the Flop



PokerStars Hand #237376413403:  Hold'em No Limit ($0.01/$0.02 USD) - 2022/07/15 11:15:49 PT [2022/07/15 14:15:49 ET]
Table 'Appella II' 9-max Seat #9 is the button
Seat 1: FACCHETADE$ ($2.08 in chips) 
Seat 2: murmuc1956 ($2 in chips) 
Seat 4: mayconmontaia ($2.08 in chips) 
Seat 5: Shahta-16 ($2.32 in chips) 
Seat 6: Zzzanderman ($2.36 in chips) 
Seat 7: rurli 26 ($3.01 in chips) 
Seat 8: Dorex2007 ($3.65 in chips) 
Seat 9: Lymnhades ($2.04 in chips) 
FACCHETADE$: posts small blind $0.01
murmuc1956: posts big blind $0.02
7AVA: sits out 
*** HOLE CARDS ***
Dealt to Dorex2007 [Td 6s]
mayconmontaia: folds 
Shahta-16: folds 
Zzzanderman: folds 
rurli 26: folds 
Dorex2007: folds 
Lymnhades: raises $0.04 to $0.06
FACCHETADE$: folds 
murmuc1956: calls $0.04
*** FLOP *** [Qc 4h 4s]
murmuc1956: checks 
Lymnhades: bets $0.09
murmuc1956: folds 
Uncalled bet ($0.09) returned to Lymnhades
Lymnhades collected $0.13 from pot
*** SUMMARY ***
Total pot $0.13 | Rake $0 
Board [Qc 4h 4s]
Seat 1: FACCHETADE$ (small blind) folded before Flop
Seat 2: murmuc1956 (big blind) folded on the Flop
Seat 4: mayconmontaia folded before Flop (didn't bet)
Seat 5: Shahta-16 folded before Flop (didn't bet)
Seat 6: Zzzanderman folded before Flop (didn't bet)
Seat 7: rurli 26 folded before Flop (didn't bet)
Seat 8: Dorex2007 folded before Flop (didn't bet)
Seat 9: Lymnhades (button) collected ($0.13)



PokerStars Hand #237376423183:  Hold'em No Limit ($0.01/$0.02 USD) - 2022/07/15 11:16:21 PT [2022/07/15 14:16:21 ET]
Table 'Appella II' 9-max Seat #1 is the button
Seat 1: FACCHETADE$ ($2.07 in chips) 
Seat 2: murmuc1956 ($1.94 in chips) 
Seat 3: 7AVA ($2 in chips) 
Seat 4: mayconmontaia ($2.08 in chips) 
Seat 5: Shahta-16 ($2.32 in chips) 
Seat 6: Zzzanderman ($2.36 in chips) 
Seat 7: rurli 26 ($3.01 in chips) 
Seat 8: Dorex2007 ($3.65 in chips) 
Seat 9: Lymnhades ($2.11 in chips) 
murmuc1956: posts small blind $0.01
7AVA: posts big blind $0.02
*** HOLE CARDS ***
Dealt to Dorex2007 [3s 3h]
mayconmontaia: folds 
Shahta-16: folds 
Zzzanderman: raises $0.12 to $0.14
rurli 26: folds 
Dorex2007: folds 
Lymnhades: folds 
FACCHETADE$: folds 
murmuc1956: folds 
7AVA: folds 
Uncalled bet ($0.12) returned to Zzzanderman
Zzzanderman collected $0.05 from pot
*** SUMMARY ***
Total pot $0.05 | Rake $0 
Seat 1: FACCHETADE$ (button) folded before Flop (didn't bet)
Seat 2: murmuc1956 (small blind) folded before Flop
Seat 3: 7AVA (big blind) folded before Flop
Seat 4: mayconmontaia folded before Flop (didn't bet)
Seat 5: Shahta-16 folded before Flop (didn't bet)
Seat 6: Zzzanderman collected ($0.05)
Seat 7: rurli 26 folded before Flop (didn't bet)
Seat 8: Dorex2007 folded before Flop (didn't bet)
Seat 9: Lymnhades folded before Flop (didn't bet)



PokerStars Hand #237376430950:  Hold'em No Limit ($0.01/$0.02 USD) - 2022/07/15 11:16:46 PT [2022/07/15 14:16:46 ET]
Table 'Appella II' 9-max Seat #2 is the button
Seat 1: FACCHETADE$ ($2.07 in chips) 
Seat 2: murmuc1956 ($1.93 in chips) 
Seat 3: 7AVA ($2 in chips) 
Seat 4: mayconmontaia ($2.08 in chips) 
Seat 5: Shahta-16 ($2.32 in chips) 
Seat 6: Zzzanderman ($2.39 in chips) 
Seat 7: rurli 26 ($3.01 in chips) 
Seat 8: Dorex2007 ($3.65 in chips) 
Seat 9: Lymnhades ($2.11 in chips) 
7AVA: posts small blind $0.01
mayconmontaia: posts big blind $0.02
*** HOLE CARDS ***
Dealt to Dorex2007 [2s Kd]
Shahta-16: folds 
Zzzanderman: folds 
rurli 26: folds 
Dorex2007: folds 
Lymnhades: folds 
FACCHETADE$: folds 
murmuc1956: folds 
7AVA: folds 
Uncalled bet ($0.01) returned to mayconmontaia
mayconmontaia collected $0.02 from pot
*** SUMMARY ***
Total pot $0.02 | Rake $0 
Seat 1: FACCHETADE$ folded before Flop (didn't bet)
Seat 2: murmuc1956 (button) folded before Flop (didn't bet)
Seat 3: 7AVA (small blind) folded before Flop
Seat 4: mayconmontaia (big blind) collected ($0.02)
Seat 5: Shahta-16 folded before Flop (didn't bet)
Seat 6: Zzzanderman folded before Flop (didn't bet)
Seat 7: rurli 26 folded before Flop (didn't bet)
Seat 8: Dorex2007 folded before Flop (didn't bet)
Seat 9: Lymnhades folded before Flop (didn't bet)



PokerStars Hand #237376437783:  Hold'em No Limit ($0.01/$0.02 USD) - 2022/07/15 11:17:07 PT [2022/07/15 14:17:07 ET]
Table 'Appella II' 9-max Seat #3 is the button
Seat 1: FACCHETADE$ ($2.07 in chips) 
Seat 2: murmuc1956 ($1.93 in chips) 
Seat 3: 7AVA ($2 in chips) 
Seat 4: mayconmontaia ($2.09 in chips) 
Seat 5: Shahta-16 ($2.32 in chips) 
Seat 6: Zzzanderman ($2.39 in chips) 
Seat 7: rurli 26 ($3.01 in chips) 
Seat 8: Dorex2007 ($3.65 in chips) 
Seat 9: Lymnhades ($2.11 in chips) 
mayconmontaia: posts small blind $0.01
Shahta-16: posts big blind $0.02
*** HOLE CARDS ***
Dealt to Dorex2007 [2s 9s]
Zzzanderman: folds 
rurli 26: folds 
Dorex2007: folds 
Lymnhades: folds 
FACCHETADE$: folds 
murmuc1956: folds 
7AVA: folds 
mayconmontaia: calls $0.01
Shahta-16: raises $0.06 to $0.08
mayconmontaia: folds 
Uncalled bet ($0.06) returned to Shahta-16
Shahta-16 collected $0.04 from pot
*** SUMMARY ***
Total pot $0.04 | Rake $0 
Seat 1: FACCHETADE$ folded before Flop (didn't bet)
Seat 2: murmuc1956 folded before Flop (didn't bet)
Seat 3: 7AVA (button) folded before Flop (didn't bet)
Seat 4: mayconmontaia (small blind) folded before Flop
Seat 5: Shahta-16 (big blind) collected ($0.04)
Seat 6: Zzzanderman folded before Flop (didn't bet)
Seat 7: rurli 26 folded before Flop (didn't bet)
Seat 8: Dorex2007 folded before Flop (didn't bet)
Seat 9: Lymnhades folded before Flop (didn't bet)



PokerStars Hand #237376445227:  Hold'em No Limit ($0.01/$0.02 USD) - 2022/07/15 11:17:31 PT [2022/07/15 14:17:31 ET]
Table 'Appella II' 9-max Seat #4 is the button
Seat 1: FACCHETADE$ ($2.07 in chips) 
Seat 2: murmuc1956 ($1.93 in chips) 
Seat 3: 7AVA ($2 in chips) 
Seat 4: mayconmontaia ($2.07 in chips) 
Seat 5: Shahta-16 ($2.34 in chips) 
Seat 6: Zzzanderman ($2.39 in chips) 
Seat 7: rurli 26 ($3.01 in chips) 
Seat 8: Dorex2007 ($3.65 in chips) 
Seat 9: Lymnhades ($2.11 in chips) 
Shahta-16: posts small blind $0.01
Zzzanderman: posts big blind $0.02
*** HOLE CARDS ***
Dealt to Dorex2007 [8h Jc]
rurli 26: folds 
Dorex2007: folds 
Lymnhades: folds 
FACCHETADE$: raises $0.02 to $0.04
murmuc1956: folds 
7AVA: folds 
mayconmontaia: folds 
Shahta-16: folds 
Zzzanderman: folds 
Uncalled bet ($0.02) returned to FACCHETADE$
FACCHETADE$ collected $0.05 from pot
*** SUMMARY ***
Total pot $0.05 | Rake $0 
Seat 1: FACCHETADE$ collected ($0.05)
Seat 2: murmuc1956 folded before Flop (didn't bet)
Seat 3: 7AVA folded before Flop (didn't bet)
Seat 4: mayconmontaia (button) folded before Flop (didn't bet)
Seat 5: Shahta-16 (small blind) folded before Flop
Seat 6: Zzzanderman (big blind) folded before Flop
Seat 7: rurli 26 folded before Flop (didn't bet)
Seat 8: Dorex2007 folded before Flop (didn't bet)
Seat 9: Lymnhades folded before Flop (didn't bet)



PokerStars Hand #237376452083:  Hold'em No Limit ($0.01/$0.02 USD) - 2022/07/15 11:17:53 PT [2022/07/15 14:17:53 ET]
Table 'Appella II' 9-max Seat #5 is the button
Seat 1: FACCHETADE$ ($2.10 in chips) 
Seat 2: murmuc1956 ($1.93 in chips) 
Seat 3: 7AVA ($2 in chips) 
Seat 4: mayconmontaia ($2.07 in chips) 
Seat 5: Shahta-16 ($2.33 in chips) 
Seat 6: Zzzanderman ($2.37 in chips) 
Seat 7: rurli 26 ($3.01 in chips) 
Seat 8: Dorex2007 ($3.65 in chips) 
Seat 9: Lymnhades ($2.11 in chips) 
Zzzanderman: posts small blind $0.01
rurli 26: posts big blind $0.02
*** HOLE CARDS ***
Dealt to Dorex2007 [7h Kh]
Dorex2007: folds 
Lymnhades: folds 
FACCHETADE$: folds 
murmuc1956: folds 
7AVA: raises $0.03 to $0.05
mayconmontaia: folds 
Shahta-16: folds 
Zzzanderman: folds 
rurli 26: calls $0.03
*** FLOP *** [5s 8c 3d]
rurli 26: checks 
7AVA: bets $0.07
rurli 26: calls $0.07
*** TURN *** [5s 8c 3d] [2c]
rurli 26: checks 
7AVA: bets $0.16
rurli 26: folds 
Uncalled bet ($0.16) returned to 7AVA
7AVA collected $0.24 from pot
*** SUMMARY ***
Total pot $0.25 | Rake $0.01 
Board [5s 8c 3d 2c]
Seat 1: FACCHETADE$ folded before Flop (didn't bet)
Seat 2: murmuc1956 folded before Flop (didn't bet)
Seat 3: 7AVA collected ($0.24)
Seat 4: mayconmontaia folded before Flop (didn't bet)
Seat 5: Shahta-16 (button) folded before Flop (didn't bet)
Seat 6: Zzzanderman (small blind) folded before Flop
Seat 7: rurli 26 (big blind) folded on the Turn
Seat 8: Dorex2007 folded before Flop (didn't bet)
Seat 9: Lymnhades folded before Flop (didn't bet)



PokerStars Hand #237376476359:  Hold'em No Limit ($0.01/$0.02 USD) - 2022/07/15 11:19:10 PT [2022/07/15 14:19:10 ET]
Table 'Appella II' 9-max Seat #6 is the button
Seat 1: FACCHETADE$ ($2.10 in chips) 
Seat 2: murmuc1956 ($1.93 in chips) 
Seat 3: 7AVA ($2.12 in chips) 
Seat 4: mayconmontaia ($2.07 in chips) 
Seat 5: Shahta-16 ($2.33 in chips) 
Seat 6: Zzzanderman ($2.36 in chips) 
Seat 7: rurli 26 ($2.89 in chips) 
Seat 8: Dorex2007 ($3.65 in chips) 
Seat 9: Lymnhades ($2.11 in chips) 
rurli 26: posts small blind $0.01
Dorex2007: posts big blind $0.02
*** HOLE CARDS ***
Dealt to Dorex2007 [5c Ah]
Lymnhades: folds 
FACCHETADE$: folds 
murmuc1956: folds 
7AVA: folds 
mayconmontaia: folds 
Shahta-16: folds 
Zzzanderman: folds 
rurli 26: folds 
Uncalled bet ($0.01) returned to Dorex2007
Dorex2007 collected $0.02 from pot
*** SUMMARY ***
Total pot $0.02 | Rake $0 
Seat 1: FACCHETADE$ folded before Flop (didn't bet)
Seat 2: murmuc1956 folded before Flop (didn't bet)
Seat 3: 7AVA folded before Flop (didn't bet)
Seat 4: mayconmontaia folded before Flop (didn't bet)
Seat 5: Shahta-16 folded before Flop (didn't bet)
Seat 6: Zzzanderman (button) folded before Flop (didn't bet)
Seat 7: rurli 26 (small blind) folded before Flop
Seat 8: Dorex2007 (big blind) collected ($0.02)
Seat 9: Lymnhades folded before Flop (didn't bet)



PokerStars Hand #237376480651:  Hold'em No Limit ($0.01/$0.02 USD) - 2022/07/15 11:19:24 PT [2022/07/15 14:19:24 ET]
Table 'Appella II' 9-max Seat #7 is the button
Seat 1: FACCHETADE$ ($2.10 in chips) 
Seat 2: murmuc1956 ($1.93 in chips) 
Seat 3: 7AVA ($2.12 in chips) 
Seat 4: mayconmontaia ($2.07 in chips) 
Seat 5: Shahta-16 ($2.33 in chips) 
Seat 6: Zzzanderman ($2.36 in chips) 
Seat 7: rurli 26 ($2.88 in chips) 
Seat 8: Dorex2007 ($3.66 in chips) 
Seat 9: Lymnhades ($2.11 in chips) 
Dorex2007: posts small blind $0.01
Lymnhades: posts big blind $0.02
*** HOLE CARDS ***
Dealt to Dorex2007 [Qs 7c]
FACCHETADE$: folds 
murmuc1956: folds 
7AVA: folds 
mayconmontaia: calls $0.02
Shahta-16: folds 
Zzzanderman: folds 
rurli 26: calls $0.02
Dorex2007: folds 
Lymnhades: raises $0.10 to $0.12
mayconmontaia: folds 
rurli 26: folds 
Uncalled bet ($0.10) returned to Lymnhades
Lymnhades collected $0.07 from pot
*** SUMMARY ***
Total pot $0.07 | Rake $0 
Seat 1: FACCHETADE$ folded before Flop (didn't bet)
Seat 2: murmuc1956 folded before Flop (didn't bet)
Seat 3: 7AVA folded before Flop (didn't bet)
Seat 4: mayconmontaia folded before Flop
Seat 5: Shahta-16 folded before Flop (didn't bet)
Seat 6: Zzzanderman folded before Flop (didn't bet)
Seat 7: rurli 26 (button) folded before Flop
Seat 8: Dorex2007 (small blind) folded before Flop
Seat 9: Lymnhades (big blind) collected ($0.07)



PokerStars Hand #237376490763:  Hold'em No Limit ($0.01/$0.02 USD) - 2022/07/15 11:19:56 PT [2022/07/15 14:19:56 ET]
Table 'Appella II' 9-max Seat #8 is the button
Seat 1: FACCHETADE$ ($2.10 in chips) 
Seat 2: murmuc1956 ($1.93 in chips) 
Seat 3: 7AVA ($2.12 in chips) 
Seat 4: mayconmontaia ($2.05 in chips) 
Seat 5: Shahta-16 ($2.33 in chips) 
Seat 6: Zzzanderman ($2.36 in chips) 
Seat 7: rurli 26 ($2.86 in chips) 
Seat 8: Dorex2007 ($3.65 in chips) 
Seat 9: Lymnhades ($2.16 in chips) 
Lymnhades: posts small blind $0.01
FACCHETADE$: posts big blind $0.02
*** HOLE CARDS ***
Dealt to Dorex2007 [3d 3c]
murmuc1956: calls $0.02
7AVA: folds 
mayconmontaia: folds 
Shahta-16: folds 
Zzzanderman: folds 
rurli 26: folds 
Dorex2007: calls $0.02
Lymnhades: folds 
FACCHETADE$: checks 
*** FLOP *** [7s Qh Ks]
FACCHETADE$: checks 
murmuc1956: checks 
Dorex2007: bets $0.07
FACCHETADE$: folds 
murmuc1956: calls $0.07
*** TURN *** [7s Qh Ks] [Ah]
murmuc1956: bets $0.02
Dorex2007: folds 
Uncalled bet ($0.02) returned to murmuc1956
murmuc1956 collected $0.20 from pot
*** SUMMARY ***
Total pot $0.21 | Rake $0.01 
Board [7s Qh Ks Ah]
Seat 1: FACCHETADE$ (big blind) folded on the Flop
Seat 2: murmuc1956 collected ($0.20)
Seat 3: 7AVA folded before Flop (didn't bet)
Seat 4: mayconmontaia folded before Flop (didn't bet)
Seat 5: Shahta-16 folded before Flop (didn't bet)
Seat 6: Zzzanderman folded before Flop (didn't bet)
Seat 7: rurli 26 folded before Flop (didn't bet)
Seat 8: Dorex2007 (button) folded on the Turn
Seat 9: Lymnhades (small blind) folded before Flop



PokerStars Hand #237376503511:  Hold'em No Limit ($0.01/$0.02 USD) - 2022/07/15 11:20:37 PT [2022/07/15 14:20:37 ET]
Table 'Appella II' 9-max Seat #9 is the button
Seat 1: FACCHETADE$ ($2.08 in chips) 
Seat 2: murmuc1956 ($2.04 in chips) 
Seat 3: 7AVA ($2.12 in chips) 
Seat 4: mayconmontaia ($2.05 in chips) 
Seat 5: Shahta-16 ($2.33 in chips) 
Seat 6: Zzzanderman ($2.36 in chips) 
Seat 7: rurli 26 ($2.86 in chips) 
Seat 8: Dorex2007 ($3.56 in chips) 
Seat 9: Lymnhades ($2.15 in chips) 
FACCHETADE$: posts small blind $0.01
murmuc1956: posts big blind $0.02
*** HOLE CARDS ***
Dealt to Dorex2007 [4c 8c]
7AVA: folds 
mayconmontaia: folds 
Shahta-16: folds 
Zzzanderman: calls $0.02
rurli 26: folds 
Dorex2007: folds 
Lymnhades: folds 
FACCHETADE$: calls $0.01
murmuc1956: checks 
*** FLOP *** [Qs 6h 6d]
FACCHETADE$: checks 
murmuc1956: checks 
Zzzanderman: checks 
*** TURN *** [Qs 6h 6d] [Js]
FACCHETADE$: checks 
murmuc1956: checks 
Zzzanderman: checks 
*** RIVER *** [Qs 6h 6d Js] [9h]
FACCHETADE$: checks 
murmuc1956: checks 
Zzzanderman: bets $0.04
FACCHETADE$: folds 
murmuc1956: folds 
Uncalled bet ($0.04) returned to Zzzanderman
Zzzanderman collected $0.06 from pot
*** SUMMARY ***
Total pot $0.06 | Rake $0 
Board [Qs 6h 6d Js 9h]
Seat 1: FACCHETADE$ (small blind) folded on the River
Seat 2: murmuc1956 (big blind) folded on the River
Seat 3: 7AVA folded before Flop (didn't bet)
Seat 4: mayconmontaia folded before Flop (didn't bet)
Seat 5: Shahta-16 folded before Flop (didn't bet)
Seat 6: Zzzanderman collected ($0.06)
Seat 7: rurli 26 folded before Flop (didn't bet)
Seat 8: Dorex2007 folded before Flop (didn't bet)
Seat 9: Lymnhades (button) folded before Flop (didn't bet)



PokerStars Hand #237376519079:  Hold'em No Limit ($0.01/$0.02 USD) - 2022/07/15 11:21:27 PT [2022/07/15 14:21:27 ET]
Table 'Appella II' 9-max Seat #1 is the button
Seat 1: FACCHETADE$ ($2.06 in chips) 
Seat 2: murmuc1956 ($2.02 in chips) 
Seat 3: 7AVA ($2.12 in chips) 
Seat 4: mayconmontaia ($2.05 in chips) 
Seat 5: Shahta-16 ($2.33 in chips) 
Seat 6: Zzzanderman ($2.40 in chips) 
Seat 7: rurli 26 ($2.86 in chips) 
Seat 8: Dorex2007 ($3.56 in chips) 
Seat 9: Lymnhades ($2.15 in chips) 
murmuc1956: posts small blind $0.01
7AVA: posts big blind $0.02
*** HOLE CARDS ***
Dealt to Dorex2007 [Qc Ah]
mayconmontaia: folds 
Shahta-16: folds 
Zzzanderman: calls $0.02
rurli 26: calls $0.02
Dorex2007: raises $0.04 to $0.06
Lymnhades: raises $0.18 to $0.24
FACCHETADE$: folds 
murmuc1956: folds 
7AVA: folds 
Zzzanderman: calls $0.22
rurli 26: folds 
Dorex2007: folds 
*** FLOP *** [6c Kc Qd]
Zzzanderman: checks 
Lymnhades: bets $0.46
Zzzanderman: folds 
Uncalled bet ($0.46) returned to Lymnhades
Lymnhades collected $0.57 from pot
*** SUMMARY ***
Total pot $0.59 | Rake $0.02 
Board [6c Kc Qd]
Seat 1: FACCHETADE$ (button) folded before Flop (didn't bet)
Seat 2: murmuc1956 (small blind) folded before Flop
Seat 3: 7AVA (big blind) folded before Flop
Seat 4: mayconmontaia folded before Flop (didn't bet)
Seat 5: Shahta-16 folded before Flop (didn't bet)
Seat 6: Zzzanderman folded on the Flop
Seat 7: rurli 26 folded before Flop
Seat 8: Dorex2007 folded before Flop
Seat 9: Lymnhades collected ($0.57)



PokerStars Hand #237376543894:  Hold'em No Limit ($0.01/$0.02 USD) - 2022/07/15 11:22:47 PT [2022/07/15 14:22:47 ET]
Table 'Appella II' 9-max Seat #2 is the button
Seat 1: FACCHETADE$ ($2.06 in chips) 
Seat 2: murmuc1956 ($2.01 in chips) 
Seat 3: 7AVA ($2.10 in chips) 
Seat 4: mayconmontaia ($2.05 in chips) 
Seat 5: Shahta-16 ($2.33 in chips) 
Seat 6: Zzzanderman ($2.16 in chips) 
Seat 7: rurli 26 ($2.84 in chips) 
Seat 8: Dorex2007 ($3.50 in chips) 
Seat 9: Lymnhades ($2.48 in chips) 
7AVA: posts small blind $0.01
mayconmontaia: posts big blind $0.02
*** HOLE CARDS ***
Dealt to Dorex2007 [9d 8d]
Shahta-16: folds 
Zzzanderman: folds 
rurli 26: folds 
Dorex2007: calls $0.02
Lymnhades: folds 
FACCHETADE$: folds 
murmuc1956: calls $0.02
7AVA: folds 
mayconmontaia: checks 
*** FLOP *** [Ah Qc Ac]
mayconmontaia: bets $0.02
Dorex2007: folds 
murmuc1956: folds 
Uncalled bet ($0.02) returned to mayconmontaia
mayconmontaia collected $0.07 from pot
*** SUMMARY ***
Total pot $0.07 | Rake $0 
Board [Ah Qc Ac]
Seat 1: FACCHETADE$ folded before Flop (didn't bet)
Seat 2: murmuc1956 (button) folded on the Flop
Seat 3: 7AVA (small blind) folded before Flop
Seat 4: mayconmontaia (big blind) collected ($0.07)
Seat 5: Shahta-16 folded before Flop (didn't bet)
Seat 6: Zzzanderman folded before Flop (didn't bet)
Seat 7: rurli 26 folded before Flop (didn't bet)
Seat 8: Dorex2007 folded on the Flop
Seat 9: Lymnhades folded before Flop (didn't bet)



PokerStars Hand #237376554127:  Hold'em No Limit ($0.01/$0.02 USD) - 2022/07/15 11:23:20 PT [2022/07/15 14:23:20 ET]
Table 'Appella II' 9-max Seat #3 is the button
Seat 1: FACCHETADE$ ($2.06 in chips) 
Seat 2: murmuc1956 ($1.99 in chips) 
Seat 3: 7AVA ($2.09 in chips) 
Seat 4: mayconmontaia ($2.10 in chips) 
Seat 5: Shahta-16 ($2.33 in chips) 
Seat 6: Zzzanderman ($2.16 in chips) 
Seat 7: rurli 26 ($2.84 in chips) 
Seat 8: Dorex2007 ($3.48 in chips) 
Seat 9: Lymnhades ($2.48 in chips) 
mayconmontaia: posts small blind $0.01
Shahta-16: posts big blind $0.02
*** HOLE CARDS ***
Dealt to Dorex2007 [As Kd]
Zzzanderman: folds 
rurli 26: raises $0.02 to $0.04
Dorex2007: raises $0.02 to $0.06
Lymnhades: folds 
FACCHETADE$: folds 
murmuc1956: folds 
7AVA: folds 
mayconmontaia: folds 
Shahta-16: folds 
rurli 26: calls $0.02
*** FLOP *** [6h Jc 2c]
rurli 26: checks 
Dorex2007: checks 
*** TURN *** [6h Jc 2c] [Qh]
rurli 26: checks 
Dorex2007: checks 
*** RIVER *** [6h Jc 2c Qh] [9s]
rurli 26: checks 
Dorex2007: checks 
*** SHOW DOWN ***
rurli 26: shows [Ah Ts] (high card Ace)
Dorex2007: shows [As Kd] (high card Ace - King kicker)
Dorex2007 collected $0.14 from pot
*** SUMMARY ***
Total pot $0.15 | Rake $0.01 
Board [6h Jc 2c Qh 9s]
Seat 1: FACCHETADE$ folded before Flop (didn't bet)
Seat 2: murmuc1956 folded before Flop (didn't bet)
Seat 3: 7AVA (button) folded before Flop (didn't bet)
Seat 4: mayconmontaia (small blind) folded before Flop
Seat 5: Shahta-16 (big blind) folded before Flop
Seat 6: Zzzanderman folded before Flop (didn't bet)
Seat 7: rurli 26 showed [Ah Ts] and lost with high card Ace
Seat 8: Dorex2007 showed [As Kd] and won ($0.14) with high card Ace
Seat 9: Lymnhades folded before Flop (didn't bet)



PokerStars Hand #237376566260:  Hold'em No Limit ($0.01/$0.02 USD) - 2022/07/15 11:23:58 PT [2022/07/15 14:23:58 ET]
Table 'Appella II' 9-max Seat #4 is the button
Seat 1: FACCHETADE$ ($2.06 in chips) 
Seat 2: murmuc1956 ($1.99 in chips) 
Seat 3: 7AVA ($2.09 in chips) 
Seat 4: mayconmontaia ($2.09 in chips) 
Seat 5: Shahta-16 ($2.31 in chips) 
Seat 6: Zzzanderman ($2.16 in chips) 
Seat 7: rurli 26 ($2.78 in chips) 
Seat 8: Dorex2007 ($3.56 in chips) 
Seat 9: Lymnhades ($2.48 in chips) 
Shahta-16: posts small blind $0.01
Zzzanderman: posts big blind $0.02
*** HOLE CARDS ***
Dealt to Dorex2007 [8h Jd]
rurli 26: folds 
Dorex2007: folds 
Lymnhades: folds 
FACCHETADE$: folds 
murmuc1956: folds 
7AVA: folds 
mayconmontaia: folds 
Shahta-16: raises $0.04 to $0.06
Zzzanderman: folds 
Uncalled bet ($0.04) returned to Shahta-16
Shahta-16 collected $0.04 from pot
*** SUMMARY ***
Total pot $0.04 | Rake $0 
Seat 1: FACCHETADE$ folded before Flop (didn't bet)
Seat 2: murmuc1956 folded before Flop (didn't bet)
Seat 3: 7AVA folded before Flop (didn't bet)
Seat 4: mayconmontaia (button) folded before Flop (didn't bet)
Seat 5: Shahta-16 (small blind) collected ($0.04)
Seat 6: Zzzanderman (big blind) folded before Flop
Seat 7: rurli 26 folded before Flop (didn't bet)
Seat 8: Dorex2007 folded before Flop (didn't bet)
Seat 9: Lymnhades folded before Flop (didn't bet)



PokerStars Hand #237376570860:  Hold'em No Limit ($0.01/$0.02 USD) - 2022/07/15 11:24:13 PT [2022/07/15 14:24:13 ET]
Table 'Appella II' 9-max Seat #5 is the button
Seat 1: FACCHETADE$ ($2.06 in chips) 
Seat 2: murmuc1956 ($1.99 in chips) 
Seat 3: 7AVA ($2.09 in chips) 
Seat 4: mayconmontaia ($2.09 in chips) 
Seat 5: Shahta-16 ($2.33 in chips) 
Seat 6: Zzzanderman ($2.14 in chips) 
Seat 7: rurli 26 ($2.78 in chips) 
Seat 8: Dorex2007 ($3.56 in chips) 
Seat 9: Lymnhades ($2.48 in chips) 
Zzzanderman: posts small blind $0.01
rurli 26: posts big blind $0.02
*** HOLE CARDS ***
Dealt to Dorex2007 [6d 4h]
Dorex2007: folds 
Lymnhades: folds 
FACCHETADE$: raises $0.02 to $0.04
murmuc1956: folds 
7AVA: folds 
mayconmontaia: calls $0.04
Shahta-16: folds 
Zzzanderman: folds 
rurli 26: calls $0.02
*** FLOP *** [8c 2c 6s]
rurli 26: checks 
FACCHETADE$: checks 
mayconmontaia: bets $0.06
rurli 26: folds 
FACCHETADE$: folds 
Uncalled bet ($0.06) returned to mayconmontaia
mayconmontaia collected $0.13 from pot
*** SUMMARY ***
Total pot $0.13 | Rake $0 
Board [8c 2c 6s]
Seat 1: FACCHETADE$ folded on the Flop
Seat 2: murmuc1956 folded before Flop (didn't bet)
Seat 3: 7AVA folded before Flop (didn't bet)
Seat 4: mayconmontaia collected ($0.13)
Seat 5: Shahta-16 (button) folded before Flop (didn't bet)
Seat 6: Zzzanderman (small blind) folded before Flop
Seat 7: rurli 26 (big blind) folded on the Flop
Seat 8: Dorex2007 folded before Flop (didn't bet)
Seat 9: Lymnhades folded before Flop (didn't bet)



PokerStars Hand #237376581862:  Hold'em No Limit ($0.01/$0.02 USD) - 2022/07/15 11:24:47 PT [2022/07/15 14:24:47 ET]
Table 'Appella II' 9-max Seat #6 is the button
Seat 1: FACCHETADE$ ($2.02 in chips) 
Seat 2: murmuc1956 ($1.99 in chips) 
Seat 3: 7AVA ($2.09 in chips) 
Seat 4: mayconmontaia ($2.18 in chips) 
Seat 5: Shahta-16 ($2.33 in chips) 
Seat 6: Zzzanderman ($2.13 in chips) 
Seat 7: rurli 26 ($2.74 in chips) 
Seat 8: Dorex2007 ($3.56 in chips) 
Seat 9: Lymnhades ($2.48 in chips) 
rurli 26: posts small blind $0.01
Dorex2007: posts big blind $0.02
*** HOLE CARDS ***
Dealt to Dorex2007 [Th 7s]
Lymnhades: folds 
FACCHETADE$: folds 
murmuc1956: folds 
7AVA: raises $0.05 to $0.07
mayconmontaia: folds 
Shahta-16: folds 
Zzzanderman: calls $0.07
rurli 26: folds 
Dorex2007: folds 
*** FLOP *** [Js 9h 3s]
7AVA: checks 
Zzzanderman: checks 
*** TURN *** [Js 9h 3s] [Td]
7AVA: bets $0.11
Zzzanderman: folds 
Uncalled bet ($0.11) returned to 7AVA
7AVA collected $0.16 from pot
*** SUMMARY ***
Total pot $0.17 | Rake $0.01 
Board [Js 9h 3s Td]
Seat 1: FACCHETADE$ folded before Flop (didn't bet)
Seat 2: murmuc1956 folded before Flop (didn't bet)
Seat 3: 7AVA collected ($0.16)
Seat 4: mayconmontaia folded before Flop (didn't bet)
Seat 5: Shahta-16 folded before Flop (didn't bet)
Seat 6: Zzzanderman (button) folded on the Turn
Seat 7: rurli 26 (small blind) folded before Flop
Seat 8: Dorex2007 (big blind) folded before Flop
Seat 9: Lymnhades folded before Flop (didn't bet)



PokerStars Hand #237376593581:  Hold'em No Limit ($0.01/$0.02 USD) - 2022/07/15 11:25:24 PT [2022/07/15 14:25:24 ET]
Table 'Appella II' 9-max Seat #7 is the button
Seat 1: FACCHETADE$ ($2.02 in chips) 
Seat 2: murmuc1956 ($1.99 in chips) 
Seat 3: 7AVA ($2.18 in chips) 
Seat 4: mayconmontaia ($2.18 in chips) 
Seat 5: Shahta-16 ($2.33 in chips) 
Seat 6: Zzzanderman ($2.06 in chips) 
Seat 7: rurli 26 ($2.73 in chips) 
Seat 8: Dorex2007 ($3.54 in chips) 
Seat 9: Lymnhades ($2.48 in chips) 
Dorex2007: posts small blind $0.01
Lymnhades: posts big blind $0.02
*** HOLE CARDS ***
Dealt to Dorex2007 [3d 5s]
FACCHETADE$: folds 
murmuc1956: folds 
7AVA: folds 
mayconmontaia: folds 
Shahta-16: raises $0.04 to $0.06
Zzzanderman: folds 
rurli 26: raises $0.15 to $0.21
Dorex2007: folds 
Lymnhades: folds 
Shahta-16: calls $0.15
*** FLOP *** [Th Jh 9d]
Shahta-16: checks 
rurli 26: bets $0.43
Shahta-16: folds 
Uncalled bet ($0.43) returned to rurli 26
rurli 26 collected $0.43 from pot
*** SUMMARY ***
Total pot $0.45 | Rake $0.02 
Board [Th Jh 9d]
Seat 1: FACCHETADE$ folded before Flop (didn't bet)
Seat 2: murmuc1956 folded before Flop (didn't bet)
Seat 3: 7AVA folded before Flop (didn't bet)
Seat 4: mayconmontaia folded before Flop (didn't bet)
Seat 5: Shahta-16 folded on the Flop
Seat 6: Zzzanderman folded before Flop (didn't bet)
Seat 7: rurli 26 (button) collected ($0.43)
Seat 8: Dorex2007 (small blind) folded before Flop
Seat 9: Lymnhades (big blind) folded before Flop



PokerStars Hand #237376606676:  Hold'em No Limit ($0.01/$0.02 USD) - 2022/07/15 11:26:06 PT [2022/07/15 14:26:06 ET]
Table 'Appella II' 9-max Seat #8 is the button
Seat 1: FACCHETADE$ ($2.02 in chips) 
Seat 2: murmuc1956 ($1.99 in chips) 
Seat 3: 7AVA ($2.18 in chips) 
Seat 4: mayconmontaia ($2.18 in chips) 
Seat 5: Shahta-16 ($2.12 in chips) 
Seat 6: Zzzanderman ($2.06 in chips) 
Seat 7: rurli 26 ($2.95 in chips) 
Seat 8: Dorex2007 ($3.53 in chips) 
Seat 9: Lymnhades ($2.46 in chips) 
Lymnhades: posts small blind $0.01
FACCHETADE$: posts big blind $0.02
*** HOLE CARDS ***
Dealt to Dorex2007 [Td 9s]
murmuc1956: calls $0.02
7AVA: folds 
mayconmontaia: folds 
Shahta-16: folds 
Zzzanderman has timed out
Zzzanderman: folds 
rurli 26: folds 
Dorex2007: folds 
Lymnhades: folds 
FACCHETADE$: checks 
*** FLOP *** [Qc Jh 2s]
FACCHETADE$: checks 
murmuc1956: checks 
*** TURN *** [Qc Jh 2s] [3d]
FACCHETADE$: checks 
murmuc1956: checks 
*** RIVER *** [Qc Jh 2s 3d] [4d]
FACCHETADE$: checks 
murmuc1956: checks 
*** SHOW DOWN ***
FACCHETADE$: shows [6s 2h] (a pair of Deuces)
murmuc1956: shows [Tc Ts] (a pair of Tens)
murmuc1956 collected $0.05 from pot
*** SUMMARY ***
Total pot $0.05 | Rake $0 
Board [Qc Jh 2s 3d 4d]
Seat 1: FACCHETADE$ (big blind) showed [6s 2h] and lost with a pair of Deuces
Seat 2: murmuc1956 showed [Tc Ts] and won ($0.05) with a pair of Tens
Seat 3: 7AVA folded before Flop (didn't bet)
Seat 4: mayconmontaia folded before Flop (didn't bet)
Seat 5: Shahta-16 folded before Flop (didn't bet)
Seat 6: Zzzanderman folded before Flop (didn't bet)
Seat 7: rurli 26 folded before Flop (didn't bet)
Seat 8: Dorex2007 (button) folded before Flop (didn't bet)
Seat 9: Lymnhades (small blind) folded before Flop



PokerStars Hand #237376619819:  Hold'em No Limit ($0.01/$0.02 USD) - 2022/07/15 11:26:48 PT [2022/07/15 14:26:48 ET]
Table 'Appella II' 9-max Seat #9 is the button
Seat 1: FACCHETADE$ ($2 in chips) 
Seat 2: murmuc1956 ($2.02 in chips) 
Seat 3: 7AVA ($2.18 in chips) 
Seat 4: mayconmontaia ($2.18 in chips) 
Seat 5: Shahta-16 ($2.12 in chips) 
Seat 7: rurli 26 ($2.95 in chips) 
Seat 8: Dorex2007 ($3.53 in chips) 
Seat 9: Lymnhades ($2.45 in chips) 
FACCHETADE$: posts small blind $0.01
murmuc1956: posts big blind $0.02
*** HOLE CARDS ***
Dealt to Dorex2007 [3c 9h]
7AVA: folds 
mayconmontaia: folds 
Shahta-16: folds 
rurli 26: folds 
Dorex2007: folds 
Lymnhades: folds 
FACCHETADE$: calls $0.01
murmuc1956: checks 
*** FLOP *** [3d Kh 8d]
FACCHETADE$: checks 
murmuc1956: checks 
*** TURN *** [3d Kh 8d] [Ts]
FACCHETADE$: checks 
murmuc1956: checks 
*** RIVER *** [3d Kh 8d Ts] [Td]
FACCHETADE$: checks 
murmuc1956: checks 
*** SHOW DOWN ***
FACCHETADE$: shows [Jh 7h] (a pair of Tens)
murmuc1956: shows [3h 5h] (two pair, Tens and Threes)
murmuc1956 collected $0.04 from pot
*** SUMMARY ***
Total pot $0.04 | Rake $0 
Board [3d Kh 8d Ts Td]
Seat 1: FACCHETADE$ (small blind) showed [Jh 7h] and lost with a pair of Tens
Seat 2: murmuc1956 (big blind) showed [3h 5h] and won ($0.04) with two pair, Tens and Threes
Seat 3: 7AVA folded before Flop (didn't bet)
Seat 4: mayconmontaia folded before Flop (didn't bet)
Seat 5: Shahta-16 folded before Flop (didn't bet)
Seat 7: rurli 26 folded before Flop (didn't bet)
Seat 8: Dorex2007 folded before Flop (didn't bet)
Seat 9: Lymnhades (button) folded before Flop (didn't bet)



PokerStars Hand #237376629369:  Hold'em No Limit ($0.01/$0.02 USD) - 2022/07/15 11:27:19 PT [2022/07/15 14:27:19 ET]
Table 'Appella II' 9-max Seat #1 is the button
Seat 1: FACCHETADE$ ($1.98 in chips) 
Seat 2: murmuc1956 ($2.04 in chips) 
Seat 3: 7AVA ($2.18 in chips) 
Seat 4: mayconmontaia ($2.18 in chips) 
Seat 5: Shahta-16 ($2.12 in chips) 
Seat 7: rurli 26 ($2.95 in chips) 
Seat 8: Dorex2007 ($3.53 in chips) 
Seat 9: Lymnhades ($2.45 in chips) 
murmuc1956: posts small blind $0.01
7AVA: posts big blind $0.02
*** HOLE CARDS ***
Dealt to Dorex2007 [9d 8c]
mayconmontaia: folds 
Shahta-16: raises $0.04 to $0.06
rurli 26: folds 
Dorex2007: folds 
Lymnhades: folds 
FACCHETADE$: folds 
murmuc1956: folds 
7AVA: folds 
Uncalled bet ($0.04) returned to Shahta-16
Shahta-16 collected $0.05 from pot
*** SUMMARY ***
Total pot $0.05 | Rake $0 
Seat 1: FACCHETADE$ (button) folded before Flop (didn't bet)
Seat 2: murmuc1956 (small blind) folded before Flop
Seat 3: 7AVA (big blind) folded before Flop
Seat 4: mayconmontaia folded before Flop (didn't bet)
Seat 5: Shahta-16 collected ($0.05)
Seat 7: rurli 26 folded before Flop (didn't bet)
Seat 8: Dorex2007 folded before Flop (didn't bet)
Seat 9: Lymnhades folded before Flop (didn't bet)



PokerStars Hand #237376634734:  Hold'em No Limit ($0.01/$0.02 USD) - 2022/07/15 11:27:36 PT [2022/07/15 14:27:36 ET]
Table 'Appella II' 9-max Seat #2 is the button
Seat 1: FACCHETADE$ ($1.98 in chips) 
Seat 2: murmuc1956 ($2.03 in chips) 
Seat 3: 7AVA ($2.16 in chips) 
Seat 4: mayconmontaia ($2.18 in chips) 
Seat 5: Shahta-16 ($2.15 in chips) 
Seat 7: rurli 26 ($2.95 in chips) 
Seat 8: Dorex2007 ($3.53 in chips) 
Seat 9: Lymnhades ($2.45 in chips) 
7AVA: posts small blind $0.01
mayconmontaia: posts big blind $0.02
*** HOLE CARDS ***
Dealt to Dorex2007 [2h 3s]
Shahta-16: raises $0.04 to $0.06
rurli 26: folds 
Dorex2007: folds 
Lymnhades: folds 
FACCHETADE$: folds 
murmuc1956: folds 
7AVA: folds 
mayconmontaia: calls $0.04
*** FLOP *** [Ac Ts Jh]
mayconmontaia: bets $0.02
Shahta-16: raises $0.06 to $0.08
mayconmontaia: calls $0.06
*** TURN *** [Ac Ts Jh] [Kh]
mayconmontaia: bets $0.02
Shahta-16: raises $0.20 to $0.22
mayconmontaia: calls $0.20
*** RIVER *** [Ac Ts Jh Kh] [Kd]
mayconmontaia: bets $0.35
Shahta-16: calls $0.35
*** SHOW DOWN ***
mayconmontaia: shows [8c Kc] (three of a kind, Kings)
Shahta-16: shows [Ad Qs] (a straight, Ten to Ace)
Shahta-16 collected $1.38 from pot
*** SUMMARY ***
Total pot $1.43 | Rake $0.05 
Board [Ac Ts Jh Kh Kd]
Seat 1: FACCHETADE$ folded before Flop (didn't bet)
Seat 2: murmuc1956 (button) folded before Flop (didn't bet)
Seat 3: 7AVA (small blind) folded before Flop
Seat 4: mayconmontaia (big blind) showed [8c Kc] and lost with three of a kind, Kings
Seat 5: Shahta-16 showed [Ad Qs] and won ($1.38) with a straight, Ten to Ace
Seat 7: rurli 26 folded before Flop (didn't bet)
Seat 8: Dorex2007 folded before Flop (didn't bet)
Seat 9: Lymnhades folded before Flop (didn't bet)



PokerStars Hand #237376651243:  Hold'em No Limit ($0.01/$0.02 USD) - 2022/07/15 11:28:29 PT [2022/07/15 14:28:29 ET]
Table 'Appella II' 9-max Seat #3 is the button
Seat 1: FACCHETADE$ ($1.98 in chips) 
Seat 2: murmuc1956 ($2.03 in chips) 
Seat 3: 7AVA ($2.15 in chips) 
Seat 4: mayconmontaia ($1.47 in chips) 
Seat 6: Zzzanderman ($2.06 in chips) 
Seat 7: rurli 26 ($2.95 in chips) 
Seat 8: Dorex2007 ($3.53 in chips) 
Seat 9: Lymnhades ($2.45 in chips) 
mayconmontaia: posts small blind $0.01
Shahta-16: is sitting out 
Zzzanderman: posts big blind $0.02
*** HOLE CARDS ***
Dealt to Dorex2007 [Jc 2s]
rurli 26: folds 
Dorex2007: folds 
Lymnhades: folds 
FACCHETADE$: raises $0.02 to $0.04
murmuc1956: folds 
7AVA: raises $0.06 to $0.10
mayconmontaia: calls $0.09
Zzzanderman: calls $0.08
FACCHETADE$: calls $0.06
*** FLOP *** [5h 2c 9s]
mayconmontaia: checks 
Zzzanderman: checks 
FACCHETADE$: checks 
Shahta-16 leaves the table
7AVA: checks 
*** TURN *** [5h 2c 9s] [3d]
mayconmontaia: bets $0.19
Zzzanderman: calls $0.19
FACCHETADE$: folds 
7AVA: folds 
*** RIVER *** [5h 2c 9s 3d] [9c]
mayconmontaia: bets $0.04
Zzzanderman: raises $1.73 to $1.77 and is all-in
mayconmontaia: folds 
Uncalled bet ($1.73) returned to Zzzanderman
Zzzanderman collected $0.83 from pot
*** SUMMARY ***
Total pot $0.86 | Rake $0.03 
Board [5h 2c 9s 3d 9c]
Seat 1: FACCHETADE$ folded on the Turn
Seat 2: murmuc1956 folded before Flop (didn't bet)
Seat 3: 7AVA (button) folded on the Turn
Seat 4: mayconmontaia (small blind) folded on the River
Seat 6: Zzzanderman (big blind) collected ($0.83)
Seat 7: rurli 26 folded before Flop (didn't bet)
Seat 8: Dorex2007 folded before Flop (didn't bet)
Seat 9: Lymnhades folded before Flop (didn't bet)



PokerStars Hand #237376678935:  Hold'em No Limit ($0.01/$0.02 USD) - 2022/07/15 11:29:43 PT [2022/07/15 14:29:43 ET]
Table 'Appella II' 9-max Seat #4 is the button
Seat 1: FACCHETADE$ ($1.88 in chips) 
Seat 2: murmuc1956 ($2.03 in chips) 
Seat 3: 7AVA ($2.05 in chips) 
Seat 4: mayconmontaia ($1.14 in chips) 
Seat 6: Zzzanderman ($2.56 in chips) 
Seat 7: rurli 26 ($2.95 in chips) 
Seat 8: Dorex2007 ($3.53 in chips) 
Seat 9: Lymnhades ($2.45 in chips) 
Zzzanderman: posts small blind $0.01
rurli 26: posts big blind $0.02
*** HOLE CARDS ***
Dealt to Dorex2007 [9d Jc]
Dorex2007: folds 
Lymnhades: folds 
FACCHETADE$: raises $0.02 to $0.04
murmuc1956: folds 
7AVA: folds 
mayconmontaia: folds 
Zzzanderman: folds 
rurli 26: folds 
Uncalled bet ($0.02) returned to FACCHETADE$
FACCHETADE$ collected $0.05 from pot
*** SUMMARY ***
Total pot $0.05 | Rake $0 
Seat 1: FACCHETADE$ collected ($0.05)
Seat 2: murmuc1956 folded before Flop (didn't bet)
Seat 3: 7AVA folded before Flop (didn't bet)
Seat 4: mayconmontaia (button) folded before Flop (didn't bet)
Seat 6: Zzzanderman (small blind) folded before Flop
Seat 7: rurli 26 (big blind) folded before Flop
Seat 8: Dorex2007 folded before Flop (didn't bet)
Seat 9: Lymnhades folded before Flop (didn't bet)



PokerStars Hand #237376683324:  Hold'em No Limit ($0.01/$0.02 USD) - 2022/07/15 11:29:57 PT [2022/07/15 14:29:57 ET]
Table 'Appella II' 9-max Seat #6 is the button
Seat 1: FACCHETADE$ ($1.91 in chips) 
Seat 2: murmuc1956 ($2.03 in chips) 
Seat 3: 7AVA ($2.05 in chips) 
Seat 4: mayconmontaia ($1.14 in chips) 
Seat 6: Zzzanderman ($2.55 in chips) 
Seat 7: rurli 26 ($2.93 in chips) 
Seat 8: Dorex2007 ($3.53 in chips) 
Seat 9: Lymnhades ($2.45 in chips) 
rurli 26: posts small blind $0.01
Dorex2007: posts big blind $0.02
*** HOLE CARDS ***
Dealt to Dorex2007 [8h Th]
Lymnhades: folds 
FACCHETADE$: folds 
murmuc1956: folds 
7AVA: folds 
mayconmontaia: folds 
Zzzanderman: folds 
rurli 26: calls $0.01
Dorex2007: checks 
*** FLOP *** [Kc 7h 3d]
rurli 26: checks 
Dorex2007: checks 
*** TURN *** [Kc 7h 3d] [5h]
rurli 26: checks 
Dorex2007: checks 
*** RIVER *** [Kc 7h 3d 5h] [Jd]
rurli 26: checks 
Dorex2007: checks 
*** SHOW DOWN ***
rurli 26: shows [Td 9c] (high card King)
Dorex2007: mucks hand 
rurli 26 collected $0.04 from pot
*** SUMMARY ***
Total pot $0.04 | Rake $0 
Board [Kc 7h 3d 5h Jd]
Seat 1: FACCHETADE$ folded before Flop (didn't bet)
Seat 2: murmuc1956 folded before Flop (didn't bet)
Seat 3: 7AVA folded before Flop (didn't bet)
Seat 4: mayconmontaia folded before Flop (didn't bet)
Seat 6: Zzzanderman (button) folded before Flop (didn't bet)
Seat 7: rurli 26 (small blind) showed [Td 9c] and won ($0.04) with high card King
Seat 8: Dorex2007 (big blind) mucked [8h Th]
Seat 9: Lymnhades folded before Flop (didn't bet)



PokerStars Hand #237376700407:  Hold'em No Limit ($0.01/$0.02 USD) - 2022/07/15 11:30:50 PT [2022/07/15 14:30:50 ET]
Table 'Appella II' 9-max Seat #7 is the button
Seat 1: FACCHETADE$ ($1.91 in chips) 
Seat 2: murmuc1956 ($2.03 in chips) 
Seat 3: 7AVA ($2.05 in chips) 
Seat 4: mayconmontaia ($1.14 in chips) 
Seat 6: Zzzanderman ($2.55 in chips) 
Seat 7: rurli 26 ($2.95 in chips) 
Seat 8: Dorex2007 ($3.51 in chips) 
Seat 9: Lymnhades ($2.45 in chips) 
Dorex2007: posts small blind $0.01
Lymnhades: posts big blind $0.02
*** HOLE CARDS ***
Dealt to Dorex2007 [5c 3d]
FACCHETADE$: raises $0.05 to $0.07
murmuc1956: folds 
7AVA: folds 
mayconmontaia: folds 
Zzzanderman: calls $0.07
rurli 26: folds 
Dorex2007: folds 
Lymnhades: folds 
*** FLOP *** [Ah 9c 5d]
FACCHETADE$: bets $1.84 and is all-in
Zzzanderman: folds 
Uncalled bet ($1.84) returned to FACCHETADE$
FACCHETADE$ collected $0.16 from pot
*** SUMMARY ***
Total pot $0.17 | Rake $0.01 
Board [Ah 9c 5d]
Seat 1: FACCHETADE$ collected ($0.16)
Seat 2: murmuc1956 folded before Flop (didn't bet)
Seat 3: 7AVA folded before Flop (didn't bet)
Seat 4: mayconmontaia folded before Flop (didn't bet)
Seat 6: Zzzanderman folded on the Flop
Seat 7: rurli 26 (button) folded before Flop (didn't bet)
Seat 8: Dorex2007 (small blind) folded before Flop
Seat 9: Lymnhades (big blind) folded before Flop



PokerStars Hand #237376708887:  Hold'em No Limit ($0.01/$0.02 USD) - 2022/07/15 11:31:17 PT [2022/07/15 14:31:17 ET]
Table 'Appella II' 9-max Seat #8 is the button
Seat 2: murmuc1956 ($2.03 in chips) 
Seat 3: 7AVA ($2.05 in chips) 
Seat 4: mayconmontaia ($1.14 in chips) 
Seat 6: Zzzanderman ($2.48 in chips) 
Seat 7: rurli 26 ($2.95 in chips) 
Seat 8: Dorex2007 ($3.50 in chips) 
Seat 9: Lymnhades ($2.43 in chips) 
dead men 111 joins the table at seat #5 
Lymnhades: posts small blind $0.01
FACCHETADE$: is sitting out 
murmuc1956: posts big blind $0.02
*** HOLE CARDS ***
Dealt to Dorex2007 [2d 2s]
7AVA: folds 
mayconmontaia: folds 
Zzzanderman: calls $0.02
rurli 26: folds 
Dorex2007: calls $0.02
Lymnhades: calls $0.01
murmuc1956: checks 
*** FLOP *** [Ts 9h Th]
Lymnhades: checks 
murmuc1956: checks 
Zzzanderman: checks 
Dorex2007: checks 
*** TURN *** [Ts 9h Th] [3c]
Lymnhades: checks 
murmuc1956: checks 
Zzzanderman: checks 
Dorex2007: checks 
*** RIVER *** [Ts 9h Th 3c] [8h]
Lymnhades: bets $0.04
murmuc1956: folds 
Zzzanderman: folds 
Dorex2007: folds 
Uncalled bet ($0.04) returned to Lymnhades
Lymnhades collected $0.08 from pot
*** SUMMARY ***
Total pot $0.08 | Rake $0 
Board [Ts 9h Th 3c 8h]
Seat 2: murmuc1956 (big blind) folded on the River
Seat 3: 7AVA folded before Flop (didn't bet)
Seat 4: mayconmontaia folded before Flop (didn't bet)
Seat 6: Zzzanderman folded on the River
Seat 7: rurli 26 folded before Flop (didn't bet)
Seat 8: Dorex2007 (button) folded on the River
Seat 9: Lymnhades (small blind) collected ($0.08)



PokerStars Hand #237376729905:  Hold'em No Limit ($0.01/$0.02 USD) - 2022/07/15 11:32:23 PT [2022/07/15 14:32:23 ET]
Table 'Appella II' 9-max Seat #9 is the button
Seat 2: murmuc1956 ($2.01 in chips) 
Seat 3: 7AVA ($2.05 in chips) 
Seat 4: mayconmontaia ($1.14 in chips) 
Seat 6: Zzzanderman ($2.46 in chips) 
Seat 7: rurli 26 ($2.95 in chips) 
Seat 8: Dorex2007 ($3.48 in chips) 
Seat 9: Lymnhades ($2.49 in chips) 
murmuc1956: posts small blind $0.01
7AVA: posts big blind $0.02
dead men 111: sits out 
*** HOLE CARDS ***
Dealt to Dorex2007 [6c Ks]
mayconmontaia: folds 
Zzzanderman: folds 
rurli 26: folds 
Dorex2007: folds 
Lymnhades: raises $0.04 to $0.06
murmuc1956: folds 
7AVA: folds 
Uncalled bet ($0.04) returned to Lymnhades
Lymnhades collected $0.05 from pot
*** SUMMARY ***
Total pot $0.05 | Rake $0 
Seat 2: murmuc1956 (small blind) folded before Flop
Seat 3: 7AVA (big blind) folded before Flop
Seat 4: mayconmontaia folded before Flop (didn't bet)
Seat 6: Zzzanderman folded before Flop (didn't bet)
Seat 7: rurli 26 folded before Flop (didn't bet)
Seat 8: Dorex2007 folded before Flop (didn't bet)
Seat 9: Lymnhades (button) collected ($0.05)



PokerStars Hand #237376735530:  Hold'em No Limit ($0.01/$0.02 USD) - 2022/07/15 11:32:40 PT [2022/07/15 14:32:40 ET]
Table 'Appella II' 9-max Seat #2 is the button
Seat 1: FACCHETADE$ ($2 in chips) 
Seat 2: murmuc1956 ($2 in chips) 
Seat 3: 7AVA ($2.03 in chips) 
Seat 4: mayconmontaia ($1.14 in chips) 
Seat 6: Zzzanderman ($2.46 in chips) 
Seat 7: rurli 26 ($2.95 in chips) 
Seat 8: Dorex2007 ($3.48 in chips) 
Seat 9: Lymnhades ($2.52 in chips) 
7AVA: posts small blind $0.01
mayconmontaia: posts big blind $0.02
dead men 111: sits out 
FACCHETADE$: posts small & big blinds $0.03
*** HOLE CARDS ***
Dealt to Dorex2007 [7d 6c]
Zzzanderman: folds 
rurli 26: folds 
Dorex2007: folds 
Lymnhades: folds 
FACCHETADE$: checks 
murmuc1956: folds 
7AVA: raises $0.05 to $0.07
mayconmontaia: folds 
FACCHETADE$: folds 
Uncalled bet ($0.05) returned to 7AVA
7AVA collected $0.07 from pot
*** SUMMARY ***
Total pot $0.07 | Rake $0 
Seat 1: FACCHETADE$ folded before Flop (didn't bet)
Seat 2: murmuc1956 (button) folded before Flop (didn't bet)
Seat 3: 7AVA (small blind) collected ($0.07)
Seat 4: mayconmontaia (big blind) folded before Flop
Seat 6: Zzzanderman folded before Flop (didn't bet)
Seat 7: rurli 26 folded before Flop (didn't bet)
Seat 8: Dorex2007 folded before Flop (didn't bet)
Seat 9: Lymnhades folded before Flop (didn't bet)



PokerStars Hand #237376741804:  Hold'em No Limit ($0.01/$0.02 USD) - 2022/07/15 11:33:00 PT [2022/07/15 14:33:00 ET]
Table 'Appella II' 9-max Seat #3 is the button
Seat 1: FACCHETADE$ ($1.97 in chips) 
Seat 2: murmuc1956 ($2 in chips) 
Seat 3: 7AVA ($2.08 in chips) 
Seat 4: mayconmontaia ($1.12 in chips) 
Seat 5: dead men 111 ($0.80 in chips) 
Seat 6: Zzzanderman ($2.46 in chips) 
Seat 7: rurli 26 ($2.95 in chips) 
Seat 8: Dorex2007 ($3.48 in chips) 
Seat 9: Lymnhades ($2.52 in chips) 
mayconmontaia: posts small blind $0.01
dead men 111: posts big blind $0.02
*** HOLE CARDS ***
Dealt to Dorex2007 [9d 3d]
Zzzanderman: folds 
rurli 26: folds 
Dorex2007: folds 
Lymnhades: folds 
FACCHETADE$: folds 
murmuc1956: folds 
7AVA: raises $0.05 to $0.07
mayconmontaia: folds 
dead men 111: folds 
Uncalled bet ($0.05) returned to 7AVA
7AVA collected $0.05 from pot
*** SUMMARY ***
Total pot $0.05 | Rake $0 
Seat 1: FACCHETADE$ folded before Flop (didn't bet)
Seat 2: murmuc1956 folded before Flop (didn't bet)
Seat 3: 7AVA (button) collected ($0.05)
Seat 4: mayconmontaia (small blind) folded before Flop
Seat 5: dead men 111 (big blind) folded before Flop
Seat 6: Zzzanderman folded before Flop (didn't bet)
Seat 7: rurli 26 folded before Flop (didn't bet)
Seat 8: Dorex2007 folded before Flop (didn't bet)
Seat 9: Lymnhades folded before Flop (didn't bet)



PokerStars Hand #237376746702:  Hold'em No Limit ($0.01/$0.02 USD) - 2022/07/15 11:33:16 PT [2022/07/15 14:33:16 ET]
Table 'Appella II' 9-max Seat #4 is the button
Seat 1: FACCHETADE$ ($1.97 in chips) 
Seat 2: murmuc1956 ($2 in chips) 
Seat 3: 7AVA ($2.11 in chips) 
Seat 4: mayconmontaia ($1.11 in chips) 
Seat 5: dead men 111 ($0.78 in chips) 
Seat 6: Zzzanderman ($2.46 in chips) 
Seat 7: rurli 26 ($2.95 in chips) 
Seat 8: Dorex2007 ($3.48 in chips) 
Seat 9: Lymnhades ($2.52 in chips) 
dead men 111: posts small blind $0.01
Zzzanderman: posts big blind $0.02
*** HOLE CARDS ***
Dealt to Dorex2007 [5c 9c]
rurli 26: folds 
Dorex2007: folds 
Lymnhades: folds 
FACCHETADE$: folds 
murmuc1956: folds 
7AVA: folds 
mayconmontaia: calls $0.02
dead men 111: calls $0.01
Zzzanderman: checks 
*** FLOP *** [Ac Qh 6d]
dead men 111: checks 
Zzzanderman: checks 
mayconmontaia: bets $0.02
dead men 111: raises $0.02 to $0.04
Zzzanderman: folds 
mayconmontaia: calls $0.02
*** TURN *** [Ac Qh 6d] [Js]
dead men 111: bets $0.06
mayconmontaia: raises $0.06 to $0.12
dead men 111: calls $0.06
*** RIVER *** [Ac Qh 6d Js] [6c]
dead men 111: bets $0.08
mayconmontaia: raises $0.08 to $0.16
dead men 111: calls $0.08
*** SHOW DOWN ***
mayconmontaia: shows [7s Qs] (two pair, Queens and Sixes)
dead men 111: shows [9h Ah] (two pair, Aces and Sixes)
dead men 111 collected $0.68 from pot
*** SUMMARY ***
Total pot $0.70 | Rake $0.02 
Board [Ac Qh 6d Js 6c]
Seat 1: FACCHETADE$ folded before Flop (didn't bet)
Seat 2: murmuc1956 folded before Flop (didn't bet)
Seat 3: 7AVA folded before Flop (didn't bet)
Seat 4: mayconmontaia (button) showed [7s Qs] and lost with two pair, Queens and Sixes
Seat 5: dead men 111 (small blind) showed [9h Ah] and won ($0.68) with two pair, Aces and Sixes
Seat 6: Zzzanderman (big blind) folded on the Flop
Seat 7: rurli 26 folded before Flop (didn't bet)
Seat 8: Dorex2007 folded before Flop (didn't bet)
Seat 9: Lymnhades folded before Flop (didn't bet)



PokerStars Hand #237376761339:  Hold'em No Limit ($0.01/$0.02 USD) - 2022/07/15 11:34:02 PT [2022/07/15 14:34:02 ET]
Table 'Appella II' 9-max Seat #5 is the button
Seat 1: FACCHETADE$ ($1.97 in chips) 
Seat 2: murmuc1956 ($2 in chips) 
Seat 3: 7AVA ($2.11 in chips) 
Seat 4: mayconmontaia ($0.77 in chips) 
Seat 5: dead men 111 ($1.12 in chips) 
Seat 6: Zzzanderman ($2.44 in chips) 
Seat 7: rurli 26 ($2.95 in chips) 
Seat 8: Dorex2007 ($3.48 in chips) 
Seat 9: Lymnhades ($2.52 in chips) 
Zzzanderman: posts small blind $0.01
rurli 26: posts big blind $0.02
*** HOLE CARDS ***
Dealt to Dorex2007 [4d Kd]
Dorex2007: calls $0.02
Lymnhades: folds 
FACCHETADE$: folds 
murmuc1956: folds 
7AVA: folds 
mayconmontaia: calls $0.02
dead men 111: calls $0.02
Zzzanderman: calls $0.01
rurli 26: checks 
*** FLOP *** [Qh 8s 2s]
Zzzanderman: bets $0.10
rurli 26: folds 
Dorex2007: folds 
mayconmontaia: calls $0.10
dead men 111: folds 
*** TURN *** [Qh 8s 2s] [2h]
Zzzanderman: bets $0.14
mayconmontaia: raises $0.14 to $0.28
Zzzanderman: calls $0.14
*** RIVER *** [Qh 8s 2s 2h] [9d]
Zzzanderman: checks 
mayconmontaia: bets $0.02
Zzzanderman: calls $0.02
*** SHOW DOWN ***
mayconmontaia: shows [As 3s] (a pair of Deuces)
Zzzanderman: shows [Qs 6s] (two pair, Queens and Deuces)
Zzzanderman collected $0.87 from pot
*** SUMMARY ***
Total pot $0.90 | Rake $0.03 
Board [Qh 8s 2s 2h 9d]
Seat 1: FACCHETADE$ folded before Flop (didn't bet)
Seat 2: murmuc1956 folded before Flop (didn't bet)
Seat 3: 7AVA folded before Flop (didn't bet)
Seat 4: mayconmontaia showed [As 3s] and lost with a pair of Deuces
Seat 5: dead men 111 (button) folded on the Flop
Seat 6: Zzzanderman (small blind) showed [Qs 6s] and won ($0.87) with two pair, Queens and Deuces
Seat 7: rurli 26 (big blind) folded on the Flop
Seat 8: Dorex2007 folded on the Flop
Seat 9: Lymnhades folded before Flop (didn't bet)



PokerStars Hand #237376782995:  Hold'em No Limit ($0.01/$0.02 USD) - 2022/07/15 11:35:11 PT [2022/07/15 14:35:11 ET]
Table 'Appella II' 9-max Seat #6 is the button
Seat 1: FACCHETADE$ ($1.97 in chips) 
Seat 2: murmuc1956 ($2 in chips) 
Seat 3: 7AVA ($2.11 in chips) 
Seat 4: mayconmontaia ($0.35 in chips) 
Seat 5: dead men 111 ($1.10 in chips) 
Seat 6: Zzzanderman ($2.89 in chips) 
Seat 7: rurli 26 ($2.93 in chips) 
Seat 8: Dorex2007 ($3.46 in chips) 
Seat 9: Lymnhades ($2.52 in chips) 
rurli 26: posts small blind $0.01
Dorex2007: posts big blind $0.02
*** HOLE CARDS ***
Dealt to Dorex2007 [8h 4s]
Lymnhades: folds 
FACCHETADE$: folds 
murmuc1956: folds 
7AVA: raises $0.05 to $0.07
mayconmontaia: folds 
dead men 111: folds 
Zzzanderman: folds 
rurli 26: folds 
Dorex2007: folds 
Uncalled bet ($0.05) returned to 7AVA
7AVA collected $0.05 from pot
*** SUMMARY ***
Total pot $0.05 | Rake $0 
Seat 1: FACCHETADE$ folded before Flop (didn't bet)
Seat 2: murmuc1956 folded before Flop (didn't bet)
Seat 3: 7AVA collected ($0.05)
Seat 4: mayconmontaia folded before Flop (didn't bet)
Seat 5: dead men 111 folded before Flop (didn't bet)
Seat 6: Zzzanderman (button) folded before Flop (didn't bet)
Seat 7: rurli 26 (small blind) folded before Flop
Seat 8: Dorex2007 (big blind) folded before Flop
Seat 9: Lymnhades folded before Flop (didn't bet)



PokerStars Hand #237376791316:  Hold'em No Limit ($0.01/$0.02 USD) - 2022/07/15 11:35:38 PT [2022/07/15 14:35:38 ET]
Table 'Appella II' 9-max Seat #7 is the button
Seat 1: FACCHETADE$ ($1.97 in chips) 
Seat 2: murmuc1956 ($2 in chips) 
Seat 3: 7AVA ($2.14 in chips) 
Seat 4: mayconmontaia ($0.35 in chips) 
Seat 5: dead men 111 ($1.10 in chips) 
Seat 6: Zzzanderman ($2.89 in chips) 
Seat 7: rurli 26 ($2.92 in chips) 
Seat 8: Dorex2007 ($3.44 in chips) 
Seat 9: Lymnhades ($2.52 in chips) 
Dorex2007: posts small blind $0.01
Lymnhades: posts big blind $0.02
*** HOLE CARDS ***
Dealt to Dorex2007 [Ad 9s]
FACCHETADE$: raises $0.02 to $0.04
murmuc1956: folds 
7AVA: folds 
mayconmontaia: folds 
dead men 111: folds 
Zzzanderman: folds 
rurli 26: calls $0.04
Dorex2007: folds 
Lymnhades: calls $0.02
*** FLOP *** [Jc Js 2h]
Lymnhades: checks 
FACCHETADE$: checks 
rurli 26: checks 
*** TURN *** [Jc Js 2h] [Kh]
Lymnhades: checks 
FACCHETADE$: checks 
rurli 26: bets $0.06
Lymnhades: calls $0.06
FACCHETADE$: folds 
*** RIVER *** [Jc Js 2h Kh] [Kd]
Lymnhades: checks 
rurli 26: bets $0.24
Lymnhades: folds 
Uncalled bet ($0.24) returned to rurli 26
rurli 26 collected $0.24 from pot
*** SUMMARY ***
Total pot $0.25 | Rake $0.01 
Board [Jc Js 2h Kh Kd]
Seat 1: FACCHETADE$ folded on the Turn
Seat 2: murmuc1956 folded before Flop (didn't bet)
Seat 3: 7AVA folded before Flop (didn't bet)
Seat 4: mayconmontaia folded before Flop (didn't bet)
Seat 5: dead men 111 folded before Flop (didn't bet)
Seat 6: Zzzanderman folded before Flop (didn't bet)
Seat 7: rurli 26 (button) collected ($0.24)
Seat 8: Dorex2007 (small blind) folded before Flop
Seat 9: Lymnhades (big blind) folded on the River



PokerStars Hand #237376810197:  Hold'em No Limit ($0.01/$0.02 USD) - 2022/07/15 11:36:37 PT [2022/07/15 14:36:37 ET]
Table 'Appella II' 9-max Seat #8 is the button
Seat 2: murmuc1956 ($2 in chips) 
Seat 3: 7AVA ($2.14 in chips) 
Seat 4: mayconmontaia ($0.35 in chips) 
Seat 5: dead men 111 ($1.10 in chips) 
Seat 6: Zzzanderman ($2.89 in chips) 
Seat 8: Dorex2007 ($3.43 in chips) 
Seat 9: Lymnhades ($2.42 in chips) 
Lymnhades: posts small blind $0.01
FACCHETADE$: is sitting out 
murmuc1956: posts big blind $0.02
*** HOLE CARDS ***
Dealt to Dorex2007 [3h 5d]
7AVA: folds 
rurli 26 leaves the table
mayconmontaia: folds 
dead men 111: folds 
Zzzanderman: calls $0.02
Dorex2007: folds 
FACCHETADE$ leaves the table
Lymnhades: calls $0.01
murmuc1956: checks 
*** FLOP *** [Kh Ad Tc]
Lymnhades: checks 
murmuc1956: checks 
Zzzanderman: checks 
*** TURN *** [Kh Ad Tc] [2s]
Lymnhades: bets $0.04
murmuc1956: folds 
RAAAAdik joins the table at seat #7 
Zzzanderman: folds 
Uncalled bet ($0.04) returned to Lymnhades
Lymnhades collected $0.06 from pot
*** SUMMARY ***
Total pot $0.06 | Rake $0 
Board [Kh Ad Tc 2s]
Seat 2: murmuc1956 (big blind) folded on the Turn
Seat 3: 7AVA folded before Flop (didn't bet)
Seat 4: mayconmontaia folded before Flop (didn't bet)
Seat 5: dead men 111 folded before Flop (didn't bet)
Seat 6: Zzzanderman folded on the Turn
Seat 8: Dorex2007 (button) folded before Flop (didn't bet)
Seat 9: Lymnhades (small blind) collected ($0.06)



PokerStars Hand #237376820813:  Hold'em No Limit ($0.01/$0.02 USD) - 2022/07/15 11:37:11 PT [2022/07/15 14:37:11 ET]
Table 'Appella II' 9-max Seat #9 is the button
Seat 2: murmuc1956 ($1.98 in chips) 
Seat 3: 7AVA ($2.14 in chips) 
Seat 4: mayconmontaia ($0.35 in chips) 
Seat 5: dead men 111 ($1.10 in chips) 
Seat 6: Zzzanderman ($2.87 in chips) 
Seat 8: Dorex2007 ($3.43 in chips) 
Seat 9: Lymnhades ($2.46 in chips) 
murmuc1956: posts small blind $0.01
7AVA: posts big blind $0.02
RAAAAdik: sits out 
*** HOLE CARDS ***
Dealt to Dorex2007 [7h Jd]
mayconmontaia: folds 
dead men 111: folds 
Zzzanderman: folds 
wALEXSANDRw joins the table at seat #1 
Dorex2007: folds 
dead men 111 leaves the table
Lymnhades: raises $0.04 to $0.06
murmuc1956: folds 
7AVA: folds 
Uncalled bet ($0.04) returned to Lymnhades
Lymnhades collected $0.05 from pot
*** SUMMARY ***
Total pot $0.05 | Rake $0 
Seat 2: murmuc1956 (small blind) folded before Flop
Seat 3: 7AVA (big blind) folded before Flop
Seat 4: mayconmontaia folded before Flop (didn't bet)
Seat 5: dead men 111 folded before Flop (didn't bet)
Seat 6: Zzzanderman folded before Flop (didn't bet)
Seat 8: Dorex2007 folded before Flop (didn't bet)
Seat 9: Lymnhades (button) collected ($0.05)



PokerStars Hand #237376827264:  Hold'em No Limit ($0.01/$0.02 USD) - 2022/07/15 11:37:31 PT [2022/07/15 14:37:31 ET]
Table 'Appella II' 9-max Seat #2 is the button
Seat 2: murmuc1956 ($1.97 in chips) 
Seat 3: 7AVA ($2.12 in chips) 
Seat 4: mayconmontaia ($0.35 in chips) 
Seat 6: Zzzanderman ($2.87 in chips) 
Seat 8: Dorex2007 ($3.43 in chips) 
Seat 9: Lymnhades ($2.49 in chips) 
7AVA: posts small blind $0.01
mayconmontaia: posts big blind $0.02
Casperle has timed out
Casperle: is sitting out 
RAAAAdik: sits out 
wALEXSANDRw: sits out 
*** HOLE CARDS ***
Dealt to Dorex2007 [6h Kh]
Zzzanderman: folds 
Dorex2007: folds 
Lymnhades: raises $0.04 to $0.06
murmuc1956: folds 
7AVA: calls $0.05
mayconmontaia: raises $0.04 to $0.10
Lymnhades: raises $0.26 to $0.36
7AVA: folds 
mayconmontaia: calls $0.25 and is all-in
Uncalled bet ($0.01) returned to Lymnhades
*** FLOP *** [8c 6d 8d]
*** TURN *** [8c 6d 8d] [2d]
*** RIVER *** [8c 6d 8d 2d] [3s]
*** SHOW DOWN ***
mayconmontaia: shows [Ac Ah] (two pair, Aces and Eights)
Lymnhades: shows [6s As] (two pair, Eights and Sixes)
mayconmontaia collected $0.73 from pot
*** SUMMARY ***
Total pot $0.76 | Rake $0.03 
Board [8c 6d 8d 2d 3s]
Seat 2: murmuc1956 (button) folded before Flop (didn't bet)
Seat 3: 7AVA (small blind) folded before Flop
Seat 4: mayconmontaia (big blind) showed [Ac Ah] and won ($0.73) with two pair, Aces and Eights
Seat 6: Zzzanderman folded before Flop (didn't bet)
Seat 8: Dorex2007 folded before Flop (didn't bet)
Seat 9: Lymnhades showed [6s As] and lost with two pair, Eights and Sixes



PokerStars Hand #237376847973:  Hold'em No Limit ($0.01/$0.02 USD) - 2022/07/15 11:38:37 PT [2022/07/15 14:38:37 ET]
Table 'Appella II' 9-max Seat #3 is the button
Seat 2: murmuc1956 ($1.97 in chips) 
Seat 3: 7AVA ($2.06 in chips) 
Seat 4: mayconmontaia ($0.73 in chips) 
Seat 5: Casperle ($2 in chips) 
Seat 6: Zzzanderman ($2.87 in chips) 
Seat 8: Dorex2007 ($3.43 in chips) 
Seat 9: Lymnhades ($2.14 in chips) 
mayconmontaia: posts small blind $0.01
Casperle: posts big blind $0.02
RAAAAdik: sits out 
wALEXSANDRw: sits out 
*** HOLE CARDS ***
Dealt to Dorex2007 [8c 9d]
Zzzanderman: folds 
Dorex2007: folds 
Lymnhades: folds 
murmuc1956: folds 
7AVA: folds 
mayconmontaia: folds 
Uncalled bet ($0.01) returned to Casperle
Casperle collected $0.02 from pot
*** SUMMARY ***
Total pot $0.02 | Rake $0 
Seat 2: murmuc1956 folded before Flop (didn't bet)
Seat 3: 7AVA (button) folded before Flop (didn't bet)
Seat 4: mayconmontaia (small blind) folded before Flop
Seat 5: Casperle (big blind) collected ($0.02)
Seat 6: Zzzanderman folded before Flop (didn't bet)
Seat 8: Dorex2007 folded before Flop (didn't bet)
Seat 9: Lymnhades folded before Flop (didn't bet)



PokerStars Hand #237376853300:  Hold'em No Limit ($0.01/$0.02 USD) - 2022/07/15 11:38:53 PT [2022/07/15 14:38:53 ET]
Table 'Appella II' 9-max Seat #4 is the button
Seat 2: murmuc1956 ($1.97 in chips) 
Seat 3: 7AVA ($2.06 in chips) 
Seat 4: mayconmontaia ($0.72 in chips) 
Seat 5: Casperle ($2.01 in chips) 
Seat 6: Zzzanderman ($2.87 in chips) 
Seat 8: Dorex2007 ($3.43 in chips) 
Seat 9: Lymnhades ($2.14 in chips) 
Casperle: posts small blind $0.01
Zzzanderman: posts big blind $0.02
RAAAAdik: sits out 
wALEXSANDRw: sits out 
*** HOLE CARDS ***
Dealt to Dorex2007 [7d 6h]
Dorex2007: folds 
Lymnhades: folds 
murmuc1956: folds 
7AVA: folds 
mayconmontaia: folds 
Casperle: folds 
Uncalled bet ($0.01) returned to Zzzanderman
Zzzanderman collected $0.02 from pot
*** SUMMARY ***
Total pot $0.02 | Rake $0 
Seat 2: murmuc1956 folded before Flop (didn't bet)
Seat 3: 7AVA folded before Flop (didn't bet)
Seat 4: mayconmontaia (button) folded before Flop (didn't bet)
Seat 5: Casperle (small blind) folded before Flop
Seat 6: Zzzanderman (big blind) collected ($0.02)
Seat 8: Dorex2007 folded before Flop (didn't bet)
Seat 9: Lymnhades folded before Flop (didn't bet)



PokerStars Hand #237376856498:  Hold'em No Limit ($0.01/$0.02 USD) - 2022/07/15 11:39:04 PT [2022/07/15 14:39:04 ET]
Table 'Appella II' 9-max Seat #5 is the button
Seat 2: murmuc1956 ($1.97 in chips) 
Seat 3: 7AVA ($2.06 in chips) 
Seat 4: mayconmontaia ($0.72 in chips) 
Seat 5: Casperle ($2 in chips) 
Seat 6: Zzzanderman ($2.88 in chips) 
Seat 7: RAAAAdik ($2 in chips) 
Seat 8: Dorex2007 ($3.43 in chips) 
Seat 9: Lymnhades ($2.14 in chips) 
Zzzanderman: posts small blind $0.01
RAAAAdik: posts big blind $0.02
wALEXSANDRw: sits out 
*** HOLE CARDS ***
Dealt to Dorex2007 [3d 3s]
Dorex2007: calls $0.02
Lymnhades: folds 
murmuc1956: folds 
7AVA: folds 
mayconmontaia: calls $0.02
Casperle: folds 
Zzzanderman: calls $0.01
RAAAAdik: checks 
*** FLOP *** [Qc Qd 9d]
Zzzanderman: checks 
RAAAAdik: checks 
Dorex2007: checks 
mayconmontaia: checks 
*** TURN *** [Qc Qd 9d] [2c]
Zzzanderman: checks 
RAAAAdik: checks 
Dorex2007: checks 
mayconmontaia: checks 
*** RIVER *** [Qc Qd 9d 2c] [6h]
Zzzanderman: checks 
RAAAAdik: bets $0.04
Dorex2007: folds 
mayconmontaia: folds 
Zzzanderman: folds 
Uncalled bet ($0.04) returned to RAAAAdik
RAAAAdik collected $0.08 from pot
*** SUMMARY ***
Total pot $0.08 | Rake $0 
Board [Qc Qd 9d 2c 6h]
Seat 2: murmuc1956 folded before Flop (didn't bet)
Seat 3: 7AVA folded before Flop (didn't bet)
Seat 4: mayconmontaia folded on the River
Seat 5: Casperle (button) folded before Flop (didn't bet)
Seat 6: Zzzanderman (small blind) folded on the River
Seat 7: RAAAAdik (big blind) collected ($0.08)
Seat 8: Dorex2007 folded on the River
Seat 9: Lymnhades folded before Flop (didn't bet)



PokerStars Hand #237376877214:  Hold'em No Limit ($0.01/$0.02 USD) - 2022/07/15 11:40:09 PT [2022/07/15 14:40:09 ET]
Table 'Appella II' 9-max Seat #6 is the button
Seat 2: murmuc1956 ($1.97 in chips) 
Seat 3: 7AVA ($2.06 in chips) 
Seat 4: mayconmontaia ($0.70 in chips) 
Seat 5: Casperle ($2 in chips) 
Seat 6: Zzzanderman ($2.86 in chips) 
Seat 7: RAAAAdik ($2.06 in chips) 
Seat 8: Dorex2007 ($3.41 in chips) 
Seat 9: Lymnhades ($2.14 in chips) 
RAAAAdik: posts small blind $0.01
Dorex2007: posts big blind $0.02
wALEXSANDRw: sits out 
*** HOLE CARDS ***
Dealt to Dorex2007 [6d Td]
Lymnhades: folds 
murmuc1956: folds 
7AVA: folds 
mayconmontaia: folds 
Casperle: calls $0.02
Zzzanderman: folds 
RAAAAdik: folds 
Dorex2007: checks 
*** FLOP *** [7c 4d Tc]
Dorex2007: checks 
Casperle: bets $0.06
Dorex2007: calls $0.06
*** TURN *** [7c 4d Tc] [4h]
Dorex2007: bets $0.08
Casperle: calls $0.08
*** RIVER *** [7c 4d Tc 4h] [9d]
Dorex2007: checks 
Casperle: checks 
*** SHOW DOWN ***
Dorex2007: shows [6d Td] (two pair, Tens and Fours)
Casperle: mucks hand 
Dorex2007 collected $0.32 from pot
*** SUMMARY ***
Total pot $0.33 | Rake $0.01 
Board [7c 4d Tc 4h 9d]
Seat 2: murmuc1956 folded before Flop (didn't bet)
Seat 3: 7AVA folded before Flop (didn't bet)
Seat 4: mayconmontaia folded before Flop (didn't bet)
Seat 5: Casperle mucked [2c Kc]
Seat 6: Zzzanderman (button) folded before Flop (didn't bet)
Seat 7: RAAAAdik (small blind) folded before Flop
Seat 8: Dorex2007 (big blind) showed [6d Td] and won ($0.32) with two pair, Tens and Fours
Seat 9: Lymnhades folded before Flop (didn't bet)



PokerStars Hand #237376892196:  Hold'em No Limit ($0.01/$0.02 USD) - 2022/07/15 11:40:56 PT [2022/07/15 14:40:56 ET]
Table 'Appella II' 9-max Seat #7 is the button
Seat 2: murmuc1956 ($1.97 in chips) 
Seat 3: 7AVA ($2.06 in chips) 
Seat 4: mayconmontaia ($0.70 in chips) 
Seat 5: Casperle ($1.84 in chips) 
Seat 6: Zzzanderman ($2.86 in chips) 
Seat 7: RAAAAdik ($2.05 in chips) 
Seat 8: Dorex2007 ($3.57 in chips) 
Seat 9: Lymnhades ($2.14 in chips) 
Dorex2007: posts small blind $0.01
Lymnhades: posts big blind $0.02
wALEXSANDRw: sits out 
*** HOLE CARDS ***
Dealt to Dorex2007 [2s Ac]
murmuc1956: folds 
7AVA: folds 
mayconmontaia: folds 
Casperle: folds 
Zzzanderman: folds 
RAAAAdik: raises $0.05 to $0.07
Dorex2007: folds 
Lymnhades: folds 
Uncalled bet ($0.05) returned to RAAAAdik
RAAAAdik collected $0.05 from pot
*** SUMMARY ***
Total pot $0.05 | Rake $0 
Seat 2: murmuc1956 folded before Flop (didn't bet)
Seat 3: 7AVA folded before Flop (didn't bet)
Seat 4: mayconmontaia folded before Flop (didn't bet)
Seat 5: Casperle folded before Flop (didn't bet)
Seat 6: Zzzanderman folded before Flop (didn't bet)
Seat 7: RAAAAdik (button) collected ($0.05)
Seat 8: Dorex2007 (small blind) folded before Flop
Seat 9: Lymnhades (big blind) folded before Flop



PokerStars Hand #237376898909:  Hold'em No Limit ($0.01/$0.02 USD) - 2022/07/15 11:41:17 PT [2022/07/15 14:41:17 ET]
Table 'Appella II' 9-max Seat #8 is the button
Seat 1: wALEXSANDRw ($1.60 in chips) 
Seat 2: murmuc1956 ($1.97 in chips) 
Seat 3: 7AVA ($2.06 in chips) 
Seat 4: mayconmontaia ($0.70 in chips) 
Seat 5: Casperle ($1.84 in chips) 
Seat 6: Zzzanderman ($2.86 in chips) 
Seat 7: RAAAAdik ($2.08 in chips) 
Seat 8: Dorex2007 ($3.56 in chips) 
Seat 9: Lymnhades ($2.12 in chips) 
Lymnhades: posts small blind $0.01
wALEXSANDRw: posts big blind $0.02
*** HOLE CARDS ***
Dealt to Dorex2007 [2c Qs]
murmuc1956: folds 
7AVA: folds 
mayconmontaia: folds 
Casperle: calls $0.02
Zzzanderman: folds 
RAAAAdik: folds 
Dorex2007: folds 
Lymnhades: calls $0.01
wALEXSANDRw: checks 
*** FLOP *** [Ad 4c 8c]
Lymnhades: checks 
wALEXSANDRw: checks 
Casperle: checks 
*** TURN *** [Ad 4c 8c] [5c]
Lymnhades: bets $0.04
wALEXSANDRw: folds 
Casperle: folds 
Uncalled bet ($0.04) returned to Lymnhades
Lymnhades collected $0.06 from pot
*** SUMMARY ***
Total pot $0.06 | Rake $0 
Board [Ad 4c 8c 5c]
Seat 1: wALEXSANDRw (big blind) folded on the Turn
Seat 2: murmuc1956 folded before Flop (didn't bet)
Seat 3: 7AVA folded before Flop (didn't bet)
Seat 4: mayconmontaia folded before Flop (didn't bet)
Seat 5: Casperle folded on the Turn
Seat 6: Zzzanderman folded before Flop (didn't bet)
Seat 7: RAAAAdik folded before Flop (didn't bet)
Seat 8: Dorex2007 (button) folded before Flop (didn't bet)
Seat 9: Lymnhades (small blind) collected ($0.06)



PokerStars Hand #237376913553:  Hold'em No Limit ($0.01/$0.02 USD) - 2022/07/15 11:42:03 PT [2022/07/15 14:42:03 ET]
Table 'Appella II' 9-max Seat #9 is the button
Seat 1: wALEXSANDRw ($1.58 in chips) 
Seat 2: murmuc1956 ($1.97 in chips) 
Seat 3: 7AVA ($2.06 in chips) 
Seat 4: mayconmontaia ($0.70 in chips) 
Seat 5: Casperle ($1.82 in chips) 
Seat 6: Zzzanderman ($2.86 in chips) 
Seat 7: RAAAAdik ($2.08 in chips) 
Seat 8: Dorex2007 ($3.56 in chips) 
Seat 9: Lymnhades ($2.16 in chips) 
wALEXSANDRw: posts small blind $0.01
murmuc1956: posts big blind $0.02
*** HOLE CARDS ***
Dealt to Dorex2007 [Ts 5h]
7AVA: folds 
mayconmontaia: folds 
Casperle: folds 
Zzzanderman: folds 
RAAAAdik: folds 
Dorex2007: folds 
Lymnhades: raises $0.04 to $0.06
wALEXSANDRw: calls $0.05
murmuc1956: folds 
*** FLOP *** [8s 2c 6d]
wALEXSANDRw: checks 
Lymnhades: bets $0.06
wALEXSANDRw: folds 
Uncalled bet ($0.06) returned to Lymnhades
Lymnhades collected $0.14 from pot
*** SUMMARY ***
Total pot $0.14 | Rake $0 
Board [8s 2c 6d]
Seat 1: wALEXSANDRw (small blind) folded on the Flop
Seat 2: murmuc1956 (big blind) folded before Flop
Seat 3: 7AVA folded before Flop (didn't bet)
Seat 4: mayconmontaia folded before Flop (didn't bet)
Seat 5: Casperle folded before Flop (didn't bet)
Seat 6: Zzzanderman folded before Flop (didn't bet)
Seat 7: RAAAAdik folded before Flop (didn't bet)
Seat 8: Dorex2007 folded before Flop (didn't bet)
Seat 9: Lymnhades (button) collected ($0.14)



PokerStars Hand #237376924111:  Hold'em No Limit ($0.01/$0.02 USD) - 2022/07/15 11:42:36 PT [2022/07/15 14:42:36 ET]
Table 'Appella II' 9-max Seat #1 is the button
Seat 1: wALEXSANDRw ($1.52 in chips) 
Seat 2: murmuc1956 ($1.95 in chips) 
Seat 3: 7AVA ($2.06 in chips) 
Seat 4: mayconmontaia ($0.70 in chips) 
Seat 5: Casperle ($1.82 in chips) 
Seat 6: Zzzanderman ($2.86 in chips) 
Seat 7: RAAAAdik ($2.08 in chips) 
Seat 8: Dorex2007 ($3.56 in chips) 
Seat 9: Lymnhades ($2.24 in chips) 
murmuc1956: posts small blind $0.01
7AVA: posts big blind $0.02
*** HOLE CARDS ***
Dealt to Dorex2007 [8c 5s]
mayconmontaia: folds 
Casperle: folds 
Zzzanderman: raises $0.04 to $0.06
RAAAAdik: folds 
Dorex2007: folds 
Lymnhades: folds 
wALEXSANDRw: folds 
murmuc1956: folds 
7AVA: folds 
Uncalled bet ($0.04) returned to Zzzanderman
Zzzanderman collected $0.05 from pot
*** SUMMARY ***
Total pot $0.05 | Rake $0 
Seat 1: wALEXSANDRw (button) folded before Flop (didn't bet)
Seat 2: murmuc1956 (small blind) folded before Flop
Seat 3: 7AVA (big blind) folded before Flop
Seat 4: mayconmontaia folded before Flop (didn't bet)
Seat 5: Casperle folded before Flop (didn't bet)
Seat 6: Zzzanderman collected ($0.05)
Seat 7: RAAAAdik folded before Flop (didn't bet)
Seat 8: Dorex2007 folded before Flop (didn't bet)
Seat 9: Lymnhades folded before Flop (didn't bet)



PokerStars Hand #237376932104:  Hold'em No Limit ($0.01/$0.02 USD) - 2022/07/15 11:43:01 PT [2022/07/15 14:43:01 ET]
Table 'Appella II' 9-max Seat #2 is the button
Seat 1: wALEXSANDRw ($1.52 in chips) 
Seat 2: murmuc1956 ($1.94 in chips) 
Seat 3: 7AVA ($2.04 in chips) 
Seat 4: mayconmontaia ($0.70 in chips) 
Seat 5: Casperle ($1.82 in chips) 
Seat 6: Zzzanderman ($2.89 in chips) 
Seat 7: RAAAAdik ($2.08 in chips) 
Seat 8: Dorex2007 ($3.56 in chips) 
Seat 9: Lymnhades ($2.24 in chips) 
7AVA: posts small blind $0.01
mayconmontaia: posts big blind $0.02
*** HOLE CARDS ***
Dealt to Dorex2007 [5s Ad]
Casperle: folds 
Zzzanderman: folds 
RAAAAdik: raises $0.05 to $0.07
Dorex2007: folds 
Lymnhades: folds 
wALEXSANDRw: folds 
murmuc1956: folds 
7AVA: folds 
mayconmontaia: folds 
Uncalled bet ($0.05) returned to RAAAAdik
RAAAAdik collected $0.05 from pot
*** SUMMARY ***
Total pot $0.05 | Rake $0 
Seat 1: wALEXSANDRw folded before Flop (didn't bet)
Seat 2: murmuc1956 (button) folded before Flop (didn't bet)
Seat 3: 7AVA (small blind) folded before Flop
Seat 4: mayconmontaia (big blind) folded before Flop
Seat 5: Casperle folded before Flop (didn't bet)
Seat 6: Zzzanderman folded before Flop (didn't bet)
Seat 7: RAAAAdik collected ($0.05)
Seat 8: Dorex2007 folded before Flop (didn't bet)
Seat 9: Lymnhades folded before Flop (didn't bet)



PokerStars Hand #237376939717:  Hold'em No Limit ($0.01/$0.02 USD) - 2022/07/15 11:43:25 PT [2022/07/15 14:43:25 ET]
Table 'Appella II' 9-max Seat #3 is the button
Seat 1: wALEXSANDRw ($1.52 in chips) 
Seat 2: murmuc1956 ($1.94 in chips) 
Seat 3: 7AVA ($2.03 in chips) 
Seat 4: mayconmontaia ($0.68 in chips) 
Seat 5: Casperle ($1.82 in chips) 
Seat 6: Zzzanderman ($2.89 in chips) 
Seat 7: RAAAAdik ($2.11 in chips) 
Seat 8: Dorex2007 ($3.56 in chips) 
Seat 9: Lymnhades ($2.24 in chips) 
mayconmontaia: posts small blind $0.01
Casperle: posts big blind $0.02
*** HOLE CARDS ***
Dealt to Dorex2007 [2c Qd]
Zzzanderman: folds 
RAAAAdik: folds 
Dorex2007: folds 
Lymnhades: folds 
wALEXSANDRw: raises $0.04 to $0.06
murmuc1956: folds 
7AVA: folds 
mayconmontaia: folds 
Casperle: calls $0.04
*** FLOP *** [Jd 6s 6h]
Casperle: checks 
wALEXSANDRw: bets $0.04
Casperle: folds 
Uncalled bet ($0.04) returned to wALEXSANDRw
wALEXSANDRw collected $0.13 from pot
*** SUMMARY ***
Total pot $0.13 | Rake $0 
Board [Jd 6s 6h]
Seat 1: wALEXSANDRw collected ($0.13)
Seat 2: murmuc1956 folded before Flop (didn't bet)
Seat 3: 7AVA (button) folded before Flop (didn't bet)
Seat 4: mayconmontaia (small blind) folded before Flop
Seat 5: Casperle (big blind) folded on the Flop
Seat 6: Zzzanderman folded before Flop (didn't bet)
Seat 7: RAAAAdik folded before Flop (didn't bet)
Seat 8: Dorex2007 folded before Flop (didn't bet)
Seat 9: Lymnhades folded before Flop (didn't bet)



PokerStars Hand #237376954894:  Hold'em No Limit ($0.01/$0.02 USD) - 2022/07/15 11:44:13 PT [2022/07/15 14:44:13 ET]
Table 'Appella II' 9-max Seat #4 is the button
Seat 1: wALEXSANDRw ($1.59 in chips) 
Seat 2: murmuc1956 ($1.94 in chips) 
Seat 3: 7AVA ($2.03 in chips) 
Seat 4: mayconmontaia ($0.67 in chips) 
Seat 5: Casperle ($1.76 in chips) 
Seat 6: Zzzanderman ($2.89 in chips) 
Seat 7: RAAAAdik ($2.11 in chips) 
Seat 8: Dorex2007 ($3.56 in chips) 
Seat 9: Lymnhades ($2.24 in chips) 
Casperle: posts small blind $0.01
Zzzanderman: posts big blind $0.02
*** HOLE CARDS ***
Dealt to Dorex2007 [Qs 8h]
RAAAAdik: folds 
Dorex2007: folds 
Lymnhades: folds 
wALEXSANDRw: raises $0.02 to $0.04
murmuc1956: folds 
7AVA: calls $0.04
mayconmontaia: folds 
Casperle: folds 
Zzzanderman: calls $0.02
*** FLOP *** [2c 4h 5h]
Zzzanderman: checks 
wALEXSANDRw: checks 
7AVA: bets $0.09
Zzzanderman: folds 
wALEXSANDRw: folds 
Uncalled bet ($0.09) returned to 7AVA
7AVA collected $0.13 from pot
*** SUMMARY ***
Total pot $0.13 | Rake $0 
Board [2c 4h 5h]
Seat 1: wALEXSANDRw folded on the Flop
Seat 2: murmuc1956 folded before Flop (didn't bet)
Seat 3: 7AVA collected ($0.13)
Seat 4: mayconmontaia (button) folded before Flop (didn't bet)
Seat 5: Casperle (small blind) folded before Flop
Seat 6: Zzzanderman (big blind) folded on the Flop
Seat 7: RAAAAdik folded before Flop (didn't bet)
Seat 8: Dorex2007 folded before Flop (didn't bet)
Seat 9: Lymnhades folded before Flop (didn't bet)



PokerStars Hand #237376969068:  Hold'em No Limit ($0.01/$0.02 USD) - 2022/07/15 11:44:57 PT [2022/07/15 14:44:57 ET]
Table 'Appella II' 9-max Seat #5 is the button
Seat 1: wALEXSANDRw ($1.55 in chips) 
Seat 2: murmuc1956 ($1.94 in chips) 
Seat 3: 7AVA ($2.12 in chips) 
Seat 4: mayconmontaia ($0.67 in chips) 
Seat 5: Casperle ($1.75 in chips) 
Seat 6: Zzzanderman ($2.85 in chips) 
Seat 8: Dorex2007 ($3.56 in chips) 
Seat 9: Lymnhades ($2.24 in chips) 
Zzzanderman: posts small blind $0.01
RAAAAdik: is sitting out 
Dorex2007: posts big blind $0.02
*** HOLE CARDS ***
Dealt to Dorex2007 [Js 7c]
Lymnhades: raises $0.04 to $0.06
wALEXSANDRw: folds 
murmuc1956: folds 
7AVA: folds 
mayconmontaia: calls $0.06
Casperle: calls $0.06
Zzzanderman: folds 
Dorex2007: folds 
*** FLOP *** [2d 6d 9d]
Lymnhades: checks 
mayconmontaia: bets $0.02
Casperle: folds 
Lymnhades: calls $0.02
*** TURN *** [2d 6d 9d] [2h]
Lymnhades: checks 
mayconmontaia: bets $0.02
Lymnhades: calls $0.02
*** RIVER *** [2d 6d 9d 2h] [Kd]
Lymnhades: checks 
mayconmontaia: bets $0.02
Lymnhades: raises $0.16 to $0.18
mayconmontaia: calls $0.16
*** SHOW DOWN ***
Lymnhades: shows [8h Ah] (a pair of Deuces)
mayconmontaia: shows [Ac 2c] (three of a kind, Deuces)
mayconmontaia collected $0.63 from pot
*** SUMMARY ***
Total pot $0.65 | Rake $0.02 
Board [2d 6d 9d 2h Kd]
Seat 1: wALEXSANDRw folded before Flop (didn't bet)
Seat 2: murmuc1956 folded before Flop (didn't bet)
Seat 3: 7AVA folded before Flop (didn't bet)
Seat 4: mayconmontaia showed [Ac 2c] and won ($0.63) with three of a kind, Deuces
Seat 5: Casperle (button) folded on the Flop
Seat 6: Zzzanderman (small blind) folded before Flop
Seat 8: Dorex2007 (big blind) folded before Flop
Seat 9: Lymnhades showed [8h Ah] and lost with a pair of Deuces



PokerStars Hand #237377007165:  Hold'em No Limit ($0.01/$0.02 USD) - 2022/07/15 11:46:28 PT [2022/07/15 14:46:28 ET]
Table 'Appella II' 9-max Seat #6 is the button
Seat 1: wALEXSANDRw ($1.55 in chips) 
Seat 2: murmuc1956 ($1.94 in chips) 
Seat 3: 7AVA ($2.12 in chips) 
Seat 4: mayconmontaia ($1.02 in chips) 
Seat 5: Casperle ($1.69 in chips) 
Seat 6: Zzzanderman ($2.84 in chips) 
Seat 8: Dorex2007 ($3.54 in chips) 
Seat 9: Lymnhades ($1.96 in chips) 
Dorex2007: posts small blind $0.01
Lymnhades: posts big blind $0.02
*** HOLE CARDS ***
Dealt to Dorex2007 [2h 5d]
wALEXSANDRw: folds 
murmuc1956: folds 
7AVA: folds 
mayconmontaia: calls $0.02
Casperle: calls $0.02
Zzzanderman: folds 
Dorex2007: folds 
Lymnhades: checks 
*** FLOP *** [7d 9d 4c]
Lymnhades: checks 
mayconmontaia: checks 
Casperle: checks 
*** TURN *** [7d 9d 4c] [9c]
Lymnhades: checks 
mayconmontaia: checks 
Casperle: checks 
*** RIVER *** [7d 9d 4c 9c] [Ks]
Lymnhades: checks 
mayconmontaia: checks 
Casperle: checks 
*** SHOW DOWN ***
Lymnhades: shows [3h 2s] (a pair of Nines)
mayconmontaia: shows [Ah Qd] (a pair of Nines - Ace kicker)
Casperle: mucks hand 
mayconmontaia collected $0.07 from pot
*** SUMMARY ***
Total pot $0.07 | Rake $0 
Board [7d 9d 4c 9c Ks]
Seat 1: wALEXSANDRw folded before Flop (didn't bet)
Seat 2: murmuc1956 folded before Flop (didn't bet)
Seat 3: 7AVA folded before Flop (didn't bet)
Seat 4: mayconmontaia showed [Ah Qd] and won ($0.07) with a pair of Nines
Seat 5: Casperle mucked [Tc Jc]
Seat 6: Zzzanderman (button) folded before Flop (didn't bet)
Seat 8: Dorex2007 (small blind) folded before Flop
Seat 9: Lymnhades (big blind) showed [3h 2s] and lost with a pair of Nines



PokerStars Hand #237377025304:  Hold'em No Limit ($0.01/$0.02 USD) - 2022/07/15 11:47:24 PT [2022/07/15 14:47:24 ET]
Table 'Appella II' 9-max Seat #8 is the button
Seat 1: wALEXSANDRw ($1.55 in chips) 
Seat 2: murmuc1956 ($1.94 in chips) 
Seat 3: 7AVA ($2.12 in chips) 
Seat 4: mayconmontaia ($1.07 in chips) 
Seat 5: Casperle ($1.67 in chips) 
Seat 6: Zzzanderman ($2.84 in chips) 
Seat 8: Dorex2007 ($3.53 in chips) 
Seat 9: Lymnhades ($1.94 in chips) 
Lymnhades: posts small blind $0.01
wALEXSANDRw: posts big blind $0.02
*** HOLE CARDS ***
Dealt to Dorex2007 [9h 8d]
murmuc1956: folds 
7AVA: folds 
mayconmontaia: folds 
Casperle: folds 
Zzzanderman: folds 
Dorex2007: folds 
Lymnhades: calls $0.01
wALEXSANDRw: checks 
*** FLOP *** [6s Ah 3d]
Lymnhades: bets $0.04
wALEXSANDRw: folds 
Uncalled bet ($0.04) returned to Lymnhades
Lymnhades collected $0.04 from pot
*** SUMMARY ***
Total pot $0.04 | Rake $0 
Board [6s Ah 3d]
Seat 1: wALEXSANDRw (big blind) folded on the Flop
Seat 2: murmuc1956 folded before Flop (didn't bet)
Seat 3: 7AVA folded before Flop (didn't bet)
Seat 4: mayconmontaia folded before Flop (didn't bet)
Seat 5: Casperle folded before Flop (didn't bet)
Seat 6: Zzzanderman folded before Flop (didn't bet)
Seat 8: Dorex2007 (button) folded before Flop (didn't bet)
Seat 9: Lymnhades (small blind) collected ($0.04)



PokerStars Hand #237377031820:  Hold'em No Limit ($0.01/$0.02 USD) - 2022/07/15 11:47:44 PT [2022/07/15 14:47:44 ET]
Table 'Appella II' 9-max Seat #9 is the button
Seat 1: wALEXSANDRw ($1.53 in chips) 
Seat 3: 7AVA ($2.12 in chips) 
Seat 4: mayconmontaia ($1.07 in chips) 
Seat 5: Casperle ($1.67 in chips) 
Seat 6: Zzzanderman ($2.84 in chips) 
Seat 8: Dorex2007 ($3.53 in chips) 
Seat 9: Lymnhades ($1.96 in chips) 
wALEXSANDRw: posts small blind $0.01
murmuc1956: is sitting out 
7AVA: posts big blind $0.02
*** HOLE CARDS ***
Dealt to Dorex2007 [2h Ks]
mayconmontaia: folds 
murmuc1956 leaves the table
Casperle: calls $0.02
Zzzanderman: folds 
Dorex2007: folds 
Lymnhades: folds 
wALEXSANDRw: raises $0.04 to $0.06
7AVA: folds 
Casperle: calls $0.04
*** FLOP *** [Ts Qh 6c]
samurai_z79 joins the table at seat #2 
wALEXSANDRw: bets $0.06
Casperle: folds 
Uncalled bet ($0.06) returned to wALEXSANDRw
wALEXSANDRw collected $0.14 from pot
*** SUMMARY ***
Total pot $0.14 | Rake $0 
Board [Ts Qh 6c]
Seat 1: wALEXSANDRw (small blind) collected ($0.14)
Seat 3: 7AVA (big blind) folded before Flop
Seat 4: mayconmontaia folded before Flop (didn't bet)
Seat 5: Casperle folded on the Flop
Seat 6: Zzzanderman folded before Flop (didn't bet)
Seat 8: Dorex2007 folded before Flop (didn't bet)
Seat 9: Lymnhades (button) folded before Flop (didn't bet)



PokerStars Hand #237377043993:  Hold'em No Limit ($0.01/$0.02 USD) - 2022/07/15 11:48:22 PT [2022/07/15 14:48:22 ET]
Table 'Appella II' 9-max Seat #1 is the button
Seat 1: wALEXSANDRw ($1.61 in chips) 
Seat 3: 7AVA ($2.10 in chips) 
Seat 4: mayconmontaia ($1.07 in chips) 
Seat 5: Casperle ($1.61 in chips) 
Seat 6: Zzzanderman ($2.84 in chips) 
Seat 8: Dorex2007 ($3.53 in chips) 
Seat 9: Lymnhades ($1.96 in chips) 
7AVA: posts small blind $0.01
mayconmontaia: posts big blind $0.02
*** HOLE CARDS ***
Dealt to Dorex2007 [4c 6c]
Casperle: raises $0.02 to $0.04
Zzzanderman: calls $0.04
Dorex2007: folds 
Lymnhades: folds 
wALEXSANDRw: folds 
7AVA: calls $0.03
mayconmontaia: folds 
*** FLOP *** [Ac 7s 5h]
7AVA: checks 
Casperle: checks 
Zzzanderman: bets $0.08
7AVA: folds 
Casperle: folds 
Uncalled bet ($0.08) returned to Zzzanderman
Zzzanderman collected $0.14 from pot
*** SUMMARY ***
Total pot $0.14 | Rake $0 
Board [Ac 7s 5h]
Seat 1: wALEXSANDRw (button) folded before Flop (didn't bet)
Seat 3: 7AVA (small blind) folded on the Flop
Seat 4: mayconmontaia (big blind) folded before Flop
Seat 5: Casperle folded on the Flop
Seat 6: Zzzanderman collected ($0.14)
Seat 8: Dorex2007 folded before Flop (didn't bet)
Seat 9: Lymnhades folded before Flop (didn't bet)



PokerStars Hand #237377059097:  Hold'em No Limit ($0.01/$0.02 USD) - 2022/07/15 11:49:09 PT [2022/07/15 14:49:09 ET]
Table 'Appella II' 9-max Seat #3 is the button
Seat 1: wALEXSANDRw ($1.61 in chips) 
Seat 2: samurai_z79 ($0.80 in chips) 
Seat 3: 7AVA ($2.06 in chips) 
Seat 4: mayconmontaia ($1.05 in chips) 
Seat 5: Casperle ($1.57 in chips) 
Seat 6: Zzzanderman ($2.94 in chips) 
Seat 8: Dorex2007 ($3.53 in chips) 
Seat 9: Lymnhades ($1.96 in chips) 
mayconmontaia: posts small blind $0.01
Casperle: posts big blind $0.02
RAAAAdik: sits out 
samurai_z79: posts big blind $0.02
*** HOLE CARDS ***
Dealt to Dorex2007 [5h 4d]
Zzzanderman: folds 
Dorex2007: folds 
Lymnhades: raises $0.06 to $0.08
wALEXSANDRw: folds 
samurai_z79: folds 
7AVA: folds 
mayconmontaia: folds 
Casperle: folds 
Uncalled bet ($0.06) returned to Lymnhades
Lymnhades collected $0.07 from pot
*** SUMMARY ***
Total pot $0.07 | Rake $0 
Seat 1: wALEXSANDRw folded before Flop (didn't bet)
Seat 2: samurai_z79 folded before Flop (didn't bet)
Seat 3: 7AVA (button) folded before Flop (didn't bet)
Seat 4: mayconmontaia (small blind) folded before Flop
Seat 5: Casperle (big blind) folded before Flop
Seat 6: Zzzanderman folded before Flop (didn't bet)
Seat 8: Dorex2007 folded before Flop (didn't bet)
Seat 9: Lymnhades collected ($0.07)



PokerStars Hand #237377065071:  Hold'em No Limit ($0.01/$0.02 USD) - 2022/07/15 11:49:28 PT [2022/07/15 14:49:28 ET]
Table 'Appella II' 9-max Seat #4 is the button
Seat 1: wALEXSANDRw ($1.61 in chips) 
Seat 2: samurai_z79 ($0.78 in chips) 
Seat 3: 7AVA ($2.06 in chips) 
Seat 4: mayconmontaia ($1.04 in chips) 
Seat 5: Casperle ($1.55 in chips) 
Seat 6: Zzzanderman ($2.94 in chips) 
Seat 8: Dorex2007 ($3.53 in chips) 
Seat 9: Lymnhades ($2.01 in chips) 
Casperle: posts small blind $0.01
Zzzanderman: posts big blind $0.02
RAAAAdik: sits out 
*** HOLE CARDS ***
Dealt to Dorex2007 [5d 4h]
Dorex2007: folds 
Lymnhades: folds 
wALEXSANDRw: raises $0.04 to $0.06
samurai_z79: folds 
7AVA: folds 
mayconmontaia: folds 
Casperle: folds 
Zzzanderman: calls $0.04
*** FLOP *** [7c 6d Qs]
Zzzanderman: checks 
wALEXSANDRw: bets $0.06
Zzzanderman: folds 
Uncalled bet ($0.06) returned to wALEXSANDRw
wALEXSANDRw collected $0.13 from pot
*** SUMMARY ***
Total pot $0.13 | Rake $0 
Board [7c 6d Qs]
Seat 1: wALEXSANDRw collected ($0.13)
Seat 2: samurai_z79 folded before Flop (didn't bet)
Seat 3: 7AVA folded before Flop (didn't bet)
Seat 4: mayconmontaia (button) folded before Flop (didn't bet)
Seat 5: Casperle (small blind) folded before Flop
Seat 6: Zzzanderman (big blind) folded on the Flop
Seat 8: Dorex2007 folded before Flop (didn't bet)
Seat 9: Lymnhades folded before Flop (didn't bet)



PokerStars Hand #237377074121:  Hold'em No Limit ($0.01/$0.02 USD) - 2022/07/15 11:49:56 PT [2022/07/15 14:49:56 ET]
Table 'Appella II' 9-max Seat #5 is the button
Seat 1: wALEXSANDRw ($1.68 in chips) 
Seat 2: samurai_z79 ($0.78 in chips) 
Seat 3: 7AVA ($2.06 in chips) 
Seat 4: mayconmontaia ($1.04 in chips) 
Seat 5: Casperle ($1.54 in chips) 
Seat 6: Zzzanderman ($2.88 in chips) 
Seat 7: RAAAAdik ($2.11 in chips) 
Seat 8: Dorex2007 ($3.53 in chips) 
Seat 9: Lymnhades ($2.01 in chips) 
Zzzanderman: posts small blind $0.01
RAAAAdik: posts big blind $0.02
*** HOLE CARDS ***
Dealt to Dorex2007 [Kd 2s]
Dorex2007: folds 
Lymnhades: raises $0.04 to $0.06
wALEXSANDRw: calls $0.06
samurai_z79: folds 
7AVA: folds 
mayconmontaia: folds 
Casperle: folds 
Zzzanderman: folds 
RAAAAdik: folds 
*** FLOP *** [6s 3s Kh]
Lymnhades: bets $0.06
wALEXSANDRw: folds 
Uncalled bet ($0.06) returned to Lymnhades
Lymnhades collected $0.14 from pot
*** SUMMARY ***
Total pot $0.15 | Rake $0.01 
Board [6s 3s Kh]
Seat 1: wALEXSANDRw folded on the Flop
Seat 2: samurai_z79 folded before Flop (didn't bet)
Seat 3: 7AVA folded before Flop (didn't bet)
Seat 4: mayconmontaia folded before Flop (didn't bet)
Seat 5: Casperle (button) folded before Flop (didn't bet)
Seat 6: Zzzanderman (small blind) folded before Flop
Seat 7: RAAAAdik (big blind) folded before Flop
Seat 8: Dorex2007 folded before Flop (didn't bet)
Seat 9: Lymnhades collected ($0.14)



PokerStars Hand #237377083232:  Hold'em No Limit ($0.01/$0.02 USD) - 2022/07/15 11:50:25 PT [2022/07/15 14:50:25 ET]
Table 'Appella II' 9-max Seat #6 is the button
Seat 1: wALEXSANDRw ($1.62 in chips) 
Seat 2: samurai_z79 ($0.78 in chips) 
Seat 3: 7AVA ($2.06 in chips) 
Seat 4: mayconmontaia ($1.04 in chips) 
Seat 5: Casperle ($1.54 in chips) 
Seat 6: Zzzanderman ($2.87 in chips) 
Seat 7: RAAAAdik ($2.09 in chips) 
Seat 8: Dorex2007 ($3.53 in chips) 
Seat 9: Lymnhades ($2.09 in chips) 
RAAAAdik: posts small blind $0.01
Dorex2007: posts big blind $0.02
*** HOLE CARDS ***
Dealt to Dorex2007 [5d Qs]
Lymnhades: calls $0.02
wALEXSANDRw: raises $0.06 to $0.08
samurai_z79: calls $0.08
7AVA: folds 
mayconmontaia: folds 
Casperle: folds 
Zzzanderman: folds 
RAAAAdik: folds 
Dorex2007: folds 
Lymnhades: calls $0.06
*** FLOP *** [Js Jc 4h]
Lymnhades: checks 
wALEXSANDRw: bets $0.06
samurai_z79: folds 
Lymnhades: calls $0.06
*** TURN *** [Js Jc 4h] [Qd]
Lymnhades: checks 
wALEXSANDRw: bets $0.06
Lymnhades: raises $0.06 to $0.12
wALEXSANDRw: calls $0.06
*** RIVER *** [Js Jc 4h Qd] [3d]
Lymnhades: checks 
wALEXSANDRw: checks 
*** SHOW DOWN ***
Lymnhades: shows [2s 2c] (two pair, Jacks and Deuces)
wALEXSANDRw: shows [Kd Ks] (two pair, Kings and Jacks)
wALEXSANDRw collected $0.61 from pot
*** SUMMARY ***
Total pot $0.63 | Rake $0.02 
Board [Js Jc 4h Qd 3d]
Seat 1: wALEXSANDRw showed [Kd Ks] and won ($0.61) with two pair, Kings and Jacks
Seat 2: samurai_z79 folded on the Flop
Seat 3: 7AVA folded before Flop (didn't bet)
Seat 4: mayconmontaia folded before Flop (didn't bet)
Seat 5: Casperle folded before Flop (didn't bet)
Seat 6: Zzzanderman (button) folded before Flop (didn't bet)
Seat 7: RAAAAdik (small blind) folded before Flop
Seat 8: Dorex2007 (big blind) folded before Flop
Seat 9: Lymnhades showed [2s 2c] and lost with two pair, Jacks and Deuces



PokerStars Hand #237377113170:  Hold'em No Limit ($0.01/$0.02 USD) - 2022/07/15 11:51:33 PT [2022/07/15 14:51:33 ET]
Table 'Appella II' 9-max Seat #7 is the button
Seat 1: wALEXSANDRw ($1.97 in chips) 
Seat 2: samurai_z79 ($0.70 in chips) 
Seat 3: 7AVA ($2.06 in chips) 
Seat 4: mayconmontaia ($1.04 in chips) 
Seat 5: Casperle ($1.54 in chips) 
Seat 6: Zzzanderman ($2.87 in chips) 
Seat 7: RAAAAdik ($2.08 in chips) 
Seat 8: Dorex2007 ($3.51 in chips) 
Seat 9: Lymnhades ($1.83 in chips) 
Dorex2007: posts small blind $0.01
Lymnhades: posts big blind $0.02
*** HOLE CARDS ***
Dealt to Dorex2007 [8d 6d]
wALEXSANDRw: folds 
samurai_z79: calls $0.02
7AVA: folds 
mayconmontaia: calls $0.02
Casperle: folds 
Zzzanderman: calls $0.02
RAAAAdik: folds 
Dorex2007: folds 
Lymnhades: checks 
*** FLOP *** [7d Qc Js]
Lymnhades: checks 
samurai_z79: bets $0.04
mayconmontaia: raises $0.04 to $0.08
Zzzanderman: folds 
Lymnhades: folds 
samurai_z79: raises $0.04 to $0.12
mayconmontaia: calls $0.04
*** TURN *** [7d Qc Js] [9h]
samurai_z79: bets $0.10
mayconmontaia: raises $0.10 to $0.20
samurai_z79: raises $0.36 to $0.56 and is all-in
mayconmontaia: calls $0.36
*** RIVER *** [7d Qc Js 9h] [7c]
*** SHOW DOWN ***
samurai_z79: shows [Qs 7h] (a full house, Sevens full of Queens)
mayconmontaia: shows [9c Kc] (two pair, Nines and Sevens)
samurai_z79 collected $1.40 from pot
*** SUMMARY ***
Total pot $1.45 | Rake $0.05 
Board [7d Qc Js 9h 7c]
Seat 1: wALEXSANDRw folded before Flop (didn't bet)
Seat 2: samurai_z79 showed [Qs 7h] and won ($1.40) with a full house, Sevens full of Queens
Seat 3: 7AVA folded before Flop (didn't bet)
Seat 4: mayconmontaia showed [9c Kc] and lost with two pair, Nines and Sevens
Seat 5: Casperle folded before Flop (didn't bet)
Seat 6: Zzzanderman folded on the Flop
Seat 7: RAAAAdik (button) folded before Flop (didn't bet)
Seat 8: Dorex2007 (small blind) folded before Flop
Seat 9: Lymnhades (big blind) folded on the Flop



PokerStars Hand #237377139513:  Hold'em No Limit ($0.01/$0.02 USD) - 2022/07/15 11:52:55 PT [2022/07/15 14:52:55 ET]
Table 'Appella II' 9-max Seat #8 is the button
Seat 1: wALEXSANDRw ($1.97 in chips) 
Seat 2: samurai_z79 ($1.40 in chips) 
Seat 3: 7AVA ($2.06 in chips) 
Seat 4: mayconmontaia ($0.34 in chips) 
Seat 5: Casperle ($1.54 in chips) 
Seat 6: Zzzanderman ($2.85 in chips) 
Seat 7: RAAAAdik ($2.08 in chips) 
Seat 8: Dorex2007 ($3.50 in chips) 
Seat 9: Lymnhades ($1.81 in chips) 
Lymnhades: posts small blind $0.01
wALEXSANDRw: posts big blind $0.02
*** HOLE CARDS ***
Dealt to Dorex2007 [Js 9d]
samurai_z79: folds 
7AVA: folds 
mayconmontaia: folds 
Casperle: folds 
Zzzanderman: folds 
RAAAAdik: folds 
Dorex2007: folds 
Lymnhades: raises $0.04 to $0.06
wALEXSANDRw: folds 
Uncalled bet ($0.04) returned to Lymnhades
Lymnhades collected $0.04 from pot
*** SUMMARY ***
Total pot $0.04 | Rake $0 
Seat 1: wALEXSANDRw (big blind) folded before Flop
Seat 2: samurai_z79 folded before Flop (didn't bet)
Seat 3: 7AVA folded before Flop (didn't bet)
Seat 4: mayconmontaia folded before Flop (didn't bet)
Seat 5: Casperle folded before Flop (didn't bet)
Seat 6: Zzzanderman folded before Flop (didn't bet)
Seat 7: RAAAAdik folded before Flop (didn't bet)
Seat 8: Dorex2007 (button) folded before Flop (didn't bet)
Seat 9: Lymnhades (small blind) collected ($0.04)



PokerStars Hand #237377145666:  Hold'em No Limit ($0.01/$0.02 USD) - 2022/07/15 11:53:13 PT [2022/07/15 14:53:13 ET]
Table 'Appella II' 9-max Seat #9 is the button
Seat 1: wALEXSANDRw ($1.95 in chips) 
Seat 2: samurai_z79 ($1.40 in chips) 
Seat 3: 7AVA ($2.06 in chips) 
Seat 4: mayconmontaia ($0.34 in chips) 
Seat 5: Casperle ($1.54 in chips) 
Seat 6: Zzzanderman ($2.85 in chips) 
Seat 7: RAAAAdik ($2.08 in chips) 
Seat 8: Dorex2007 ($3.50 in chips) 
Seat 9: Lymnhades ($1.83 in chips) 
wALEXSANDRw: posts small blind $0.01
samurai_z79: posts big blind $0.02
*** HOLE CARDS ***
Dealt to Dorex2007 [2h 3h]
7AVA: folds 
mayconmontaia: raises $0.02 to $0.04
Casperle: folds 
Zzzanderman: folds 
RAAAAdik: folds 
Dorex2007: folds 
Lymnhades: calls $0.04
wALEXSANDRw: calls $0.03
samurai_z79: calls $0.02
*** FLOP *** [6d 9c 5s]
wALEXSANDRw: checks 
samurai_z79: bets $0.02
mayconmontaia: raises $0.02 to $0.04
Lymnhades: calls $0.04
wALEXSANDRw: calls $0.04
samurai_z79: calls $0.02
*** TURN *** [6d 9c 5s] [Qd]
wALEXSANDRw: checks 
samurai_z79: checks 
mayconmontaia: bets $0.26 and is all-in
Lymnhades: folds 
wALEXSANDRw: folds 
samurai_z79: calls $0.26
*** RIVER *** [6d 9c 5s Qd] [Qs]
*** SHOW DOWN ***
samurai_z79: shows [4h 9d] (two pair, Queens and Nines)
mayconmontaia: shows [4s Ac] (a pair of Queens)
samurai_z79 collected $0.81 from pot
*** SUMMARY ***
Total pot $0.84 | Rake $0.03 
Board [6d 9c 5s Qd Qs]
Seat 1: wALEXSANDRw (small blind) folded on the Turn
Seat 2: samurai_z79 (big blind) showed [4h 9d] and won ($0.81) with two pair, Queens and Nines
Seat 3: 7AVA folded before Flop (didn't bet)
Seat 4: mayconmontaia showed [4s Ac] and lost with a pair of Queens
Seat 5: Casperle folded before Flop (didn't bet)
Seat 6: Zzzanderman folded before Flop (didn't bet)
Seat 7: RAAAAdik folded before Flop (didn't bet)
Seat 8: Dorex2007 folded before Flop (didn't bet)
Seat 9: Lymnhades (button) folded on the Turn



PokerStars Hand #237377165805:  Hold'em No Limit ($0.01/$0.02 USD) - 2022/07/15 11:54:16 PT [2022/07/15 14:54:16 ET]
Table 'Appella II' 9-max Seat #1 is the button
Seat 1: wALEXSANDRw ($1.87 in chips) 
Seat 2: samurai_z79 ($1.87 in chips) 
Seat 3: 7AVA ($2.06 in chips) 
Seat 5: Casperle ($1.54 in chips) 
Seat 6: Zzzanderman ($2.85 in chips) 
Seat 7: RAAAAdik ($2.08 in chips) 
Seat 8: Dorex2007 ($3.50 in chips) 
Seat 9: Lymnhades ($1.75 in chips) 
samurai_z79: posts small blind $0.01
7AVA: posts big blind $0.02
*** HOLE CARDS ***
Dealt to Dorex2007 [7h Jc]
Casperle: folds 
Zzzanderman: folds 
RAAAAdik: folds 
Dorex2007: folds 
Lymnhades: raises $0.04 to $0.06
wALEXSANDRw: folds 
samurai_z79: calls $0.05
7AVA: folds 
*** FLOP *** [7c Ac 5d]
samurai_z79: checks 
Lymnhades: bets $0.09
samurai_z79: folds 
Uncalled bet ($0.09) returned to Lymnhades
Lymnhades collected $0.14 from pot
*** SUMMARY ***
Total pot $0.14 | Rake $0 
Board [7c Ac 5d]
Seat 1: wALEXSANDRw (button) folded before Flop (didn't bet)
Seat 2: samurai_z79 (small blind) folded on the Flop
Seat 3: 7AVA (big blind) folded before Flop
Seat 5: Casperle folded before Flop (didn't bet)
Seat 6: Zzzanderman folded before Flop (didn't bet)
Seat 7: RAAAAdik folded before Flop (didn't bet)
Seat 8: Dorex2007 folded before Flop (didn't bet)
Seat 9: Lymnhades collected ($0.14)



PokerStars Hand #237377177505:  Hold'em No Limit ($0.01/$0.02 USD) - 2022/07/15 11:54:52 PT [2022/07/15 14:54:52 ET]
Table 'Appella II' 9-max Seat #2 is the button
Seat 1: wALEXSANDRw ($1.87 in chips) 
Seat 2: samurai_z79 ($1.81 in chips) 
Seat 3: 7AVA ($2.04 in chips) 
Seat 4: mayconmontaia ($2 in chips) 
Seat 5: Casperle ($1.54 in chips) 
Seat 6: Zzzanderman ($2.85 in chips) 
Seat 7: RAAAAdik ($2.08 in chips) 
Seat 8: Dorex2007 ($3.50 in chips) 
Seat 9: Lymnhades ($1.83 in chips) 
7AVA: posts small blind $0.01
mayconmontaia: posts big blind $0.02
*** HOLE CARDS ***
Dealt to Dorex2007 [2c Kc]
Casperle: calls $0.02
Zzzanderman: calls $0.02
RAAAAdik: folds 
Dorex2007: folds 
Lymnhades: folds 
wALEXSANDRw: calls $0.02
samurai_z79: folds 
samurai_z79 leaves the table
7AVA: folds 
mayconmontaia: raises $0.02 to $0.04
Casperle: calls $0.02
Zzzanderman: calls $0.02
wALEXSANDRw: calls $0.02
*** FLOP *** [6d 8h Js]
mayconmontaia: bets $0.08
Casperle: calls $0.08
Zzzanderman: folds 
wALEXSANDRw: folds 
*** TURN *** [6d 8h Js] [5s]
mayconmontaia: bets $0.16
Katharinad0 joins the table at seat #2 
Casperle: folds 
Uncalled bet ($0.16) returned to mayconmontaia
mayconmontaia collected $0.32 from pot
*** SUMMARY ***
Total pot $0.33 | Rake $0.01 
Board [6d 8h Js 5s]
Seat 1: wALEXSANDRw folded on the Flop
Seat 2: samurai_z79 (button) folded before Flop (didn't bet)
Seat 3: 7AVA (small blind) folded before Flop
Seat 4: mayconmontaia (big blind) collected ($0.32)
Seat 5: Casperle folded on the Turn
Seat 6: Zzzanderman folded on the Flop
Seat 7: RAAAAdik folded before Flop (didn't bet)
Seat 8: Dorex2007 folded before Flop (didn't bet)
Seat 9: Lymnhades folded before Flop (didn't bet)



