PokerStars Hand #238669355710:  Hold'em No Limit ($0.02/$0.05 USD) - 2022/09/16 13:15:29 PT [2022/09/16 16:15:29 ET]
Table 'Hedera II' 9-max Seat #2 is the button
Seat 2: Alex.Petrovskiy ($5.19 in chips) 
Seat 3: kramnoy.ivan ($4.95 in chips) 
Seat 4: cz_Fox_cz ($5 in chips) 
Seat 5: Lucases Ente ($5.73 in chips) 
Seat 6: TheQuicksand ($4.65 in chips) 
Seat 7: Den19930817 ($5 in chips) 
Seat 8: fiekoes ($6.74 in chips) 
Seat 9: Dorex2007 ($5 in chips) 
kramnoy.ivan: posts small blind $0.02
cz_Fox_cz: posts big blind $0.05
Dorex2007: posts big blind $0.05
BluffOnTable: sits out 
*** HOLE CARDS ***
Dealt to Dorex2007 [5s 3h]
Lucases Ente: raises $0.05 to $0.10
TheQuicksand: folds 
Den19930817: folds 
fiekoes: calls $0.10
Dorex2007: folds 
Alex.Petrovskiy: folds 
kramnoy.ivan: calls $0.08
cz_Fox_cz: calls $0.05
*** FLOP *** [5c Ks 4c]
kramnoy.ivan: bets $0.21
cz_Fox_cz: folds 
Lucases Ente: calls $0.21
fiekoes: calls $0.21
*** TURN *** [5c Ks 4c] [Kc]
kramnoy.ivan: bets $0.10
Lucases Ente: raises $0.40 to $0.50
fiekoes: folds 
kramnoy.ivan: raises $0.50 to $1
Lucases Ente: calls $0.50
*** RIVER *** [5c Ks 4c Kc] [5d]
kramnoy.ivan: bets $0.20
Lucases Ente: calls $0.20
*** SHOW DOWN ***
kramnoy.ivan: shows [4h Kh] (a full house, Kings full of Fives)
Lucases Ente: mucks hand 
kramnoy.ivan collected $3.34 from pot
*** SUMMARY ***
Total pot $3.48 | Rake $0.14 
Board [5c Ks 4c Kc 5d]
Seat 2: Alex.Petrovskiy (button) folded before Flop (didn't bet)
Seat 3: kramnoy.ivan (small blind) showed [4h Kh] and won ($3.34) with a full house, Kings full of Fives
Seat 4: cz_Fox_cz (big blind) folded on the Flop
Seat 5: Lucases Ente mucked [Jc 9c]
Seat 6: TheQuicksand folded before Flop (didn't bet)
Seat 7: Den19930817 folded before Flop (didn't bet)
Seat 8: fiekoes folded on the Turn
Seat 9: Dorex2007 folded before Flop (didn't bet)



PokerStars Hand #238669385252:  Hold'em No Limit ($0.02/$0.05 USD) - 2022/09/16 13:16:33 PT [2022/09/16 16:16:33 ET]
Table 'Hedera II' 9-max Seat #3 is the button
Seat 2: Alex.Petrovskiy ($5.19 in chips) 
Seat 3: kramnoy.ivan ($6.78 in chips) 
Seat 4: cz_Fox_cz ($4.90 in chips) 
Seat 5: Lucases Ente ($4.22 in chips) 
Seat 6: TheQuicksand ($4.65 in chips) 
Seat 7: Den19930817 ($5 in chips) 
Seat 8: fiekoes ($6.43 in chips) 
Seat 9: Dorex2007 ($5 in chips) 
cz_Fox_cz: posts small blind $0.02
Lucases Ente: posts big blind $0.05
BluffOnTable: sits out 
*** HOLE CARDS ***
Dealt to Dorex2007 [8c Ts]
TheQuicksand: calls $0.05
Den19930817: folds 
fiekoes: calls $0.05
Dorex2007: folds 
Alex.Petrovskiy: raises $0.20 to $0.25
kramnoy.ivan: folds 
cz_Fox_cz: folds 
Lucases Ente: folds 
TheQuicksand: calls $0.20
fiekoes: calls $0.20
*** FLOP *** [2d 7s Ad]
TheQuicksand: bets $0.39
fiekoes: calls $0.39
Alex.Petrovskiy: calls $0.39
*** TURN *** [2d 7s Ad] [8d]
TheQuicksand: checks 
fiekoes: bets $0.20
Alex.Petrovskiy: raises $0.63 to $0.83
TheQuicksand: folds 
fiekoes: calls $0.63
*** RIVER *** [2d 7s Ad 8d] [4s]
fiekoes: bets $0.15
Alex.Petrovskiy: raises $2.46 to $2.61
fiekoes: calls $2.46
*** SHOW DOWN ***
Alex.Petrovskiy: shows [Jd Kd] (a flush, Ace high)
fiekoes: mucks hand 
Alex.Petrovskiy collected $8.50 from pot
*** SUMMARY ***
Total pot $8.87 | Rake $0.37 
Board [2d 7s Ad 8d 4s]
Seat 2: Alex.Petrovskiy showed [Jd Kd] and won ($8.50) with a flush, Ace high
Seat 3: kramnoy.ivan (button) folded before Flop (didn't bet)
Seat 4: cz_Fox_cz (small blind) folded before Flop
Seat 5: Lucases Ente (big blind) folded before Flop
Seat 6: TheQuicksand folded on the Turn
Seat 7: Den19930817 folded before Flop (didn't bet)
Seat 8: fiekoes mucked [9h As]
Seat 9: Dorex2007 folded before Flop (didn't bet)



PokerStars Hand #238669417413:  Hold'em No Limit ($0.02/$0.05 USD) - 2022/09/16 13:17:45 PT [2022/09/16 16:17:45 ET]
Table 'Hedera II' 9-max Seat #4 is the button
Seat 2: Alex.Petrovskiy ($9.61 in chips) 
Seat 3: kramnoy.ivan ($6.78 in chips) 
Seat 4: cz_Fox_cz ($4.88 in chips) 
Seat 5: Lucases Ente ($4.17 in chips) 
Seat 6: TheQuicksand ($4.01 in chips) 
Seat 7: Den19930817 ($5 in chips) 
Seat 8: fiekoes ($2.35 in chips) 
Seat 9: Dorex2007 ($5 in chips) 
Lucases Ente: posts small blind $0.02
TheQuicksand: posts big blind $0.05
BluffOnTable: sits out 
*** HOLE CARDS ***
Dealt to Dorex2007 [3h 8d]
Den19930817: folds 
fiekoes: calls $0.05
Dorex2007: folds 
Alex.Petrovskiy: folds 
kramnoy.ivan: folds 
cz_Fox_cz: calls $0.05
Lucases Ente: raises $0.10 to $0.15
TheQuicksand: folds 
fiekoes: calls $0.10
cz_Fox_cz: calls $0.10
*** FLOP *** [As Kd Td]
Lucases Ente: checks 
fiekoes: bets $0.05
cz_Fox_cz: folds 
Lucases Ente: calls $0.05
*** TURN *** [As Kd Td] [6d]
Lucases Ente: checks 
fiekoes: bets $0.15
Lucases Ente: calls $0.15
*** RIVER *** [As Kd Td 6d] [Qc]
Lucases Ente: checks 
fiekoes: bets $0.15
Lucases Ente: folds 
Uncalled bet ($0.15) returned to fiekoes
fiekoes collected $0.86 from pot
*** SUMMARY ***
Total pot $0.90 | Rake $0.04 
Board [As Kd Td 6d Qc]
Seat 2: Alex.Petrovskiy folded before Flop (didn't bet)
Seat 3: kramnoy.ivan folded before Flop (didn't bet)
Seat 4: cz_Fox_cz (button) folded on the Flop
Seat 5: Lucases Ente (small blind) folded on the River
Seat 6: TheQuicksand (big blind) folded before Flop
Seat 7: Den19930817 folded before Flop (didn't bet)
Seat 8: fiekoes collected ($0.86)
Seat 9: Dorex2007 folded before Flop (didn't bet)



PokerStars Hand #238669441397:  Hold'em No Limit ($0.02/$0.05 USD) - 2022/09/16 13:18:38 PT [2022/09/16 16:18:38 ET]
Table 'Hedera II' 9-max Seat #5 is the button
Seat 2: Alex.Petrovskiy ($9.61 in chips) 
Seat 3: kramnoy.ivan ($6.78 in chips) 
Seat 4: cz_Fox_cz ($4.73 in chips) 
Seat 5: Lucases Ente ($3.82 in chips) 
Seat 6: TheQuicksand ($3.96 in chips) 
Seat 7: Den19930817 ($5 in chips) 
Seat 8: fiekoes ($2.86 in chips) 
Seat 9: Dorex2007 ($5 in chips) 
TheQuicksand: posts small blind $0.02
Den19930817: posts big blind $0.05
BluffOnTable: sits out 
*** HOLE CARDS ***
Dealt to Dorex2007 [3s 8c]
fiekoes: calls $0.05
Dorex2007: folds 
Alex.Petrovskiy has timed out
Alex.Petrovskiy: folds 
kramnoy.ivan: folds 
cz_Fox_cz: calls $0.05
Lucases Ente: folds 
TheQuicksand: folds 
Den19930817: raises $0.21 to $0.26
fiekoes: calls $0.21
cz_Fox_cz: raises $0.21 to $0.47
Den19930817: calls $0.21
fiekoes: calls $0.21
*** FLOP *** [6s 2d 9d]
Den19930817: checks 
fiekoes: bets $0.15
cz_Fox_cz: raises $0.15 to $0.30
Den19930817: calls $0.30
fiekoes: calls $0.15
*** TURN *** [6s 2d 9d] [4d]
Den19930817: checks 
fiekoes: bets $0.15
cz_Fox_cz: raises $0.15 to $0.30
Den19930817: calls $0.30
fiekoes: calls $0.15
*** RIVER *** [6s 2d 9d 4d] [4s]
Den19930817: checks 
fiekoes: checks 
cz_Fox_cz: bets $0.05
Den19930817: calls $0.05
fiekoes: calls $0.05
*** SHOW DOWN ***
cz_Fox_cz: shows [3h Jc] (a pair of Fours)
Den19930817: shows [Qd Ah] (a pair of Fours - Ace kicker)
fiekoes: shows [Qs Ad] (a pair of Fours)
Den19930817 collected $1.62 from pot
fiekoes collected $1.62 from pot
*** SUMMARY ***
Total pot $3.38 | Rake $0.14 
Board [6s 2d 9d 4d 4s]
Seat 2: Alex.Petrovskiy folded before Flop (didn't bet)
Seat 3: kramnoy.ivan folded before Flop (didn't bet)
Seat 4: cz_Fox_cz showed [3h Jc] and lost with a pair of Fours
Seat 5: Lucases Ente (button) folded before Flop (didn't bet)
Seat 6: TheQuicksand (small blind) folded before Flop
Seat 7: Den19930817 (big blind) showed [Qd Ah] and won ($1.62) with a pair of Fours
Seat 8: fiekoes showed [Qs Ad] and won ($1.62) with a pair of Fours
Seat 9: Dorex2007 folded before Flop (didn't bet)



PokerStars Hand #238669476048:  Hold'em No Limit ($0.02/$0.05 USD) - 2022/09/16 13:19:54 PT [2022/09/16 16:19:54 ET]
Table 'Hedera II' 9-max Seat #6 is the button
Seat 2: Alex.Petrovskiy ($9.61 in chips) 
Seat 3: kramnoy.ivan ($6.78 in chips) 
Seat 4: cz_Fox_cz ($3.61 in chips) 
Seat 5: Lucases Ente ($5 in chips) 
Seat 6: TheQuicksand ($3.94 in chips) 
Seat 7: Den19930817 ($5.50 in chips) 
Seat 8: fiekoes ($3.36 in chips) 
Seat 9: Dorex2007 ($5 in chips) 
Den19930817: posts small blind $0.02
fiekoes: posts big blind $0.05
BluffOnTable: sits out 
*** HOLE CARDS ***
Dealt to Dorex2007 [Ts 2c]
Dorex2007: folds 
Alex.Petrovskiy: raises $0.10 to $0.15
kramnoy.ivan: calls $0.15
cz_Fox_cz: folds 
Lucases Ente: raises $0.35 to $0.50
TheQuicksand: folds 
Den19930817: folds 
fiekoes: calls $0.45
Alex.Petrovskiy: calls $0.35
kramnoy.ivan: calls $0.35
*** FLOP *** [5h Qs Kc]
fiekoes: bets $0.05
Alex.Petrovskiy: raises $0.64 to $0.69
kramnoy.ivan: folds 
Lucases Ente: raises $0.99 to $1.68
fiekoes: calls $1.63
Alex.Petrovskiy: folds 
*** TURN *** [5h Qs Kc] [Kh]
fiekoes: checks 
Lucases Ente: bets $1.75
fiekoes: calls $1.18 and is all-in
Uncalled bet ($0.57) returned to Lucases Ente
*** RIVER *** [5h Qs Kc Kh] [4c]
*** SHOW DOWN ***
fiekoes: shows [Qd 4d] (two pair, Kings and Queens)
Lucases Ente: shows [As Kd] (three of a kind, Kings)
Lucases Ente collected $7.99 from pot
*** SUMMARY ***
Total pot $8.43 | Rake $0.44 
Board [5h Qs Kc Kh 4c]
Seat 2: Alex.Petrovskiy folded on the Flop
Seat 3: kramnoy.ivan folded on the Flop
Seat 4: cz_Fox_cz folded before Flop (didn't bet)
Seat 5: Lucases Ente showed [As Kd] and won ($7.99) with three of a kind, Kings
Seat 6: TheQuicksand (button) folded before Flop (didn't bet)
Seat 7: Den19930817 (small blind) folded before Flop
Seat 8: fiekoes (big blind) showed [Qd 4d] and lost with two pair, Kings and Queens
Seat 9: Dorex2007 folded before Flop (didn't bet)



PokerStars Hand #238669505772:  Hold'em No Limit ($0.02/$0.05 USD) - 2022/09/16 13:21:00 PT [2022/09/16 16:21:00 ET]
Table 'Hedera II' 9-max Seat #7 is the button
Seat 1: BluffOnTable ($5.05 in chips) 
Seat 2: Alex.Petrovskiy ($8.42 in chips) 
Seat 3: kramnoy.ivan ($6.28 in chips) 
Seat 4: cz_Fox_cz ($3.61 in chips) 
Seat 5: Lucases Ente ($9.63 in chips) 
Seat 6: TheQuicksand ($3.94 in chips) 
Seat 7: Den19930817 ($5.48 in chips) 
Seat 9: Dorex2007 ($5 in chips) 
Dorex2007: posts small blind $0.02
BluffOnTable: posts big blind $0.05
*** HOLE CARDS ***
Dealt to Dorex2007 [3d Jh]
Alex.Petrovskiy: folds 
kramnoy.ivan: folds 
cz_Fox_cz: calls $0.05
Lucases Ente: calls $0.05
TheQuicksand: folds 
Den19930817: folds 
Dorex2007: folds 
BluffOnTable: raises $0.35 to $0.40
cz_Fox_cz: folds 
Lucases Ente: folds 
Uncalled bet ($0.35) returned to BluffOnTable
BluffOnTable collected $0.17 from pot
BluffOnTable: doesn't show hand 
*** SUMMARY ***
Total pot $0.17 | Rake $0 
Seat 1: BluffOnTable (big blind) collected ($0.17)
Seat 2: Alex.Petrovskiy folded before Flop (didn't bet)
Seat 3: kramnoy.ivan folded before Flop (didn't bet)
Seat 4: cz_Fox_cz folded before Flop
Seat 5: Lucases Ente folded before Flop
Seat 6: TheQuicksand folded before Flop (didn't bet)
Seat 7: Den19930817 (button) folded before Flop (didn't bet)
Seat 9: Dorex2007 (small blind) folded before Flop



PokerStars Hand #238669518719:  Hold'em No Limit ($0.02/$0.05 USD) - 2022/09/16 13:21:30 PT [2022/09/16 16:21:30 ET]
Table 'Hedera II' 9-max Seat #9 is the button
Seat 1: BluffOnTable ($5.17 in chips) 
Seat 2: Alex.Petrovskiy ($8.42 in chips) 
Seat 3: kramnoy.ivan ($6.28 in chips) 
Seat 4: cz_Fox_cz ($3.56 in chips) 
Seat 5: Lucases Ente ($9.58 in chips) 
Seat 6: TheQuicksand ($3.94 in chips) 
Seat 7: Den19930817 ($5.48 in chips) 
Seat 9: Dorex2007 ($5 in chips) 
BluffOnTable: posts small blind $0.02
Alex.Petrovskiy: posts big blind $0.05
*** HOLE CARDS ***
Dealt to Dorex2007 [Qd 6c]
kramnoy.ivan: folds 
cz_Fox_cz: calls $0.05
Lucases Ente: folds 
TheQuicksand: folds 
Den19930817: raises $0.15 to $0.20
Dorex2007: folds 
fiekoes is disconnected 
BluffOnTable: folds 
Alex.Petrovskiy: folds 
cz_Fox_cz: calls $0.15
*** FLOP *** [9c 8c 5d]
cz_Fox_cz: checks 
Den19930817: checks 
*** TURN *** [9c 8c 5d] [Th]
cz_Fox_cz: checks 
Den19930817: bets $0.15
cz_Fox_cz: calls $0.15
*** RIVER *** [9c 8c 5d Th] [6h]
cz_Fox_cz: checks 
Den19930817: checks 
*** SHOW DOWN ***
cz_Fox_cz: shows [2s 2d] (a pair of Deuces)
Den19930817: mucks hand 
cz_Fox_cz collected $0.74 from pot
*** SUMMARY ***
Total pot $0.77 | Rake $0.03 
Board [9c 8c 5d Th 6h]
Seat 1: BluffOnTable (small blind) folded before Flop
Seat 2: Alex.Petrovskiy (big blind) folded before Flop
Seat 3: kramnoy.ivan folded before Flop (didn't bet)
Seat 4: cz_Fox_cz showed [2s 2d] and won ($0.74) with a pair of Deuces
Seat 5: Lucases Ente folded before Flop (didn't bet)
Seat 6: TheQuicksand folded before Flop (didn't bet)
Seat 7: Den19930817 mucked [Jc As]
Seat 9: Dorex2007 (button) folded before Flop (didn't bet)



PokerStars Hand #238669539308:  Hold'em No Limit ($0.02/$0.05 USD) - 2022/09/16 13:22:16 PT [2022/09/16 16:22:16 ET]
Table 'Hedera II' 9-max Seat #1 is the button
Seat 1: BluffOnTable ($5.15 in chips) 
Seat 2: Alex.Petrovskiy ($8.37 in chips) 
Seat 3: kramnoy.ivan ($6.28 in chips) 
Seat 4: cz_Fox_cz ($3.95 in chips) 
Seat 5: Lucases Ente ($9.58 in chips) 
Seat 6: TheQuicksand ($3.94 in chips) 
Seat 7: Den19930817 ($5.13 in chips) 
Seat 9: Dorex2007 ($5 in chips) 
Alex.Petrovskiy: posts small blind $0.02
kramnoy.ivan: posts big blind $0.05
*** HOLE CARDS ***
Dealt to Dorex2007 [8h 4c]
cz_Fox_cz: raises $0.05 to $0.10
Lucases Ente: calls $0.10
TheQuicksand: calls $0.10
Den19930817: folds 
Dorex2007: folds 
BluffOnTable: folds 
Alex.Petrovskiy: folds 
kramnoy.ivan: folds 
*** FLOP *** [As 7d 2c]
cz_Fox_cz: bets $0.20
Lucases Ente: folds 
TheQuicksand: folds 
Uncalled bet ($0.20) returned to cz_Fox_cz
cz_Fox_cz collected $0.35 from pot
*** SUMMARY ***
Total pot $0.37 | Rake $0.02 
Board [As 7d 2c]
Seat 1: BluffOnTable (button) folded before Flop (didn't bet)
Seat 2: Alex.Petrovskiy (small blind) folded before Flop
Seat 3: kramnoy.ivan (big blind) folded before Flop
Seat 4: cz_Fox_cz collected ($0.35)
Seat 5: Lucases Ente folded on the Flop
Seat 6: TheQuicksand folded on the Flop
Seat 7: Den19930817 folded before Flop (didn't bet)
Seat 9: Dorex2007 folded before Flop (didn't bet)



PokerStars Hand #238669553621:  Hold'em No Limit ($0.02/$0.05 USD) - 2022/09/16 13:22:48 PT [2022/09/16 16:22:48 ET]
Table 'Hedera II' 9-max Seat #2 is the button
Seat 1: BluffOnTable ($5.15 in chips) 
Seat 2: Alex.Petrovskiy ($8.35 in chips) 
Seat 3: kramnoy.ivan ($6.23 in chips) 
Seat 4: cz_Fox_cz ($4.20 in chips) 
Seat 5: Lucases Ente ($9.48 in chips) 
Seat 6: TheQuicksand ($3.84 in chips) 
Seat 7: Den19930817 ($5.13 in chips) 
Seat 9: Dorex2007 ($5 in chips) 
kramnoy.ivan: posts small blind $0.02
cz_Fox_cz: posts big blind $0.05
*** HOLE CARDS ***
Dealt to Dorex2007 [6c Th]
Lucases Ente: calls $0.05
TheQuicksand: folds 
Den19930817: folds 
Dorex2007: folds 
BluffOnTable: folds 
Alex.Petrovskiy: folds 
kramnoy.ivan: folds 
cz_Fox_cz: raises $0.05 to $0.10
Lucases Ente: calls $0.05
*** FLOP *** [8h Ac Kd]
cz_Fox_cz: bets $0.05
Lucases Ente: calls $0.05
*** TURN *** [8h Ac Kd] [8s]
cz_Fox_cz: bets $0.05
Lucases Ente: calls $0.05
*** RIVER *** [8h Ac Kd 8s] [5s]
cz_Fox_cz: bets $0.05
Lucases Ente: calls $0.05
*** SHOW DOWN ***
cz_Fox_cz: shows [Kh 4h] (two pair, Kings and Eights)
Lucases Ente: mucks hand 
cz_Fox_cz collected $0.50 from pot
*** SUMMARY ***
Total pot $0.52 | Rake $0.02 
Board [8h Ac Kd 8s 5s]
Seat 1: BluffOnTable folded before Flop (didn't bet)
Seat 2: Alex.Petrovskiy (button) folded before Flop (didn't bet)
Seat 3: kramnoy.ivan (small blind) folded before Flop
Seat 4: cz_Fox_cz (big blind) showed [Kh 4h] and won ($0.50) with two pair, Kings and Eights
Seat 5: Lucases Ente mucked [2d 2s]
Seat 6: TheQuicksand folded before Flop (didn't bet)
Seat 7: Den19930817 folded before Flop (didn't bet)
Seat 9: Dorex2007 folded before Flop (didn't bet)



PokerStars Hand #238669571882:  Hold'em No Limit ($0.02/$0.05 USD) - 2022/09/16 13:23:30 PT [2022/09/16 16:23:30 ET]
Table 'Hedera II' 9-max Seat #3 is the button
Seat 1: BluffOnTable ($5.15 in chips) 
Seat 2: Alex.Petrovskiy ($8.35 in chips) 
Seat 3: kramnoy.ivan ($6.21 in chips) 
Seat 4: cz_Fox_cz ($4.45 in chips) 
Seat 5: Lucases Ente ($9.23 in chips) 
Seat 6: TheQuicksand ($3.84 in chips) 
Seat 7: Den19930817 ($5.13 in chips) 
Seat 9: Dorex2007 ($5 in chips) 
cz_Fox_cz: posts small blind $0.02
Lucases Ente: posts big blind $0.05
*** HOLE CARDS ***
Dealt to Dorex2007 [Ad Kd]
TheQuicksand: folds 
Den19930817: folds 
Dorex2007: raises $0.05 to $0.10
BluffOnTable: folds 
Alex.Petrovskiy: folds 
kramnoy.ivan: folds 
cz_Fox_cz: folds 
Lucases Ente: folds 
Uncalled bet ($0.05) returned to Dorex2007
Dorex2007 collected $0.12 from pot
Dorex2007: doesn't show hand 
*** SUMMARY ***
Total pot $0.12 | Rake $0 
Seat 1: BluffOnTable folded before Flop (didn't bet)
Seat 2: Alex.Petrovskiy folded before Flop (didn't bet)
Seat 3: kramnoy.ivan (button) folded before Flop (didn't bet)
Seat 4: cz_Fox_cz (small blind) folded before Flop
Seat 5: Lucases Ente (big blind) folded before Flop
Seat 6: TheQuicksand folded before Flop (didn't bet)
Seat 7: Den19930817 folded before Flop (didn't bet)
Seat 9: Dorex2007 collected ($0.12)



PokerStars Hand #238669579417:  Hold'em No Limit ($0.02/$0.05 USD) - 2022/09/16 13:23:47 PT [2022/09/16 16:23:47 ET]
Table 'Hedera II' 9-max Seat #4 is the button
Seat 1: BluffOnTable ($5.15 in chips) 
Seat 2: Alex.Petrovskiy ($8.35 in chips) 
Seat 3: kramnoy.ivan ($6.21 in chips) 
Seat 4: cz_Fox_cz ($4.43 in chips) 
Seat 5: Lucases Ente ($9.18 in chips) 
Seat 6: TheQuicksand ($3.84 in chips) 
Seat 7: Den19930817 ($5.13 in chips) 
Seat 9: Dorex2007 ($5.07 in chips) 
Lucases Ente: posts small blind $0.02
TheQuicksand: posts big blind $0.05
*** HOLE CARDS ***
Dealt to Dorex2007 [7s Jc]
Den19930817: raises $0.07 to $0.12
Dorex2007: folds 
BluffOnTable: folds 
Alex.Petrovskiy: calls $0.12
kramnoy.ivan: folds 
cz_Fox_cz: folds 
Lucases Ente: folds 
TheQuicksand: folds 
*** FLOP *** [7d 9h As]
Den19930817: bets $0.10
Alex.Petrovskiy: folds 
Uncalled bet ($0.10) returned to Den19930817
Den19930817 collected $0.30 from pot
*** SUMMARY ***
Total pot $0.31 | Rake $0.01 
Board [7d 9h As]
Seat 1: BluffOnTable folded before Flop (didn't bet)
Seat 2: Alex.Petrovskiy folded on the Flop
Seat 3: kramnoy.ivan folded before Flop (didn't bet)
Seat 4: cz_Fox_cz (button) folded before Flop (didn't bet)
Seat 5: Lucases Ente (small blind) folded before Flop
Seat 6: TheQuicksand (big blind) folded before Flop
Seat 7: Den19930817 collected ($0.30)
Seat 9: Dorex2007 folded before Flop (didn't bet)



PokerStars Hand #238669593281:  Hold'em No Limit ($0.02/$0.05 USD) - 2022/09/16 13:24:18 PT [2022/09/16 16:24:18 ET]
Table 'Hedera II' 9-max Seat #5 is the button
Seat 1: BluffOnTable ($5.15 in chips) 
Seat 2: Alex.Petrovskiy ($8.23 in chips) 
Seat 3: kramnoy.ivan ($6.21 in chips) 
Seat 4: cz_Fox_cz ($4.43 in chips) 
Seat 5: Lucases Ente ($9.16 in chips) 
Seat 6: TheQuicksand ($3.79 in chips) 
Seat 9: Dorex2007 ($5.07 in chips) 
TheQuicksand: posts small blind $0.02
Den19930817: is sitting out 
Dorex2007: posts big blind $0.05
*** HOLE CARDS ***
Dealt to Dorex2007 [5h 3c]
BluffOnTable: folds 
Alex.Petrovskiy: folds 
kramnoy.ivan: folds 
cz_Fox_cz: calls $0.05
Lucases Ente: folds 
Den19930817 leaves the table
TheQuicksand: calls $0.03
Dorex2007: checks 
*** FLOP *** [5d 7d 4s]
TheQuicksand: checks 
Dorex2007: checks 
cz_Fox_cz: checks 
*** TURN *** [5d 7d 4s] [5c]
TheQuicksand: checks 
Dorex2007: bets $0.09
cz_Fox_cz: folds 
TheQuicksand: calls $0.09
*** RIVER *** [5d 7d 4s 5c] [3s]
TheQuicksand: checks 
Dorex2007: bets $0.32
TheQuicksand: folds 
Uncalled bet ($0.32) returned to Dorex2007
Dorex2007 collected $0.32 from pot
Dorex2007: doesn't show hand 
*** SUMMARY ***
Total pot $0.33 | Rake $0.01 
Board [5d 7d 4s 5c 3s]
Seat 1: BluffOnTable folded before Flop (didn't bet)
Seat 2: Alex.Petrovskiy folded before Flop (didn't bet)
Seat 3: kramnoy.ivan folded before Flop (didn't bet)
Seat 4: cz_Fox_cz folded on the Turn
Seat 5: Lucases Ente (button) folded before Flop (didn't bet)
Seat 6: TheQuicksand (small blind) folded on the River
Seat 9: Dorex2007 (big blind) collected ($0.32)



PokerStars Hand #238669610011:  Hold'em No Limit ($0.02/$0.05 USD) - 2022/09/16 13:24:56 PT [2022/09/16 16:24:56 ET]
Table 'Hedera II' 9-max Seat #6 is the button
Seat 1: BluffOnTable ($5.15 in chips) 
Seat 2: Alex.Petrovskiy ($8.23 in chips) 
Seat 3: kramnoy.ivan ($6.21 in chips) 
Seat 4: cz_Fox_cz ($4.38 in chips) 
Seat 5: Lucases Ente ($9.16 in chips) 
Seat 6: TheQuicksand ($3.65 in chips) 
Seat 9: Dorex2007 ($5.25 in chips) 
Dorex2007: posts small blind $0.02
BluffOnTable: posts big blind $0.05
*** HOLE CARDS ***
Dealt to Dorex2007 [Js 8c]
Alex.Petrovskiy: folds 
kramnoy.ivan: raises $0.05 to $0.10
cz_Fox_cz: calls $0.10
Lucases Ente: calls $0.10
TheQuicksand: folds 
Dorex2007: folds 
BluffOnTable: calls $0.05
*** FLOP *** [6d 8h Ac]
BluffOnTable: checks 
kramnoy.ivan: checks 
cz_Fox_cz: bets $0.05
Lucases Ente: calls $0.05
BluffOnTable: folds 
kramnoy.ivan: calls $0.05
*** TURN *** [6d 8h Ac] [2s]
kramnoy.ivan: checks 
cz_Fox_cz: bets $0.10
SzNorbert12 joins the table at seat #7 
Lucases Ente: folds 
kramnoy.ivan: folds 
Uncalled bet ($0.10) returned to cz_Fox_cz
cz_Fox_cz collected $0.55 from pot
*** SUMMARY ***
Total pot $0.57 | Rake $0.02 
Board [6d 8h Ac 2s]
Seat 1: BluffOnTable (big blind) folded on the Flop
Seat 2: Alex.Petrovskiy folded before Flop (didn't bet)
Seat 3: kramnoy.ivan folded on the Turn
Seat 4: cz_Fox_cz collected ($0.55)
Seat 5: Lucases Ente folded on the Turn
Seat 6: TheQuicksand (button) folded before Flop (didn't bet)
Seat 9: Dorex2007 (small blind) folded before Flop



PokerStars Hand #238669629533:  Hold'em No Limit ($0.02/$0.05 USD) - 2022/09/16 13:25:40 PT [2022/09/16 16:25:40 ET]
Table 'Hedera II' 9-max Seat #9 is the button
Seat 1: BluffOnTable ($5.05 in chips) 
Seat 2: Alex.Petrovskiy ($8.23 in chips) 
Seat 3: kramnoy.ivan ($6.06 in chips) 
Seat 4: cz_Fox_cz ($4.78 in chips) 
Seat 5: Lucases Ente ($9.01 in chips) 
Seat 6: TheQuicksand ($3.65 in chips) 
Seat 9: Dorex2007 ($5.23 in chips) 
BluffOnTable: posts small blind $0.02
Alex.Petrovskiy: posts big blind $0.05
SzNorbert12: sits out 
*** HOLE CARDS ***
Dealt to Dorex2007 [3h 9h]
kramnoy.ivan: folds 
cz_Fox_cz: folds 
Lucases Ente: folds 
TheQuicksand: folds 
Dorex2007: folds 
BluffOnTable: raises $0.10 to $0.15
Alex.Petrovskiy: folds 
Uncalled bet ($0.10) returned to BluffOnTable
BluffOnTable collected $0.10 from pot
BluffOnTable: doesn't show hand 
*** SUMMARY ***
Total pot $0.10 | Rake $0 
Seat 1: BluffOnTable (small blind) collected ($0.10)
Seat 2: Alex.Petrovskiy (big blind) folded before Flop
Seat 3: kramnoy.ivan folded before Flop (didn't bet)
Seat 4: cz_Fox_cz folded before Flop (didn't bet)
Seat 5: Lucases Ente folded before Flop (didn't bet)
Seat 6: TheQuicksand folded before Flop (didn't bet)
Seat 9: Dorex2007 (button) folded before Flop (didn't bet)



PokerStars Hand #238669635237:  Hold'em No Limit ($0.02/$0.05 USD) - 2022/09/16 13:25:52 PT [2022/09/16 16:25:52 ET]
Table 'Hedera II' 9-max Seat #1 is the button
Seat 1: BluffOnTable ($5.10 in chips) 
Seat 2: Alex.Petrovskiy ($8.18 in chips) 
Seat 3: kramnoy.ivan ($6.06 in chips) 
Seat 4: cz_Fox_cz ($4.78 in chips) 
Seat 6: TheQuicksand ($3.65 in chips) 
Seat 9: Dorex2007 ($5.23 in chips) 
Alex.Petrovskiy: posts small blind $0.02
kramnoy.ivan: posts big blind $0.05
SzNorbert12: sits out 
*** HOLE CARDS ***
Dealt to Dorex2007 [6s Qd]
cz_Fox_cz: calls $0.05
TheQuicksand: folds 
Dorex2007: folds 
BluffOnTable: folds 
Alex.Petrovskiy: folds 
kramnoy.ivan: checks 
*** FLOP *** [3d 2h 3c]
kramnoy.ivan: checks 
cz_Fox_cz: bets $0.05
kramnoy.ivan: folds 
Uncalled bet ($0.05) returned to cz_Fox_cz
cz_Fox_cz collected $0.12 from pot
*** SUMMARY ***
Total pot $0.12 | Rake $0 
Board [3d 2h 3c]
Seat 1: BluffOnTable (button) folded before Flop (didn't bet)
Seat 2: Alex.Petrovskiy (small blind) folded before Flop
Seat 3: kramnoy.ivan (big blind) folded on the Flop
Seat 4: cz_Fox_cz collected ($0.12)
Seat 6: TheQuicksand folded before Flop (didn't bet)
Seat 9: Dorex2007 folded before Flop (didn't bet)



PokerStars Hand #238669654893:  Hold'em No Limit ($0.02/$0.05 USD) - 2022/09/16 13:26:36 PT [2022/09/16 16:26:36 ET]
Table 'Hedera II' 9-max Seat #2 is the button
Seat 1: BluffOnTable ($5.10 in chips) 
Seat 2: Alex.Petrovskiy ($8.16 in chips) 
Seat 3: kramnoy.ivan ($6.01 in chips) 
Seat 4: cz_Fox_cz ($4.85 in chips) 
Seat 6: TheQuicksand ($3.65 in chips) 
Seat 9: Dorex2007 ($5.23 in chips) 
kramnoy.ivan: posts small blind $0.02
cz_Fox_cz: posts big blind $0.05
SzNorbert12: sits out 
*** HOLE CARDS ***
Dealt to Dorex2007 [Tc Jd]
TheQuicksand: folds 
Dorex2007: folds 
BluffOnTable: folds 
Alex.Petrovskiy: folds 
kramnoy.ivan: folds 
Uncalled bet ($0.03) returned to cz_Fox_cz
cz_Fox_cz collected $0.04 from pot
*** SUMMARY ***
Total pot $0.04 | Rake $0 
Seat 1: BluffOnTable folded before Flop (didn't bet)
Seat 2: Alex.Petrovskiy (button) folded before Flop (didn't bet)
Seat 3: kramnoy.ivan (small blind) folded before Flop
Seat 4: cz_Fox_cz (big blind) collected ($0.04)
Seat 6: TheQuicksand folded before Flop (didn't bet)
Seat 9: Dorex2007 folded before Flop (didn't bet)



PokerStars Hand #238669659655:  Hold'em No Limit ($0.02/$0.05 USD) - 2022/09/16 13:26:47 PT [2022/09/16 16:26:47 ET]
Table 'Hedera II' 9-max Seat #3 is the button
Seat 2: Alex.Petrovskiy ($8.16 in chips) 
Seat 3: kramnoy.ivan ($5.99 in chips) 
Seat 4: cz_Fox_cz ($4.87 in chips) 
Seat 6: TheQuicksand ($3.65 in chips) 
Seat 9: Dorex2007 ($5.23 in chips) 
cz_Fox_cz: posts small blind $0.02
TheQuicksand: posts big blind $0.05
SzNorbert12: sits out 
*** HOLE CARDS ***
Dealt to Dorex2007 [4c Tc]
Dorex2007: folds 
Alex.Petrovskiy: raises $0.08 to $0.13
kramnoy.ivan: folds 
cz_Fox_cz: folds 
TheQuicksand: folds 
Uncalled bet ($0.08) returned to Alex.Petrovskiy
Alex.Petrovskiy collected $0.12 from pot
*** SUMMARY ***
Total pot $0.12 | Rake $0 
Seat 2: Alex.Petrovskiy collected ($0.12)
Seat 3: kramnoy.ivan (button) folded before Flop (didn't bet)
Seat 4: cz_Fox_cz (small blind) folded before Flop
Seat 6: TheQuicksand (big blind) folded before Flop
Seat 9: Dorex2007 folded before Flop (didn't bet)



PokerStars Hand #238669664917:  Hold'em No Limit ($0.02/$0.05 USD) - 2022/09/16 13:26:59 PT [2022/09/16 16:26:59 ET]
Table 'Hedera II' 9-max Seat #4 is the button
Seat 2: Alex.Petrovskiy ($8.23 in chips) 
Seat 3: kramnoy.ivan ($5.99 in chips) 
Seat 4: cz_Fox_cz ($4.85 in chips) 
Seat 6: TheQuicksand ($3.60 in chips) 
Seat 7: SzNorbert12 ($5 in chips) 
Seat 9: Dorex2007 ($5.23 in chips) 
TheQuicksand: posts small blind $0.02
SzNorbert12: posts big blind $0.05
*** HOLE CARDS ***
Dealt to Dorex2007 [Ts 3d]
Dorex2007: folds 
Alex.Petrovskiy: folds 
kramnoy.ivan: folds 
cz_Fox_cz: calls $0.05
TheQuicksand: folds 
SzNorbert12: checks 
*** FLOP *** [5d 2c Kc]
SzNorbert12: checks 
cz_Fox_cz: bets $0.05
SzNorbert12: folds 
Uncalled bet ($0.05) returned to cz_Fox_cz
cz_Fox_cz collected $0.12 from pot
*** SUMMARY ***
Total pot $0.12 | Rake $0 
Board [5d 2c Kc]
Seat 2: Alex.Petrovskiy folded before Flop (didn't bet)
Seat 3: kramnoy.ivan folded before Flop (didn't bet)
Seat 4: cz_Fox_cz (button) collected ($0.12)
Seat 6: TheQuicksand (small blind) folded before Flop
Seat 7: SzNorbert12 (big blind) folded on the Flop
Seat 9: Dorex2007 folded before Flop (didn't bet)



PokerStars Hand #238669675445:  Hold'em No Limit ($0.02/$0.05 USD) - 2022/09/16 13:27:22 PT [2022/09/16 16:27:22 ET]
Table 'Hedera II' 9-max Seat #6 is the button
Seat 2: Alex.Petrovskiy ($8.23 in chips) 
Seat 3: kramnoy.ivan ($5.99 in chips) 
Seat 4: cz_Fox_cz ($4.92 in chips) 
Seat 6: TheQuicksand ($3.58 in chips) 
Seat 7: SzNorbert12 ($5 in chips) 
Seat 9: Dorex2007 ($5.23 in chips) 
SzNorbert12: posts small blind $0.02
Dorex2007: posts big blind $0.05
*** HOLE CARDS ***
Dealt to Dorex2007 [Ts 9d]
Alex.Petrovskiy: folds 
kramnoy.ivan: raises $0.10 to $0.15
cz_Fox_cz: calls $0.15
TheQuicksand: calls $0.15
SzNorbert12: folds 
Dorex2007: folds 
*** FLOP *** [5c Th 2c]
kramnoy.ivan: bets $0.35
cz_Fox_cz: calls $0.35
TheQuicksand: calls $0.35
*** TURN *** [5c Th 2c] [Kh]
kramnoy.ivan: checks 
cz_Fox_cz: bets $0.25
TheQuicksand: calls $0.25
kramnoy.ivan: raises $0.50 to $0.75
cz_Fox_cz: calls $0.50
TheQuicksand: calls $0.50
*** RIVER *** [5c Th 2c Kh] [9s]
kramnoy.ivan: checks 
cz_Fox_cz: checks 
TheQuicksand: checks 
*** SHOW DOWN ***
kramnoy.ivan: shows [Jd Js] (a pair of Jacks)
cz_Fox_cz: shows [Qd Kc] (a pair of Kings)
TheQuicksand: mucks hand 
cz_Fox_cz collected $3.66 from pot
*** SUMMARY ***
Total pot $3.82 | Rake $0.16 
Board [5c Th 2c Kh 9s]
Seat 2: Alex.Petrovskiy folded before Flop (didn't bet)
Seat 3: kramnoy.ivan showed [Jd Js] and lost with a pair of Jacks
Seat 4: cz_Fox_cz showed [Qd Kc] and won ($3.66) with a pair of Kings
Seat 6: TheQuicksand (button) mucked [8d Ah]
Seat 7: SzNorbert12 (small blind) folded before Flop
Seat 9: Dorex2007 (big blind) folded before Flop



PokerStars Hand #238669703391:  Hold'em No Limit ($0.02/$0.05 USD) - 2022/09/16 13:28:25 PT [2022/09/16 16:28:25 ET]
Table 'Hedera II' 9-max Seat #7 is the button
Seat 2: Alex.Petrovskiy ($8.23 in chips) 
Seat 3: kramnoy.ivan ($4.74 in chips) 
Seat 4: cz_Fox_cz ($7.33 in chips) 
Seat 5: Lucases Ente ($9.01 in chips) 
Seat 6: TheQuicksand ($2.33 in chips) 
Seat 7: SzNorbert12 ($5 in chips) 
Seat 9: Dorex2007 ($5.18 in chips) 
Dorex2007: posts small blind $0.02
Alex.Petrovskiy: posts big blind $0.05
Lucases Ente: posts small & big blinds $0.07
*** HOLE CARDS ***
Dealt to Dorex2007 [Th 7c]
kramnoy.ivan: folds 
cz_Fox_cz: calls $0.05
Lucases Ente: checks 
TheQuicksand: folds 
TheQuicksand leaves the table
SzNorbert12: raises $0.17 to $0.22
Dorex2007: folds 
noraemon joins the table at seat #6 
Alex.Petrovskiy: calls $0.17
cz_Fox_cz: calls $0.17
Lucases Ente: folds 
*** FLOP *** [Kd 4c Jd]
Alex.Petrovskiy: checks 
cz_Fox_cz: checks 
SzNorbert12: bets $0.35
Alex.Petrovskiy: folds 
cz_Fox_cz: calls $0.35
*** TURN *** [Kd 4c Jd] [Ah]
cz_Fox_cz: checks 
SzNorbert12: checks 
*** RIVER *** [Kd 4c Jd Ah] [3d]
cz_Fox_cz: checks 
SzNorbert12: checks 
*** SHOW DOWN ***
cz_Fox_cz: shows [8c Kc] (a pair of Kings)
SzNorbert12: shows [Ac 2h] (a pair of Aces)
SzNorbert12 collected $1.39 from pot
*** SUMMARY ***
Total pot $1.45 | Rake $0.06 
Board [Kd 4c Jd Ah 3d]
Seat 2: Alex.Petrovskiy (big blind) folded on the Flop
Seat 3: kramnoy.ivan folded before Flop (didn't bet)
Seat 4: cz_Fox_cz showed [8c Kc] and lost with a pair of Kings
Seat 5: Lucases Ente folded before Flop (didn't bet)
Seat 6: TheQuicksand folded before Flop (didn't bet)
Seat 7: SzNorbert12 (button) showed [Ac 2h] and won ($1.39) with a pair of Aces
Seat 9: Dorex2007 (small blind) folded before Flop



PokerStars Hand #238669732929:  Hold'em No Limit ($0.02/$0.05 USD) - 2022/09/16 13:29:33 PT [2022/09/16 16:29:33 ET]
Table 'Hedera II' 9-max Seat #9 is the button
Seat 2: Alex.Petrovskiy ($8.01 in chips) 
Seat 3: kramnoy.ivan ($4.74 in chips) 
Seat 4: cz_Fox_cz ($6.76 in chips) 
Seat 5: Lucases Ente ($8.94 in chips) 
Seat 7: SzNorbert12 ($5.82 in chips) 
Seat 9: Dorex2007 ($5.16 in chips) 
Alex.Petrovskiy: posts small blind $0.02
kramnoy.ivan: posts big blind $0.05
noraemon: sits out 
*** HOLE CARDS ***
Dealt to Dorex2007 [Jd Jc]
cz_Fox_cz: folds 
Lucases Ente: calls $0.05
SzNorbert12: folds 
Dorex2007: raises $0.05 to $0.10
Alex.Petrovskiy: folds 
kramnoy.ivan: calls $0.05
Lucases Ente: calls $0.05
*** FLOP *** [3h 4s Qh]
kramnoy.ivan: checks 
Lucases Ente: checks 
Dorex2007: checks 
*** TURN *** [3h 4s Qh] [2c]
kramnoy.ivan: checks 
Lucases Ente: checks 
Dorex2007: checks 
*** RIVER *** [3h 4s Qh 2c] [6s]
kramnoy.ivan: checks 
Lucases Ente: checks 
Dorex2007: checks 
*** SHOW DOWN ***
kramnoy.ivan: shows [9c Kh] (high card King)
Lucases Ente: shows [2d As] (a pair of Deuces)
Dorex2007: shows [Jd Jc] (a pair of Jacks)
Dorex2007 collected $0.31 from pot
*** SUMMARY ***
Total pot $0.32 | Rake $0.01 
Board [3h 4s Qh 2c 6s]
Seat 2: Alex.Petrovskiy (small blind) folded before Flop
Seat 3: kramnoy.ivan (big blind) showed [9c Kh] and lost with high card King
Seat 4: cz_Fox_cz folded before Flop (didn't bet)
Seat 5: Lucases Ente showed [2d As] and lost with a pair of Deuces
Seat 7: SzNorbert12 folded before Flop (didn't bet)
Seat 9: Dorex2007 (button) showed [Jd Jc] and won ($0.31) with a pair of Jacks



PokerStars Hand #238669752855:  Hold'em No Limit ($0.02/$0.05 USD) - 2022/09/16 13:30:18 PT [2022/09/16 16:30:18 ET]
Table 'Hedera II' 9-max Seat #2 is the button
Seat 2: Alex.Petrovskiy ($7.99 in chips) 
Seat 3: kramnoy.ivan ($4.64 in chips) 
Seat 4: cz_Fox_cz ($6.76 in chips) 
Seat 5: Lucases Ente ($8.84 in chips) 
Seat 7: SzNorbert12 ($5.82 in chips) 
Seat 9: Dorex2007 ($5.37 in chips) 
kramnoy.ivan: posts small blind $0.02
cz_Fox_cz: posts big blind $0.05
noraemon: sits out 
*** HOLE CARDS ***
Dealt to Dorex2007 [9c Td]
Lucases Ente: calls $0.05
SzNorbert12: folds 
Dorex2007: folds 
Alex.Petrovskiy: folds 
kramnoy.ivan: folds 
cz_Fox_cz: checks 
*** FLOP *** [4h 8d 9s]
cz_Fox_cz: bets $0.05
Lucases Ente: calls $0.05
*** TURN *** [4h 8d 9s] [Tc]
cz_Fox_cz: checks 
Lucases Ente: checks 
*** RIVER *** [4h 8d 9s Tc] [Ad]
cz_Fox_cz: checks 
Lucases Ente: bets $0.10
cz_Fox_cz: calls $0.10
*** SHOW DOWN ***
Lucases Ente: shows [5h As] (a pair of Aces)
cz_Fox_cz: mucks hand 
Lucases Ente collected $0.40 from pot
*** SUMMARY ***
Total pot $0.42 | Rake $0.02 
Board [4h 8d 9s Tc Ad]
Seat 2: Alex.Petrovskiy (button) folded before Flop (didn't bet)
Seat 3: kramnoy.ivan (small blind) folded before Flop
Seat 4: cz_Fox_cz (big blind) mucked [3d Qc]
Seat 5: Lucases Ente showed [5h As] and won ($0.40) with a pair of Aces
Seat 7: SzNorbert12 folded before Flop (didn't bet)
Seat 9: Dorex2007 folded before Flop (didn't bet)



PokerStars Hand #238669766581:  Hold'em No Limit ($0.02/$0.05 USD) - 2022/09/16 13:30:49 PT [2022/09/16 16:30:49 ET]
Table 'Hedera II' 9-max Seat #3 is the button
Seat 2: Alex.Petrovskiy ($7.99 in chips) 
Seat 3: kramnoy.ivan ($4.62 in chips) 
Seat 4: cz_Fox_cz ($6.56 in chips) 
Seat 5: Lucases Ente ($9.04 in chips) 
Seat 7: SzNorbert12 ($5.82 in chips) 
Seat 9: Dorex2007 ($5.37 in chips) 
cz_Fox_cz: posts small blind $0.02
Lucases Ente: posts big blind $0.05
noraemon: sits out 
*** HOLE CARDS ***
Dealt to Dorex2007 [Qd 8s]
SzNorbert12: raises $0.10 to $0.15
Dorex2007: folds 
Alex.Petrovskiy: folds 
kramnoy.ivan: folds 
cz_Fox_cz: calls $0.13
Lucases Ente: folds 
*** FLOP *** [7s 9d 3s]
cz_Fox_cz: bets $0.05
SzNorbert12: raises $0.24 to $0.29
cz_Fox_cz: calls $0.24
*** TURN *** [7s 9d 3s] [Kc]
cz_Fox_cz: bets $0.05
SzNorbert12: raises $0.80 to $0.85
cz_Fox_cz: calls $0.80
*** RIVER *** [7s 9d 3s Kc] [6c]
cz_Fox_cz: checks 
SzNorbert12: checks 
*** SHOW DOWN ***
cz_Fox_cz: shows [8c 7c] (a pair of Sevens)
SzNorbert12: shows [Ad Ks] (a pair of Kings)
SzNorbert12 collected $2.52 from pot
*** SUMMARY ***
Total pot $2.63 | Rake $0.11 
Board [7s 9d 3s Kc 6c]
Seat 2: Alex.Petrovskiy folded before Flop (didn't bet)
Seat 3: kramnoy.ivan (button) folded before Flop (didn't bet)
Seat 4: cz_Fox_cz (small blind) showed [8c 7c] and lost with a pair of Sevens
Seat 5: Lucases Ente (big blind) folded before Flop
Seat 7: SzNorbert12 showed [Ad Ks] and won ($2.52) with a pair of Kings
Seat 9: Dorex2007 folded before Flop (didn't bet)



PokerStars Hand #238669786061:  Hold'em No Limit ($0.02/$0.05 USD) - 2022/09/16 13:31:33 PT [2022/09/16 16:31:33 ET]
Table 'Hedera II' 9-max Seat #4 is the button
Seat 2: Alex.Petrovskiy ($7.99 in chips) 
Seat 3: kramnoy.ivan ($4.62 in chips) 
Seat 4: cz_Fox_cz ($5.27 in chips) 
Seat 5: Lucases Ente ($8.99 in chips) 
Seat 6: noraemon ($5 in chips) 
Seat 7: SzNorbert12 ($7.05 in chips) 
Seat 9: Dorex2007 ($5.37 in chips) 
Lucases Ente: posts small blind $0.02
noraemon: posts big blind $0.05
*** HOLE CARDS ***
Dealt to Dorex2007 [Jd 6h]
SzNorbert12: folds 
Dorex2007: folds 
Alex.Petrovskiy: folds 
kramnoy.ivan: folds 
cz_Fox_cz: calls $0.05
Lucases Ente: raises $0.10 to $0.15
fiekoes leaves the table
noraemon: calls $0.10
cz_Fox_cz: calls $0.10
*** FLOP *** [8c 9s 4s]
Lucases Ente: checks 
noraemon: checks 
cz_Fox_cz: bets $0.05
Lucases Ente: calls $0.05
noraemon: folds 
*** TURN *** [8c 9s 4s] [3d]
Lucases Ente: checks 
cz_Fox_cz: checks 
*** RIVER *** [8c 9s 4s 3d] [9h]
Lucases Ente: checks 
cz_Fox_cz: checks 
*** SHOW DOWN ***
Lucases Ente: shows [Ah Th] (a pair of Nines)
cz_Fox_cz: shows [7d 7c] (two pair, Nines and Sevens)
cz_Fox_cz collected $0.53 from pot
*** SUMMARY ***
Total pot $0.55 | Rake $0.02 
Board [8c 9s 4s 3d 9h]
Seat 2: Alex.Petrovskiy folded before Flop (didn't bet)
Seat 3: kramnoy.ivan folded before Flop (didn't bet)
Seat 4: cz_Fox_cz (button) showed [7d 7c] and won ($0.53) with two pair, Nines and Sevens
Seat 5: Lucases Ente (small blind) showed [Ah Th] and lost with a pair of Nines
Seat 6: noraemon (big blind) folded on the Flop
Seat 7: SzNorbert12 folded before Flop (didn't bet)
Seat 9: Dorex2007 folded before Flop (didn't bet)



PokerStars Hand #238669804928:  Hold'em No Limit ($0.02/$0.05 USD) - 2022/09/16 13:32:15 PT [2022/09/16 16:32:15 ET]
Table 'Hedera II' 9-max Seat #5 is the button
Seat 2: Alex.Petrovskiy ($7.99 in chips) 
Seat 3: kramnoy.ivan ($4.62 in chips) 
Seat 4: cz_Fox_cz ($5.60 in chips) 
Seat 5: Lucases Ente ($8.79 in chips) 
Seat 6: noraemon ($5 in chips) 
Seat 7: SzNorbert12 ($7.05 in chips) 
Seat 9: Dorex2007 ($5.37 in chips) 
Yoyoppy joins the table at seat #8 
noraemon: posts small blind $0.02
SzNorbert12: posts big blind $0.05
BluffOnTable: sits out 
*** HOLE CARDS ***
Dealt to Dorex2007 [9d 6c]
Dorex2007: folds 
Alex.Petrovskiy: folds 
kramnoy.ivan: folds 
cz_Fox_cz: calls $0.05
Lucases Ente: folds 
noraemon: folds 
SzNorbert12: checks 
*** FLOP *** [Ah 3c 8h]
SzNorbert12: bets $0.07
cz_Fox_cz: calls $0.07
*** TURN *** [Ah 3c 8h] [4h]
SzNorbert12: bets $0.15
cz_Fox_cz: calls $0.15
*** RIVER *** [Ah 3c 8h 4h] [6h]
SzNorbert12: bets $0.41
cz_Fox_cz: raises $4.92 to $5.33 and is all-in
SzNorbert12: calls $4.92
*** SHOW DOWN ***
cz_Fox_cz: shows [Ad 4d] (two pair, Aces and Fours)
SzNorbert12: shows [Qh 8s] (a flush, Ace high)
SzNorbert12 collected $10.75 from pot
*** SUMMARY ***
Total pot $11.22 | Rake $0.47 
Board [Ah 3c 8h 4h 6h]
Seat 2: Alex.Petrovskiy folded before Flop (didn't bet)
Seat 3: kramnoy.ivan folded before Flop (didn't bet)
Seat 4: cz_Fox_cz showed [Ad 4d] and lost with two pair, Aces and Fours
Seat 5: Lucases Ente (button) folded before Flop (didn't bet)
Seat 6: noraemon (small blind) folded before Flop
Seat 7: SzNorbert12 (big blind) showed [Qh 8s] and won ($10.75) with a flush, Ace high
Seat 9: Dorex2007 folded before Flop (didn't bet)



PokerStars Hand #238669823809:  Hold'em No Limit ($0.02/$0.05 USD) - 2022/09/16 13:32:58 PT [2022/09/16 16:32:58 ET]
Table 'Hedera II' 9-max Seat #6 is the button
Seat 2: Alex.Petrovskiy ($7.99 in chips) 
Seat 3: kramnoy.ivan ($4.62 in chips) 
Seat 5: Lucases Ente ($8.79 in chips) 
Seat 6: noraemon ($5 in chips) 
Seat 7: SzNorbert12 ($12.20 in chips) 
Seat 8: Yoyoppy ($5 in chips) 
Seat 9: Dorex2007 ($5.37 in chips) 
SzNorbert12: posts small blind $0.02
Yoyoppy: posts big blind $0.05
BluffOnTable: sits out 
*** HOLE CARDS ***
Dealt to Dorex2007 [Kh 4s]
Dorex2007: folds 
Alex.Petrovskiy: folds 
kramnoy.ivan: raises $0.05 to $0.10
Lucases Ente: calls $0.10
noraemon: folds 
SzNorbert12: folds 
Yoyoppy: raises $0.50 to $0.60
kramnoy.ivan: calls $0.50
Lucases Ente: folds 
*** FLOP *** [7s 8s Tc]
Yoyoppy: bets $0.72
kramnoy.ivan: folds 
Uncalled bet ($0.72) returned to Yoyoppy
Yoyoppy collected $1.27 from pot
Yoyoppy: doesn't show hand 
cz_Fox_cz is disconnected 
*** SUMMARY ***
Total pot $1.32 | Rake $0.05 
Board [7s 8s Tc]
Seat 2: Alex.Petrovskiy folded before Flop (didn't bet)
Seat 3: kramnoy.ivan folded on the Flop
Seat 5: Lucases Ente folded before Flop
Seat 6: noraemon (button) folded before Flop (didn't bet)
Seat 7: SzNorbert12 (small blind) folded before Flop
Seat 8: Yoyoppy (big blind) collected ($1.27)
Seat 9: Dorex2007 folded before Flop (didn't bet)



PokerStars Hand #238669837919:  Hold'em No Limit ($0.02/$0.05 USD) - 2022/09/16 13:33:30 PT [2022/09/16 16:33:30 ET]
Table 'Hedera II' 9-max Seat #7 is the button
Seat 2: Alex.Petrovskiy ($7.99 in chips) 
Seat 3: kramnoy.ivan ($4.02 in chips) 
Seat 5: Lucases Ente ($8.69 in chips) 
Seat 6: noraemon ($5 in chips) 
Seat 7: SzNorbert12 ($12.18 in chips) 
Seat 8: Yoyoppy ($5.67 in chips) 
Seat 9: Dorex2007 ($5.37 in chips) 
Yoyoppy: posts small blind $0.02
Dorex2007: posts big blind $0.05
BluffOnTable: sits out 
*** HOLE CARDS ***
Dealt to Dorex2007 [8h 7s]
Alex.Petrovskiy: folds 
kramnoy.ivan: raises $0.05 to $0.10
Lucases Ente: folds 
noraemon: folds 
SzNorbert12: folds 
Yoyoppy: folds 
Dorex2007: folds 
Uncalled bet ($0.05) returned to kramnoy.ivan
kramnoy.ivan collected $0.12 from pot
*** SUMMARY ***
Total pot $0.12 | Rake $0 
Seat 2: Alex.Petrovskiy folded before Flop (didn't bet)
Seat 3: kramnoy.ivan collected ($0.12)
Seat 5: Lucases Ente folded before Flop (didn't bet)
Seat 6: noraemon folded before Flop (didn't bet)
Seat 7: SzNorbert12 (button) folded before Flop (didn't bet)
Seat 8: Yoyoppy (small blind) folded before Flop
Seat 9: Dorex2007 (big blind) folded before Flop



PokerStars Hand #238669844757:  Hold'em No Limit ($0.02/$0.05 USD) - 2022/09/16 13:33:45 PT [2022/09/16 16:33:45 ET]
Table 'Hedera II' 9-max Seat #8 is the button
Seat 1: BluffOnTable ($5.10 in chips) 
Seat 2: Alex.Petrovskiy ($7.99 in chips) 
Seat 3: kramnoy.ivan ($4.09 in chips) 
Seat 5: Lucases Ente ($8.69 in chips) 
Seat 6: noraemon ($5 in chips) 
Seat 7: SzNorbert12 ($12.18 in chips) 
Seat 8: Yoyoppy ($5.65 in chips) 
Seat 9: Dorex2007 ($5.32 in chips) 
Dorex2007: posts small blind $0.02
BluffOnTable: posts big blind $0.05
*** HOLE CARDS ***
Dealt to Dorex2007 [4s Ah]
Alex.Petrovskiy: folds 
kramnoy.ivan: folds 
Lucases Ente: folds 
noraemon: folds 
SzNorbert12: folds 
Yoyoppy: raises $0.07 to $0.12
Dorex2007: folds 
BluffOnTable: folds 
Uncalled bet ($0.07) returned to Yoyoppy
Yoyoppy collected $0.12 from pot
Yoyoppy: doesn't show hand 
*** SUMMARY ***
Total pot $0.12 | Rake $0 
Seat 1: BluffOnTable (big blind) folded before Flop
Seat 2: Alex.Petrovskiy folded before Flop (didn't bet)
Seat 3: kramnoy.ivan folded before Flop (didn't bet)
Seat 5: Lucases Ente folded before Flop (didn't bet)
Seat 6: noraemon folded before Flop (didn't bet)
Seat 7: SzNorbert12 folded before Flop (didn't bet)
Seat 8: Yoyoppy (button) collected ($0.12)
Seat 9: Dorex2007 (small blind) folded before Flop



PokerStars Hand #238669852672:  Hold'em No Limit ($0.02/$0.05 USD) - 2022/09/16 13:34:03 PT [2022/09/16 16:34:03 ET]
Table 'Hedera II' 9-max Seat #9 is the button
Seat 1: BluffOnTable ($5.05 in chips) 
Seat 3: kramnoy.ivan ($5 in chips) 
Seat 5: Lucases Ente ($8.69 in chips) 
Seat 6: noraemon ($5 in chips) 
Seat 7: SzNorbert12 ($12.18 in chips) 
Seat 8: Yoyoppy ($5.72 in chips) 
Seat 9: Dorex2007 ($5.30 in chips) 
BluffOnTable: posts small blind $0.02
Alex.Petrovskiy: is sitting out 
kramnoy.ivan: posts big blind $0.05
*** HOLE CARDS ***
Dealt to Dorex2007 [7c 6d]
Lucases Ente: raises $0.05 to $0.10
noraemon: folds 
SzNorbert12: calls $0.10
Yoyoppy: raises $0.37 to $0.47
Dorex2007: folds 
BluffOnTable: folds 
kramnoy.ivan: folds 
Lucases Ente: folds 
SzNorbert12: folds 
Uncalled bet ($0.37) returned to Yoyoppy
Yoyoppy collected $0.37 from pot
Yoyoppy: doesn't show hand 
*** SUMMARY ***
Total pot $0.37 | Rake $0 
Seat 1: BluffOnTable (small blind) folded before Flop
Seat 3: kramnoy.ivan (big blind) folded before Flop
Seat 5: Lucases Ente folded before Flop
Seat 6: noraemon folded before Flop (didn't bet)
Seat 7: SzNorbert12 folded before Flop
Seat 8: Yoyoppy collected ($0.37)
Seat 9: Dorex2007 (button) folded before Flop (didn't bet)



PokerStars Hand #238669865749:  Hold'em No Limit ($0.02/$0.05 USD) - 2022/09/16 13:34:32 PT [2022/09/16 16:34:32 ET]
Table 'Hedera II' 9-max Seat #1 is the button
Seat 1: BluffOnTable ($5.03 in chips) 
Seat 3: kramnoy.ivan ($4.95 in chips) 
Seat 5: Lucases Ente ($8.59 in chips) 
Seat 6: noraemon ($5 in chips) 
Seat 7: SzNorbert12 ($12.08 in chips) 
Seat 8: Yoyoppy ($5.99 in chips) 
Seat 9: Dorex2007 ($5.30 in chips) 
kramnoy.ivan: posts small blind $0.02
Lucases Ente: posts big blind $0.05
*** HOLE CARDS ***
Dealt to Dorex2007 [6h Jh]
noraemon: folds 
SzNorbert12: folds 
Yoyoppy: folds 
Dorex2007: folds 
BluffOnTable: folds 
kramnoy.ivan: calls $0.03
Lucases Ente: checks 
*** FLOP *** [9d Kh 2c]
kramnoy.ivan: checks 
Lucases Ente: checks 
*** TURN *** [9d Kh 2c] [7c]
kramnoy.ivan: checks 
Lucases Ente: checks 
*** RIVER *** [9d Kh 2c 7c] [5s]
kramnoy.ivan: checks 
Lucases Ente: checks 
*** SHOW DOWN ***
kramnoy.ivan: shows [6s Ad] (high card Ace)
Lucases Ente: mucks hand 
kramnoy.ivan collected $0.10 from pot
*** SUMMARY ***
Total pot $0.10 | Rake $0 
Board [9d Kh 2c 7c 5s]
Seat 1: BluffOnTable (button) folded before Flop (didn't bet)
Seat 3: kramnoy.ivan (small blind) showed [6s Ad] and won ($0.10) with high card Ace
Seat 5: Lucases Ente (big blind) mucked [Ah 3h]
Seat 6: noraemon folded before Flop (didn't bet)
Seat 7: SzNorbert12 folded before Flop (didn't bet)
Seat 8: Yoyoppy folded before Flop (didn't bet)
Seat 9: Dorex2007 folded before Flop (didn't bet)



PokerStars Hand #238669875344:  Hold'em No Limit ($0.02/$0.05 USD) - 2022/09/16 13:34:54 PT [2022/09/16 16:34:54 ET]
Table 'Hedera II' 9-max Seat #3 is the button
Seat 1: BluffOnTable ($5.03 in chips) 
Seat 3: kramnoy.ivan ($5 in chips) 
Seat 5: Lucases Ente ($8.54 in chips) 
Seat 6: noraemon ($5 in chips) 
Seat 7: SzNorbert12 ($12.08 in chips) 
Seat 8: Yoyoppy ($5.99 in chips) 
Seat 9: Dorex2007 ($5.30 in chips) 
Lucases Ente: posts small blind $0.02
noraemon: posts big blind $0.05
*** HOLE CARDS ***
Dealt to Dorex2007 [9s Kc]
SzNorbert12: folds 
Yoyoppy: folds 
Dorex2007: folds 
BluffOnTable: raises $0.10 to $0.15
kramnoy.ivan: folds 
Lucases Ente: calls $0.13
noraemon: folds 
*** FLOP *** [Jc Tc 6h]
Lucases Ente: checks 
BluffOnTable: checks 
*** TURN *** [Jc Tc 6h] [5c]
Lucases Ente: checks 
BluffOnTable: bets $0.23
Lucases Ente: folds 
Uncalled bet ($0.23) returned to BluffOnTable
BluffOnTable collected $0.34 from pot
BluffOnTable: doesn't show hand 
*** SUMMARY ***
Total pot $0.35 | Rake $0.01 
Board [Jc Tc 6h 5c]
Seat 1: BluffOnTable collected ($0.34)
Seat 3: kramnoy.ivan (button) folded before Flop (didn't bet)
Seat 5: Lucases Ente (small blind) folded on the Turn
Seat 6: noraemon (big blind) folded before Flop
Seat 7: SzNorbert12 folded before Flop (didn't bet)
Seat 8: Yoyoppy folded before Flop (didn't bet)
Seat 9: Dorex2007 folded before Flop (didn't bet)



PokerStars Hand #238669889860:  Hold'em No Limit ($0.02/$0.05 USD) - 2022/09/16 13:35:26 PT [2022/09/16 16:35:26 ET]
Table 'Hedera II' 9-max Seat #5 is the button
Seat 1: BluffOnTable ($5.22 in chips) 
Seat 3: kramnoy.ivan ($5 in chips) 
Seat 5: Lucases Ente ($8.39 in chips) 
Seat 6: noraemon ($5 in chips) 
Seat 8: Yoyoppy ($5.99 in chips) 
Seat 9: Dorex2007 ($5.30 in chips) 
noraemon: posts small blind $0.02
SzNorbert12: is sitting out 
Yoyoppy: posts big blind $0.05
*** HOLE CARDS ***
Dealt to Dorex2007 [3h Td]
SzNorbert12 leaves the table
Dorex2007: folds 
BluffOnTable: folds 
kramnoy.ivan: folds 
Lucases Ente: folds 
noraemon: raises $0.10 to $0.15
Yoyoppy: calls $0.10
*** FLOP *** [As Ad 4d]
noraemon: bets $0.11
Yoyoppy: calls $0.11
*** TURN *** [As Ad 4d] [Jh]
noraemon: checks 
Yoyoppy: bets $0.24
noraemon: calls $0.24
*** RIVER *** [As Ad 4d Jh] [7d]
noraemon: checks 
Yoyoppy: checks 
*** SHOW DOWN ***
noraemon: shows [Jc Qh] (two pair, Aces and Jacks)
Yoyoppy: shows [Ac 5c] (three of a kind, Aces)
Yoyoppy collected $0.96 from pot
*** SUMMARY ***
Total pot $1 | Rake $0.04 
Board [As Ad 4d Jh 7d]
Seat 1: BluffOnTable folded before Flop (didn't bet)
Seat 3: kramnoy.ivan folded before Flop (didn't bet)
Seat 5: Lucases Ente (button) folded before Flop (didn't bet)
Seat 6: noraemon (small blind) showed [Jc Qh] and lost with two pair, Aces and Jacks
Seat 8: Yoyoppy (big blind) showed [Ac 5c] and won ($0.96) with three of a kind, Aces
Seat 9: Dorex2007 folded before Flop (didn't bet)



PokerStars Hand #238669909315:  Hold'em No Limit ($0.02/$0.05 USD) - 2022/09/16 13:36:11 PT [2022/09/16 16:36:11 ET]
Table 'Hedera II' 9-max Seat #6 is the button
Seat 1: BluffOnTable ($5.22 in chips) 
Seat 3: kramnoy.ivan ($5 in chips) 
Seat 5: Lucases Ente ($8.39 in chips) 
Seat 6: noraemon ($5 in chips) 
Seat 8: Yoyoppy ($6.45 in chips) 
Seat 9: Dorex2007 ($5.30 in chips) 
Yoyoppy: posts small blind $0.02
Dorex2007: posts big blind $0.05
*** HOLE CARDS ***
Dealt to Dorex2007 [Ac Jc]
BluffOnTable: folds 
kramnoy.ivan: folds 
Lucases Ente: folds 
noraemon: folds 
Yoyoppy: folds 
Uncalled bet ($0.03) returned to Dorex2007
Dorex2007 collected $0.04 from pot
Dorex2007: doesn't show hand 
*** SUMMARY ***
Total pot $0.04 | Rake $0 
Seat 1: BluffOnTable folded before Flop (didn't bet)
Seat 3: kramnoy.ivan folded before Flop (didn't bet)
Seat 5: Lucases Ente folded before Flop (didn't bet)
Seat 6: noraemon (button) folded before Flop (didn't bet)
Seat 8: Yoyoppy (small blind) folded before Flop
Seat 9: Dorex2007 (big blind) collected ($0.04)



PokerStars Hand #238669915911:  Hold'em No Limit ($0.02/$0.05 USD) - 2022/09/16 13:36:26 PT [2022/09/16 16:36:26 ET]
Table 'Hedera II' 9-max Seat #8 is the button
Seat 1: BluffOnTable ($5.22 in chips) 
Seat 3: kramnoy.ivan ($5 in chips) 
Seat 5: Lucases Ente ($8.39 in chips) 
Seat 6: noraemon ($5 in chips) 
Seat 8: Yoyoppy ($6.43 in chips) 
Seat 9: Dorex2007 ($5.32 in chips) 
Dorex2007: posts small blind $0.02
BluffOnTable: posts big blind $0.05
*** HOLE CARDS ***
Dealt to Dorex2007 [8h Ad]
kramnoy.ivan: folds 
Lucases Ente: raises $0.05 to $0.10
noraemon: folds 
Yoyoppy: folds 
Dorex2007: calls $0.08
BluffOnTable: folds 
*** FLOP *** [8d 4d 9s]
HéStiA joins the table at seat #7 
Dorex2007: checks 
Lucases Ente: checks 
*** TURN *** [8d 4d 9s] [5s]
Dorex2007: checks 
Lucases Ente: checks 
*** RIVER *** [8d 4d 9s 5s] [8c]
Dorex2007: checks 
Lucases Ente: checks 
*** SHOW DOWN ***
Dorex2007: shows [8h Ad] (three of a kind, Eights)
Lucases Ente: mucks hand 
Dorex2007 collected $0.24 from pot
*** SUMMARY ***
Total pot $0.25 | Rake $0.01 
Board [8d 4d 9s 5s 8c]
Seat 1: BluffOnTable (big blind) folded before Flop
Seat 3: kramnoy.ivan folded before Flop (didn't bet)
Seat 5: Lucases Ente mucked [Ac Jd]
Seat 6: noraemon folded before Flop (didn't bet)
Seat 8: Yoyoppy (button) folded before Flop (didn't bet)
Seat 9: Dorex2007 (small blind) showed [8h Ad] and won ($0.24) with three of a kind, Eights



PokerStars Hand #238669933343:  Hold'em No Limit ($0.02/$0.05 USD) - 2022/09/16 13:37:05 PT [2022/09/16 16:37:05 ET]
Table 'Hedera II' 9-max Seat #9 is the button
Seat 1: BluffOnTable ($5.17 in chips) 
Seat 3: kramnoy.ivan ($5 in chips) 
Seat 5: Lucases Ente ($8.29 in chips) 
Seat 6: noraemon ($5 in chips) 
Seat 7: HéStiA ($5 in chips) 
Seat 8: Yoyoppy ($6.43 in chips) 
Seat 9: Dorex2007 ($5.46 in chips) 
BluffOnTable: posts small blind $0.02
kramnoy.ivan: posts big blind $0.05
HéStiA: posts big blind $0.05
*** HOLE CARDS ***
Dealt to Dorex2007 [Th Kd]
Lucases Ente: raises $0.05 to $0.10
noraemon: folds 
HéStiA: calls $0.05
Yoyoppy: folds 
Dorex2007: calls $0.10
BluffOnTable: calls $0.08
kramnoy.ivan: calls $0.05
*** FLOP *** [6s Td 6c]
BluffOnTable: checks 
kramnoy.ivan: bets $0.05
Lucases Ente: calls $0.05
HéStiA: folds 
Dorex2007: calls $0.05
BluffOnTable: calls $0.05
*** TURN *** [6s Td 6c] [6h]
BluffOnTable: bets $0.25
kramnoy.ivan: raises $0.49 to $0.74
Lucases Ente: folds 
Dorex2007: raises $4.57 to $5.31 and is all-in
BluffOnTable: folds 
kramnoy.ivan: calls $4.11 and is all-in
Uncalled bet ($0.46) returned to Dorex2007
*** RIVER *** [6s Td 6c 6h] [7h]
*** SHOW DOWN ***
kramnoy.ivan: shows [8h 8c] (a full house, Sixes full of Eights)
Dorex2007: shows [Th Kd] (a full house, Sixes full of Tens)
Dorex2007 cashed out the hand for $9.64 | Cash Out Fee $0.10
*** SUMMARY ***
Total pot $10.65 | Rake $0.44 
Board [6s Td 6c 6h 7h]
Seat 1: BluffOnTable (small blind) folded on the Turn
Seat 3: kramnoy.ivan (big blind) showed [8h 8c] and lost with a full house, Sixes full of Eights
Seat 5: Lucases Ente folded on the Turn
Seat 6: noraemon folded before Flop (didn't bet)
Seat 7: HéStiA folded on the Flop
Seat 8: Yoyoppy folded before Flop (didn't bet)
Seat 9: Dorex2007 (button) showed [Th Kd] and won ($10.21) with a full house, Sixes full of Tens (pot not awarded as player cashed out)



PokerStars Hand #238669978564:  Hold'em No Limit ($0.02/$0.05 USD) - 2022/09/16 13:38:48 PT [2022/09/16 16:38:48 ET]
Table 'Hedera II' 9-max Seat #1 is the button
Seat 1: BluffOnTable ($5 in chips) 
Seat 5: Lucases Ente ($8.14 in chips) 
Seat 6: noraemon ($5 in chips) 
Seat 7: HéStiA ($5 in chips) 
Seat 8: Yoyoppy ($6.43 in chips) 
Seat 9: Dorex2007 ($10.10 in chips) 
Lucases Ente: posts small blind $0.02
noraemon: posts big blind $0.05
*** HOLE CARDS ***
Dealt to Dorex2007 [Qh Ad]
HéStiA: folds 
Yoyoppy: folds 
Dorex2007: calls $0.05
BluffOnTable: calls $0.05
Lucases Ente: calls $0.03
noraemon: checks 
*** FLOP *** [9s Qs 9h]
Lucases Ente: checks 
noraemon: checks 
Dorex2007: bets $0.13
BluffOnTable: folds 
Lucases Ente: folds 
noraemon: calls $0.13
*** TURN *** [9s Qs 9h] [2c]
noraemon: checks 
Dorex2007: bets $0.29
noraemon: folds 
Uncalled bet ($0.29) returned to Dorex2007
Dorex2007 collected $0.44 from pot
Dorex2007: doesn't show hand 
*** SUMMARY ***
Total pot $0.46 | Rake $0.02 
Board [9s Qs 9h 2c]
Seat 1: BluffOnTable (button) folded on the Flop
Seat 5: Lucases Ente (small blind) folded on the Flop
Seat 6: noraemon (big blind) folded on the Turn
Seat 7: HéStiA folded before Flop (didn't bet)
Seat 8: Yoyoppy folded before Flop (didn't bet)
Seat 9: Dorex2007 collected ($0.44)



PokerStars Hand #238670000797:  Hold'em No Limit ($0.02/$0.05 USD) - 2022/09/16 13:39:39 PT [2022/09/16 16:39:39 ET]
Table 'Hedera II' 9-max Seat #5 is the button
Seat 1: BluffOnTable ($5 in chips) 
Seat 3: kramnoy.ivan ($5 in chips) 
Seat 5: Lucases Ente ($8.09 in chips) 
Seat 6: noraemon ($5 in chips) 
Seat 7: HéStiA ($5 in chips) 
Seat 8: Yoyoppy ($6.43 in chips) 
Seat 9: Dorex2007 ($10.36 in chips) 
noraemon: posts small blind $0.02
HéStiA: posts big blind $0.05
kramnoy.ivan: posts small blind $0.02
*** HOLE CARDS ***
Dealt to Dorex2007 [4d Kd]
Yoyoppy: folds 
Dorex2007: folds 
BluffOnTable: folds 
kramnoy.ivan: folds 
Lucases Ente: raises $0.05 to $0.10
noraemon: raises $0.30 to $0.40
HéStiA: folds 
Lucases Ente: folds 
Uncalled bet ($0.30) returned to noraemon
noraemon collected $0.27 from pot
noraemon: doesn't show hand 
*** SUMMARY ***
Total pot $0.27 | Rake $0 
Seat 1: BluffOnTable folded before Flop (didn't bet)
Seat 3: kramnoy.ivan folded before Flop (didn't bet)
Seat 5: Lucases Ente (button) folded before Flop
Seat 6: noraemon (small blind) collected ($0.27)
Seat 7: HéStiA (big blind) folded before Flop
Seat 8: Yoyoppy folded before Flop (didn't bet)
Seat 9: Dorex2007 folded before Flop (didn't bet)



PokerStars Hand #238670010093:  Hold'em No Limit ($0.02/$0.05 USD) - 2022/09/16 13:40:00 PT [2022/09/16 16:40:00 ET]
Table 'Hedera II' 9-max Seat #6 is the button
Seat 1: BluffOnTable ($5 in chips) 
Seat 3: kramnoy.ivan ($4.98 in chips) 
Seat 5: Lucases Ente ($7.99 in chips) 
Seat 6: noraemon ($5.17 in chips) 
Seat 7: HéStiA ($5 in chips) 
Seat 8: Yoyoppy ($6.43 in chips) 
Seat 9: Dorex2007 ($10.36 in chips) 
HéStiA: posts small blind $0.02
Yoyoppy: posts big blind $0.05
*** HOLE CARDS ***
Dealt to Dorex2007 [Jh As]
Dorex2007: calls $0.05
BluffOnTable: folds 
kramnoy.ivan: folds 
Lucases Ente: folds 
noraemon: folds 
HéStiA: calls $0.03
Yoyoppy: checks 
*** FLOP *** [Jc Kh Kc]
HéStiA: checks 
Yoyoppy: checks 
Dorex2007: bets $0.07
HéStiA: calls $0.07
Yoyoppy: folds 
*** TURN *** [Jc Kh Kc] [8c]
HéStiA: checks 
Dorex2007: checks 
*** RIVER *** [Jc Kh Kc 8c] [Td]
HéStiA: checks 
Dorex2007: checks 
*** SHOW DOWN ***
HéStiA: shows [Js 3s] (two pair, Kings and Jacks)
Dorex2007: shows [Jh As] (two pair, Kings and Jacks - Ace kicker)
Dorex2007 collected $0.28 from pot
*** SUMMARY ***
Total pot $0.29 | Rake $0.01 
Board [Jc Kh Kc 8c Td]
Seat 1: BluffOnTable folded before Flop (didn't bet)
Seat 3: kramnoy.ivan folded before Flop (didn't bet)
Seat 5: Lucases Ente folded before Flop (didn't bet)
Seat 6: noraemon (button) folded before Flop (didn't bet)
Seat 7: HéStiA (small blind) showed [Js 3s] and lost with two pair, Kings and Jacks
Seat 8: Yoyoppy (big blind) folded on the Flop
Seat 9: Dorex2007 showed [Jh As] and won ($0.28) with two pair, Kings and Jacks



PokerStars Hand #238670034208:  Hold'em No Limit ($0.02/$0.05 USD) - 2022/09/16 13:40:56 PT [2022/09/16 16:40:56 ET]
Table 'Hedera II' 9-max Seat #7 is the button
Seat 1: BluffOnTable ($5 in chips) 
Seat 3: kramnoy.ivan ($4.98 in chips) 
Seat 5: Lucases Ente ($7.99 in chips) 
Seat 6: noraemon ($5.17 in chips) 
Seat 7: HéStiA ($5 in chips) 
Seat 8: Yoyoppy ($6.38 in chips) 
Seat 9: Dorex2007 ($10.52 in chips) 
Yoyoppy: posts small blind $0.02
Dorex2007: posts big blind $0.05
*** HOLE CARDS ***
Dealt to Dorex2007 [7d 2c]
BluffOnTable: folds 
kramnoy.ivan: raises $0.20 to $0.25
Lucases Ente: folds 
noraemon: folds 
HéStiA: raises $0.50 to $0.75
Yoyoppy: folds 
Dorex2007: folds 
kramnoy.ivan: raises $4.23 to $4.98 and is all-in
HéStiA: folds 
Uncalled bet ($4.23) returned to kramnoy.ivan
kramnoy.ivan collected $1.57 from pot
*** SUMMARY ***
Total pot $1.57 | Rake $0 
Seat 1: BluffOnTable folded before Flop (didn't bet)
Seat 3: kramnoy.ivan collected ($1.57)
Seat 5: Lucases Ente folded before Flop (didn't bet)
Seat 6: noraemon folded before Flop (didn't bet)
Seat 7: HéStiA (button) folded before Flop
Seat 8: Yoyoppy (small blind) folded before Flop
Seat 9: Dorex2007 (big blind) folded before Flop



PokerStars Hand #238670050867:  Hold'em No Limit ($0.02/$0.05 USD) - 2022/09/16 13:41:35 PT [2022/09/16 16:41:35 ET]
Table 'Hedera II' 9-max Seat #8 is the button
Seat 1: BluffOnTable ($5 in chips) 
Seat 3: kramnoy.ivan ($5.80 in chips) 
Seat 5: Lucases Ente ($7.99 in chips) 
Seat 6: noraemon ($5.17 in chips) 
Seat 7: HéStiA ($5 in chips) 
Seat 8: Yoyoppy ($6.36 in chips) 
Seat 9: Dorex2007 ($10.47 in chips) 
Dorex2007: posts small blind $0.02
BluffOnTable: posts big blind $0.05
*** HOLE CARDS ***
Dealt to Dorex2007 [2d Qd]
kramnoy.ivan: raises $0.05 to $0.10
Lucases Ente: folds 
noraemon: folds 
HéStiA: folds 
Yoyoppy: folds 
Dorex2007: folds 
BluffOnTable: calls $0.05
*** FLOP *** [5d Ac Jd]
BluffOnTable: checks 
kramnoy.ivan: bets $0.10
BluffOnTable: folds 
Uncalled bet ($0.10) returned to kramnoy.ivan
kramnoy.ivan collected $0.21 from pot
*** SUMMARY ***
Total pot $0.22 | Rake $0.01 
Board [5d Ac Jd]
Seat 1: BluffOnTable (big blind) folded on the Flop
Seat 3: kramnoy.ivan collected ($0.21)
Seat 5: Lucases Ente folded before Flop (didn't bet)
Seat 6: noraemon folded before Flop (didn't bet)
Seat 7: HéStiA folded before Flop (didn't bet)
Seat 8: Yoyoppy (button) folded before Flop (didn't bet)
Seat 9: Dorex2007 (small blind) folded before Flop



PokerStars Hand #238670062890:  Hold'em No Limit ($0.02/$0.05 USD) - 2022/09/16 13:42:02 PT [2022/09/16 16:42:02 ET]
Table 'Hedera II' 9-max Seat #9 is the button
Seat 1: BluffOnTable ($5 in chips) 
Seat 3: kramnoy.ivan ($5.91 in chips) 
Seat 5: Lucases Ente ($7.99 in chips) 
Seat 6: noraemon ($5.17 in chips) 
Seat 7: HéStiA ($5 in chips) 
Seat 8: Yoyoppy ($6.36 in chips) 
Seat 9: Dorex2007 ($10.45 in chips) 
BluffOnTable: posts small blind $0.02
kramnoy.ivan: posts big blind $0.05
*** HOLE CARDS ***
Dealt to Dorex2007 [Kd 5c]
Lucases Ente: folds 
noraemon: folds 
HéStiA: folds 
Yoyoppy: folds 
Dorex2007: folds 
BluffOnTable: calls $0.03
kramnoy.ivan: checks 
*** FLOP *** [Td 6d Ah]
BluffOnTable: checks 
kramnoy.ivan: bets $0.05
BluffOnTable: calls $0.05
*** TURN *** [Td 6d Ah] [Jd]
BluffOnTable: checks 
kramnoy.ivan: bets $0.05
BluffOnTable: raises $4.85 to $4.90 and is all-in
kramnoy.ivan: folds 
Uncalled bet ($4.85) returned to BluffOnTable
BluffOnTable collected $0.29 from pot
BluffOnTable: doesn't show hand 
*** SUMMARY ***
Total pot $0.30 | Rake $0.01 
Board [Td 6d Ah Jd]
Seat 1: BluffOnTable (small blind) collected ($0.29)
Seat 3: kramnoy.ivan (big blind) folded on the Turn
Seat 5: Lucases Ente folded before Flop (didn't bet)
Seat 6: noraemon folded before Flop (didn't bet)
Seat 7: HéStiA folded before Flop (didn't bet)
Seat 8: Yoyoppy folded before Flop (didn't bet)
Seat 9: Dorex2007 (button) folded before Flop (didn't bet)



PokerStars Hand #238670081391:  Hold'em No Limit ($0.02/$0.05 USD) - 2022/09/16 13:42:45 PT [2022/09/16 16:42:45 ET]
Table 'Hedera II' 9-max Seat #1 is the button
Seat 1: BluffOnTable ($5.14 in chips) 
Seat 3: kramnoy.ivan ($5.76 in chips) 
Seat 5: Lucases Ente ($7.99 in chips) 
Seat 6: noraemon ($5.17 in chips) 
Seat 7: HéStiA ($5 in chips) 
Seat 8: Yoyoppy ($6.36 in chips) 
Seat 9: Dorex2007 ($10.45 in chips) 
kramnoy.ivan: posts small blind $0.02
Lucases Ente: posts big blind $0.05
*** HOLE CARDS ***
Dealt to Dorex2007 [8s Kh]
noraemon: folds 
HéStiA: folds 
Yoyoppy: folds 
Dorex2007: folds 
BluffOnTable: folds 
kramnoy.ivan: calls $0.03
Lucases Ente: checks 
*** FLOP *** [2h 5h Js]
kramnoy.ivan: checks 
Lucases Ente: checks 
*** TURN *** [2h 5h Js] [7s]
kramnoy.ivan: checks 
Lucases Ente: checks 
*** RIVER *** [2h 5h Js 7s] [7h]
kramnoy.ivan: checks 
Lucases Ente: checks 
*** SHOW DOWN ***
kramnoy.ivan: shows [5s 6s] (two pair, Sevens and Fives)
Lucases Ente: mucks hand 
kramnoy.ivan collected $0.10 from pot
*** SUMMARY ***
Total pot $0.10 | Rake $0 
Board [2h 5h Js 7s 7h]
Seat 1: BluffOnTable (button) folded before Flop (didn't bet)
Seat 3: kramnoy.ivan (small blind) showed [5s 6s] and won ($0.10) with two pair, Sevens and Fives
Seat 5: Lucases Ente (big blind) mucked [Td 8d]
Seat 6: noraemon folded before Flop (didn't bet)
Seat 7: HéStiA folded before Flop (didn't bet)
Seat 8: Yoyoppy folded before Flop (didn't bet)
Seat 9: Dorex2007 folded before Flop (didn't bet)



PokerStars Hand #238670091530:  Hold'em No Limit ($0.02/$0.05 USD) - 2022/09/16 13:43:09 PT [2022/09/16 16:43:09 ET]
Table 'Hedera II' 9-max Seat #3 is the button
Seat 1: BluffOnTable ($5.14 in chips) 
Seat 3: kramnoy.ivan ($5.81 in chips) 
Seat 5: Lucases Ente ($7.94 in chips) 
Seat 6: noraemon ($5.17 in chips) 
Seat 7: HéStiA ($5 in chips) 
Seat 8: Yoyoppy ($6.36 in chips) 
Seat 9: Dorex2007 ($10.45 in chips) 
Lucases Ente: posts small blind $0.02
noraemon: posts big blind $0.05
*** HOLE CARDS ***
Dealt to Dorex2007 [8s Th]
HéStiA: raises $0.07 to $0.12
Yoyoppy: calls $0.12
Dorex2007: folds 
BluffOnTable: folds 
kramnoy.ivan: folds 
Lucases Ente: folds 
cz_Fox_cz leaves the table
noraemon: folds 
*** FLOP *** [8d 8h 6c]
HéStiA: bets $0.15
Yoyoppy: folds 
Uncalled bet ($0.15) returned to HéStiA
HéStiA collected $0.30 from pot
*** SUMMARY ***
Total pot $0.31 | Rake $0.01 
Board [8d 8h 6c]
Seat 1: BluffOnTable folded before Flop (didn't bet)
Seat 3: kramnoy.ivan (button) folded before Flop (didn't bet)
Seat 5: Lucases Ente (small blind) folded before Flop
Seat 6: noraemon (big blind) folded before Flop
Seat 7: HéStiA collected ($0.30)
Seat 8: Yoyoppy folded on the Flop
Seat 9: Dorex2007 folded before Flop (didn't bet)



PokerStars Hand #238670104109:  Hold'em No Limit ($0.02/$0.05 USD) - 2022/09/16 13:43:38 PT [2022/09/16 16:43:38 ET]
Table 'Hedera II' 9-max Seat #5 is the button
Seat 1: BluffOnTable ($5.14 in chips) 
Seat 3: kramnoy.ivan ($5.81 in chips) 
Seat 5: Lucases Ente ($7.92 in chips) 
Seat 6: noraemon ($5.12 in chips) 
Seat 7: HéStiA ($5.18 in chips) 
Seat 8: Yoyoppy ($6.24 in chips) 
Seat 9: Dorex2007 ($10.45 in chips) 
noraemon: posts small blind $0.02
HéStiA: posts big blind $0.05
*** HOLE CARDS ***
Dealt to Dorex2007 [Jd As]
Yoyoppy: folds 
Dorex2007: raises $0.05 to $0.10
BluffOnTable: folds 
kramnoy.ivan: calls $0.10
Lucases Ente: folds 
noraemon: folds 
HéStiA: calls $0.05
*** FLOP *** [9d Kc Ac]
HéStiA: checks 
Dorex2007: bets $0.15
zbig-u joins the table at seat #4 
kramnoy.ivan: folds 
HéStiA: folds 
Uncalled bet ($0.15) returned to Dorex2007
Dorex2007 collected $0.31 from pot
Dorex2007: doesn't show hand 
*** SUMMARY ***
Total pot $0.32 | Rake $0.01 
Board [9d Kc Ac]
Seat 1: BluffOnTable folded before Flop (didn't bet)
Seat 3: kramnoy.ivan folded on the Flop
Seat 5: Lucases Ente (button) folded before Flop (didn't bet)
Seat 6: noraemon (small blind) folded before Flop
Seat 7: HéStiA (big blind) folded on the Flop
Seat 8: Yoyoppy folded before Flop (didn't bet)
Seat 9: Dorex2007 collected ($0.31)



PokerStars Hand #238670119341:  Hold'em No Limit ($0.02/$0.05 USD) - 2022/09/16 13:44:14 PT [2022/09/16 16:44:14 ET]
Table 'Hedera II' 9-max Seat #6 is the button
Seat 1: BluffOnTable ($5.14 in chips) 
Seat 3: kramnoy.ivan ($5.71 in chips) 
Seat 5: Lucases Ente ($7.92 in chips) 
Seat 6: noraemon ($5.10 in chips) 
Seat 7: HéStiA ($5.08 in chips) 
Seat 8: Yoyoppy ($6.24 in chips) 
Seat 9: Dorex2007 ($10.66 in chips) 
HéStiA: posts small blind $0.02
Yoyoppy: posts big blind $0.05
Alex.Petrovskiy: sits out 
zbig-u: sits out 
*** HOLE CARDS ***
Dealt to Dorex2007 [Js As]
Dorex2007: raises $0.05 to $0.10
BluffOnTable: folds 
kramnoy.ivan: calls $0.10
Lucases Ente: folds 
noraemon: folds 
HéStiA: raises $0.65 to $0.75
Yoyoppy: folds 
Dorex2007: folds 
kramnoy.ivan: folds 
Uncalled bet ($0.65) returned to HéStiA
HéStiA collected $0.35 from pot
*** SUMMARY ***
Total pot $0.35 | Rake $0 
Seat 1: BluffOnTable folded before Flop (didn't bet)
Seat 3: kramnoy.ivan folded before Flop
Seat 5: Lucases Ente folded before Flop (didn't bet)
Seat 6: noraemon (button) folded before Flop (didn't bet)
Seat 7: HéStiA (small blind) collected ($0.35)
Seat 8: Yoyoppy (big blind) folded before Flop
Seat 9: Dorex2007 folded before Flop



PokerStars Hand #238670133041:  Hold'em No Limit ($0.02/$0.05 USD) - 2022/09/16 13:44:46 PT [2022/09/16 16:44:46 ET]
Table 'Hedera II' 9-max Seat #7 is the button
Seat 1: BluffOnTable ($5.14 in chips) 
Seat 3: kramnoy.ivan ($5.61 in chips) 
Seat 5: Lucases Ente ($7.92 in chips) 
Seat 6: noraemon ($5.10 in chips) 
Seat 7: HéStiA ($5.33 in chips) 
Seat 8: Yoyoppy ($6.19 in chips) 
Seat 9: Dorex2007 ($10.56 in chips) 
Yoyoppy: posts small blind $0.02
Dorex2007: posts big blind $0.05
Alex.Petrovskiy: sits out 
zbig-u: sits out 
*** HOLE CARDS ***
Dealt to Dorex2007 [7h 5s]
BluffOnTable: folds 
kramnoy.ivan: folds 
Lucases Ente: folds 
noraemon: folds 
HéStiA: folds 
Yoyoppy: raises $0.09 to $0.14
Dorex2007: folds 
Uncalled bet ($0.09) returned to Yoyoppy
Yoyoppy collected $0.10 from pot
Yoyoppy: doesn't show hand 
*** SUMMARY ***
Total pot $0.10 | Rake $0 
Seat 1: BluffOnTable folded before Flop (didn't bet)
Seat 3: kramnoy.ivan folded before Flop (didn't bet)
Seat 5: Lucases Ente folded before Flop (didn't bet)
Seat 6: noraemon folded before Flop (didn't bet)
Seat 7: HéStiA (button) folded before Flop (didn't bet)
Seat 8: Yoyoppy (small blind) collected ($0.10)
Seat 9: Dorex2007 (big blind) folded before Flop



PokerStars Hand #238670139084:  Hold'em No Limit ($0.02/$0.05 USD) - 2022/09/16 13:45:00 PT [2022/09/16 16:45:00 ET]
Table 'Hedera II' 9-max Seat #8 is the button
Seat 1: BluffOnTable ($5.14 in chips) 
Seat 3: kramnoy.ivan ($5.61 in chips) 
Seat 5: Lucases Ente ($7.92 in chips) 
Seat 6: noraemon ($5.10 in chips) 
Seat 7: HéStiA ($5.33 in chips) 
Seat 8: Yoyoppy ($6.24 in chips) 
Seat 9: Dorex2007 ($10.51 in chips) 
Dorex2007: posts small blind $0.02
BluffOnTable: posts big blind $0.05
Alex.Petrovskiy: sits out 
zbig-u: sits out 
*** HOLE CARDS ***
Dealt to Dorex2007 [Td Kh]
kramnoy.ivan: raises $0.05 to $0.10
Lucases Ente: folds 
noraemon: folds 
HéStiA: folds 
Yoyoppy: folds 
Dorex2007: folds 
BluffOnTable: raises $0.35 to $0.45
kramnoy.ivan: calls $0.35
*** FLOP *** [5d 3d 8s]
BluffOnTable: bets $4.69 and is all-in
kramnoy.ivan: folds 
Uncalled bet ($4.69) returned to BluffOnTable
BluffOnTable collected $0.88 from pot
BluffOnTable: doesn't show hand 
*** SUMMARY ***
Total pot $0.92 | Rake $0.04 
Board [5d 3d 8s]
Seat 1: BluffOnTable (big blind) collected ($0.88)
Seat 3: kramnoy.ivan folded on the Flop
Seat 5: Lucases Ente folded before Flop (didn't bet)
Seat 6: noraemon folded before Flop (didn't bet)
Seat 7: HéStiA folded before Flop (didn't bet)
Seat 8: Yoyoppy (button) folded before Flop (didn't bet)
Seat 9: Dorex2007 (small blind) folded before Flop



PokerStars Hand #238670150843:  Hold'em No Limit ($0.02/$0.05 USD) - 2022/09/16 13:45:28 PT [2022/09/16 16:45:28 ET]
Table 'Hedera II' 9-max Seat #9 is the button
Seat 1: BluffOnTable ($5.57 in chips) 
Seat 2: Alex.Petrovskiy ($7.99 in chips) 
Seat 3: kramnoy.ivan ($5.16 in chips) 
Seat 5: Lucases Ente ($7.92 in chips) 
Seat 6: noraemon ($5.10 in chips) 
Seat 7: HéStiA ($5.33 in chips) 
Seat 8: Yoyoppy ($6.24 in chips) 
Seat 9: Dorex2007 ($10.49 in chips) 
BluffOnTable: posts small blind $0.02
Alex.Petrovskiy: posts big blind $0.05
zbig-u: sits out 
*** HOLE CARDS ***
Dealt to Dorex2007 [2s Tc]
kramnoy.ivan: folds 
Lucases Ente: raises $0.10 to $0.15
noraemon: folds 
HéStiA: calls $0.15
Yoyoppy: folds 
Dorex2007: folds 
BluffOnTable: folds 
Alex.Petrovskiy: folds 
*** FLOP *** [7s 9h 2h]
Lucases Ente: bets $0.10
HéStiA: calls $0.10
*** TURN *** [7s 9h 2h] [5d]
Lucases Ente: bets $0.15
HéStiA: calls $0.15
*** RIVER *** [7s 9h 2h 5d] [3s]
Lucases Ente: checks 
HéStiA: checks 
*** SHOW DOWN ***
Lucases Ente: shows [Js Ts] (high card Jack)
HéStiA: shows [Ac Qd] (high card Ace)
HéStiA collected $0.83 from pot
*** SUMMARY ***
Total pot $0.87 | Rake $0.04 
Board [7s 9h 2h 5d 3s]
Seat 1: BluffOnTable (small blind) folded before Flop
Seat 2: Alex.Petrovskiy (big blind) folded before Flop
Seat 3: kramnoy.ivan folded before Flop (didn't bet)
Seat 5: Lucases Ente showed [Js Ts] and lost with high card Jack
Seat 6: noraemon folded before Flop (didn't bet)
Seat 7: HéStiA showed [Ac Qd] and won ($0.83) with high card Ace
Seat 8: Yoyoppy folded before Flop (didn't bet)
Seat 9: Dorex2007 (button) folded before Flop (didn't bet)



PokerStars Hand #238670165227:  Hold'em No Limit ($0.02/$0.05 USD) - 2022/09/16 13:46:01 PT [2022/09/16 16:46:01 ET]
Table 'Hedera II' 9-max Seat #1 is the button
Seat 1: BluffOnTable ($5.55 in chips) 
Seat 2: Alex.Petrovskiy ($7.94 in chips) 
Seat 3: kramnoy.ivan ($5.16 in chips) 
Seat 5: Lucases Ente ($7.52 in chips) 
Seat 6: noraemon ($5.10 in chips) 
Seat 7: HéStiA ($5.76 in chips) 
Seat 8: Yoyoppy ($6.24 in chips) 
Seat 9: Dorex2007 ($10.49 in chips) 
Alex.Petrovskiy: posts small blind $0.02
kramnoy.ivan: posts big blind $0.05
zbig-u: sits out 
*** HOLE CARDS ***
Dealt to Dorex2007 [3h 5s]
Lucases Ente: folds 
noraemon: folds 
HéStiA: folds 
Yoyoppy: folds 
Dorex2007: folds 
BluffOnTable: folds 
Alex.Petrovskiy: raises $0.08 to $0.13
kramnoy.ivan: folds 
Uncalled bet ($0.08) returned to Alex.Petrovskiy
Alex.Petrovskiy collected $0.10 from pot
*** SUMMARY ***
Total pot $0.10 | Rake $0 
Seat 1: BluffOnTable (button) folded before Flop (didn't bet)
Seat 2: Alex.Petrovskiy (small blind) collected ($0.10)
Seat 3: kramnoy.ivan (big blind) folded before Flop
Seat 5: Lucases Ente folded before Flop (didn't bet)
Seat 6: noraemon folded before Flop (didn't bet)
Seat 7: HéStiA folded before Flop (didn't bet)
Seat 8: Yoyoppy folded before Flop (didn't bet)
Seat 9: Dorex2007 folded before Flop (didn't bet)



PokerStars Hand #238670173443:  Hold'em No Limit ($0.02/$0.05 USD) - 2022/09/16 13:46:20 PT [2022/09/16 16:46:20 ET]
Table 'Hedera II' 9-max Seat #2 is the button
Seat 1: BluffOnTable ($5.55 in chips) 
Seat 2: Alex.Petrovskiy ($7.99 in chips) 
Seat 3: kramnoy.ivan ($5.11 in chips) 
Seat 4: zbig-u ($5 in chips) 
Seat 5: Lucases Ente ($7.52 in chips) 
Seat 6: noraemon ($5.10 in chips) 
Seat 7: HéStiA ($5.76 in chips) 
Seat 8: Yoyoppy ($6.24 in chips) 
Seat 9: Dorex2007 ($10.49 in chips) 
kramnoy.ivan: posts small blind $0.02
zbig-u: posts big blind $0.05
*** HOLE CARDS ***
Dealt to Dorex2007 [5d 4s]
Lucases Ente: calls $0.05
noraemon: folds 
HéStiA: folds 
Yoyoppy: folds 
Dorex2007: folds 
BluffOnTable: folds 
Alex.Petrovskiy: folds 
kramnoy.ivan: calls $0.03
zbig-u: checks 
*** FLOP *** [Qh Th 9h]
kramnoy.ivan: checks 
zbig-u: checks 
Lucases Ente: bets $0.15
kramnoy.ivan: folds 
zbig-u: folds 
Uncalled bet ($0.15) returned to Lucases Ente
Lucases Ente collected $0.14 from pot
*** SUMMARY ***
Total pot $0.15 | Rake $0.01 
Board [Qh Th 9h]
Seat 1: BluffOnTable folded before Flop (didn't bet)
Seat 2: Alex.Petrovskiy (button) folded before Flop (didn't bet)
Seat 3: kramnoy.ivan (small blind) folded on the Flop
Seat 4: zbig-u (big blind) folded on the Flop
Seat 5: Lucases Ente collected ($0.14)
Seat 6: noraemon folded before Flop (didn't bet)
Seat 7: HéStiA folded before Flop (didn't bet)
Seat 8: Yoyoppy folded before Flop (didn't bet)
Seat 9: Dorex2007 folded before Flop (didn't bet)



PokerStars Hand #238670187523:  Hold'em No Limit ($0.02/$0.05 USD) - 2022/09/16 13:46:53 PT [2022/09/16 16:46:53 ET]
Table 'Hedera II' 9-max Seat #3 is the button
Seat 1: BluffOnTable ($5.55 in chips) 
Seat 2: Alex.Petrovskiy ($7.99 in chips) 
Seat 3: kramnoy.ivan ($5.06 in chips) 
Seat 4: zbig-u ($5 in chips) 
Seat 5: Lucases Ente ($7.61 in chips) 
Seat 6: noraemon ($5.10 in chips) 
Seat 7: HéStiA ($5.76 in chips) 
Seat 8: Yoyoppy ($6.24 in chips) 
Seat 9: Dorex2007 ($10.49 in chips) 
zbig-u: posts small blind $0.02
Lucases Ente: posts big blind $0.05
*** HOLE CARDS ***
Dealt to Dorex2007 [7s 6c]
noraemon: folds 
HéStiA: raises $0.07 to $0.12
Yoyoppy: folds 
Dorex2007: folds 
BluffOnTable: folds 
Alex.Petrovskiy: folds 
kramnoy.ivan: folds 
zbig-u: folds 
Lucases Ente: calls $0.07
*** FLOP *** [As 9c 6s]
Lucases Ente: checks 
HéStiA: bets $0.12
Lucases Ente: calls $0.12
*** TURN *** [As 9c 6s] [7h]
Lucases Ente: checks 
HéStiA: bets $0.24
Lucases Ente: folds 
Uncalled bet ($0.24) returned to HéStiA
HéStiA collected $0.48 from pot
*** SUMMARY ***
Total pot $0.50 | Rake $0.02 
Board [As 9c 6s 7h]
Seat 1: BluffOnTable folded before Flop (didn't bet)
Seat 2: Alex.Petrovskiy folded before Flop (didn't bet)
Seat 3: kramnoy.ivan (button) folded before Flop (didn't bet)
Seat 4: zbig-u (small blind) folded before Flop
Seat 5: Lucases Ente (big blind) folded on the Turn
Seat 6: noraemon folded before Flop (didn't bet)
Seat 7: HéStiA collected ($0.48)
Seat 8: Yoyoppy folded before Flop (didn't bet)
Seat 9: Dorex2007 folded before Flop (didn't bet)



PokerStars Hand #238670203237:  Hold'em No Limit ($0.02/$0.05 USD) - 2022/09/16 13:47:29 PT [2022/09/16 16:47:29 ET]
Table 'Hedera II' 9-max Seat #4 is the button
Seat 1: BluffOnTable ($5.55 in chips) 
Seat 2: Alex.Petrovskiy ($7.99 in chips) 
Seat 3: kramnoy.ivan ($5.06 in chips) 
Seat 4: zbig-u ($5 in chips) 
Seat 5: Lucases Ente ($7.37 in chips) 
Seat 6: noraemon ($5.10 in chips) 
Seat 7: HéStiA ($6 in chips) 
Seat 8: Yoyoppy ($6.24 in chips) 
Seat 9: Dorex2007 ($10.49 in chips) 
Lucases Ente: posts small blind $0.02
noraemon: posts big blind $0.05
*** HOLE CARDS ***
Dealt to Dorex2007 [5h 7h]
HéStiA: folds 
Yoyoppy: folds 
Dorex2007: folds 
BluffOnTable: folds 
Alex.Petrovskiy: folds 
kramnoy.ivan: raises $0.05 to $0.10
zbig-u: folds 
Lucases Ente: folds 
noraemon: calls $0.05
*** FLOP *** [6h As Jc]
noraemon: checks 
kramnoy.ivan: bets $0.10
noraemon: folds 
Uncalled bet ($0.10) returned to kramnoy.ivan
kramnoy.ivan collected $0.21 from pot
*** SUMMARY ***
Total pot $0.22 | Rake $0.01 
Board [6h As Jc]
Seat 1: BluffOnTable folded before Flop (didn't bet)
Seat 2: Alex.Petrovskiy folded before Flop (didn't bet)
Seat 3: kramnoy.ivan collected ($0.21)
Seat 4: zbig-u (button) folded before Flop (didn't bet)
Seat 5: Lucases Ente (small blind) folded before Flop
Seat 6: noraemon (big blind) folded on the Flop
Seat 7: HéStiA folded before Flop (didn't bet)
Seat 8: Yoyoppy folded before Flop (didn't bet)
Seat 9: Dorex2007 folded before Flop (didn't bet)



PokerStars Hand #238670219136:  Hold'em No Limit ($0.02/$0.05 USD) - 2022/09/16 13:48:06 PT [2022/09/16 16:48:06 ET]
Table 'Hedera II' 9-max Seat #5 is the button
Seat 1: BluffOnTable ($5.55 in chips) 
Seat 2: Alex.Petrovskiy ($7.99 in chips) 
Seat 3: kramnoy.ivan ($5.17 in chips) 
Seat 4: zbig-u ($5 in chips) 
Seat 5: Lucases Ente ($7.35 in chips) 
Seat 6: noraemon ($5 in chips) 
Seat 7: HéStiA ($6 in chips) 
Seat 8: Yoyoppy ($6.24 in chips) 
Seat 9: Dorex2007 ($10.49 in chips) 
noraemon: posts small blind $0.02
HéStiA: posts big blind $0.05
*** HOLE CARDS ***
Dealt to Dorex2007 [8c 3s]
Yoyoppy: folds 
Dorex2007: folds 
BluffOnTable: raises $0.10 to $0.15
Alex.Petrovskiy: folds 
kramnoy.ivan: calls $0.15
zbig-u: folds 
Lucases Ente: folds 
noraemon: folds 
HéStiA: calls $0.10
*** FLOP *** [7s 4d Jh]
HéStiA: checks 
BluffOnTable: bets $0.20
kramnoy.ivan: calls $0.20
HéStiA: calls $0.20
*** TURN *** [7s 4d Jh] [4h]
HéStiA: checks 
BluffOnTable: bets $0.45
kramnoy.ivan: calls $0.45
HéStiA: folds 
*** RIVER *** [7s 4d Jh 4h] [4s]
BluffOnTable: checks 
kramnoy.ivan: bets $1.89
BluffOnTable: calls $1.89
*** SHOW DOWN ***
kramnoy.ivan: shows [Ad Jc] (a full house, Fours full of Jacks)
BluffOnTable: shows [Qs Qc] (a full house, Fours full of Queens)
BluffOnTable collected $5.51 from pot
*** SUMMARY ***
Total pot $5.75 | Rake $0.24 
Board [7s 4d Jh 4h 4s]
Seat 1: BluffOnTable showed [Qs Qc] and won ($5.51) with a full house, Fours full of Queens
Seat 2: Alex.Petrovskiy folded before Flop (didn't bet)
Seat 3: kramnoy.ivan showed [Ad Jc] and lost with a full house, Fours full of Jacks
Seat 4: zbig-u folded before Flop (didn't bet)
Seat 5: Lucases Ente (button) folded before Flop (didn't bet)
Seat 6: noraemon (small blind) folded before Flop
Seat 7: HéStiA (big blind) folded on the Turn
Seat 8: Yoyoppy folded before Flop (didn't bet)
Seat 9: Dorex2007 folded before Flop (didn't bet)



PokerStars Hand #238670249247:  Hold'em No Limit ($0.02/$0.05 USD) - 2022/09/16 13:49:16 PT [2022/09/16 16:49:16 ET]
Table 'Hedera II' 9-max Seat #6 is the button
Seat 1: BluffOnTable ($8.37 in chips) 
Seat 2: Alex.Petrovskiy ($7.99 in chips) 
Seat 3: kramnoy.ivan ($2.48 in chips) 
Seat 4: zbig-u ($5 in chips) 
Seat 5: Lucases Ente ($7.35 in chips) 
Seat 6: noraemon ($5 in chips) 
Seat 7: HéStiA ($5.65 in chips) 
Seat 8: Yoyoppy ($6.24 in chips) 
Seat 9: Dorex2007 ($10.49 in chips) 
HéStiA: posts small blind $0.02
Yoyoppy: posts big blind $0.05
*** HOLE CARDS ***
Dealt to Dorex2007 [2c Jh]
Dorex2007: folds 
BluffOnTable: folds 
Alex.Petrovskiy: raises $0.10 to $0.15
kramnoy.ivan: folds 
zbig-u: folds 
Lucases Ente is disconnected 
Lucases Ente is connected 
Lucases Ente has timed out
Lucases Ente: folds 
noraemon: folds 
HéStiA: folds 
Yoyoppy: folds 
Uncalled bet ($0.10) returned to Alex.Petrovskiy
Alex.Petrovskiy collected $0.12 from pot
*** SUMMARY ***
Total pot $0.12 | Rake $0 
Seat 1: BluffOnTable folded before Flop (didn't bet)
Seat 2: Alex.Petrovskiy collected ($0.12)
Seat 3: kramnoy.ivan folded before Flop (didn't bet)
Seat 4: zbig-u folded before Flop (didn't bet)
Seat 5: Lucases Ente folded before Flop (didn't bet)
Seat 6: noraemon (button) folded before Flop (didn't bet)
Seat 7: HéStiA (small blind) folded before Flop
Seat 8: Yoyoppy (big blind) folded before Flop
Seat 9: Dorex2007 folded before Flop (didn't bet)



PokerStars Hand #238670267696:  Hold'em No Limit ($0.02/$0.05 USD) - 2022/09/16 13:50:00 PT [2022/09/16 16:50:00 ET]
Table 'Hedera II' 9-max Seat #7 is the button
Seat 1: BluffOnTable ($8.37 in chips) 
Seat 2: Alex.Petrovskiy ($8.06 in chips) 
Seat 3: kramnoy.ivan ($5 in chips) 
Seat 4: zbig-u ($5 in chips) 
Seat 5: Lucases Ente ($7.35 in chips) 
Seat 6: noraemon ($5 in chips) 
Seat 7: HéStiA ($5.63 in chips) 
Seat 8: Yoyoppy ($6.19 in chips) 
Seat 9: Dorex2007 ($10.49 in chips) 
Yoyoppy: posts small blind $0.02
Dorex2007: posts big blind $0.05
*** HOLE CARDS ***
Dealt to Dorex2007 [Jh 7c]
BluffOnTable: folds 
Alex.Petrovskiy: folds 
kramnoy.ivan: raises $0.05 to $0.10
zbig-u: folds 
Lucases Ente: folds 
noraemon: folds 
HéStiA: folds 
Yoyoppy: folds 
Dorex2007: folds 
Uncalled bet ($0.05) returned to kramnoy.ivan
kramnoy.ivan collected $0.12 from pot
*** SUMMARY ***
Total pot $0.12 | Rake $0 
Seat 1: BluffOnTable folded before Flop (didn't bet)
Seat 2: Alex.Petrovskiy folded before Flop (didn't bet)
Seat 3: kramnoy.ivan collected ($0.12)
Seat 4: zbig-u folded before Flop (didn't bet)
Seat 5: Lucases Ente folded before Flop (didn't bet)
Seat 6: noraemon folded before Flop (didn't bet)
Seat 7: HéStiA (button) folded before Flop (didn't bet)
Seat 8: Yoyoppy (small blind) folded before Flop
Seat 9: Dorex2007 (big blind) folded before Flop



PokerStars Hand #238670273738:  Hold'em No Limit ($0.02/$0.05 USD) - 2022/09/16 13:50:14 PT [2022/09/16 16:50:14 ET]
Table 'Hedera II' 9-max Seat #8 is the button
Seat 1: BluffOnTable ($8.37 in chips) 
Seat 2: Alex.Petrovskiy ($8.06 in chips) 
Seat 3: kramnoy.ivan ($5.07 in chips) 
Seat 4: zbig-u ($5 in chips) 
Seat 5: Lucases Ente ($7.35 in chips) 
Seat 6: noraemon ($5 in chips) 
Seat 7: HéStiA ($5.63 in chips) 
Seat 8: Yoyoppy ($6.17 in chips) 
Seat 9: Dorex2007 ($10.44 in chips) 
Dorex2007: posts small blind $0.02
BluffOnTable: posts big blind $0.05
*** HOLE CARDS ***
Dealt to Dorex2007 [7h Tc]
Alex.Petrovskiy: folds 
kramnoy.ivan: raises $0.05 to $0.10
zbig-u: calls $0.10
Lucases Ente: folds 
noraemon: folds 
HéStiA: folds 
Yoyoppy: folds 
Dorex2007: folds 
BluffOnTable: folds 
*** FLOP *** [9d 4d Ts]
kramnoy.ivan: checks 
zbig-u: checks 
*** TURN *** [9d 4d Ts] [8d]
kramnoy.ivan: bets $0.13
zbig-u: folds 
Uncalled bet ($0.13) returned to kramnoy.ivan
kramnoy.ivan collected $0.26 from pot
*** SUMMARY ***
Total pot $0.27 | Rake $0.01 
Board [9d 4d Ts 8d]
Seat 1: BluffOnTable (big blind) folded before Flop
Seat 2: Alex.Petrovskiy folded before Flop (didn't bet)
Seat 3: kramnoy.ivan collected ($0.26)
Seat 4: zbig-u folded on the Turn
Seat 5: Lucases Ente folded before Flop (didn't bet)
Seat 6: noraemon folded before Flop (didn't bet)
Seat 7: HéStiA folded before Flop (didn't bet)
Seat 8: Yoyoppy (button) folded before Flop (didn't bet)
Seat 9: Dorex2007 (small blind) folded before Flop



PokerStars Hand #238670292118:  Hold'em No Limit ($0.02/$0.05 USD) - 2022/09/16 13:50:57 PT [2022/09/16 16:50:57 ET]
Table 'Hedera II' 9-max Seat #9 is the button
Seat 1: BluffOnTable ($8.32 in chips) 
Seat 2: Alex.Petrovskiy ($8.06 in chips) 
Seat 3: kramnoy.ivan ($5.23 in chips) 
Seat 4: zbig-u ($5 in chips) 
Seat 5: Lucases Ente ($7.35 in chips) 
Seat 6: noraemon ($5 in chips) 
Seat 7: HéStiA ($5.63 in chips) 
Seat 8: Yoyoppy ($6.17 in chips) 
Seat 9: Dorex2007 ($10.42 in chips) 
BluffOnTable: posts small blind $0.02
Alex.Petrovskiy: posts big blind $0.05
*** HOLE CARDS ***
Dealt to Dorex2007 [7s Jc]
kramnoy.ivan: folds 
zbig-u: folds 
Lucases Ente: calls $0.05
noraemon: folds 
HéStiA: calls $0.05
Yoyoppy: folds 
Dorex2007: folds 
BluffOnTable: calls $0.03
Alex.Petrovskiy: raises $0.25 to $0.30
Lucases Ente: folds 
HéStiA: calls $0.25
BluffOnTable: folds 
*** FLOP *** [8h Th 7c]
Alex.Petrovskiy: checks 
HéStiA: bets $0.33
Alex.Petrovskiy: calls $0.33
*** TURN *** [8h Th 7c] [5d]
Alex.Petrovskiy: checks 
HéStiA: bets $0.65
Alex.Petrovskiy: folds 
Uncalled bet ($0.65) returned to HéStiA
HéStiA collected $1.30 from pot
*** SUMMARY ***
Total pot $1.36 | Rake $0.06 
Board [8h Th 7c 5d]
Seat 1: BluffOnTable (small blind) folded before Flop
Seat 2: Alex.Petrovskiy (big blind) folded on the Turn
Seat 3: kramnoy.ivan folded before Flop (didn't bet)
Seat 4: zbig-u folded before Flop (didn't bet)
Seat 5: Lucases Ente folded before Flop
Seat 6: noraemon folded before Flop (didn't bet)
Seat 7: HéStiA collected ($1.30)
Seat 8: Yoyoppy folded before Flop (didn't bet)
Seat 9: Dorex2007 (button) folded before Flop (didn't bet)



PokerStars Hand #238670312662:  Hold'em No Limit ($0.02/$0.05 USD) - 2022/09/16 13:51:46 PT [2022/09/16 16:51:46 ET]
Table 'Hedera II' 9-max Seat #1 is the button
Seat 1: BluffOnTable ($8.27 in chips) 
Seat 2: Alex.Petrovskiy ($7.43 in chips) 
Seat 3: kramnoy.ivan ($5.23 in chips) 
Seat 4: zbig-u ($5 in chips) 
Seat 5: Lucases Ente ($7.30 in chips) 
Seat 6: noraemon ($5 in chips) 
Seat 7: HéStiA ($6.30 in chips) 
Seat 8: Yoyoppy ($6.17 in chips) 
Seat 9: Dorex2007 ($10.42 in chips) 
Alex.Petrovskiy: posts small blind $0.02
kramnoy.ivan: posts big blind $0.05
*** HOLE CARDS ***
Dealt to Dorex2007 [Qh 3h]
zbig-u: folds 
Lucases Ente: folds 
noraemon: folds 
HéStiA: folds 
Yoyoppy: folds 
Dorex2007: folds 
BluffOnTable has timed out
BluffOnTable: folds 
Alex.Petrovskiy: folds 
Uncalled bet ($0.03) returned to kramnoy.ivan
kramnoy.ivan collected $0.04 from pot
*** SUMMARY ***
Total pot $0.04 | Rake $0 
Seat 1: BluffOnTable (button) folded before Flop (didn't bet)
Seat 2: Alex.Petrovskiy (small blind) folded before Flop
Seat 3: kramnoy.ivan (big blind) collected ($0.04)
Seat 4: zbig-u folded before Flop (didn't bet)
Seat 5: Lucases Ente folded before Flop (didn't bet)
Seat 6: noraemon folded before Flop (didn't bet)
Seat 7: HéStiA folded before Flop (didn't bet)
Seat 8: Yoyoppy folded before Flop (didn't bet)
Seat 9: Dorex2007 folded before Flop (didn't bet)



PokerStars Hand #238670326025:  Hold'em No Limit ($0.02/$0.05 USD) - 2022/09/16 13:52:17 PT [2022/09/16 16:52:17 ET]
Table 'Hedera II' 9-max Seat #2 is the button
Seat 2: Alex.Petrovskiy ($7.41 in chips) 
Seat 3: kramnoy.ivan ($5.25 in chips) 
Seat 4: zbig-u ($5 in chips) 
Seat 5: Lucases Ente ($7.30 in chips) 
Seat 6: noraemon ($5 in chips) 
Seat 7: HéStiA ($6.30 in chips) 
Seat 8: Yoyoppy ($6.17 in chips) 
Seat 9: Dorex2007 ($10.42 in chips) 
kramnoy.ivan: posts small blind $0.02
zbig-u: posts big blind $0.05
*** HOLE CARDS ***
Dealt to Dorex2007 [Kc 7s]
Lucases Ente is disconnected 
Lucases Ente has timed out while being disconnected
Lucases Ente: folds 
noraemon: folds 
HéStiA: folds 
Yoyoppy: folds 
Dorex2007: folds 
Alex.Petrovskiy: raises $0.08 to $0.13
kramnoy.ivan: folds 
zbig-u: folds 
Uncalled bet ($0.08) returned to Alex.Petrovskiy
Alex.Petrovskiy collected $0.12 from pot
*** SUMMARY ***
Total pot $0.12 | Rake $0 
Seat 2: Alex.Petrovskiy (button) collected ($0.12)
Seat 3: kramnoy.ivan (small blind) folded before Flop
Seat 4: zbig-u (big blind) folded before Flop
Seat 5: Lucases Ente folded before Flop (didn't bet)
Seat 6: noraemon folded before Flop (didn't bet)
Seat 7: HéStiA folded before Flop (didn't bet)
Seat 8: Yoyoppy folded before Flop (didn't bet)
Seat 9: Dorex2007 folded before Flop (didn't bet)



PokerStars Hand #238670342662:  Hold'em No Limit ($0.02/$0.05 USD) - 2022/09/16 13:52:57 PT [2022/09/16 16:52:57 ET]
Table 'Hedera II' 9-max Seat #3 is the button
Seat 2: Alex.Petrovskiy ($7.48 in chips) 
Seat 3: kramnoy.ivan ($5.23 in chips) 
Seat 4: zbig-u ($5 in chips) 
Seat 6: noraemon ($5 in chips) 
Seat 7: HéStiA ($6.30 in chips) 
Seat 8: Yoyoppy ($6.17 in chips) 
Seat 9: Dorex2007 ($10.42 in chips) 
zbig-u: posts small blind $0.02
noraemon: posts big blind $0.05
*** HOLE CARDS ***
Dealt to Dorex2007 [6s 4s]
HéStiA: raises $0.07 to $0.12
Yoyoppy: folds 
Dorex2007: folds 
Alex.Petrovskiy: folds 
kramnoy.ivan: folds 
zbig-u: folds 
noraemon: folds 
Uncalled bet ($0.07) returned to HéStiA
HéStiA collected $0.12 from pot
*** SUMMARY ***
Total pot $0.12 | Rake $0 
Seat 2: Alex.Petrovskiy folded before Flop (didn't bet)
Seat 3: kramnoy.ivan (button) folded before Flop (didn't bet)
Seat 4: zbig-u (small blind) folded before Flop
Seat 6: noraemon (big blind) folded before Flop
Seat 7: HéStiA collected ($0.12)
Seat 8: Yoyoppy folded before Flop (didn't bet)
Seat 9: Dorex2007 folded before Flop (didn't bet)



PokerStars Hand #238670349418:  Hold'em No Limit ($0.02/$0.05 USD) - 2022/09/16 13:53:13 PT [2022/09/16 16:53:13 ET]
Table 'Hedera II' 9-max Seat #4 is the button
Seat 1: BluffOnTable ($8.27 in chips) 
Seat 2: Alex.Petrovskiy ($7.48 in chips) 
Seat 3: kramnoy.ivan ($5.23 in chips) 
Seat 4: zbig-u ($5 in chips) 
Seat 6: noraemon ($5 in chips) 
Seat 7: HéStiA ($6.37 in chips) 
Seat 8: Yoyoppy ($6.17 in chips) 
Seat 9: Dorex2007 ($10.42 in chips) 
noraemon: posts small blind $0.02
HéStiA: posts big blind $0.05
*** HOLE CARDS ***
Dealt to Dorex2007 [Jd 9c]
Yoyoppy: folds 
Dorex2007: folds 
BluffOnTable: folds 
Alex.Petrovskiy: folds 
kramnoy.ivan: folds 
zbig-u: folds 
noraemon: raises $0.10 to $0.15
HéStiA: calls $0.10
*** FLOP *** [5c Jc Kh]
noraemon: bets $0.11
HéStiA: calls $0.11
*** TURN *** [5c Jc Kh] [Qh]
noraemon: checks 
HéStiA: bets $0.25
noraemon: folds 
Uncalled bet ($0.25) returned to HéStiA
HéStiA collected $0.50 from pot
*** SUMMARY ***
Total pot $0.52 | Rake $0.02 
Board [5c Jc Kh Qh]
Seat 1: BluffOnTable folded before Flop (didn't bet)
Seat 2: Alex.Petrovskiy folded before Flop (didn't bet)
Seat 3: kramnoy.ivan folded before Flop (didn't bet)
Seat 4: zbig-u (button) folded before Flop (didn't bet)
Seat 6: noraemon (small blind) folded on the Turn
Seat 7: HéStiA (big blind) collected ($0.50)
Seat 8: Yoyoppy folded before Flop (didn't bet)
Seat 9: Dorex2007 folded before Flop (didn't bet)



PokerStars Hand #238670362997:  Hold'em No Limit ($0.02/$0.05 USD) - 2022/09/16 13:53:45 PT [2022/09/16 16:53:45 ET]
Table 'Hedera II' 9-max Seat #6 is the button
Seat 1: BluffOnTable ($8.27 in chips) 
Seat 2: Alex.Petrovskiy ($7.48 in chips) 
Seat 3: kramnoy.ivan ($5.23 in chips) 
Seat 4: zbig-u ($5 in chips) 
Seat 5: Lucases Ente ($7.30 in chips) 
Seat 6: noraemon ($5 in chips) 
Seat 7: HéStiA ($6.61 in chips) 
Seat 8: Yoyoppy ($6.17 in chips) 
Seat 9: Dorex2007 ($10.42 in chips) 
HéStiA: posts small blind $0.02
Yoyoppy: posts big blind $0.05
Lucases Ente: posts small & big blinds $0.07
*** HOLE CARDS ***
Dealt to Dorex2007 [5s Kc]
Dorex2007: folds 
BluffOnTable: folds 
Alex.Petrovskiy: raises $0.15 to $0.20
kramnoy.ivan: folds 
zbig-u: folds 
Lucases Ente: folds 
noraemon: folds 
HéStiA: folds 
Yoyoppy: folds 
Uncalled bet ($0.15) returned to Alex.Petrovskiy
Alex.Petrovskiy collected $0.19 from pot
*** SUMMARY ***
Total pot $0.19 | Rake $0 
Seat 1: BluffOnTable folded before Flop (didn't bet)
Seat 2: Alex.Petrovskiy collected ($0.19)
Seat 3: kramnoy.ivan folded before Flop (didn't bet)
Seat 4: zbig-u folded before Flop (didn't bet)
Seat 5: Lucases Ente folded before Flop (didn't bet)
Seat 6: noraemon (button) folded before Flop (didn't bet)
Seat 7: HéStiA (small blind) folded before Flop
Seat 8: Yoyoppy (big blind) folded before Flop
Seat 9: Dorex2007 folded before Flop (didn't bet)



PokerStars Hand #238670377690:  Hold'em No Limit ($0.02/$0.05 USD) - 2022/09/16 13:54:20 PT [2022/09/16 16:54:20 ET]
Table 'Hedera II' 9-max Seat #7 is the button
Seat 1: BluffOnTable ($8.27 in chips) 
Seat 2: Alex.Petrovskiy ($7.62 in chips) 
Seat 3: kramnoy.ivan ($5.23 in chips) 
Seat 4: zbig-u ($5 in chips) 
Seat 5: Lucases Ente ($7.23 in chips) 
Seat 6: noraemon ($5 in chips) 
Seat 7: HéStiA ($6.59 in chips) 
Seat 8: Yoyoppy ($6.12 in chips) 
Seat 9: Dorex2007 ($10.42 in chips) 
Yoyoppy: posts small blind $0.02
Dorex2007: posts big blind $0.05
*** HOLE CARDS ***
Dealt to Dorex2007 [5d 8s]
BluffOnTable: raises $0.10 to $0.15
Alex.Petrovskiy: folds 
kramnoy.ivan: folds 
zbig-u: folds 
Lucases Ente: calls $0.15
noraemon: folds 
HéStiA: calls $0.15
Yoyoppy: folds 
Dorex2007: folds 
*** FLOP *** [Tc 5h 7d]
BluffOnTable: checks 
Lucases Ente: checks 
HéStiA: bets $0.25
BluffOnTable: folds 
Lucases Ente: folds 
Uncalled bet ($0.25) returned to HéStiA
HéStiA collected $0.50 from pot
*** SUMMARY ***
Total pot $0.52 | Rake $0.02 
Board [Tc 5h 7d]
Seat 1: BluffOnTable folded on the Flop
Seat 2: Alex.Petrovskiy folded before Flop (didn't bet)
Seat 3: kramnoy.ivan folded before Flop (didn't bet)
Seat 4: zbig-u folded before Flop (didn't bet)
Seat 5: Lucases Ente folded on the Flop
Seat 6: noraemon folded before Flop (didn't bet)
Seat 7: HéStiA (button) collected ($0.50)
Seat 8: Yoyoppy (small blind) folded before Flop
Seat 9: Dorex2007 (big blind) folded before Flop



PokerStars Hand #238670389167:  Hold'em No Limit ($0.02/$0.05 USD) - 2022/09/16 13:54:47 PT [2022/09/16 16:54:47 ET]
Table 'Hedera II' 9-max Seat #8 is the button
Seat 1: BluffOnTable ($8.12 in chips) 
Seat 2: Alex.Petrovskiy ($7.62 in chips) 
Seat 3: kramnoy.ivan ($5.23 in chips) 
Seat 4: zbig-u ($5 in chips) 
Seat 5: Lucases Ente ($7.08 in chips) 
Seat 6: noraemon ($5 in chips) 
Seat 7: HéStiA ($6.94 in chips) 
Seat 8: Yoyoppy ($6.10 in chips) 
Seat 9: Dorex2007 ($10.37 in chips) 
Dorex2007: posts small blind $0.02
BluffOnTable: posts big blind $0.05
*** HOLE CARDS ***
Dealt to Dorex2007 [As Tc]
Alex.Petrovskiy: folds 
kramnoy.ivan: raises $0.10 to $0.15
zbig-u: folds 
Lucases Ente: folds 
noraemon: folds 
HéStiA: folds 
Yoyoppy: folds 
Dorex2007: calls $0.13
BluffOnTable: folds 
*** FLOP *** [5d 9c 8c]
Dorex2007: checks 
kramnoy.ivan: bets $0.17
Dorex2007: calls $0.17
*** TURN *** [5d 9c 8c] [7s]
Dorex2007: checks 
kramnoy.ivan: bets $0.33
Dorex2007: calls $0.33
*** RIVER *** [5d 9c 8c 7s] [Ts]
Dorex2007: bets $0.86
kramnoy.ivan: raises $3.72 to $4.58 and is all-in
Dorex2007: folds 
Uncalled bet ($3.72) returned to kramnoy.ivan
kramnoy.ivan collected $2.94 from pot
*** SUMMARY ***
Total pot $3.07 | Rake $0.13 
Board [5d 9c 8c 7s Ts]
Seat 1: BluffOnTable (big blind) folded before Flop
Seat 2: Alex.Petrovskiy folded before Flop (didn't bet)
Seat 3: kramnoy.ivan collected ($2.94)
Seat 4: zbig-u folded before Flop (didn't bet)
Seat 5: Lucases Ente folded before Flop (didn't bet)
Seat 6: noraemon folded before Flop (didn't bet)
Seat 7: HéStiA folded before Flop (didn't bet)
Seat 8: Yoyoppy (button) folded before Flop (didn't bet)
Seat 9: Dorex2007 (small blind) folded on the River



PokerStars Hand #238670407132:  Hold'em No Limit ($0.02/$0.05 USD) - 2022/09/16 13:55:38 PT [2022/09/16 16:55:38 ET]
Table 'Hedera II' 9-max Seat #9 is the button
Seat 1: BluffOnTable ($8.07 in chips) 
Seat 2: Alex.Petrovskiy ($7.62 in chips) 
Seat 3: kramnoy.ivan ($6.66 in chips) 
Seat 4: zbig-u ($5 in chips) 
Seat 5: Lucases Ente ($7.08 in chips) 
Seat 6: noraemon ($5 in chips) 
Seat 7: HéStiA ($6.94 in chips) 
Seat 8: Yoyoppy ($6.10 in chips) 
Seat 9: Dorex2007 ($8.86 in chips) 
BluffOnTable: posts small blind $0.02
Alex.Petrovskiy: posts big blind $0.05
*** HOLE CARDS ***
Dealt to Dorex2007 [8c Jc]
kramnoy.ivan: calls $0.05
zbig-u: folds 
Lucases Ente has timed out
Lucases Ente: folds 
noraemon: folds 
HéStiA: folds 
Yoyoppy: folds 
Dorex2007: folds 
BluffOnTable: calls $0.03
Alex.Petrovskiy: checks 
*** FLOP *** [Ad As Qc]
BluffOnTable: checks 
Alex.Petrovskiy: checks 
Lucases Ente is disconnected 
kramnoy.ivan: checks 
*** TURN *** [Ad As Qc] [3d]
BluffOnTable: checks 
Alex.Petrovskiy: checks 
kramnoy.ivan: bets $0.14
BluffOnTable: folds 
Alex.Petrovskiy: folds 
Uncalled bet ($0.14) returned to kramnoy.ivan
kramnoy.ivan collected $0.14 from pot
*** SUMMARY ***
Total pot $0.15 | Rake $0.01 
Board [Ad As Qc 3d]
Seat 1: BluffOnTable (small blind) folded on the Turn
Seat 2: Alex.Petrovskiy (big blind) folded on the Turn
Seat 3: kramnoy.ivan collected ($0.14)
Seat 4: zbig-u folded before Flop (didn't bet)
Seat 5: Lucases Ente folded before Flop (didn't bet)
Seat 6: noraemon folded before Flop (didn't bet)
Seat 7: HéStiA folded before Flop (didn't bet)
Seat 8: Yoyoppy folded before Flop (didn't bet)
Seat 9: Dorex2007 (button) folded before Flop (didn't bet)



PokerStars Hand #238670426811:  Hold'em No Limit ($0.02/$0.05 USD) - 2022/09/16 13:56:46 PT [2022/09/16 16:56:46 ET]
Table 'Hedera II' 9-max Seat #1 is the button
Seat 1: BluffOnTable ($8.02 in chips) 
Seat 2: Alex.Petrovskiy ($7.57 in chips) 
Seat 3: kramnoy.ivan ($6.75 in chips) 
Seat 4: zbig-u ($5 in chips) 
Seat 6: noraemon ($5 in chips) 
Seat 7: HéStiA ($6.94 in chips) 
Seat 8: Yoyoppy ($6.10 in chips) 
Seat 9: Dorex2007 ($8.86 in chips) 
Alex.Petrovskiy: posts small blind $0.02
kramnoy.ivan: posts big blind $0.05
*** HOLE CARDS ***
Dealt to Dorex2007 [Ah Qd]
zbig-u: folds 
noraemon: folds 
HéStiA: raises $0.07 to $0.12
Yoyoppy: folds 
Dorex2007: calls $0.12
BluffOnTable: folds 
Alex.Petrovskiy: folds 
kramnoy.ivan: calls $0.07
*** FLOP *** [Js 2d 2s]
kramnoy.ivan: checks 
HéStiA: bets $0.18
Dorex2007: folds 
kramnoy.ivan: calls $0.18
*** TURN *** [Js 2d 2s] [As]
kramnoy.ivan: checks 
HéStiA: bets $0.35
kramnoy.ivan: calls $0.35
*** RIVER *** [Js 2d 2s As] [9s]
kramnoy.ivan: bets $0.15
HéStiA: calls $0.15
*** SHOW DOWN ***
kramnoy.ivan: shows [Ks Jh] (a flush, Ace high)
HéStiA: mucks hand 
kramnoy.ivan collected $1.67 from pot
*** SUMMARY ***
Total pot $1.74 | Rake $0.07 
Board [Js 2d 2s As 9s]
Seat 1: BluffOnTable (button) folded before Flop (didn't bet)
Seat 2: Alex.Petrovskiy (small blind) folded before Flop
Seat 3: kramnoy.ivan (big blind) showed [Ks Jh] and won ($1.67) with a flush, Ace high
Seat 4: zbig-u folded before Flop (didn't bet)
Seat 6: noraemon folded before Flop (didn't bet)
Seat 7: HéStiA mucked [Ac Jc]
Seat 8: Yoyoppy folded before Flop (didn't bet)
Seat 9: Dorex2007 folded on the Flop



PokerStars Hand #238670448660:  Hold'em No Limit ($0.02/$0.05 USD) - 2022/09/16 13:58:00 PT [2022/09/16 16:58:00 ET]
Table 'Hedera II' 9-max Seat #2 is the button
Seat 1: BluffOnTable ($8.02 in chips) 
Seat 2: Alex.Petrovskiy ($7.55 in chips) 
Seat 3: kramnoy.ivan ($7.62 in chips) 
Seat 4: zbig-u ($5 in chips) 
Seat 5: Lucases Ente ($7.08 in chips) 
Seat 6: noraemon ($5 in chips) 
Seat 7: HéStiA ($6.14 in chips) 
Seat 8: Yoyoppy ($6.10 in chips) 
Seat 9: Dorex2007 ($8.74 in chips) 
kramnoy.ivan: posts small blind $0.02
zbig-u: posts big blind $0.05
*** HOLE CARDS ***
Dealt to Dorex2007 [As Th]
Lucases Ente: folds 
noraemon: folds 
HéStiA: raises $0.07 to $0.12
Yoyoppy: folds 
Dorex2007: folds 
BluffOnTable: calls $0.12
Alex.Petrovskiy: folds 
kramnoy.ivan: folds 
zbig-u: calls $0.07
*** FLOP *** [8h 3d 2s]
zbig-u: checks 
HéStiA: bets $0.18
BluffOnTable: calls $0.18
zbig-u: folds 
*** TURN *** [8h 3d 2s] [Jh]
HéStiA: checks 
BluffOnTable: checks 
*** RIVER *** [8h 3d 2s Jh] [9h]
HéStiA: bets $0.35
BluffOnTable: calls $0.35
*** SHOW DOWN ***
HéStiA: shows [Jd Jc] (three of a kind, Jacks)
BluffOnTable: mucks hand 
HéStiA collected $1.38 from pot
*** SUMMARY ***
Total pot $1.44 | Rake $0.06 
Board [8h 3d 2s Jh 9h]
Seat 1: BluffOnTable mucked [9c 9s]
Seat 2: Alex.Petrovskiy (button) folded before Flop (didn't bet)
Seat 3: kramnoy.ivan (small blind) folded before Flop
Seat 4: zbig-u (big blind) folded on the Flop
Seat 5: Lucases Ente folded before Flop (didn't bet)
Seat 6: noraemon folded before Flop (didn't bet)
Seat 7: HéStiA showed [Jd Jc] and won ($1.38) with three of a kind, Jacks
Seat 8: Yoyoppy folded before Flop (didn't bet)
Seat 9: Dorex2007 folded before Flop (didn't bet)



PokerStars Hand #238670466236:  Hold'em No Limit ($0.02/$0.05 USD) - 2022/09/16 13:58:59 PT [2022/09/16 16:58:59 ET]
Table 'Hedera II' 9-max Seat #3 is the button
Seat 1: BluffOnTable ($7.37 in chips) 
Seat 2: Alex.Petrovskiy ($7.55 in chips) 
Seat 3: kramnoy.ivan ($7.60 in chips) 
Seat 4: zbig-u ($5 in chips) 
Seat 5: Lucases Ente ($7.08 in chips) 
Seat 6: noraemon ($5 in chips) 
Seat 7: HéStiA ($6.87 in chips) 
Seat 8: Yoyoppy ($6.10 in chips) 
Seat 9: Dorex2007 ($8.74 in chips) 
zbig-u: posts small blind $0.02
Lucases Ente: posts big blind $0.05
*** HOLE CARDS ***
Dealt to Dorex2007 [2s 7c]
noraemon: folds 
HéStiA: folds 
Yoyoppy: folds 
Dorex2007: folds 
BluffOnTable: folds 
Alex.Petrovskiy: folds 
kramnoy.ivan: raises $0.05 to $0.10
zbig-u: folds 
Lucases Ente: calls $0.05
*** FLOP *** [7d Td Jh]
Lucases Ente: bets $0.10
kramnoy.ivan: calls $0.10
*** TURN *** [7d Td Jh] [3d]
Lucases Ente: checks 
kramnoy.ivan: bets $0.20
Lucases Ente: folds 
Uncalled bet ($0.20) returned to kramnoy.ivan
kramnoy.ivan collected $0.40 from pot
*** SUMMARY ***
Total pot $0.42 | Rake $0.02 
Board [7d Td Jh 3d]
Seat 1: BluffOnTable folded before Flop (didn't bet)
Seat 2: Alex.Petrovskiy folded before Flop (didn't bet)
Seat 3: kramnoy.ivan (button) collected ($0.40)
Seat 4: zbig-u (small blind) folded before Flop
Seat 5: Lucases Ente (big blind) folded on the Turn
Seat 6: noraemon folded before Flop (didn't bet)
Seat 7: HéStiA folded before Flop (didn't bet)
Seat 8: Yoyoppy folded before Flop (didn't bet)
Seat 9: Dorex2007 folded before Flop (didn't bet)



PokerStars Hand #238670479710:  Hold'em No Limit ($0.02/$0.05 USD) - 2022/09/16 13:59:44 PT [2022/09/16 16:59:44 ET]
Table 'Hedera II' 9-max Seat #4 is the button
Seat 1: BluffOnTable ($7.37 in chips) 
Seat 2: Alex.Petrovskiy ($7.55 in chips) 
Seat 3: kramnoy.ivan ($7.80 in chips) 
Seat 4: zbig-u ($5 in chips) 
Seat 5: Lucases Ente ($6.88 in chips) 
Seat 7: HéStiA ($6.87 in chips) 
Seat 8: Yoyoppy ($6.10 in chips) 
Seat 9: Dorex2007 ($8.74 in chips) 
Lucases Ente: posts small blind $0.02
noraemon: is sitting out 
HéStiA: posts big blind $0.05
*** HOLE CARDS ***
Dealt to Dorex2007 [Ah 4c]
Yoyoppy: folds 
Dorex2007: folds 
BluffOnTable: raises $0.10 to $0.15
Alex.Petrovskiy: folds 
kramnoy.ivan: folds 
zbig-u: raises $0.30 to $0.45
noraemon leaves the table
Lucases Ente: folds 
HéStiA: folds 
BluffOnTable: raises $6.92 to $7.37 and is all-in
zbig-u: folds 
Uncalled bet ($6.92) returned to BluffOnTable
BluffOnTable collected $0.97 from pot
BluffOnTable: doesn't show hand 
*** SUMMARY ***
Total pot $0.97 | Rake $0 
Seat 1: BluffOnTable collected ($0.97)
Seat 2: Alex.Petrovskiy folded before Flop (didn't bet)
Seat 3: kramnoy.ivan folded before Flop (didn't bet)
Seat 4: zbig-u (button) folded before Flop
Seat 5: Lucases Ente (small blind) folded before Flop
Seat 7: HéStiA (big blind) folded before Flop
Seat 8: Yoyoppy folded before Flop (didn't bet)
Seat 9: Dorex2007 folded before Flop (didn't bet)



PokerStars Hand #238670491523:  Hold'em No Limit ($0.02/$0.05 USD) - 2022/09/16 14:00:23 PT [2022/09/16 17:00:23 ET]
Table 'Hedera II' 9-max Seat #5 is the button
Seat 1: BluffOnTable ($7.89 in chips) 
Seat 2: Alex.Petrovskiy ($7.55 in chips) 
Seat 3: kramnoy.ivan ($7.80 in chips) 
Seat 4: zbig-u ($5 in chips) 
Seat 5: Lucases Ente ($6.86 in chips) 
Seat 7: HéStiA ($6.82 in chips) 
Seat 8: Yoyoppy ($6.10 in chips) 
Seat 9: Dorex2007 ($8.74 in chips) 
HéStiA: posts small blind $0.02
Yoyoppy: posts big blind $0.05
*** HOLE CARDS ***
Dealt to Dorex2007 [5d 6c]
Dorex2007: folds 
BluffOnTable: folds 
Alex.Petrovskiy: folds 
kramnoy.ivan: raises $0.05 to $0.10
zbig-u: folds 
Lucases Ente: folds 
HéStiA: calls $0.08
Yoyoppy: calls $0.05
*** FLOP *** [Ks 7h 9h]
HéStiA: checks 
Yoyoppy: bets $0.15
Luckman_brz joins the table at seat #6 
kramnoy.ivan: raises $0.15 to $0.30
HéStiA: folds 
Yoyoppy: calls $0.15
*** TURN *** [Ks 7h 9h] [7s]
Yoyoppy: checks 
kramnoy.ivan: bets $0.10
Yoyoppy: folds 
Uncalled bet ($0.10) returned to kramnoy.ivan
kramnoy.ivan collected $0.86 from pot
*** SUMMARY ***
Total pot $0.90 | Rake $0.04 
Board [Ks 7h 9h 7s]
Seat 1: BluffOnTable folded before Flop (didn't bet)
Seat 2: Alex.Petrovskiy folded before Flop (didn't bet)
Seat 3: kramnoy.ivan collected ($0.86)
Seat 4: zbig-u folded before Flop (didn't bet)
Seat 5: Lucases Ente (button) folded before Flop (didn't bet)
Seat 7: HéStiA (small blind) folded on the Flop
Seat 8: Yoyoppy (big blind) folded on the Turn
Seat 9: Dorex2007 folded before Flop (didn't bet)



PokerStars Hand #238670515295:  Hold'em No Limit ($0.02/$0.05 USD) - 2022/09/16 14:01:31 PT [2022/09/16 17:01:31 ET]
Table 'Hedera II' 9-max Seat #7 is the button
Seat 1: BluffOnTable ($7.89 in chips) 
Seat 2: Alex.Petrovskiy ($7.55 in chips) 
Seat 3: kramnoy.ivan ($8.26 in chips) 
Seat 4: zbig-u ($5 in chips) 
Seat 5: Lucases Ente ($6.86 in chips) 
Seat 6: Luckman_brz ($5 in chips) 
Seat 7: HéStiA ($6.72 in chips) 
Seat 8: Yoyoppy ($5.70 in chips) 
Seat 9: Dorex2007 ($8.74 in chips) 
Yoyoppy: posts small blind $0.02
Dorex2007: posts big blind $0.05
Luckman_brz: posts big blind $0.05
*** HOLE CARDS ***
Dealt to Dorex2007 [5d Ac]
BluffOnTable: raises $0.10 to $0.15
Alex.Petrovskiy: folds 
kramnoy.ivan: folds 
zbig-u: raises $0.30 to $0.45
Lucases Ente: folds 
Luckman_brz: folds 
HéStiA: folds 
Yoyoppy: folds 
Dorex2007: folds 
BluffOnTable: folds 
Uncalled bet ($0.30) returned to zbig-u
zbig-u collected $0.42 from pot
zbig-u: doesn't show hand 
*** SUMMARY ***
Total pot $0.42 | Rake $0 
Seat 1: BluffOnTable folded before Flop
Seat 2: Alex.Petrovskiy folded before Flop (didn't bet)
Seat 3: kramnoy.ivan folded before Flop (didn't bet)
Seat 4: zbig-u collected ($0.42)
Seat 5: Lucases Ente folded before Flop (didn't bet)
Seat 6: Luckman_brz folded before Flop (didn't bet)
Seat 7: HéStiA (button) folded before Flop (didn't bet)
Seat 8: Yoyoppy (small blind) folded before Flop
Seat 9: Dorex2007 (big blind) folded before Flop



PokerStars Hand #238670527489:  Hold'em No Limit ($0.02/$0.05 USD) - 2022/09/16 14:02:02 PT [2022/09/16 17:02:02 ET]
Table 'Hedera II' 9-max Seat #8 is the button
Seat 1: BluffOnTable ($7.74 in chips) 
Seat 2: Alex.Petrovskiy ($7.55 in chips) 
Seat 3: kramnoy.ivan ($8.26 in chips) 
Seat 4: zbig-u ($5.27 in chips) 
Seat 5: Lucases Ente ($6.86 in chips) 
Seat 6: Luckman_brz ($4.95 in chips) 
Seat 7: HéStiA ($6.72 in chips) 
Seat 8: Yoyoppy ($5.68 in chips) 
Seat 9: Dorex2007 ($8.69 in chips) 
Dorex2007: posts small blind $0.02
BluffOnTable: posts big blind $0.05
*** HOLE CARDS ***
Dealt to Dorex2007 [9s Ah]
Alex.Petrovskiy: folds 
kramnoy.ivan: folds 
zbig-u: folds 
Lucases Ente: folds 
Luckman_brz: folds 
HéStiA: folds 
Yoyoppy: raises $0.10 to $0.15
Dorex2007: folds 
BluffOnTable: folds 
Uncalled bet ($0.10) returned to Yoyoppy
Yoyoppy collected $0.12 from pot
Yoyoppy: doesn't show hand 
*** SUMMARY ***
Total pot $0.12 | Rake $0 
Seat 1: BluffOnTable (big blind) folded before Flop
Seat 2: Alex.Petrovskiy folded before Flop (didn't bet)
Seat 3: kramnoy.ivan folded before Flop (didn't bet)
Seat 4: zbig-u folded before Flop (didn't bet)
Seat 5: Lucases Ente folded before Flop (didn't bet)
Seat 6: Luckman_brz folded before Flop (didn't bet)
Seat 7: HéStiA folded before Flop (didn't bet)
Seat 8: Yoyoppy (button) collected ($0.12)
Seat 9: Dorex2007 (small blind) folded before Flop



PokerStars Hand #238670536343:  Hold'em No Limit ($0.02/$0.05 USD) - 2022/09/16 14:02:23 PT [2022/09/16 17:02:23 ET]
Table 'Hedera II' 9-max Seat #9 is the button
Seat 1: BluffOnTable ($7.69 in chips) 
Seat 3: kramnoy.ivan ($8.26 in chips) 
Seat 4: zbig-u ($5.27 in chips) 
Seat 5: Lucases Ente ($6.86 in chips) 
Seat 6: Luckman_brz ($4.95 in chips) 
Seat 7: HéStiA ($6.72 in chips) 
Seat 8: Yoyoppy ($5.75 in chips) 
Seat 9: Dorex2007 ($8.67 in chips) 
BluffOnTable: posts small blind $0.02
Alex.Petrovskiy: is sitting out 
kramnoy.ivan: posts big blind $0.05
*** HOLE CARDS ***
Dealt to Dorex2007 [8c 4d]
zbig-u: folds 
Lucases Ente: folds 
Luckman_brz: folds 
HéStiA: raises $0.07 to $0.12
Yoyoppy: folds 
Dorex2007: folds 
BluffOnTable: folds 
kramnoy.ivan: calls $0.07
*** FLOP *** [5d Ad 6d]
kramnoy.ivan: checks 
Alex.Petrovskiy leaves the table
HéStiA: bets $0.12
kramnoy.ivan: folds 
Uncalled bet ($0.12) returned to HéStiA
HéStiA collected $0.25 from pot
*** SUMMARY ***
Total pot $0.26 | Rake $0.01 
Board [5d Ad 6d]
Seat 1: BluffOnTable (small blind) folded before Flop
Seat 3: kramnoy.ivan (big blind) folded on the Flop
Seat 4: zbig-u folded before Flop (didn't bet)
Seat 5: Lucases Ente folded before Flop (didn't bet)
Seat 6: Luckman_brz folded before Flop (didn't bet)
Seat 7: HéStiA collected ($0.25)
Seat 8: Yoyoppy folded before Flop (didn't bet)
Seat 9: Dorex2007 (button) folded before Flop (didn't bet)



PokerStars Hand #238670549196:  Hold'em No Limit ($0.02/$0.05 USD) - 2022/09/16 14:02:53 PT [2022/09/16 17:02:53 ET]
Table 'Hedera II' 9-max Seat #1 is the button
Seat 1: BluffOnTable ($7.67 in chips) 
Seat 3: kramnoy.ivan ($8.14 in chips) 
Seat 4: zbig-u ($5.27 in chips) 
Seat 5: Lucases Ente ($6.86 in chips) 
Seat 6: Luckman_brz ($4.95 in chips) 
Seat 7: HéStiA ($6.85 in chips) 
Seat 8: Yoyoppy ($5.75 in chips) 
Seat 9: Dorex2007 ($8.67 in chips) 
kramnoy.ivan: posts small blind $0.02
zbig-u: posts big blind $0.05
*** HOLE CARDS ***
Dealt to Dorex2007 [6c 8h]
mahspace joins the table at seat #2 
Lucases Ente: calls $0.05
Luckman_brz: folds 
HéStiA: calls $0.05
Yoyoppy: folds 
Dorex2007: folds 
BluffOnTable: folds 
kramnoy.ivan: raises $0.05 to $0.10
zbig-u: folds 
Lucases Ente: calls $0.05
HéStiA: calls $0.05
*** FLOP *** [4d Jd Ks]
kramnoy.ivan: bets $0.17
Lucases Ente: folds 
HéStiA: calls $0.17
*** TURN *** [4d Jd Ks] [Th]
kramnoy.ivan: bets $0.33
HéStiA: raises $0.66 to $0.99
kramnoy.ivan: calls $0.66
*** RIVER *** [4d Jd Ks Th] [Jh]
kramnoy.ivan: checks 
HéStiA: bets $1.28
kramnoy.ivan: folds 
Uncalled bet ($1.28) returned to HéStiA
HéStiA collected $2.56 from pot
*** SUMMARY ***
Total pot $2.67 | Rake $0.11 
Board [4d Jd Ks Th Jh]
Seat 1: BluffOnTable (button) folded before Flop (didn't bet)
Seat 3: kramnoy.ivan (small blind) folded on the River
Seat 4: zbig-u (big blind) folded before Flop
Seat 5: Lucases Ente folded on the Flop
Seat 6: Luckman_brz folded before Flop (didn't bet)
Seat 7: HéStiA collected ($2.56)
Seat 8: Yoyoppy folded before Flop (didn't bet)
Seat 9: Dorex2007 folded before Flop (didn't bet)



PokerStars Hand #238670583490:  Hold'em No Limit ($0.02/$0.05 USD) - 2022/09/16 14:04:13 PT [2022/09/16 17:04:13 ET]
Table 'Hedera II' 9-max Seat #3 is the button
Seat 1: BluffOnTable ($7.67 in chips) 
Seat 3: kramnoy.ivan ($6.88 in chips) 
Seat 4: zbig-u ($5.22 in chips) 
Seat 5: Lucases Ente ($6.76 in chips) 
Seat 6: Luckman_brz ($4.95 in chips) 
Seat 7: HéStiA ($8.15 in chips) 
Seat 8: Yoyoppy ($5.75 in chips) 
Seat 9: Dorex2007 ($8.67 in chips) 
zbig-u: posts small blind $0.02
Lucases Ente: posts big blind $0.05
mahspace: sits out 
*** HOLE CARDS ***
Dealt to Dorex2007 [Kh 8s]
Luckman_brz: folds 
HéStiA: folds 
Yoyoppy: folds 
Dorex2007: folds 
BluffOnTable: folds 
kramnoy.ivan: folds 
zbig-u: folds 
Uncalled bet ($0.03) returned to Lucases Ente
Lucases Ente collected $0.04 from pot
*** SUMMARY ***
Total pot $0.04 | Rake $0 
Seat 1: BluffOnTable folded before Flop (didn't bet)
Seat 3: kramnoy.ivan (button) folded before Flop (didn't bet)
Seat 4: zbig-u (small blind) folded before Flop
Seat 5: Lucases Ente (big blind) collected ($0.04)
Seat 6: Luckman_brz folded before Flop (didn't bet)
Seat 7: HéStiA folded before Flop (didn't bet)
Seat 8: Yoyoppy folded before Flop (didn't bet)
Seat 9: Dorex2007 folded before Flop (didn't bet)



PokerStars Hand #238670594004:  Hold'em No Limit ($0.02/$0.05 USD) - 2022/09/16 14:04:38 PT [2022/09/16 17:04:38 ET]
Table 'Hedera II' 9-max Seat #4 is the button
Seat 1: BluffOnTable ($7.67 in chips) 
Seat 3: kramnoy.ivan ($6.88 in chips) 
Seat 4: zbig-u ($5.20 in chips) 
Seat 5: Lucases Ente ($6.78 in chips) 
Seat 6: Luckman_brz ($4.95 in chips) 
Seat 7: HéStiA ($8.15 in chips) 
Seat 8: Yoyoppy ($5.75 in chips) 
Seat 9: Dorex2007 ($8.67 in chips) 
Lucases Ente: posts small blind $0.02
Luckman_brz: posts big blind $0.05
mahspace: sits out 
*** HOLE CARDS ***
Dealt to Dorex2007 [Jh 6c]
HéStiA: folds 
Yoyoppy: folds 
Dorex2007: folds 
BluffOnTable: folds 
kramnoy.ivan: raises $0.05 to $0.10
zbig-u: folds 
Lucases Ente: folds 
Luckman_brz: folds 
Uncalled bet ($0.05) returned to kramnoy.ivan
kramnoy.ivan collected $0.12 from pot
*** SUMMARY ***
Total pot $0.12 | Rake $0 
Seat 1: BluffOnTable folded before Flop (didn't bet)
Seat 3: kramnoy.ivan collected ($0.12)
Seat 4: zbig-u (button) folded before Flop (didn't bet)
Seat 5: Lucases Ente (small blind) folded before Flop
Seat 6: Luckman_brz (big blind) folded before Flop
Seat 7: HéStiA folded before Flop (didn't bet)
Seat 8: Yoyoppy folded before Flop (didn't bet)
Seat 9: Dorex2007 folded before Flop (didn't bet)



PokerStars Hand #238670600097:  Hold'em No Limit ($0.02/$0.05 USD) - 2022/09/16 14:04:52 PT [2022/09/16 17:04:52 ET]
Table 'Hedera II' 9-max Seat #5 is the button
Seat 1: BluffOnTable ($7.67 in chips) 
Seat 3: kramnoy.ivan ($6.95 in chips) 
Seat 4: zbig-u ($5.20 in chips) 
Seat 5: Lucases Ente ($6.76 in chips) 
Seat 6: Luckman_brz ($4.90 in chips) 
Seat 7: HéStiA ($8.15 in chips) 
Seat 8: Yoyoppy ($5.75 in chips) 
Seat 9: Dorex2007 ($8.67 in chips) 
Luckman_brz: posts small blind $0.02
HéStiA: posts big blind $0.05
mahspace: sits out 
*** HOLE CARDS ***
Dealt to Dorex2007 [9c 6s]
Yoyoppy: folds 
Dorex2007: folds 
BluffOnTable: folds 
kramnoy.ivan has timed out
kramnoy.ivan: folds 
zbig-u: folds 
Lucases Ente: folds 
Luckman_brz: calls $0.03
HéStiA: checks 
*** FLOP *** [9d 5c 6c]
Luckman_brz: checks 
HéStiA: checks 
*** TURN *** [9d 5c 6c] [Jc]
Luckman_brz: checks 
HéStiA: checks 
*** RIVER *** [9d 5c 6c Jc] [7c]
Luckman_brz: checks 
HéStiA: checks 
*** SHOW DOWN ***
Luckman_brz: shows [4h Ks] (high card King)
HéStiA: shows [Ah Th] (high card Ace)
HéStiA collected $0.10 from pot
*** SUMMARY ***
Total pot $0.10 | Rake $0 
Board [9d 5c 6c Jc 7c]
Seat 1: BluffOnTable folded before Flop (didn't bet)
Seat 3: kramnoy.ivan folded before Flop (didn't bet)
Seat 4: zbig-u folded before Flop (didn't bet)
Seat 5: Lucases Ente (button) folded before Flop (didn't bet)
Seat 6: Luckman_brz (small blind) showed [4h Ks] and lost with high card King
Seat 7: HéStiA (big blind) showed [Ah Th] and won ($0.10) with high card Ace
Seat 8: Yoyoppy folded before Flop (didn't bet)
Seat 9: Dorex2007 folded before Flop (didn't bet)



PokerStars Hand #238670620603:  Hold'em No Limit ($0.02/$0.05 USD) - 2022/09/16 14:05:39 PT [2022/09/16 17:05:39 ET]
Table 'Hedera II' 9-max Seat #6 is the button
Seat 1: BluffOnTable ($7.67 in chips) 
Seat 3: kramnoy.ivan ($6.95 in chips) 
Seat 4: zbig-u ($5.20 in chips) 
Seat 5: Lucases Ente ($6.76 in chips) 
Seat 6: Luckman_brz ($4.85 in chips) 
Seat 7: HéStiA ($8.20 in chips) 
Seat 9: Dorex2007 ($8.67 in chips) 
HéStiA: posts small blind $0.02
Yoyoppy: is sitting out 
Yoyoppy leaves the table
Dorex2007: posts big blind $0.05
mahspace: sits out 
*** HOLE CARDS ***
Dealt to Dorex2007 [Ac 6c]
BluffOnTable: raises $0.10 to $0.15
kramnoy.ivan: folds 
zbig-u: folds 
Lucases Ente: folds 
Luckman_brz: folds 
HéStiA: folds 
Dorex2007: folds 
Uncalled bet ($0.10) returned to BluffOnTable
BluffOnTable collected $0.12 from pot
BluffOnTable: doesn't show hand 
*** SUMMARY ***
Total pot $0.12 | Rake $0 
Seat 1: BluffOnTable collected ($0.12)
Seat 3: kramnoy.ivan folded before Flop (didn't bet)
Seat 4: zbig-u folded before Flop (didn't bet)
Seat 5: Lucases Ente folded before Flop (didn't bet)
Seat 6: Luckman_brz (button) folded before Flop (didn't bet)
Seat 7: HéStiA (small blind) folded before Flop
Seat 9: Dorex2007 (big blind) folded before Flop



PokerStars Hand #238670629958:  Hold'em No Limit ($0.02/$0.05 USD) - 2022/09/16 14:06:01 PT [2022/09/16 17:06:01 ET]
Table 'Hedera II' 9-max Seat #7 is the button
Seat 1: BluffOnTable ($7.74 in chips) 
Seat 3: kramnoy.ivan ($6.95 in chips) 
Seat 4: zbig-u ($5.20 in chips) 
Seat 5: Lucases Ente ($6.76 in chips) 
Seat 6: Luckman_brz ($4.85 in chips) 
Seat 7: HéStiA ($8.18 in chips) 
Seat 9: Dorex2007 ($8.62 in chips) 
Dorex2007: posts small blind $0.02
BluffOnTable: posts big blind $0.05
mahspace: sits out 
*** HOLE CARDS ***
Dealt to Dorex2007 [Th Tc]
kramnoy.ivan is disconnected 
kramnoy.ivan has timed out while disconnected
kramnoy.ivan: folds 
zbig-u: folds 
Lucases Ente: folds 
Luckman_brz: folds 
HéStiA: folds 
Dorex2007: raises $0.10 to $0.15
BluffOnTable: folds 
Uncalled bet ($0.10) returned to Dorex2007
Dorex2007 collected $0.10 from pot
Dorex2007: doesn't show hand 
*** SUMMARY ***
Total pot $0.10 | Rake $0 
Seat 1: BluffOnTable (big blind) folded before Flop
Seat 3: kramnoy.ivan folded before Flop (didn't bet)
Seat 4: zbig-u folded before Flop (didn't bet)
Seat 5: Lucases Ente folded before Flop (didn't bet)
Seat 6: Luckman_brz folded before Flop (didn't bet)
Seat 7: HéStiA (button) folded before Flop (didn't bet)
Seat 9: Dorex2007 (small blind) collected ($0.10)



PokerStars Hand #238670639020:  Hold'em No Limit ($0.02/$0.05 USD) - 2022/09/16 14:06:22 PT [2022/09/16 17:06:22 ET]
Table 'Hedera II' 9-max Seat #9 is the button
Seat 1: BluffOnTable ($7.69 in chips) 
Seat 2: mahspace ($5 in chips) 
Seat 4: zbig-u ($5.20 in chips) 
Seat 5: Lucases Ente ($6.76 in chips) 
Seat 6: Luckman_brz ($4.85 in chips) 
Seat 7: HéStiA ($8.18 in chips) 
Seat 9: Dorex2007 ($8.67 in chips) 
BluffOnTable: posts small blind $0.02
mahspace: posts big blind $0.05
*** HOLE CARDS ***
Dealt to Dorex2007 [7h 3h]
zbig-u: folds 
Lucases Ente: folds 
Luckman_brz: calls $0.05
HéStiA: folds 
Dorex2007: folds 
BluffOnTable: folds 
mahspace: checks 
*** FLOP *** [Td 6s 4c]
mahspace: checks 
In-Solem joins the table at seat #8 
Luckman_brz: checks 
*** TURN *** [Td 6s 4c] [9d]
mahspace: checks 
Luckman_brz: bets $0.10
mahspace: folds 
Uncalled bet ($0.10) returned to Luckman_brz
Luckman_brz collected $0.12 from pot
Luckman_brz: doesn't show hand 
*** SUMMARY ***
Total pot $0.12 | Rake $0 
Board [Td 6s 4c 9d]
Seat 1: BluffOnTable (small blind) folded before Flop
Seat 2: mahspace (big blind) folded on the Turn
Seat 4: zbig-u folded before Flop (didn't bet)
Seat 5: Lucases Ente folded before Flop (didn't bet)
Seat 6: Luckman_brz collected ($0.12)
Seat 7: HéStiA folded before Flop (didn't bet)
Seat 9: Dorex2007 (button) folded before Flop (didn't bet)



PokerStars Hand #238670652340:  Hold'em No Limit ($0.02/$0.05 USD) - 2022/09/16 14:06:53 PT [2022/09/16 17:06:53 ET]
Table 'Hedera II' 9-max Seat #1 is the button
Seat 1: BluffOnTable ($7.67 in chips) 
Seat 2: mahspace ($4.95 in chips) 
Seat 3: kramnoy.ivan ($6.95 in chips) 
Seat 4: zbig-u ($5.20 in chips) 
Seat 5: Lucases Ente ($6.76 in chips) 
Seat 6: Luckman_brz ($4.92 in chips) 
Seat 7: HéStiA ($8.18 in chips) 
Seat 8: In-Solem ($5 in chips) 
Seat 9: Dorex2007 ($8.67 in chips) 
mahspace: posts small blind $0.02
kramnoy.ivan: posts big blind $0.05
In-Solem: posts big blind $0.05
*** HOLE CARDS ***
Dealt to Dorex2007 [5d Tc]
zbig-u: folds 
Lucases Ente has timed out
Lucases Ente: folds 
Luckman_brz: folds 
HéStiA: folds 
In-Solem: raises $0.15 to $0.20
Dorex2007: folds 
BluffOnTable: calls $0.20
mahspace: folds 
kramnoy.ivan: folds 
*** FLOP *** [Js 6c 5c]
In-Solem: bets $0.45
BluffOnTable: folds 
Uncalled bet ($0.45) returned to In-Solem
In-Solem collected $0.45 from pot
*** SUMMARY ***
Total pot $0.47 | Rake $0.02 
Board [Js 6c 5c]
Seat 1: BluffOnTable (button) folded on the Flop
Seat 2: mahspace (small blind) folded before Flop
Seat 3: kramnoy.ivan (big blind) folded before Flop
Seat 4: zbig-u folded before Flop (didn't bet)
Seat 5: Lucases Ente folded before Flop (didn't bet)
Seat 6: Luckman_brz folded before Flop (didn't bet)
Seat 7: HéStiA folded before Flop (didn't bet)
Seat 8: In-Solem collected ($0.45)
Seat 9: Dorex2007 folded before Flop (didn't bet)



PokerStars Hand #238670674446:  Hold'em No Limit ($0.02/$0.05 USD) - 2022/09/16 14:07:45 PT [2022/09/16 17:07:45 ET]
Table 'Hedera II' 9-max Seat #2 is the button
Seat 1: BluffOnTable ($7.47 in chips) 
Seat 2: mahspace ($4.93 in chips) 
Seat 3: kramnoy.ivan ($6.90 in chips) 
Seat 4: zbig-u ($5.20 in chips) 
Seat 5: Lucases Ente ($6.76 in chips) 
Seat 6: Luckman_brz ($4.92 in chips) 
Seat 7: HéStiA ($8.18 in chips) 
Seat 8: In-Solem ($5.25 in chips) 
Seat 9: Dorex2007 ($8.67 in chips) 
kramnoy.ivan: posts small blind $0.02
zbig-u: posts big blind $0.05
*** HOLE CARDS ***
Dealt to Dorex2007 [As 3d]
Lucases Ente: folds 
Luckman_brz: folds 
HéStiA: folds 
In-Solem: folds 
Dorex2007: folds 
BluffOnTable: folds 
mahspace: folds 
kramnoy.ivan: folds 
Uncalled bet ($0.03) returned to zbig-u
zbig-u collected $0.04 from pot
zbig-u: doesn't show hand 
*** SUMMARY ***
Total pot $0.04 | Rake $0 
Seat 1: BluffOnTable folded before Flop (didn't bet)
Seat 2: mahspace (button) folded before Flop (didn't bet)
Seat 3: kramnoy.ivan (small blind) folded before Flop
Seat 4: zbig-u (big blind) collected ($0.04)
Seat 5: Lucases Ente folded before Flop (didn't bet)
Seat 6: Luckman_brz folded before Flop (didn't bet)
Seat 7: HéStiA folded before Flop (didn't bet)
Seat 8: In-Solem folded before Flop (didn't bet)
Seat 9: Dorex2007 folded before Flop (didn't bet)



PokerStars Hand #238670681092:  Hold'em No Limit ($0.02/$0.05 USD) - 2022/09/16 14:08:01 PT [2022/09/16 17:08:01 ET]
Table 'Hedera II' 9-max Seat #3 is the button
Seat 1: BluffOnTable ($7.47 in chips) 
Seat 2: mahspace ($4.93 in chips) 
Seat 3: kramnoy.ivan ($6.88 in chips) 
Seat 4: zbig-u ($5.22 in chips) 
Seat 5: Lucases Ente ($6.76 in chips) 
Seat 6: Luckman_brz ($4.92 in chips) 
Seat 7: HéStiA ($8.18 in chips) 
Seat 8: In-Solem ($5.25 in chips) 
Seat 9: Dorex2007 ($8.67 in chips) 
zbig-u: posts small blind $0.02
Lucases Ente: posts big blind $0.05
*** HOLE CARDS ***
Dealt to Dorex2007 [Qc 6s]
Luckman_brz: folds 
HéStiA: folds 
In-Solem: raises $0.12 to $0.17
Dorex2007: folds 
BluffOnTable: folds 
mahspace: folds 
kramnoy.ivan: folds 
zbig-u: folds 
Lucases Ente: calls $0.12
*** FLOP *** [5s 4s 5d]
Lucases Ente: checks 
In-Solem: bets $0.35
Lucases Ente: folds 
Uncalled bet ($0.35) returned to In-Solem
In-Solem collected $0.35 from pot
*** SUMMARY ***
Total pot $0.36 | Rake $0.01 
Board [5s 4s 5d]
Seat 1: BluffOnTable folded before Flop (didn't bet)
Seat 2: mahspace folded before Flop (didn't bet)
Seat 3: kramnoy.ivan (button) folded before Flop (didn't bet)
Seat 4: zbig-u (small blind) folded before Flop
Seat 5: Lucases Ente (big blind) folded on the Flop
Seat 6: Luckman_brz folded before Flop (didn't bet)
Seat 7: HéStiA folded before Flop (didn't bet)
Seat 8: In-Solem collected ($0.35)
Seat 9: Dorex2007 folded before Flop (didn't bet)



PokerStars Hand #238670695867:  Hold'em No Limit ($0.02/$0.05 USD) - 2022/09/16 14:08:35 PT [2022/09/16 17:08:35 ET]
Table 'Hedera II' 9-max Seat #4 is the button
Seat 1: BluffOnTable ($7.47 in chips) 
Seat 2: mahspace ($4.93 in chips) 
Seat 3: kramnoy.ivan ($6.88 in chips) 
Seat 4: zbig-u ($5.20 in chips) 
Seat 5: Lucases Ente ($6.59 in chips) 
Seat 6: Luckman_brz ($4.92 in chips) 
Seat 7: HéStiA ($8.18 in chips) 
Seat 8: In-Solem ($5.43 in chips) 
Seat 9: Dorex2007 ($8.67 in chips) 
Lucases Ente: posts small blind $0.02
Luckman_brz: posts big blind $0.05
*** HOLE CARDS ***
Dealt to Dorex2007 [4c 5c]
HéStiA: folds 
In-Solem: folds 
Dorex2007: folds 
BluffOnTable: folds 
mahspace: folds 
kramnoy.ivan: folds 
zbig-u: folds 
Lucases Ente: folds 
Uncalled bet ($0.03) returned to Luckman_brz
Luckman_brz collected $0.04 from pot
Luckman_brz: doesn't show hand 
*** SUMMARY ***
Total pot $0.04 | Rake $0 
Seat 1: BluffOnTable folded before Flop (didn't bet)
Seat 2: mahspace folded before Flop (didn't bet)
Seat 3: kramnoy.ivan folded before Flop (didn't bet)
Seat 4: zbig-u (button) folded before Flop (didn't bet)
Seat 5: Lucases Ente (small blind) folded before Flop
Seat 6: Luckman_brz (big blind) collected ($0.04)
Seat 7: HéStiA folded before Flop (didn't bet)
Seat 8: In-Solem folded before Flop (didn't bet)
Seat 9: Dorex2007 folded before Flop (didn't bet)



PokerStars Hand #238670703650:  Hold'em No Limit ($0.02/$0.05 USD) - 2022/09/16 14:08:53 PT [2022/09/16 17:08:53 ET]
Table 'Hedera II' 9-max Seat #5 is the button
Seat 1: BluffOnTable ($7.47 in chips) 
Seat 2: mahspace ($4.93 in chips) 
Seat 3: kramnoy.ivan ($6.88 in chips) 
Seat 4: zbig-u ($5.20 in chips) 
Seat 5: Lucases Ente ($6.57 in chips) 
Seat 6: Luckman_brz ($4.94 in chips) 
Seat 7: HéStiA ($8.18 in chips) 
Seat 8: In-Solem ($5.43 in chips) 
Seat 9: Dorex2007 ($8.67 in chips) 
Luckman_brz: posts small blind $0.02
HéStiA: posts big blind $0.05
*** HOLE CARDS ***
Dealt to Dorex2007 [Js 2d]
In-Solem: raises $0.10 to $0.15
Dorex2007: folds 
BluffOnTable: folds 
mahspace: folds 
kramnoy.ivan: folds 
zbig-u: folds 
Lucases Ente: folds 
Luckman_brz: folds 
HéStiA: folds 
Uncalled bet ($0.10) returned to In-Solem
In-Solem collected $0.12 from pot
*** SUMMARY ***
Total pot $0.12 | Rake $0 
Seat 1: BluffOnTable folded before Flop (didn't bet)
Seat 2: mahspace folded before Flop (didn't bet)
Seat 3: kramnoy.ivan folded before Flop (didn't bet)
Seat 4: zbig-u folded before Flop (didn't bet)
Seat 5: Lucases Ente (button) folded before Flop (didn't bet)
Seat 6: Luckman_brz (small blind) folded before Flop
Seat 7: HéStiA (big blind) folded before Flop
Seat 8: In-Solem collected ($0.12)
Seat 9: Dorex2007 folded before Flop (didn't bet)



PokerStars Hand #238670712548:  Hold'em No Limit ($0.02/$0.05 USD) - 2022/09/16 14:09:14 PT [2022/09/16 17:09:14 ET]
Table 'Hedera II' 9-max Seat #6 is the button
Seat 1: BluffOnTable ($7.47 in chips) 
Seat 2: mahspace ($4.93 in chips) 
Seat 3: kramnoy.ivan ($6.88 in chips) 
Seat 4: zbig-u ($5.20 in chips) 
Seat 5: Lucases Ente ($6.57 in chips) 
Seat 6: Luckman_brz ($4.92 in chips) 
Seat 7: HéStiA ($8.13 in chips) 
Seat 8: In-Solem ($5.50 in chips) 
Seat 9: Dorex2007 ($8.67 in chips) 
HéStiA: posts small blind $0.02
In-Solem: posts big blind $0.05
*** HOLE CARDS ***
Dealt to Dorex2007 [3s Td]
Dorex2007: folds 
BluffOnTable: folds 
mahspace: folds 
kramnoy.ivan: raises $0.05 to $0.10
zbig-u: folds 
Lucases Ente: calls $0.10
Luckman_brz: folds 
HéStiA: calls $0.08
In-Solem: calls $0.05
*** FLOP *** [4c 9h 2c]
HéStiA: checks 
In-Solem: bets $0.38
kramnoy.ivan: folds 
Lucases Ente: folds 
HéStiA: calls $0.38
*** TURN *** [4c 9h 2c] [6s]
HéStiA: checks 
In-Solem: bets $1.11
HéStiA: calls $1.11
*** RIVER *** [4c 9h 2c 6s] [Jd]
HéStiA: checks 
In-Solem: checks 
*** SHOW DOWN ***
HéStiA: shows [9c 8c] (a pair of Nines)
In-Solem: shows [9d Qd] (a pair of Nines - Queen kicker)
In-Solem collected $3.24 from pot
*** SUMMARY ***
Total pot $3.38 | Rake $0.14 
Board [4c 9h 2c 6s Jd]
Seat 1: BluffOnTable folded before Flop (didn't bet)
Seat 2: mahspace folded before Flop (didn't bet)
Seat 3: kramnoy.ivan folded on the Flop
Seat 4: zbig-u folded before Flop (didn't bet)
Seat 5: Lucases Ente folded on the Flop
Seat 6: Luckman_brz (button) folded before Flop (didn't bet)
Seat 7: HéStiA (small blind) showed [9c 8c] and lost with a pair of Nines
Seat 8: In-Solem (big blind) showed [9d Qd] and won ($3.24) with a pair of Nines
Seat 9: Dorex2007 folded before Flop (didn't bet)



PokerStars Hand #238670737081:  Hold'em No Limit ($0.02/$0.05 USD) - 2022/09/16 14:10:12 PT [2022/09/16 17:10:12 ET]
Table 'Hedera II' 9-max Seat #7 is the button
Seat 1: BluffOnTable ($7.47 in chips) 
Seat 2: mahspace ($4.93 in chips) 
Seat 3: kramnoy.ivan ($6.78 in chips) 
Seat 4: zbig-u ($5.20 in chips) 
Seat 5: Lucases Ente ($6.47 in chips) 
Seat 6: Luckman_brz ($4.92 in chips) 
Seat 7: HéStiA ($6.54 in chips) 
Seat 8: In-Solem ($7.15 in chips) 
Seat 9: Dorex2007 ($8.67 in chips) 
In-Solem: posts small blind $0.02
Dorex2007: posts big blind $0.05
*** HOLE CARDS ***
Dealt to Dorex2007 [4c 9d]
BluffOnTable: folds 
mahspace: folds 
kramnoy.ivan: raises $0.05 to $0.10
zbig-u: calls $0.10
Lucases Ente: folds 
Luckman_brz: calls $0.10
HéStiA: calls $0.10
In-Solem: calls $0.08
Dorex2007: folds 
*** FLOP *** [8c 5d 2c]
In-Solem: bets $0.15
kramnoy.ivan: calls $0.15
zbig-u: calls $0.15
Luckman_brz: folds 
HéStiA: calls $0.15
*** TURN *** [8c 5d 2c] [4s]
In-Solem: bets $6.90 and is all-in
kramnoy.ivan: folds 
BluffOnTable leaves the table
zbig-u: folds 
HéStiA: folds 
Uncalled bet ($6.90) returned to In-Solem
In-Solem collected $1.10 from pot
*** SUMMARY ***
Total pot $1.15 | Rake $0.05 
Board [8c 5d 2c 4s]
Seat 1: BluffOnTable folded before Flop (didn't bet)
Seat 2: mahspace folded before Flop (didn't bet)
Seat 3: kramnoy.ivan folded on the Turn
Seat 4: zbig-u folded on the Turn
Seat 5: Lucases Ente folded before Flop (didn't bet)
Seat 6: Luckman_brz folded on the Flop
Seat 7: HéStiA (button) folded on the Turn
Seat 8: In-Solem (small blind) collected ($1.10)
Seat 9: Dorex2007 (big blind) folded before Flop



PokerStars Hand #238670766460:  Hold'em No Limit ($0.02/$0.05 USD) - 2022/09/16 14:11:21 PT [2022/09/16 17:11:21 ET]
Table 'Hedera II' 9-max Seat #8 is the button
Seat 2: mahspace ($4.93 in chips) 
Seat 3: kramnoy.ivan ($6.53 in chips) 
Seat 4: zbig-u ($5 in chips) 
Seat 5: Lucases Ente ($6.47 in chips) 
Seat 6: Luckman_brz ($4.82 in chips) 
Seat 7: HéStiA ($6.29 in chips) 
Seat 8: In-Solem ($8 in chips) 
Seat 9: Dorex2007 ($8.62 in chips) 
Dorex2007: posts small blind $0.02
mahspace: posts big blind $0.05
*** HOLE CARDS ***
Dealt to Dorex2007 [Td 4s]
kramnoy.ivan: folds 
zbig-u: folds 
Lucases Ente: folds 
Luckman_brz: folds 
HéStiA: folds 
In-Solem: folds 
Dorex2007: folds 
Uncalled bet ($0.03) returned to mahspace
mahspace collected $0.04 from pot
mahspace: doesn't show hand 
*** SUMMARY ***
Total pot $0.04 | Rake $0 
Seat 2: mahspace (big blind) collected ($0.04)
Seat 3: kramnoy.ivan folded before Flop (didn't bet)
Seat 4: zbig-u folded before Flop (didn't bet)
Seat 5: Lucases Ente folded before Flop (didn't bet)
Seat 6: Luckman_brz folded before Flop (didn't bet)
Seat 7: HéStiA folded before Flop (didn't bet)
Seat 8: In-Solem (button) folded before Flop (didn't bet)
Seat 9: Dorex2007 (small blind) folded before Flop



PokerStars Hand #238670771833:  Hold'em No Limit ($0.02/$0.05 USD) - 2022/09/16 14:11:33 PT [2022/09/16 17:11:33 ET]
Table 'Hedera II' 9-max Seat #9 is the button
Seat 2: mahspace ($4.95 in chips) 
Seat 3: kramnoy.ivan ($6.53 in chips) 
Seat 4: zbig-u ($5 in chips) 
Seat 5: Lucases Ente ($6.47 in chips) 
Seat 6: Luckman_brz ($4.82 in chips) 
Seat 7: HéStiA ($6.29 in chips) 
Seat 8: In-Solem ($8 in chips) 
Seat 9: Dorex2007 ($8.60 in chips) 
mahspace: posts small blind $0.02
kramnoy.ivan: posts big blind $0.05
*** HOLE CARDS ***
Dealt to Dorex2007 [6c 5c]
zbig-u: folds 
Lucases Ente: folds 
Luckman_brz: calls $0.05
HéStiA: folds 
MarkFitz76 joins the table at seat #1 
MarkFitz76 leaves the table
In-Solem: raises $0.10 to $0.15
Dorex2007: folds 
mahspace: folds 
kramnoy.ivan: folds 
ValerkaO_o joins the table at seat #1 
Luckman_brz: calls $0.10
*** FLOP *** [9c Qd 6d]
Luckman_brz: checks 
In-Solem: checks 
*** TURN *** [9c Qd 6d] [6h]
Luckman_brz: bets $0.10
In-Solem: calls $0.10
*** RIVER *** [9c Qd 6d 6h] [3h]
Luckman_brz: bets $0.15
In-Solem: calls $0.15
*** SHOW DOWN ***
Luckman_brz: shows [Kd Qh] (two pair, Queens and Sixes)
In-Solem: mucks hand 
Luckman_brz collected $0.83 from pot
*** SUMMARY ***
Total pot $0.87 | Rake $0.04 
Board [9c Qd 6d 6h 3h]
Seat 2: mahspace (small blind) folded before Flop
Seat 3: kramnoy.ivan (big blind) folded before Flop
Seat 4: zbig-u folded before Flop (didn't bet)
Seat 5: Lucases Ente folded before Flop (didn't bet)
Seat 6: Luckman_brz showed [Kd Qh] and won ($0.83) with two pair, Queens and Sixes
Seat 7: HéStiA folded before Flop (didn't bet)
Seat 8: In-Solem mucked [Tc Td]
Seat 9: Dorex2007 (button) folded before Flop (didn't bet)



PokerStars Hand #238670793674:  Hold'em No Limit ($0.02/$0.05 USD) - 2022/09/16 14:12:25 PT [2022/09/16 17:12:25 ET]
Table 'Hedera II' 9-max Seat #2 is the button
Seat 2: mahspace ($4.93 in chips) 
Seat 3: kramnoy.ivan ($6.48 in chips) 
Seat 4: zbig-u ($5 in chips) 
Seat 5: Lucases Ente ($6.47 in chips) 
Seat 6: Luckman_brz ($5.25 in chips) 
Seat 7: HéStiA ($6.29 in chips) 
Seat 8: In-Solem ($7.60 in chips) 
Seat 9: Dorex2007 ($8.60 in chips) 
kramnoy.ivan: posts small blind $0.02
zbig-u: posts big blind $0.05
ValerkaO_o: sits out 
*** HOLE CARDS ***
Dealt to Dorex2007 [3s Jh]
Lucases Ente: calls $0.05
Luckman_brz: calls $0.05
HéStiA: folds 
In-Solem: folds 
Dorex2007: folds 
mahspace: folds 
kramnoy.ivan: calls $0.03
zbig-u: checks 
*** FLOP *** [7s Jd 6c]
kramnoy.ivan: bets $0.09
zbig-u: folds 
Lucases Ente: folds 
Luckman_brz: folds 
Uncalled bet ($0.09) returned to kramnoy.ivan
kramnoy.ivan collected $0.19 from pot
*** SUMMARY ***
Total pot $0.20 | Rake $0.01 
Board [7s Jd 6c]
Seat 2: mahspace (button) folded before Flop (didn't bet)
Seat 3: kramnoy.ivan (small blind) collected ($0.19)
Seat 4: zbig-u (big blind) folded on the Flop
Seat 5: Lucases Ente folded on the Flop
Seat 6: Luckman_brz folded on the Flop
Seat 7: HéStiA folded before Flop (didn't bet)
Seat 8: In-Solem folded before Flop (didn't bet)
Seat 9: Dorex2007 folded before Flop (didn't bet)



PokerStars Hand #238670805758:  Hold'em No Limit ($0.02/$0.05 USD) - 2022/09/16 14:12:54 PT [2022/09/16 17:12:54 ET]
Table 'Hedera II' 9-max Seat #3 is the button
Seat 2: mahspace ($4.93 in chips) 
Seat 3: kramnoy.ivan ($6.62 in chips) 
Seat 4: zbig-u ($5 in chips) 
Seat 5: Lucases Ente ($6.42 in chips) 
Seat 6: Luckman_brz ($5.20 in chips) 
Seat 7: HéStiA ($6.29 in chips) 
Seat 8: In-Solem ($7.60 in chips) 
Seat 9: Dorex2007 ($8.60 in chips) 
zbig-u: posts small blind $0.02
Lucases Ente: posts big blind $0.05
ValerkaO_o: sits out 
*** HOLE CARDS ***
Dealt to Dorex2007 [6d Ks]
Luckman_brz: calls $0.05
HéStiA: calls $0.05
In-Solem: calls $0.05
Dorex2007: folds 
mahspace: folds 
kramnoy.ivan: folds 
zbig-u: folds 
Lucases Ente: checks 
*** FLOP *** [As Tc 5s]
Lucases Ente: checks 
Luckman_brz: checks 
HéStiA: bets $0.10
In-Solem: folds 
Lucases Ente: folds 
Luckman_brz is disconnected 
Luckman_brz has timed out while disconnected
Luckman_brz: folds 
Uncalled bet ($0.10) returned to HéStiA
HéStiA collected $0.21 from pot
*** SUMMARY ***
Total pot $0.22 | Rake $0.01 
Board [As Tc 5s]
Seat 2: mahspace folded before Flop (didn't bet)
Seat 3: kramnoy.ivan (button) folded before Flop (didn't bet)
Seat 4: zbig-u (small blind) folded before Flop
Seat 5: Lucases Ente (big blind) folded on the Flop
Seat 6: Luckman_brz folded on the Flop
Seat 7: HéStiA collected ($0.21)
Seat 8: In-Solem folded on the Flop
Seat 9: Dorex2007 folded before Flop (didn't bet)



PokerStars Hand #238670847205:  Hold'em No Limit ($0.02/$0.05 USD) - 2022/09/16 14:14:32 PT [2022/09/16 17:14:32 ET]
Table 'Hedera II' 9-max Seat #4 is the button
Seat 2: mahspace ($4.93 in chips) 
Seat 3: kramnoy.ivan ($6.62 in chips) 
Seat 4: zbig-u ($5 in chips) 
Seat 5: Lucases Ente ($6.37 in chips) 
Seat 7: HéStiA ($6.45 in chips) 
Seat 8: In-Solem ($7.55 in chips) 
Seat 9: Dorex2007 ($8.60 in chips) 
Lucases Ente: posts small blind $0.02
HéStiA: posts big blind $0.05
ValerkaO_o: sits out 
*** HOLE CARDS ***
Dealt to Dorex2007 [Th 7h]
In-Solem: folds 
Dorex2007: folds 
mahspace: folds 
kramnoy.ivan: folds 
zbig-u: folds 
Lucases Ente: folds 
Uncalled bet ($0.03) returned to HéStiA
HéStiA collected $0.04 from pot
*** SUMMARY ***
Total pot $0.04 | Rake $0 
Seat 2: mahspace folded before Flop (didn't bet)
Seat 3: kramnoy.ivan folded before Flop (didn't bet)
Seat 4: zbig-u (button) folded before Flop (didn't bet)
Seat 5: Lucases Ente (small blind) folded before Flop
Seat 7: HéStiA (big blind) collected ($0.04)
Seat 8: In-Solem folded before Flop (didn't bet)
Seat 9: Dorex2007 folded before Flop (didn't bet)



PokerStars Hand #238670850363:  Hold'em No Limit ($0.02/$0.05 USD) - 2022/09/16 14:14:40 PT [2022/09/16 17:14:40 ET]
Table 'Hedera II' 9-max Seat #5 is the button
Seat 2: mahspace ($4.93 in chips) 
Seat 3: kramnoy.ivan ($6.62 in chips) 
Seat 4: zbig-u ($5 in chips) 
Seat 5: Lucases Ente ($6.35 in chips) 
Seat 7: HéStiA ($6.47 in chips) 
Seat 8: In-Solem ($7.55 in chips) 
Seat 9: Dorex2007 ($8.60 in chips) 
HéStiA: posts small blind $0.02
In-Solem: posts big blind $0.05
ValerkaO_o: sits out 
*** HOLE CARDS ***
Dealt to Dorex2007 [3h 4d]
Dorex2007: folds 
mahspace: folds 
kramnoy.ivan: folds 
zbig-u: raises $0.10 to $0.15
Lucases Ente: calls $0.15
HéStiA: folds 
In-Solem: folds 
*** FLOP *** [Js 5d 5c]
zbig-u: checks 
Lucases Ente: checks 
*** TURN *** [Js 5d 5c] [3d]
zbig-u: bets $0.32
Lucases Ente: folds 
Uncalled bet ($0.32) returned to zbig-u
zbig-u collected $0.35 from pot
zbig-u: doesn't show hand 
*** SUMMARY ***
Total pot $0.37 | Rake $0.02 
Board [Js 5d 5c 3d]
Seat 2: mahspace folded before Flop (didn't bet)
Seat 3: kramnoy.ivan folded before Flop (didn't bet)
Seat 4: zbig-u collected ($0.35)
Seat 5: Lucases Ente (button) folded on the Turn
Seat 7: HéStiA (small blind) folded before Flop
Seat 8: In-Solem (big blind) folded before Flop
Seat 9: Dorex2007 folded before Flop (didn't bet)



PokerStars Hand #238670862692:  Hold'em No Limit ($0.02/$0.05 USD) - 2022/09/16 14:15:10 PT [2022/09/16 17:15:10 ET]
Table 'Hedera II' 9-max Seat #7 is the button
Seat 2: mahspace ($4.93 in chips) 
Seat 3: kramnoy.ivan ($6.62 in chips) 
Seat 4: zbig-u ($5.20 in chips) 
Seat 5: Lucases Ente ($6.20 in chips) 
Seat 7: HéStiA ($6.45 in chips) 
Seat 8: In-Solem ($7.50 in chips) 
Seat 9: Dorex2007 ($8.60 in chips) 
In-Solem: posts small blind $0.02
Dorex2007: posts big blind $0.05
ValerkaO_o: sits out 
*** HOLE CARDS ***
Dealt to Dorex2007 [Td Jh]
mahspace: folds 
kramnoy.ivan: folds 
zbig-u: folds 
Lucases Ente: calls $0.05
HéStiA: calls $0.05
In-Solem: calls $0.03
Dorex2007: checks 
*** FLOP *** [2s Qh Jd]
In-Solem: checks 
Dorex2007: checks 
Lucases Ente: checks 
HéStiA: checks 
*** TURN *** [2s Qh Jd] [2c]
In-Solem: checks 
Dorex2007: checks 
Lucases Ente: checks 
HéStiA: checks 
*** RIVER *** [2s Qh Jd 2c] [4s]
In-Solem: checks 
Dorex2007: bets $0.09
Lucases Ente: folds 
HéStiA: raises $0.37 to $0.46
In-Solem: folds 
Dorex2007: folds 
Uncalled bet ($0.37) returned to HéStiA
HéStiA collected $0.36 from pot
*** SUMMARY ***
Total pot $0.38 | Rake $0.02 
Board [2s Qh Jd 2c 4s]
Seat 2: mahspace folded before Flop (didn't bet)
Seat 3: kramnoy.ivan folded before Flop (didn't bet)
Seat 4: zbig-u folded before Flop (didn't bet)
Seat 5: Lucases Ente folded on the River
Seat 7: HéStiA (button) collected ($0.36)
Seat 8: In-Solem (small blind) folded on the River
Seat 9: Dorex2007 (big blind) folded on the River



PokerStars Hand #238670886689:  Hold'em No Limit ($0.02/$0.05 USD) - 2022/09/16 14:16:07 PT [2022/09/16 17:16:07 ET]
Table 'Hedera II' 9-max Seat #8 is the button
Seat 1: ValerkaO_o ($5 in chips) 
Seat 2: mahspace ($4.93 in chips) 
Seat 3: kramnoy.ivan ($6.62 in chips) 
Seat 4: zbig-u ($5.20 in chips) 
Seat 5: Lucases Ente ($6.15 in chips) 
Seat 7: HéStiA ($6.67 in chips) 
Seat 8: In-Solem ($7.45 in chips) 
Seat 9: Dorex2007 ($8.46 in chips) 
Dorex2007: posts small blind $0.02
ValerkaO_o: posts big blind $0.05
*** HOLE CARDS ***
Dealt to Dorex2007 [Kc 4d]
mahspace: folds 
kramnoy.ivan: folds 
zbig-u: folds 
Lucases Ente: folds 
HéStiA: folds 
In-Solem: folds 
Dorex2007: folds 
Uncalled bet ($0.03) returned to ValerkaO_o
ValerkaO_o collected $0.04 from pot
ValerkaO_o: doesn't show hand 
*** SUMMARY ***
Total pot $0.04 | Rake $0 
Seat 1: ValerkaO_o (big blind) collected ($0.04)
Seat 2: mahspace folded before Flop (didn't bet)
Seat 3: kramnoy.ivan folded before Flop (didn't bet)
Seat 4: zbig-u folded before Flop (didn't bet)
Seat 5: Lucases Ente folded before Flop (didn't bet)
Seat 7: HéStiA folded before Flop (didn't bet)
Seat 8: In-Solem (button) folded before Flop (didn't bet)
Seat 9: Dorex2007 (small blind) folded before Flop



PokerStars Hand #238670892145:  Hold'em No Limit ($0.02/$0.05 USD) - 2022/09/16 14:16:20 PT [2022/09/16 17:16:20 ET]
Table 'Hedera II' 9-max Seat #9 is the button
Seat 1: ValerkaO_o ($5.02 in chips) 
Seat 2: mahspace ($4.93 in chips) 
Seat 3: kramnoy.ivan ($6.62 in chips) 
Seat 4: zbig-u ($5.20 in chips) 
Seat 5: Lucases Ente ($6.15 in chips) 
Seat 7: HéStiA ($6.67 in chips) 
Seat 8: In-Solem ($7.45 in chips) 
Seat 9: Dorex2007 ($8.44 in chips) 
ValerkaO_o: posts small blind $0.02
mahspace: posts big blind $0.05
*** HOLE CARDS ***
Dealt to Dorex2007 [Kh 4h]
kramnoy.ivan: raises $0.05 to $0.10
zbig-u: folds 
Lucases Ente: folds 
HéStiA: folds 
In-Solem: calls $0.10
Dorex2007: calls $0.10
ValerkaO_o: folds 
mahspace: folds 
*** FLOP *** [7c 5d 3d]
kramnoy.ivan: checks 
In-Solem: checks 
Dorex2007: checks 
*** TURN *** [7c 5d 3d] [2h]
kramnoy.ivan: checks 
In-Solem: checks 
Dorex2007: checks 
*** RIVER *** [7c 5d 3d 2h] [Qs]
kramnoy.ivan: checks 
In-Solem: checks 
Dorex2007: bets $0.17
kramnoy.ivan: folds 
In-Solem: folds 
Uncalled bet ($0.17) returned to Dorex2007
Dorex2007 collected $0.35 from pot
Dorex2007: doesn't show hand 
*** SUMMARY ***
Total pot $0.37 | Rake $0.02 
Board [7c 5d 3d 2h Qs]
Seat 1: ValerkaO_o (small blind) folded before Flop
Seat 2: mahspace (big blind) folded before Flop
Seat 3: kramnoy.ivan folded on the River
Seat 4: zbig-u folded before Flop (didn't bet)
Seat 5: Lucases Ente folded before Flop (didn't bet)
Seat 7: HéStiA folded before Flop (didn't bet)
Seat 8: In-Solem folded on the River
Seat 9: Dorex2007 (button) collected ($0.35)



PokerStars Hand #238670912639:  Hold'em No Limit ($0.02/$0.05 USD) - 2022/09/16 14:17:09 PT [2022/09/16 17:17:09 ET]
Table 'Hedera II' 9-max Seat #1 is the button
Seat 1: ValerkaO_o ($5 in chips) 
Seat 2: mahspace ($4.88 in chips) 
Seat 3: kramnoy.ivan ($6.52 in chips) 
Seat 4: zbig-u ($5.20 in chips) 
Seat 5: Lucases Ente ($6.15 in chips) 
Seat 7: HéStiA ($6.67 in chips) 
Seat 8: In-Solem ($7.35 in chips) 
Seat 9: Dorex2007 ($8.69 in chips) 
mahspace: posts small blind $0.02
kramnoy.ivan: posts big blind $0.05
*** HOLE CARDS ***
Dealt to Dorex2007 [Ts Qd]
zbig-u: folds 
Lucases Ente: raises $0.05 to $0.10
HéStiA: folds 
In-Solem: raises $0.25 to $0.35
Dorex2007: folds 
ValerkaO_o: folds 
mahspace: folds 
kramnoy.ivan: folds 
Lucases Ente: calls $0.25
*** FLOP *** [3c Jd 4s]
Lucases Ente: checks 
In-Solem: bets $0.74
Lucases Ente: folds 
Uncalled bet ($0.74) returned to In-Solem
In-Solem collected $0.74 from pot
*** SUMMARY ***
Total pot $0.77 | Rake $0.03 
Board [3c Jd 4s]
Seat 1: ValerkaO_o (button) folded before Flop (didn't bet)
Seat 2: mahspace (small blind) folded before Flop
Seat 3: kramnoy.ivan (big blind) folded before Flop
Seat 4: zbig-u folded before Flop (didn't bet)
Seat 5: Lucases Ente folded on the Flop
Seat 7: HéStiA folded before Flop (didn't bet)
Seat 8: In-Solem collected ($0.74)
Seat 9: Dorex2007 folded before Flop (didn't bet)



PokerStars Hand #238670927663:  Hold'em No Limit ($0.02/$0.05 USD) - 2022/09/16 14:17:46 PT [2022/09/16 17:17:46 ET]
Table 'Hedera II' 9-max Seat #2 is the button
Seat 1: ValerkaO_o ($5 in chips) 
Seat 2: mahspace ($4.86 in chips) 
Seat 3: kramnoy.ivan ($6.47 in chips) 
Seat 4: zbig-u ($5.20 in chips) 
Seat 5: Lucases Ente ($5.80 in chips) 
Seat 7: HéStiA ($6.67 in chips) 
Seat 8: In-Solem ($7.74 in chips) 
Seat 9: Dorex2007 ($8.69 in chips) 
kramnoy.ivan: posts small blind $0.02
zbig-u: posts big blind $0.05
*** HOLE CARDS ***
Dealt to Dorex2007 [Ts 3s]
Lucases Ente: folds 
HéStiA: raises $0.07 to $0.12
In-Solem: folds 
Dorex2007: folds 
ValerkaO_o: folds 
mahspace: folds 
kramnoy.ivan: calls $0.10
zbig-u: folds 
*** FLOP *** [6d 2c Kc]
kramnoy.ivan: checks 
HéStiA: bets $0.15
kramnoy.ivan: folds 
Uncalled bet ($0.15) returned to HéStiA
HéStiA collected $0.28 from pot
*** SUMMARY ***
Total pot $0.29 | Rake $0.01 
Board [6d 2c Kc]
Seat 1: ValerkaO_o folded before Flop (didn't bet)
Seat 2: mahspace (button) folded before Flop (didn't bet)
Seat 3: kramnoy.ivan (small blind) folded on the Flop
Seat 4: zbig-u (big blind) folded before Flop
Seat 5: Lucases Ente folded before Flop (didn't bet)
Seat 7: HéStiA collected ($0.28)
Seat 8: In-Solem folded before Flop (didn't bet)
Seat 9: Dorex2007 folded before Flop (didn't bet)



PokerStars Hand #238670940910:  Hold'em No Limit ($0.02/$0.05 USD) - 2022/09/16 14:18:17 PT [2022/09/16 17:18:17 ET]
Table 'Hedera II' 9-max Seat #3 is the button
Seat 1: ValerkaO_o ($5 in chips) 
Seat 2: mahspace ($4.86 in chips) 
Seat 3: kramnoy.ivan ($6.35 in chips) 
Seat 4: zbig-u ($5.15 in chips) 
Seat 5: Lucases Ente ($5.80 in chips) 
Seat 6: Luckman_brz ($5.15 in chips) 
Seat 7: HéStiA ($6.83 in chips) 
Seat 8: In-Solem ($7.74 in chips) 
Seat 9: Dorex2007 ($8.69 in chips) 
zbig-u: posts small blind $0.02
Lucases Ente: posts big blind $0.05
Luckman_brz: posts small & big blinds $0.07
*** HOLE CARDS ***
Dealt to Dorex2007 [6d Qh]
Luckman_brz: checks 
HéStiA: folds 
In-Solem: folds 
Dorex2007: folds 
ValerkaO_o: folds 
mahspace: folds 
kramnoy.ivan: raises $0.05 to $0.10
zbig-u: folds 
Lucases Ente: folds 
Luckman_brz: folds 
Uncalled bet ($0.05) returned to kramnoy.ivan
kramnoy.ivan collected $0.19 from pot
*** SUMMARY ***
Total pot $0.19 | Rake $0 
Seat 1: ValerkaO_o folded before Flop (didn't bet)
Seat 2: mahspace folded before Flop (didn't bet)
Seat 3: kramnoy.ivan (button) collected ($0.19)
Seat 4: zbig-u (small blind) folded before Flop
Seat 5: Lucases Ente (big blind) folded before Flop
Seat 6: Luckman_brz folded before Flop (didn't bet)
Seat 7: HéStiA folded before Flop (didn't bet)
Seat 8: In-Solem folded before Flop (didn't bet)
Seat 9: Dorex2007 folded before Flop (didn't bet)



PokerStars Hand #238670950222:  Hold'em No Limit ($0.02/$0.05 USD) - 2022/09/16 14:18:40 PT [2022/09/16 17:18:40 ET]
Table 'Hedera II' 9-max Seat #4 is the button
Seat 1: ValerkaO_o ($5 in chips) 
Seat 2: mahspace ($4.86 in chips) 
Seat 3: kramnoy.ivan ($6.49 in chips) 
Seat 4: zbig-u ($5.13 in chips) 
Seat 5: Lucases Ente ($5.75 in chips) 
Seat 6: Luckman_brz ($5.08 in chips) 
Seat 7: HéStiA ($6.83 in chips) 
Seat 8: In-Solem ($7.74 in chips) 
Seat 9: Dorex2007 ($8.69 in chips) 
Lucases Ente: posts small blind $0.02
Luckman_brz: posts big blind $0.05
*** HOLE CARDS ***
Dealt to Dorex2007 [3h Th]
HéStiA: folds 
In-Solem: folds 
Dorex2007: folds 
ValerkaO_o: folds 
mahspace: folds 
kramnoy.ivan: raises $0.10 to $0.15
zbig-u: folds 
Lucases Ente: calls $0.13
Luckman_brz: folds 
*** FLOP *** [Tc 5d 3c]
Lucases Ente: checks 
kramnoy.ivan: bets $0.22
Lucases Ente: folds 
Uncalled bet ($0.22) returned to kramnoy.ivan
kramnoy.ivan collected $0.34 from pot
*** SUMMARY ***
Total pot $0.35 | Rake $0.01 
Board [Tc 5d 3c]
Seat 1: ValerkaO_o folded before Flop (didn't bet)
Seat 2: mahspace folded before Flop (didn't bet)
Seat 3: kramnoy.ivan collected ($0.34)
Seat 4: zbig-u (button) folded before Flop (didn't bet)
Seat 5: Lucases Ente (small blind) folded on the Flop
Seat 6: Luckman_brz (big blind) folded before Flop
Seat 7: HéStiA folded before Flop (didn't bet)
Seat 8: In-Solem folded before Flop (didn't bet)
Seat 9: Dorex2007 folded before Flop (didn't bet)



PokerStars Hand #238670963844:  Hold'em No Limit ($0.02/$0.05 USD) - 2022/09/16 14:19:13 PT [2022/09/16 17:19:13 ET]
Table 'Hedera II' 9-max Seat #5 is the button
Seat 1: ValerkaO_o ($5 in chips) 
Seat 2: mahspace ($4.86 in chips) 
Seat 3: kramnoy.ivan ($6.68 in chips) 
Seat 4: zbig-u ($5.13 in chips) 
Seat 5: Lucases Ente ($5.60 in chips) 
Seat 6: Luckman_brz ($5.03 in chips) 
Seat 7: HéStiA ($6.83 in chips) 
Seat 8: In-Solem ($7.74 in chips) 
Seat 9: Dorex2007 ($8.69 in chips) 
Luckman_brz: posts small blind $0.02
HéStiA: posts big blind $0.05
*** HOLE CARDS ***
Dealt to Dorex2007 [4c Td]
In-Solem: raises $0.10 to $0.15
Dorex2007: folds 
ValerkaO_o: folds 
mahspace: folds 
kramnoy.ivan: calls $0.15
zbig-u: calls $0.15
Lucases Ente: folds 
Luckman_brz: folds 
HéStiA: folds 
*** FLOP *** [5h 6h Ks]
In-Solem: folds 
In-Solem leaves the table
kramnoy.ivan: checks 
zbig-u: checks 
*** TURN *** [5h 6h Ks] [5s]
kramnoy.ivan: bets $0.25
87pinardi joins the table at seat #8 
zbig-u: folds 
Uncalled bet ($0.25) returned to kramnoy.ivan
kramnoy.ivan collected $0.50 from pot
*** SUMMARY ***
Total pot $0.52 | Rake $0.02 
Board [5h 6h Ks 5s]
Seat 1: ValerkaO_o folded before Flop (didn't bet)
Seat 2: mahspace folded before Flop (didn't bet)
Seat 3: kramnoy.ivan collected ($0.50)
Seat 4: zbig-u folded on the Turn
Seat 5: Lucases Ente (button) folded before Flop (didn't bet)
Seat 6: Luckman_brz (small blind) folded before Flop
Seat 7: HéStiA (big blind) folded before Flop
Seat 8: In-Solem folded on the Flop
Seat 9: Dorex2007 folded before Flop (didn't bet)



PokerStars Hand #238670985898:  Hold'em No Limit ($0.02/$0.05 USD) - 2022/09/16 14:20:06 PT [2022/09/16 17:20:06 ET]
Table 'Hedera II' 9-max Seat #6 is the button
Seat 1: ValerkaO_o ($5 in chips) 
Seat 2: mahspace ($4.86 in chips) 
Seat 3: kramnoy.ivan ($7.03 in chips) 
Seat 4: zbig-u ($5 in chips) 
Seat 5: Lucases Ente ($5.60 in chips) 
Seat 6: Luckman_brz ($5.01 in chips) 
Seat 7: HéStiA ($6.78 in chips) 
Seat 8: 87pinardi ($5 in chips) 
Seat 9: Dorex2007 ($8.69 in chips) 
HéStiA: posts small blind $0.02
87pinardi: posts big blind $0.05
*** HOLE CARDS ***
Dealt to Dorex2007 [Ah 4c]
Dorex2007: folds 
ValerkaO_o: folds 
mahspace: folds 
kramnoy.ivan: folds 
zbig-u: folds 
Lucases Ente: folds 
Luckman_brz: folds 
HéStiA: folds 
Uncalled bet ($0.03) returned to 87pinardi
87pinardi collected $0.04 from pot
87pinardi: doesn't show hand 
*** SUMMARY ***
Total pot $0.04 | Rake $0 
Seat 1: ValerkaO_o folded before Flop (didn't bet)
Seat 2: mahspace folded before Flop (didn't bet)
Seat 3: kramnoy.ivan folded before Flop (didn't bet)
Seat 4: zbig-u folded before Flop (didn't bet)
Seat 5: Lucases Ente folded before Flop (didn't bet)
Seat 6: Luckman_brz (button) folded before Flop (didn't bet)
Seat 7: HéStiA (small blind) folded before Flop
Seat 8: 87pinardi (big blind) collected ($0.04)
Seat 9: Dorex2007 folded before Flop (didn't bet)



PokerStars Hand #238670991640:  Hold'em No Limit ($0.02/$0.05 USD) - 2022/09/16 14:20:20 PT [2022/09/16 17:20:20 ET]
Table 'Hedera II' 9-max Seat #7 is the button
Seat 1: ValerkaO_o ($5 in chips) 
Seat 2: mahspace ($4.86 in chips) 
Seat 3: kramnoy.ivan ($7.03 in chips) 
Seat 4: zbig-u ($5 in chips) 
Seat 5: Lucases Ente ($5.60 in chips) 
Seat 6: Luckman_brz ($5.01 in chips) 
Seat 7: HéStiA ($6.76 in chips) 
Seat 8: 87pinardi ($5.02 in chips) 
Seat 9: Dorex2007 ($8.69 in chips) 
87pinardi: posts small blind $0.02
Dorex2007: posts big blind $0.05
*** HOLE CARDS ***
Dealt to Dorex2007 [Kd Th]
ValerkaO_o: folds 
mahspace: folds 
kramnoy.ivan: raises $0.10 to $0.15
zbig-u: folds 
Lucases Ente: folds 
Luckman_brz: folds 
HéStiA: folds 
87pinardi: folds 
Dorex2007: folds 
Uncalled bet ($0.10) returned to kramnoy.ivan
kramnoy.ivan collected $0.12 from pot
*** SUMMARY ***
Total pot $0.12 | Rake $0 
Seat 1: ValerkaO_o folded before Flop (didn't bet)
Seat 2: mahspace folded before Flop (didn't bet)
Seat 3: kramnoy.ivan collected ($0.12)
Seat 4: zbig-u folded before Flop (didn't bet)
Seat 5: Lucases Ente folded before Flop (didn't bet)
Seat 6: Luckman_brz folded before Flop (didn't bet)
Seat 7: HéStiA (button) folded before Flop (didn't bet)
Seat 8: 87pinardi (small blind) folded before Flop
Seat 9: Dorex2007 (big blind) folded before Flop



PokerStars Hand #238671000904:  Hold'em No Limit ($0.02/$0.05 USD) - 2022/09/16 14:20:43 PT [2022/09/16 17:20:43 ET]
Table 'Hedera II' 9-max Seat #8 is the button
Seat 1: ValerkaO_o ($5 in chips) 
Seat 2: mahspace ($4.86 in chips) 
Seat 3: kramnoy.ivan ($7.10 in chips) 
Seat 4: zbig-u ($5 in chips) 
Seat 5: Lucases Ente ($5.60 in chips) 
Seat 6: Luckman_brz ($5.01 in chips) 
Seat 7: HéStiA ($6.76 in chips) 
Seat 8: 87pinardi ($5 in chips) 
Seat 9: Dorex2007 ($8.64 in chips) 
Dorex2007: posts small blind $0.02
ValerkaO_o: posts big blind $0.05
*** HOLE CARDS ***
Dealt to Dorex2007 [Qd Kh]
mahspace: folds 
kramnoy.ivan: raises $0.05 to $0.10
zbig-u: folds 
Lucases Ente: calls $0.10
Luckman_brz: calls $0.10
HéStiA: calls $0.10
87pinardi: folds 
Dorex2007: folds 
ValerkaO_o: folds 
*** FLOP *** [5c Jh 2h]
kramnoy.ivan: checks 
Lucases Ente: checks 
Luckman_brz: checks 
HéStiA: bets $0.22
kramnoy.ivan: folds 
Lucases Ente: folds 
Luckman_brz: folds 
Uncalled bet ($0.22) returned to HéStiA
HéStiA collected $0.45 from pot
*** SUMMARY ***
Total pot $0.47 | Rake $0.02 
Board [5c Jh 2h]
Seat 1: ValerkaO_o (big blind) folded before Flop
Seat 2: mahspace folded before Flop (didn't bet)
Seat 3: kramnoy.ivan folded on the Flop
Seat 4: zbig-u folded before Flop (didn't bet)
Seat 5: Lucases Ente folded on the Flop
Seat 6: Luckman_brz folded on the Flop
Seat 7: HéStiA collected ($0.45)
Seat 8: 87pinardi (button) folded before Flop (didn't bet)
Seat 9: Dorex2007 (small blind) folded before Flop



PokerStars Hand #238671020930:  Hold'em No Limit ($0.02/$0.05 USD) - 2022/09/16 14:21:31 PT [2022/09/16 17:21:31 ET]
Table 'Hedera II' 9-max Seat #9 is the button
Seat 1: ValerkaO_o ($5 in chips) 
Seat 2: mahspace ($4.86 in chips) 
Seat 3: kramnoy.ivan ($7 in chips) 
Seat 4: zbig-u ($5 in chips) 
Seat 5: Lucases Ente ($5.50 in chips) 
Seat 6: Luckman_brz ($4.91 in chips) 
Seat 7: HéStiA ($7.11 in chips) 
Seat 8: 87pinardi ($5 in chips) 
Seat 9: Dorex2007 ($8.62 in chips) 
ValerkaO_o: posts small blind $0.02
mahspace: posts big blind $0.05
*** HOLE CARDS ***
Dealt to Dorex2007 [Jh 9c]
kramnoy.ivan: folds 
zbig-u: folds 
Lucases Ente: raises $0.10 to $0.15
Luckman_brz: calls $0.15
HéStiA: folds 
87pinardi: folds 
Dorex2007: folds 
ValerkaO_o: calls $0.13
mahspace: folds 
*** FLOP *** [3s Ts 3h]
ValerkaO_o: checks 
Lucases Ente: bets $0.25
Luckman_brz: calls $0.25
ValerkaO_o: folds 
*** TURN *** [3s Ts 3h] [2h]
Lucases Ente: checks 
Luckman_brz: bets $0.15
Lucases Ente: calls $0.15
*** RIVER *** [3s Ts 3h 2h] [Qc]
Lucases Ente: checks 
Luckman_brz: checks 
*** SHOW DOWN ***
Lucases Ente: shows [9h 9d] (two pair, Nines and Threes)
Luckman_brz: shows [As Ac] (two pair, Aces and Threes)
Luckman_brz collected $1.25 from pot
*** SUMMARY ***
Total pot $1.30 | Rake $0.05 
Board [3s Ts 3h 2h Qc]
Seat 1: ValerkaO_o (small blind) folded on the Flop
Seat 2: mahspace (big blind) folded before Flop
Seat 3: kramnoy.ivan folded before Flop (didn't bet)
Seat 4: zbig-u folded before Flop (didn't bet)
Seat 5: Lucases Ente showed [9h 9d] and lost with two pair, Nines and Threes
Seat 6: Luckman_brz showed [As Ac] and won ($1.25) with two pair, Aces and Threes
Seat 7: HéStiA folded before Flop (didn't bet)
Seat 8: 87pinardi folded before Flop (didn't bet)
Seat 9: Dorex2007 (button) folded before Flop (didn't bet)



PokerStars Hand #238671042545:  Hold'em No Limit ($0.02/$0.05 USD) - 2022/09/16 14:22:23 PT [2022/09/16 17:22:23 ET]
Table 'Hedera II' 9-max Seat #1 is the button
Seat 1: ValerkaO_o ($5 in chips) 
Seat 2: mahspace ($4.81 in chips) 
Seat 3: kramnoy.ivan ($7 in chips) 
Seat 4: zbig-u ($5 in chips) 
Seat 5: Lucases Ente ($4.95 in chips) 
Seat 6: Luckman_brz ($5.61 in chips) 
Seat 7: HéStiA ($7.11 in chips) 
Seat 8: 87pinardi ($5 in chips) 
Seat 9: Dorex2007 ($8.62 in chips) 
mahspace: posts small blind $0.02
kramnoy.ivan: posts big blind $0.05
*** HOLE CARDS ***
Dealt to Dorex2007 [Qd 7s]
zbig-u: raises $0.10 to $0.15
Lucases Ente: folds 
Luckman_brz: folds 
HéStiA: folds 
87pinardi: folds 
Lucases Ente leaves the table
Dorex2007: folds 
ValerkaO_o: folds 
mahspace: folds 
kramnoy.ivan: folds 
Uncalled bet ($0.10) returned to zbig-u
zbig-u collected $0.12 from pot
zbig-u: doesn't show hand 
*** SUMMARY ***
Total pot $0.12 | Rake $0 
Seat 1: ValerkaO_o (button) folded before Flop (didn't bet)
Seat 2: mahspace (small blind) folded before Flop
Seat 3: kramnoy.ivan (big blind) folded before Flop
Seat 4: zbig-u collected ($0.12)
Seat 5: Lucases Ente folded before Flop (didn't bet)
Seat 6: Luckman_brz folded before Flop (didn't bet)
Seat 7: HéStiA folded before Flop (didn't bet)
Seat 8: 87pinardi folded before Flop (didn't bet)
Seat 9: Dorex2007 folded before Flop (didn't bet)



PokerStars Hand #238671050528:  Hold'em No Limit ($0.02/$0.05 USD) - 2022/09/16 14:22:43 PT [2022/09/16 17:22:43 ET]
Table 'Hedera II' 9-max Seat #2 is the button
Seat 1: ValerkaO_o ($5 in chips) 
Seat 2: mahspace ($4.79 in chips) 
Seat 3: kramnoy.ivan ($6.95 in chips) 
Seat 4: zbig-u ($5.07 in chips) 
Seat 6: Luckman_brz ($5.61 in chips) 
Seat 7: HéStiA ($7.11 in chips) 
Seat 8: 87pinardi ($5 in chips) 
Seat 9: Dorex2007 ($8.62 in chips) 
kramnoy.ivan: posts small blind $0.02
zbig-u: posts big blind $0.05
*** HOLE CARDS ***
Dealt to Dorex2007 [Js 2h]
Luckman_brz: folds 
HéStiA: folds 
87pinardi: folds 
Dorex2007: folds 
ValerkaO_o: folds 
mahspace: raises $0.10 to $0.15
kramnoy.ivan: folds 
zbig-u: folds 
Uncalled bet ($0.10) returned to mahspace
mahspace collected $0.12 from pot
mahspace: doesn't show hand 
*** SUMMARY ***
Total pot $0.12 | Rake $0 
Seat 1: ValerkaO_o folded before Flop (didn't bet)
Seat 2: mahspace (button) collected ($0.12)
Seat 3: kramnoy.ivan (small blind) folded before Flop
Seat 4: zbig-u (big blind) folded before Flop
Seat 6: Luckman_brz folded before Flop (didn't bet)
Seat 7: HéStiA folded before Flop (didn't bet)
Seat 8: 87pinardi folded before Flop (didn't bet)
Seat 9: Dorex2007 folded before Flop (didn't bet)



PokerStars Hand #238671057489:  Hold'em No Limit ($0.02/$0.05 USD) - 2022/09/16 14:23:00 PT [2022/09/16 17:23:00 ET]
Table 'Hedera II' 9-max Seat #3 is the button
Seat 1: ValerkaO_o ($5 in chips) 
Seat 2: mahspace ($4.86 in chips) 
Seat 3: kramnoy.ivan ($6.93 in chips) 
Seat 4: zbig-u ($5.02 in chips) 
Seat 6: Luckman_brz ($5.61 in chips) 
Seat 7: HéStiA ($7.11 in chips) 
Seat 8: 87pinardi ($5 in chips) 
Seat 9: Dorex2007 ($8.62 in chips) 
zbig-u: posts small blind $0.02
Luckman_brz: posts big blind $0.05
*** HOLE CARDS ***
Dealt to Dorex2007 [2c 2d]
HéStiA: folds 
87pinardi: folds 
Dorex2007: calls $0.05
ValerkaO_o: folds 
mahspace: folds 
kramnoy.ivan: folds 
zbig-u: folds 
Luckman_brz: checks 
*** FLOP *** [Qs 2s Ks]
Luckman_brz: checks 
Dorex2007: bets $0.12
Luckman_brz: folds 
Uncalled bet ($0.12) returned to Dorex2007
Dorex2007 collected $0.12 from pot
Dorex2007: doesn't show hand 
*** SUMMARY ***
Total pot $0.12 | Rake $0 
Board [Qs 2s Ks]
Seat 1: ValerkaO_o folded before Flop (didn't bet)
Seat 2: mahspace folded before Flop (didn't bet)
Seat 3: kramnoy.ivan (button) folded before Flop (didn't bet)
Seat 4: zbig-u (small blind) folded before Flop
Seat 6: Luckman_brz (big blind) folded on the Flop
Seat 7: HéStiA folded before Flop (didn't bet)
Seat 8: 87pinardi folded before Flop (didn't bet)
Seat 9: Dorex2007 collected ($0.12)



PokerStars Hand #238671070667:  Hold'em No Limit ($0.02/$0.05 USD) - 2022/09/16 14:23:32 PT [2022/09/16 17:23:32 ET]
Table 'Hedera II' 9-max Seat #4 is the button
Seat 1: ValerkaO_o ($5 in chips) 
Seat 2: mahspace ($4.86 in chips) 
Seat 3: kramnoy.ivan ($6.93 in chips) 
Seat 4: zbig-u ($5 in chips) 
Seat 6: Luckman_brz ($5.56 in chips) 
Seat 7: HéStiA ($7.11 in chips) 
Seat 8: 87pinardi ($5 in chips) 
Seat 9: Dorex2007 ($8.69 in chips) 
Luckman_brz: posts small blind $0.02
HéStiA: posts big blind $0.05
*** HOLE CARDS ***
Dealt to Dorex2007 [9h 8c]
87pinardi: folds 
Dorex2007: folds 
ValerkaO_o: folds 
mahspace: raises $0.15 to $0.20
kramnoy.ivan: calls $0.20
zbig-u: raises $0.25 to $0.45
MarkFitz76 joins the table at seat #5 
Luckman_brz: folds 
HéStiA: folds 
mahspace: calls $0.25
kramnoy.ivan: calls $0.25
*** FLOP *** [Jc Qs 6d]
mahspace: checks 
kramnoy.ivan: checks 
zbig-u: bets $0.68
mahspace: raises $0.68 to $1.36
kramnoy.ivan: folds 
zbig-u: calls $0.68
*** TURN *** [Jc Qs 6d] [Ad]
mahspace: bets $2.38
zbig-u: calls $2.38
*** RIVER *** [Jc Qs 6d Ad] [Qd]
mahspace: bets $0.67 and is all-in
zbig-u: calls $0.67
*** SHOW DOWN ***
mahspace: shows [Ks Kh] (two pair, Kings and Queens)
zbig-u: shows [Kc Ah] (two pair, Aces and Queens)
zbig-u collected $9.82 from pot
*** SUMMARY ***
Total pot $10.24 | Rake $0.42 
Board [Jc Qs 6d Ad Qd]
Seat 1: ValerkaO_o folded before Flop (didn't bet)
Seat 2: mahspace showed [Ks Kh] and lost with two pair, Kings and Queens
Seat 3: kramnoy.ivan folded on the Flop
Seat 4: zbig-u (button) showed [Kc Ah] and won ($9.82) with two pair, Aces and Queens
Seat 6: Luckman_brz (small blind) folded before Flop
Seat 7: HéStiA (big blind) folded before Flop
Seat 8: 87pinardi folded before Flop (didn't bet)
Seat 9: Dorex2007 folded before Flop (didn't bet)



PokerStars Hand #238671093881:  Hold'em No Limit ($0.02/$0.05 USD) - 2022/09/16 14:24:28 PT [2022/09/16 17:24:28 ET]
Table 'Hedera II' 9-max Seat #6 is the button
Seat 1: ValerkaO_o ($5 in chips) 
Seat 3: kramnoy.ivan ($6.48 in chips) 
Seat 4: zbig-u ($9.96 in chips) 
Seat 6: Luckman_brz ($5.54 in chips) 
Seat 7: HéStiA ($7.06 in chips) 
Seat 8: 87pinardi ($5 in chips) 
Seat 9: Dorex2007 ($8.69 in chips) 
HéStiA: posts small blind $0.02
87pinardi: posts big blind $0.05
MarkFitz76: sits out 
*** HOLE CARDS ***
Dealt to Dorex2007 [Qc 9h]
Dorex2007: folds 
ValerkaO_o: folds 
mahspace leaves the table
kramnoy.ivan: raises $0.05 to $0.10
zbig-u: folds 
Luckman_brz: folds 
HéStiA: folds 
87pinardi: folds 
Uncalled bet ($0.05) returned to kramnoy.ivan
kramnoy.ivan collected $0.12 from pot
*** SUMMARY ***
Total pot $0.12 | Rake $0 
Seat 1: ValerkaO_o folded before Flop (didn't bet)
Seat 3: kramnoy.ivan collected ($0.12)
Seat 4: zbig-u folded before Flop (didn't bet)
Seat 6: Luckman_brz (button) folded before Flop (didn't bet)
Seat 7: HéStiA (small blind) folded before Flop
Seat 8: 87pinardi (big blind) folded before Flop
Seat 9: Dorex2007 folded before Flop (didn't bet)



PokerStars Hand #238671103100:  Hold'em No Limit ($0.02/$0.05 USD) - 2022/09/16 14:24:51 PT [2022/09/16 17:24:51 ET]
Table 'Hedera II' 9-max Seat #7 is the button
Seat 1: ValerkaO_o ($5 in chips) 
Seat 3: kramnoy.ivan ($6.55 in chips) 
Seat 4: zbig-u ($9.96 in chips) 
Seat 6: Luckman_brz ($5.54 in chips) 
Seat 7: HéStiA ($7.04 in chips) 
Seat 8: 87pinardi ($4.95 in chips) 
Seat 9: Dorex2007 ($8.69 in chips) 
87pinardi: posts small blind $0.02
Dorex2007: posts big blind $0.05
MarkFitz76: sits out 
*** HOLE CARDS ***
Dealt to Dorex2007 [8d 8c]
ValerkaO_o: folds 
kramnoy.ivan: raises $0.05 to $0.10
zbig-u: folds 
Luckman_brz: calls $0.10
HéStiA: calls $0.10
87pinardi: folds 
Dorex2007: calls $0.05
*** FLOP *** [Ac 3c Kc]
Dorex2007: checks 
kramnoy.ivan: checks 
Luckman_brz: checks 
HéStiA: bets $0.20
Dorex2007: folds 
kramnoy.ivan: folds 
Luckman_brz: folds 
Uncalled bet ($0.20) returned to HéStiA
HéStiA collected $0.40 from pot
*** SUMMARY ***
Total pot $0.42 | Rake $0.02 
Board [Ac 3c Kc]
Seat 1: ValerkaO_o folded before Flop (didn't bet)
Seat 3: kramnoy.ivan folded on the Flop
Seat 4: zbig-u folded before Flop (didn't bet)
Seat 6: Luckman_brz folded on the Flop
Seat 7: HéStiA (button) collected ($0.40)
Seat 8: 87pinardi (small blind) folded before Flop
Seat 9: Dorex2007 (big blind) folded on the Flop



PokerStars Hand #238671119794:  Hold'em No Limit ($0.02/$0.05 USD) - 2022/09/16 14:25:32 PT [2022/09/16 17:25:32 ET]
Table 'Hedera II' 9-max Seat #8 is the button
Seat 1: ValerkaO_o ($5 in chips) 
Seat 3: kramnoy.ivan ($6.45 in chips) 
Seat 4: zbig-u ($9.96 in chips) 
Seat 6: Luckman_brz ($5.44 in chips) 
Seat 7: HéStiA ($7.34 in chips) 
Seat 8: 87pinardi ($4.93 in chips) 
Seat 9: Dorex2007 ($8.59 in chips) 
Dorex2007: posts small blind $0.02
ValerkaO_o: posts big blind $0.05
MarkFitz76: sits out 
*** HOLE CARDS ***
Dealt to Dorex2007 [9s 4s]
kramnoy.ivan: folds 
zbig-u: folds 
Luckman_brz: calls $0.05
HéStiA: folds 
87pinardi: folds 
Dorex2007: folds 
ValerkaO_o: checks 
*** FLOP *** [9c 7c Qd]
ValerkaO_o: checks 
Luckman_brz: checks 
*** TURN *** [9c 7c Qd] [8c]
ValerkaO_o: checks 
Luckman_brz: checks 
*** RIVER *** [9c 7c Qd 8c] [Td]
ValerkaO_o: checks 
Luckman_brz: checks 
*** SHOW DOWN ***
ValerkaO_o: shows [5d 3d] (high card Queen)
Luckman_brz: shows [Ts Ac] (a pair of Tens)
Luckman_brz collected $0.12 from pot
*** SUMMARY ***
Total pot $0.12 | Rake $0 
Board [9c 7c Qd 8c Td]
Seat 1: ValerkaO_o (big blind) showed [5d 3d] and lost with high card Queen
Seat 3: kramnoy.ivan folded before Flop (didn't bet)
Seat 4: zbig-u folded before Flop (didn't bet)
Seat 6: Luckman_brz showed [Ts Ac] and won ($0.12) with a pair of Tens
Seat 7: HéStiA folded before Flop (didn't bet)
Seat 8: 87pinardi (button) folded before Flop (didn't bet)
Seat 9: Dorex2007 (small blind) folded before Flop



PokerStars Hand #238671132588:  Hold'em No Limit ($0.02/$0.05 USD) - 2022/09/16 14:26:03 PT [2022/09/16 17:26:03 ET]
Table 'Hedera II' 9-max Seat #9 is the button
Seat 1: ValerkaO_o ($5 in chips) 
Seat 3: kramnoy.ivan ($6.45 in chips) 
Seat 4: zbig-u ($9.96 in chips) 
Seat 6: Luckman_brz ($5.51 in chips) 
Seat 7: HéStiA ($7.34 in chips) 
Seat 8: 87pinardi ($4.93 in chips) 
Seat 9: Dorex2007 ($8.57 in chips) 
ValerkaO_o: posts small blind $0.02
kramnoy.ivan: posts big blind $0.05
MarkFitz76: sits out 
*** HOLE CARDS ***
Dealt to Dorex2007 [3s Ac]
zbig-u: folds 
Luckman_brz: calls $0.05
HéStiA: folds 
87pinardi: folds 
Dorex2007: folds 
ValerkaO_o: folds 
kramnoy.ivan: raises $0.05 to $0.10
Luckman_brz: calls $0.05
*** FLOP *** [Ts Kh Qc]
kramnoy.ivan: bets $0.21
Luckman_brz: folds 
Uncalled bet ($0.21) returned to kramnoy.ivan
kramnoy.ivan collected $0.21 from pot
*** SUMMARY ***
Total pot $0.22 | Rake $0.01 
Board [Ts Kh Qc]
Seat 1: ValerkaO_o (small blind) folded before Flop
Seat 3: kramnoy.ivan (big blind) collected ($0.21)
Seat 4: zbig-u folded before Flop (didn't bet)
Seat 6: Luckman_brz folded on the Flop
Seat 7: HéStiA folded before Flop (didn't bet)
Seat 8: 87pinardi folded before Flop (didn't bet)
Seat 9: Dorex2007 (button) folded before Flop (didn't bet)



PokerStars Hand #238671149224:  Hold'em No Limit ($0.02/$0.05 USD) - 2022/09/16 14:26:44 PT [2022/09/16 17:26:44 ET]
Table 'Hedera II' 9-max Seat #1 is the button
Seat 1: ValerkaO_o ($5 in chips) 
Seat 3: kramnoy.ivan ($6.56 in chips) 
Seat 4: zbig-u ($9.96 in chips) 
Seat 6: Luckman_brz ($5.41 in chips) 
Seat 7: HéStiA ($7.34 in chips) 
Seat 8: 87pinardi ($4.93 in chips) 
Seat 9: Dorex2007 ($8.57 in chips) 
kramnoy.ivan: posts small blind $0.02
zbig-u: posts big blind $0.05
MarkFitz76: sits out 
*** HOLE CARDS ***
Dealt to Dorex2007 [7s Js]
TheQuicksand joins the table at seat #2 
Luckman_brz: folds 
HéStiA: folds 
87pinardi: folds 
Dorex2007: folds 
ValerkaO_o: calls $0.05
kramnoy.ivan: raises $0.05 to $0.10
zbig-u: calls $0.05
ValerkaO_o: calls $0.05
*** FLOP *** [5d 2d 9d]
kramnoy.ivan: checks 
zbig-u: checks 
ValerkaO_o: checks 
*** TURN *** [5d 2d 9d] [Kc]
kramnoy.ivan: checks 
zbig-u: checks 
ValerkaO_o: checks 
*** RIVER *** [5d 2d 9d Kc] [3c]
kramnoy.ivan: checks 
zbig-u: checks 
ValerkaO_o: checks 
*** SHOW DOWN ***
kramnoy.ivan: shows [4c Qc] (high card King)
zbig-u: shows [Qh Td] (high card King - Queen+Ten kicker)
ValerkaO_o: shows [4h 5h] (a pair of Fives)
ValerkaO_o collected $0.29 from pot
*** SUMMARY ***
Total pot $0.30 | Rake $0.01 
Board [5d 2d 9d Kc 3c]
Seat 1: ValerkaO_o (button) showed [4h 5h] and won ($0.29) with a pair of Fives
Seat 3: kramnoy.ivan (small blind) showed [4c Qc] and lost with high card King
Seat 4: zbig-u (big blind) showed [Qh Td] and lost with high card King
Seat 6: Luckman_brz folded before Flop (didn't bet)
Seat 7: HéStiA folded before Flop (didn't bet)
Seat 8: 87pinardi folded before Flop (didn't bet)
Seat 9: Dorex2007 folded before Flop (didn't bet)



PokerStars Hand #238671166704:  Hold'em No Limit ($0.02/$0.05 USD) - 2022/09/16 14:27:27 PT [2022/09/16 17:27:27 ET]
Table 'Hedera II' 9-max Seat #3 is the button
Seat 1: ValerkaO_o ($5.19 in chips) 
Seat 2: TheQuicksand ($5 in chips) 
Seat 3: kramnoy.ivan ($6.46 in chips) 
Seat 4: zbig-u ($9.86 in chips) 
Seat 5: MarkFitz76 ($5 in chips) 
Seat 6: Luckman_brz ($5.41 in chips) 
Seat 7: HéStiA ($7.34 in chips) 
Seat 8: 87pinardi ($4.93 in chips) 
Seat 9: Dorex2007 ($8.57 in chips) 
zbig-u: posts small blind $0.02
MarkFitz76: posts big blind $0.05
TheQuicksand: posts big blind $0.05
*** HOLE CARDS ***
Dealt to Dorex2007 [2s 5d]
Luckman_brz: folds 
HéStiA: folds 
87pinardi: folds 
Dorex2007: folds 
ValerkaO_o: folds 
TheQuicksand: checks 
kramnoy.ivan: raises $0.05 to $0.10
zbig-u: folds 
MarkFitz76: calls $0.05
TheQuicksand: calls $0.05
*** FLOP *** [4s Qs 3h]
MarkFitz76: checks 
TheQuicksand: checks 
kramnoy.ivan: checks 
*** TURN *** [4s Qs 3h] [9s]
MarkFitz76: checks 
TheQuicksand: checks 
kramnoy.ivan: checks 
*** RIVER *** [4s Qs 3h 9s] [Qd]
MarkFitz76: checks 
TheQuicksand: checks 
kramnoy.ivan: checks 
*** SHOW DOWN ***
MarkFitz76: shows [6d Jd] (a pair of Queens)
TheQuicksand: shows [Kd 9h] (two pair, Queens and Nines)
kramnoy.ivan: mucks hand 
TheQuicksand collected $0.31 from pot
*** SUMMARY ***
Total pot $0.32 | Rake $0.01 
Board [4s Qs 3h 9s Qd]
Seat 1: ValerkaO_o folded before Flop (didn't bet)
Seat 2: TheQuicksand showed [Kd 9h] and won ($0.31) with two pair, Queens and Nines
Seat 3: kramnoy.ivan (button) mucked [7h 6h]
Seat 4: zbig-u (small blind) folded before Flop
Seat 5: MarkFitz76 (big blind) showed [6d Jd] and lost with a pair of Queens
Seat 6: Luckman_brz folded before Flop (didn't bet)
Seat 7: HéStiA folded before Flop (didn't bet)
Seat 8: 87pinardi folded before Flop (didn't bet)
Seat 9: Dorex2007 folded before Flop (didn't bet)



PokerStars Hand #238671191935:  Hold'em No Limit ($0.02/$0.05 USD) - 2022/09/16 14:28:29 PT [2022/09/16 17:28:29 ET]
Table 'Hedera II' 9-max Seat #4 is the button
Seat 1: ValerkaO_o ($5.19 in chips) 
Seat 2: TheQuicksand ($5.21 in chips) 
Seat 3: kramnoy.ivan ($6.36 in chips) 
Seat 4: zbig-u ($9.84 in chips) 
Seat 5: MarkFitz76 ($5 in chips) 
Seat 6: Luckman_brz ($5.41 in chips) 
Seat 7: HéStiA ($7.34 in chips) 
Seat 8: 87pinardi ($4.93 in chips) 
Seat 9: Dorex2007 ($8.57 in chips) 
MarkFitz76: posts small blind $0.02
Luckman_brz: posts big blind $0.05
*** HOLE CARDS ***
Dealt to Dorex2007 [Td 3d]
HéStiA: folds 
87pinardi: raises $0.10 to $0.15
Dorex2007: folds 
ValerkaO_o: folds 
TheQuicksand: folds 
kramnoy.ivan: folds 
zbig-u: calls $0.15
MarkFitz76: folds 
Luckman_brz: folds 
*** FLOP *** [9h Qh 4c]
87pinardi: checks 
zbig-u: bets $0.18
87pinardi: folds 
Uncalled bet ($0.18) returned to zbig-u
zbig-u collected $0.35 from pot
zbig-u: doesn't show hand 
*** SUMMARY ***
Total pot $0.37 | Rake $0.02 
Board [9h Qh 4c]
Seat 1: ValerkaO_o folded before Flop (didn't bet)
Seat 2: TheQuicksand folded before Flop (didn't bet)
Seat 3: kramnoy.ivan folded before Flop (didn't bet)
Seat 4: zbig-u (button) collected ($0.35)
Seat 5: MarkFitz76 (small blind) folded before Flop
Seat 6: Luckman_brz (big blind) folded before Flop
Seat 7: HéStiA folded before Flop (didn't bet)
Seat 8: 87pinardi folded on the Flop
Seat 9: Dorex2007 folded before Flop (didn't bet)



PokerStars Hand #238671205310:  Hold'em No Limit ($0.02/$0.05 USD) - 2022/09/16 14:29:01 PT [2022/09/16 17:29:01 ET]
Table 'Hedera II' 9-max Seat #5 is the button
Seat 1: ValerkaO_o ($5.19 in chips) 
Seat 2: TheQuicksand ($5.21 in chips) 
Seat 3: kramnoy.ivan ($6.36 in chips) 
Seat 4: zbig-u ($10.04 in chips) 
Seat 5: MarkFitz76 ($5 in chips) 
Seat 6: Luckman_brz ($5.36 in chips) 
Seat 7: HéStiA ($7.34 in chips) 
Seat 8: 87pinardi ($4.78 in chips) 
Seat 9: Dorex2007 ($8.57 in chips) 
Luckman_brz: posts small blind $0.02
HéStiA: posts big blind $0.05
*** HOLE CARDS ***
Dealt to Dorex2007 [6c 9s]
87pinardi: folds 
Dorex2007: folds 
ValerkaO_o: folds 
TheQuicksand: folds 
kramnoy.ivan: folds 
zbig-u: folds 
MarkFitz76: raises $0.10 to $0.15
Luckman_brz: folds 
HéStiA: calls $0.10
*** FLOP *** [Kh 5c 4d]
HéStiA: checks 
MarkFitz76: checks 
*** TURN *** [Kh 5c 4d] [Qc]
HéStiA: checks 
MarkFitz76: bets $0.15
HéStiA: folds 
Uncalled bet ($0.15) returned to MarkFitz76
MarkFitz76 collected $0.31 from pot
MarkFitz76: doesn't show hand 
*** SUMMARY ***
Total pot $0.32 | Rake $0.01 
Board [Kh 5c 4d Qc]
Seat 1: ValerkaO_o folded before Flop (didn't bet)
Seat 2: TheQuicksand folded before Flop (didn't bet)
Seat 3: kramnoy.ivan folded before Flop (didn't bet)
Seat 4: zbig-u folded before Flop (didn't bet)
Seat 5: MarkFitz76 (button) collected ($0.31)
Seat 6: Luckman_brz (small blind) folded before Flop
Seat 7: HéStiA (big blind) folded on the Turn
Seat 8: 87pinardi folded before Flop (didn't bet)
Seat 9: Dorex2007 folded before Flop (didn't bet)



PokerStars Hand #238671224863:  Hold'em No Limit ($0.02/$0.05 USD) - 2022/09/16 14:29:49 PT [2022/09/16 17:29:49 ET]
Table 'Hedera II' 9-max Seat #6 is the button
Seat 1: ValerkaO_o ($5.19 in chips) 
Seat 2: TheQuicksand ($5.21 in chips) 
Seat 3: kramnoy.ivan ($6.36 in chips) 
Seat 4: zbig-u ($10.04 in chips) 
Seat 5: MarkFitz76 ($5.16 in chips) 
Seat 6: Luckman_brz ($5.34 in chips) 
Seat 7: HéStiA ($7.19 in chips) 
Seat 8: 87pinardi ($4.78 in chips) 
Seat 9: Dorex2007 ($8.57 in chips) 
HéStiA: posts small blind $0.02
87pinardi: posts big blind $0.05
*** HOLE CARDS ***
Dealt to Dorex2007 [5h 8h]
Dorex2007: folds 
ValerkaO_o: folds 
TheQuicksand: folds 
kramnoy.ivan: raises $0.05 to $0.10
zbig-u: folds 
MarkFitz76: folds 
Luckman_brz: folds 
HéStiA: folds 
87pinardi: calls $0.05
*** FLOP *** [Qc 8d Ks]
87pinardi: checks 
kramnoy.ivan: checks 
*** TURN *** [Qc 8d Ks] [7d]
87pinardi: checks 
kramnoy.ivan: checks 
*** RIVER *** [Qc 8d Ks 7d] [4s]
87pinardi: checks 
kramnoy.ivan: checks 
*** SHOW DOWN ***
87pinardi: shows [Js Ah] (high card Ace)
kramnoy.ivan: shows [6h 6s] (a pair of Sixes)
kramnoy.ivan collected $0.21 from pot
*** SUMMARY ***
Total pot $0.22 | Rake $0.01 
Board [Qc 8d Ks 7d 4s]
Seat 1: ValerkaO_o folded before Flop (didn't bet)
Seat 2: TheQuicksand folded before Flop (didn't bet)
Seat 3: kramnoy.ivan showed [6h 6s] and won ($0.21) with a pair of Sixes
Seat 4: zbig-u folded before Flop (didn't bet)
Seat 5: MarkFitz76 folded before Flop (didn't bet)
Seat 6: Luckman_brz (button) folded before Flop (didn't bet)
Seat 7: HéStiA (small blind) folded before Flop
Seat 8: 87pinardi (big blind) showed [Js Ah] and lost with high card Ace
Seat 9: Dorex2007 folded before Flop (didn't bet)



PokerStars Hand #238671238288:  Hold'em No Limit ($0.02/$0.05 USD) - 2022/09/16 14:30:22 PT [2022/09/16 17:30:22 ET]
Table 'Hedera II' 9-max Seat #7 is the button
Seat 1: ValerkaO_o ($5.19 in chips) 
Seat 2: TheQuicksand ($5.21 in chips) 
Seat 3: kramnoy.ivan ($6.47 in chips) 
Seat 4: zbig-u ($10.04 in chips) 
Seat 5: MarkFitz76 ($5.16 in chips) 
Seat 6: Luckman_brz ($5.34 in chips) 
Seat 7: HéStiA ($7.17 in chips) 
Seat 8: 87pinardi ($4.68 in chips) 
Seat 9: Dorex2007 ($8.57 in chips) 
87pinardi: posts small blind $0.02
Dorex2007: posts big blind $0.05
*** HOLE CARDS ***
Dealt to Dorex2007 [3s 7s]
ValerkaO_o: folds 
TheQuicksand: folds 
kramnoy.ivan: folds 
zbig-u: folds 
MarkFitz76: folds 
ValerkaO_o leaves the table
Luckman_brz: folds 
HéStiA: folds 
87pinardi: raises $0.10 to $0.15
Dorex2007: folds 
Uncalled bet ($0.10) returned to 87pinardi
87pinardi collected $0.10 from pot
87pinardi: doesn't show hand 
*** SUMMARY ***
Total pot $0.10 | Rake $0 
Seat 1: ValerkaO_o folded before Flop (didn't bet)
Seat 2: TheQuicksand folded before Flop (didn't bet)
Seat 3: kramnoy.ivan folded before Flop (didn't bet)
Seat 4: zbig-u folded before Flop (didn't bet)
Seat 5: MarkFitz76 folded before Flop (didn't bet)
Seat 6: Luckman_brz folded before Flop (didn't bet)
Seat 7: HéStiA (button) folded before Flop (didn't bet)
Seat 8: 87pinardi (small blind) collected ($0.10)
Seat 9: Dorex2007 (big blind) folded before Flop



PokerStars Hand #238671246614:  Hold'em No Limit ($0.02/$0.05 USD) - 2022/09/16 14:30:42 PT [2022/09/16 17:30:42 ET]
Table 'Hedera II' 9-max Seat #8 is the button
Seat 2: TheQuicksand ($5.21 in chips) 
Seat 3: kramnoy.ivan ($6.47 in chips) 
Seat 4: zbig-u ($10.04 in chips) 
Seat 5: MarkFitz76 ($5.16 in chips) 
Seat 6: Luckman_brz ($5.34 in chips) 
Seat 7: HéStiA ($7.17 in chips) 
Seat 8: 87pinardi ($4.73 in chips) 
Seat 9: Dorex2007 ($8.52 in chips) 
Dorex2007: posts small blind $0.02
TheQuicksand: posts big blind $0.05
*** HOLE CARDS ***
Dealt to Dorex2007 [As 9d]
sipo1 joins the table at seat #1 
kramnoy.ivan: raises $0.05 to $0.10
zbig-u: folds 
MarkFitz76: folds 
Luckman_brz: folds 
HéStiA: calls $0.10
87pinardi: calls $0.10
Dorex2007: folds 
TheQuicksand: folds 
*** FLOP *** [Ac 3c 3h]
kramnoy.ivan: checks 
HéStiA: bets $0.17
87pinardi: calls $0.17
kramnoy.ivan: folds 
*** TURN *** [Ac 3c 3h] [Ks]
HéStiA: checks 
87pinardi: bets $0.68
HéStiA: calls $0.68
*** RIVER *** [Ac 3c 3h Ks] [5c]
HéStiA: checks 
87pinardi: checks 
*** SHOW DOWN ***
HéStiA: shows [Jh Ad] (two pair, Aces and Threes)
87pinardi: shows [Jc Qc] (a flush, Ace high)
87pinardi collected $1.98 from pot
*** SUMMARY ***
Total pot $2.07 | Rake $0.09 
Board [Ac 3c 3h Ks 5c]
Seat 2: TheQuicksand (big blind) folded before Flop
Seat 3: kramnoy.ivan folded on the Flop
Seat 4: zbig-u folded before Flop (didn't bet)
Seat 5: MarkFitz76 folded before Flop (didn't bet)
Seat 6: Luckman_brz folded before Flop (didn't bet)
Seat 7: HéStiA showed [Jh Ad] and lost with two pair, Aces and Threes
Seat 8: 87pinardi (button) showed [Jc Qc] and won ($1.98) with a flush, Ace high
Seat 9: Dorex2007 (small blind) folded before Flop



PokerStars Hand #238671272866:  Hold'em No Limit ($0.02/$0.05 USD) - 2022/09/16 14:31:47 PT [2022/09/16 17:31:47 ET]
Table 'Hedera II' 9-max Seat #9 is the button
Seat 2: TheQuicksand ($5.16 in chips) 
Seat 3: kramnoy.ivan ($6.37 in chips) 
Seat 4: zbig-u ($10.04 in chips) 
Seat 5: MarkFitz76 ($5.16 in chips) 
Seat 6: Luckman_brz ($5.34 in chips) 
Seat 7: HéStiA ($6.22 in chips) 
Seat 8: 87pinardi ($5.76 in chips) 
Seat 9: Dorex2007 ($8.50 in chips) 
TheQuicksand: posts small blind $0.02
kramnoy.ivan: posts big blind $0.05
*** HOLE CARDS ***
Dealt to Dorex2007 [7s Th]
zbig-u: folds 
MarkFitz76: folds 
Luckman_brz: folds 
HéStiA: raises $0.07 to $0.12
87pinardi: folds 
Dorex2007: folds 
TheQuicksand: folds 
kramnoy.ivan: folds 
Uncalled bet ($0.07) returned to HéStiA
HéStiA collected $0.12 from pot
*** SUMMARY ***
Total pot $0.12 | Rake $0 
Seat 2: TheQuicksand (small blind) folded before Flop
Seat 3: kramnoy.ivan (big blind) folded before Flop
Seat 4: zbig-u folded before Flop (didn't bet)
Seat 5: MarkFitz76 folded before Flop (didn't bet)
Seat 6: Luckman_brz folded before Flop (didn't bet)
Seat 7: HéStiA collected ($0.12)
Seat 8: 87pinardi folded before Flop (didn't bet)
Seat 9: Dorex2007 (button) folded before Flop (didn't bet)



PokerStars Hand #238671280415:  Hold'em No Limit ($0.02/$0.05 USD) - 2022/09/16 14:32:06 PT [2022/09/16 17:32:06 ET]
Table 'Hedera II' 9-max Seat #2 is the button
Seat 2: TheQuicksand ($5.14 in chips) 
Seat 3: kramnoy.ivan ($6.32 in chips) 
Seat 5: MarkFitz76 ($5.16 in chips) 
Seat 6: Luckman_brz ($5.34 in chips) 
Seat 7: HéStiA ($6.29 in chips) 
Seat 8: 87pinardi ($5.76 in chips) 
Seat 9: Dorex2007 ($8.50 in chips) 
kramnoy.ivan: posts small blind $0.02
zbig-u: is sitting out 
MarkFitz76: posts big blind $0.05
sipo1: sits out 
*** HOLE CARDS ***
Dealt to Dorex2007 [3h 4c]
zbig-u leaves the table
Luckman_brz: calls $0.05
HéStiA: calls $0.05
87pinardi: folds 
Dorex2007: folds 
TheQuicksand: folds 
kramnoy.ivan: folds 
MarkFitz76: checks 
*** FLOP *** [4s Qs Kh]
MarkFitz76: checks 
Luckman_brz: checks 
malliosK joins the table at seat #4 
HéStiA: checks 
*** TURN *** [4s Qs Kh] [Ac]
MarkFitz76: checks 
Luckman_brz: checks 
HéStiA: checks 
*** RIVER *** [4s Qs Kh Ac] [Tc]
MarkFitz76: checks 
Luckman_brz: bets $0.15
HéStiA: folds 
MarkFitz76: folds 
Uncalled bet ($0.15) returned to Luckman_brz
Luckman_brz collected $0.16 from pot
Luckman_brz: doesn't show hand 
*** SUMMARY ***
Total pot $0.17 | Rake $0.01 
Board [4s Qs Kh Ac Tc]
Seat 2: TheQuicksand (button) folded before Flop (didn't bet)
Seat 3: kramnoy.ivan (small blind) folded before Flop
Seat 5: MarkFitz76 (big blind) folded on the River
Seat 6: Luckman_brz collected ($0.16)
Seat 7: HéStiA folded on the River
Seat 8: 87pinardi folded before Flop (didn't bet)
Seat 9: Dorex2007 folded before Flop (didn't bet)



PokerStars Hand #238671303181:  Hold'em No Limit ($0.02/$0.05 USD) - 2022/09/16 14:33:02 PT [2022/09/16 17:33:02 ET]
Table 'Hedera II' 9-max Seat #3 is the button
Seat 2: TheQuicksand ($5.14 in chips) 
Seat 3: kramnoy.ivan ($6.30 in chips) 
Seat 5: MarkFitz76 ($5.11 in chips) 
Seat 6: Luckman_brz ($5.45 in chips) 
Seat 7: HéStiA ($6.24 in chips) 
Seat 8: 87pinardi ($5.76 in chips) 
Seat 9: Dorex2007 ($8.50 in chips) 
MarkFitz76: posts small blind $0.02
Luckman_brz: posts big blind $0.05
sipo1: sits out 
*** HOLE CARDS ***
Dealt to Dorex2007 [7h 4d]
HéStiA: folds 
87pinardi: raises $0.10 to $0.15
Dorex2007: folds 
TheQuicksand: folds 
kramnoy.ivan: calls $0.15
MarkFitz76: folds 
Luckman_brz: folds 
*** FLOP *** [5s 6c 4h]
87pinardi: bets $0.17
kramnoy.ivan: folds 
Uncalled bet ($0.17) returned to 87pinardi
87pinardi collected $0.35 from pot
87pinardi: doesn't show hand 
*** SUMMARY ***
Total pot $0.37 | Rake $0.02 
Board [5s 6c 4h]
Seat 2: TheQuicksand folded before Flop (didn't bet)
Seat 3: kramnoy.ivan (button) folded on the Flop
Seat 5: MarkFitz76 (small blind) folded before Flop
Seat 6: Luckman_brz (big blind) folded before Flop
Seat 7: HéStiA folded before Flop (didn't bet)
Seat 8: 87pinardi collected ($0.35)
Seat 9: Dorex2007 folded before Flop (didn't bet)



PokerStars Hand #238671314070:  Hold'em No Limit ($0.02/$0.05 USD) - 2022/09/16 14:33:30 PT [2022/09/16 17:33:30 ET]
Table 'Hedera II' 9-max Seat #5 is the button
Seat 2: TheQuicksand ($5.14 in chips) 
Seat 3: kramnoy.ivan ($6.15 in chips) 
Seat 5: MarkFitz76 ($5.09 in chips) 
Seat 6: Luckman_brz ($5.40 in chips) 
Seat 8: 87pinardi ($5.96 in chips) 
Seat 9: Dorex2007 ($8.50 in chips) 
Luckman_brz: posts small blind $0.02
HéStiA: is sitting out 
87pinardi: posts big blind $0.05
sipo1: sits out 
malliosK: sits out 
*** HOLE CARDS ***
Dealt to Dorex2007 [As 6s]
HéStiA leaves the table
Dorex2007: folds 
TheQuicksand: calls $0.05
kramnoy.ivan: folds 
MarkFitz76: folds 
Luckman_brz: calls $0.03
87pinardi: checks 
*** FLOP *** [9h Ad Jc]
Luckman_brz: checks 
87pinardi: checks 
TheQuicksand: checks 
*** TURN *** [9h Ad Jc] [3c]
Luckman_brz: bets $0.15
87pinardi: folds 
TheQuicksand: calls $0.15
*** RIVER *** [9h Ad Jc 3c] [Th]
Luckman_brz: bets $0.10
TheQuicksand: calls $0.10
*** SHOW DOWN ***
Luckman_brz: shows [Ah Qc] (a pair of Aces)
TheQuicksand: mucks hand 
Luckman_brz collected $0.62 from pot
*** SUMMARY ***
Total pot $0.65 | Rake $0.03 
Board [9h Ad Jc 3c Th]
Seat 2: TheQuicksand mucked [Qh Ts]
Seat 3: kramnoy.ivan folded before Flop (didn't bet)
Seat 5: MarkFitz76 (button) folded before Flop (didn't bet)
Seat 6: Luckman_brz (small blind) showed [Ah Qc] and won ($0.62) with a pair of Aces
Seat 8: 87pinardi (big blind) folded on the Turn
Seat 9: Dorex2007 folded before Flop (didn't bet)



PokerStars Hand #238671328267:  Hold'em No Limit ($0.02/$0.05 USD) - 2022/09/16 14:34:05 PT [2022/09/16 17:34:05 ET]
Table 'Hedera II' 9-max Seat #6 is the button
Seat 2: TheQuicksand ($4.84 in chips) 
Seat 3: kramnoy.ivan ($6.15 in chips) 
Seat 5: MarkFitz76 ($5.09 in chips) 
Seat 6: Luckman_brz ($5.72 in chips) 
Seat 8: 87pinardi ($5.91 in chips) 
Seat 9: Dorex2007 ($8.50 in chips) 
87pinardi: posts small blind $0.02
Dorex2007: posts big blind $0.05
sipo1: sits out 
malliosK: sits out 
*** HOLE CARDS ***
Dealt to Dorex2007 [Td Js]
TheQuicksand: folds 
kramnoy.ivan: folds 
MarkFitz76: folds 
Luckman_brz: raises $0.15 to $0.20
87pinardi: folds 
Dorex2007: folds 
Uncalled bet ($0.15) returned to Luckman_brz
Luckman_brz collected $0.12 from pot
Luckman_brz: doesn't show hand 
*** SUMMARY ***
Total pot $0.12 | Rake $0 
Seat 2: TheQuicksand folded before Flop (didn't bet)
Seat 3: kramnoy.ivan folded before Flop (didn't bet)
Seat 5: MarkFitz76 folded before Flop (didn't bet)
Seat 6: Luckman_brz (button) collected ($0.12)
Seat 8: 87pinardi (small blind) folded before Flop
Seat 9: Dorex2007 (big blind) folded before Flop



PokerStars Hand #238671334507:  Hold'em No Limit ($0.02/$0.05 USD) - 2022/09/16 14:34:20 PT [2022/09/16 17:34:20 ET]
Table 'Hedera II' 9-max Seat #8 is the button
Seat 1: sipo1 ($5 in chips) 
Seat 2: TheQuicksand ($4.84 in chips) 
Seat 3: kramnoy.ivan ($6.15 in chips) 
Seat 5: MarkFitz76 ($5.09 in chips) 
Seat 6: Luckman_brz ($5.79 in chips) 
Seat 8: 87pinardi ($5.89 in chips) 
Seat 9: Dorex2007 ($8.45 in chips) 
Dorex2007: posts small blind $0.02
sipo1: posts big blind $0.05
malliosK: sits out 
*** HOLE CARDS ***
Dealt to Dorex2007 [6c 7d]
TheQuicksand: folds 
kramnoy.ivan: raises $0.05 to $0.10
MarkFitz76: folds 
Luckman_brz: folds 
87pinardi: raises $0.20 to $0.30
Dorex2007: folds 
sipo1: folds 
notis-magia joins the table at seat #7 
Luckman_brz leaves the table
kramnoy.ivan: calls $0.20
*** FLOP *** [3d Ac Jd]
kramnoy.ivan: checks 
87pinardi: bets $0.32
Azimusback joins the table at seat #6 
kramnoy.ivan: calls $0.32
*** TURN *** [3d Ac Jd] [4s]
kramnoy.ivan: checks 
87pinardi: bets $1.05
kramnoy.ivan: folds 
Uncalled bet ($1.05) returned to 87pinardi
87pinardi collected $1.26 from pot
87pinardi: doesn't show hand 
*** SUMMARY ***
Total pot $1.31 | Rake $0.05 
Board [3d Ac Jd 4s]
Seat 1: sipo1 (big blind) folded before Flop
Seat 2: TheQuicksand folded before Flop (didn't bet)
Seat 3: kramnoy.ivan folded on the Turn
Seat 5: MarkFitz76 folded before Flop (didn't bet)
Seat 6: Luckman_brz folded before Flop (didn't bet)
Seat 8: 87pinardi (button) collected ($1.26)
Seat 9: Dorex2007 (small blind) folded before Flop



PokerStars Hand #238671356962:  Hold'em No Limit ($0.02/$0.05 USD) - 2022/09/16 14:35:16 PT [2022/09/16 17:35:16 ET]
Table 'Hedera II' 9-max Seat #9 is the button
Seat 1: sipo1 ($4.95 in chips) 
Seat 2: TheQuicksand ($4.84 in chips) 
Seat 3: kramnoy.ivan ($5.53 in chips) 
Seat 5: MarkFitz76 ($5.09 in chips) 
Seat 8: 87pinardi ($6.53 in chips) 
Seat 9: Dorex2007 ($8.43 in chips) 
sipo1: posts small blind $0.02
TheQuicksand: posts big blind $0.05
malliosK: sits out 
Azimusback: sits out 
notis-magia: sits out 
*** HOLE CARDS ***
Dealt to Dorex2007 [Ad 4h]
kramnoy.ivan: folds 
MarkFitz76: folds 
87pinardi: folds 
Dorex2007: folds 
sipo1: calls $0.03
TheQuicksand: checks 
*** FLOP *** [2s 8c Jd]
sipo1: checks 
TheQuicksand: checks 
*** TURN *** [2s 8c Jd] [Ks]
sipo1: checks 
TheQuicksand: checks 
*** RIVER *** [2s 8c Jd Ks] [9c]
sipo1: bets $0.05
TheQuicksand: raises $0.05 to $0.10
sipo1: folds 
Uncalled bet ($0.05) returned to TheQuicksand
TheQuicksand collected $0.19 from pot
TheQuicksand: doesn't show hand 
*** SUMMARY ***
Total pot $0.20 | Rake $0.01 
Board [2s 8c Jd Ks 9c]
Seat 1: sipo1 (small blind) folded on the River
Seat 2: TheQuicksand (big blind) collected ($0.19)
Seat 3: kramnoy.ivan folded before Flop (didn't bet)
Seat 5: MarkFitz76 folded before Flop (didn't bet)
Seat 8: 87pinardi folded before Flop (didn't bet)
Seat 9: Dorex2007 (button) folded before Flop (didn't bet)



PokerStars Hand #238671375453:  Hold'em No Limit ($0.02/$0.05 USD) - 2022/09/16 14:36:02 PT [2022/09/16 17:36:02 ET]
Table 'Hedera II' 9-max Seat #1 is the button
Seat 1: sipo1 ($4.85 in chips) 
Seat 2: TheQuicksand ($4.93 in chips) 
Seat 3: kramnoy.ivan ($5.53 in chips) 
Seat 5: MarkFitz76 ($5.09 in chips) 
Seat 8: 87pinardi ($6.53 in chips) 
Seat 9: Dorex2007 ($8.43 in chips) 
TheQuicksand: posts small blind $0.02
kramnoy.ivan: posts big blind $0.05
malliosK: sits out 
Azimusback: sits out 
notis-magia: sits out 
*** HOLE CARDS ***
Dealt to Dorex2007 [9c 5s]
MarkFitz76: folds 
87pinardi: folds 
Dorex2007: folds 
sipo1: folds 
TheQuicksand: folds 
Uncalled bet ($0.03) returned to kramnoy.ivan
kramnoy.ivan collected $0.04 from pot
*** SUMMARY ***
Total pot $0.04 | Rake $0 
Seat 1: sipo1 (button) folded before Flop (didn't bet)
Seat 2: TheQuicksand (small blind) folded before Flop
Seat 3: kramnoy.ivan (big blind) collected ($0.04)
Seat 5: MarkFitz76 folded before Flop (didn't bet)
Seat 8: 87pinardi folded before Flop (didn't bet)
Seat 9: Dorex2007 folded before Flop (didn't bet)



PokerStars Hand #238671380311:  Hold'em No Limit ($0.02/$0.05 USD) - 2022/09/16 14:36:14 PT [2022/09/16 17:36:14 ET]
Table 'Hedera II' 9-max Seat #2 is the button
Seat 1: sipo1 ($4.85 in chips) 
Seat 2: TheQuicksand ($4.91 in chips) 
Seat 3: kramnoy.ivan ($5.55 in chips) 
Seat 4: malliosK ($4.70 in chips) 
Seat 5: MarkFitz76 ($5.09 in chips) 
Seat 8: 87pinardi ($6.53 in chips) 
Seat 9: Dorex2007 ($8.43 in chips) 
kramnoy.ivan: posts small blind $0.02
malliosK: posts big blind $0.05
Azimusback: sits out 
notis-magia: sits out 
*** HOLE CARDS ***
Dealt to Dorex2007 [Qc 9s]
MarkFitz76: folds 
87pinardi: folds 
Dorex2007: folds 
sipo1: calls $0.05
TheQuicksand: folds 
kramnoy.ivan: calls $0.03
malliosK has timed out
malliosK: checks 
*** FLOP *** [Ks 2c 3d]
kramnoy.ivan: bets $0.07
malliosK: folds 
sipo1: folds 
Uncalled bet ($0.07) returned to kramnoy.ivan
kramnoy.ivan collected $0.14 from pot
*** SUMMARY ***
Total pot $0.15 | Rake $0.01 
Board [Ks 2c 3d]
Seat 1: sipo1 folded on the Flop
Seat 2: TheQuicksand (button) folded before Flop (didn't bet)
Seat 3: kramnoy.ivan (small blind) collected ($0.14)
Seat 4: malliosK (big blind) folded on the Flop
Seat 5: MarkFitz76 folded before Flop (didn't bet)
Seat 8: 87pinardi folded before Flop (didn't bet)
Seat 9: Dorex2007 folded before Flop (didn't bet)



PokerStars Hand #238671409649:  Hold'em No Limit ($0.02/$0.05 USD) - 2022/09/16 14:37:28 PT [2022/09/16 17:37:28 ET]
Table 'Hedera II' 9-max Seat #3 is the button
Seat 1: sipo1 ($4.80 in chips) 
Seat 2: TheQuicksand ($4.91 in chips) 
Seat 3: kramnoy.ivan ($5.64 in chips) 
Seat 4: malliosK ($4.65 in chips) 
Seat 5: MarkFitz76 ($5.09 in chips) 
Seat 8: 87pinardi ($6.53 in chips) 
Seat 9: Dorex2007 ($8.43 in chips) 
malliosK: posts small blind $0.02
MarkFitz76: posts big blind $0.05
Azimusback: sits out 
notis-magia: sits out 
*** HOLE CARDS ***
Dealt to Dorex2007 [5c 9h]
87pinardi: folds 
Dorex2007: folds 
sipo1: folds 
TheQuicksand: folds 
kramnoy.ivan: folds 
malliosK: calls $0.03
MarkFitz76: checks 
*** FLOP *** [2s Qd 8s]
malliosK: checks 
MarkFitz76: checks 
*** TURN *** [2s Qd 8s] [Kc]
malliosK: bets $0.06
MarkFitz76: calls $0.06
*** RIVER *** [2s Qd 8s Kc] [7c]
malliosK: bets $0.33
MarkFitz76: calls $0.33
*** SHOW DOWN ***
malliosK: shows [9s 8d] (a pair of Eights)
MarkFitz76: shows [7s Qs] (two pair, Queens and Sevens)
MarkFitz76 collected $0.84 from pot
*** SUMMARY ***
Total pot $0.88 | Rake $0.04 
Board [2s Qd 8s Kc 7c]
Seat 1: sipo1 folded before Flop (didn't bet)
Seat 2: TheQuicksand folded before Flop (didn't bet)
Seat 3: kramnoy.ivan (button) folded before Flop (didn't bet)
Seat 4: malliosK (small blind) showed [9s 8d] and lost with a pair of Eights
Seat 5: MarkFitz76 (big blind) showed [7s Qs] and won ($0.84) with two pair, Queens and Sevens
Seat 8: 87pinardi folded before Flop (didn't bet)
Seat 9: Dorex2007 folded before Flop (didn't bet)



PokerStars Hand #238671428463:  Hold'em No Limit ($0.02/$0.05 USD) - 2022/09/16 14:38:15 PT [2022/09/16 17:38:15 ET]
Table 'Hedera II' 9-max Seat #4 is the button
Seat 1: sipo1 ($4.80 in chips) 
Seat 2: TheQuicksand ($4.91 in chips) 
Seat 3: kramnoy.ivan ($5.64 in chips) 
Seat 4: malliosK ($4.21 in chips) 
Seat 5: MarkFitz76 ($5.49 in chips) 
Seat 6: Azimusback ($5 in chips) 
Seat 8: 87pinardi ($6.53 in chips) 
Seat 9: Dorex2007 ($8.43 in chips) 
MarkFitz76: posts small blind $0.02
Azimusback: posts big blind $0.05
notis-magia: sits out 
*** HOLE CARDS ***
Dealt to Dorex2007 [4d 3s]
87pinardi: folds 
Dorex2007: folds 
sipo1: folds 
TheQuicksand: raises $0.05 to $0.10
kramnoy.ivan: calls $0.10
malliosK: folds 
MarkFitz76: folds 
Azimusback: calls $0.05
*** FLOP *** [6c 2h Ts]
Azimusback: checks 
TheQuicksand: bets $0.15
kramnoy.ivan: folds 
Azimusback: calls $0.15
*** TURN *** [6c 2h Ts] [2s]
Azimusback: checks 
TheQuicksand: bets $0.25
Azimusback: calls $0.25
*** RIVER *** [6c 2h Ts 2s] [Ad]
Azimusback: checks 
TheQuicksand: checks 
*** SHOW DOWN ***
Azimusback: shows [Td Kd] (two pair, Tens and Deuces)
TheQuicksand: mucks hand 
Azimusback collected $1.07 from pot
*** SUMMARY ***
Total pot $1.12 | Rake $0.05 
Board [6c 2h Ts 2s Ad]
Seat 1: sipo1 folded before Flop (didn't bet)
Seat 2: TheQuicksand mucked [4c 4h]
Seat 3: kramnoy.ivan folded on the Flop
Seat 4: malliosK (button) folded before Flop (didn't bet)
Seat 5: MarkFitz76 (small blind) folded before Flop
Seat 6: Azimusback (big blind) showed [Td Kd] and won ($1.07) with two pair, Tens and Deuces
Seat 8: 87pinardi folded before Flop (didn't bet)
Seat 9: Dorex2007 folded before Flop (didn't bet)



PokerStars Hand #238671450985:  Hold'em No Limit ($0.02/$0.05 USD) - 2022/09/16 14:39:11 PT [2022/09/16 17:39:11 ET]
Table 'Hedera II' 9-max Seat #5 is the button
Seat 1: sipo1 ($4.80 in chips) 
Seat 2: TheQuicksand ($4.41 in chips) 
Seat 3: kramnoy.ivan ($5.54 in chips) 
Seat 4: malliosK ($4.21 in chips) 
Seat 5: MarkFitz76 ($5.47 in chips) 
Seat 6: Azimusback ($5.57 in chips) 
Seat 7: notis-magia ($5 in chips) 
Seat 8: 87pinardi ($6.53 in chips) 
Seat 9: Dorex2007 ($8.43 in chips) 
Azimusback: posts small blind $0.02
notis-magia: posts big blind $0.05
*** HOLE CARDS ***
Dealt to Dorex2007 [5h 4h]
87pinardi: folds 
Dorex2007: folds 
sipo1: folds 
TheQuicksand: folds 
kramnoy.ivan: raises $0.05 to $0.10
malliosK: folds 
MarkFitz76: folds 
Azimusback: folds 
notis-magia: folds 
Uncalled bet ($0.05) returned to kramnoy.ivan
kramnoy.ivan collected $0.12 from pot
*** SUMMARY ***
Total pot $0.12 | Rake $0 
Seat 1: sipo1 folded before Flop (didn't bet)
Seat 2: TheQuicksand folded before Flop (didn't bet)
Seat 3: kramnoy.ivan collected ($0.12)
Seat 4: malliosK folded before Flop (didn't bet)
Seat 5: MarkFitz76 (button) folded before Flop (didn't bet)
Seat 6: Azimusback (small blind) folded before Flop
Seat 7: notis-magia (big blind) folded before Flop
Seat 8: 87pinardi folded before Flop (didn't bet)
Seat 9: Dorex2007 folded before Flop (didn't bet)



PokerStars Hand #238671460674:  Hold'em No Limit ($0.02/$0.05 USD) - 2022/09/16 14:39:36 PT [2022/09/16 17:39:36 ET]
Table 'Hedera II' 9-max Seat #6 is the button
Seat 1: sipo1 ($4.80 in chips) 
Seat 2: TheQuicksand ($4.41 in chips) 
Seat 3: kramnoy.ivan ($5.61 in chips) 
Seat 4: malliosK ($4.21 in chips) 
Seat 5: MarkFitz76 ($5.47 in chips) 
Seat 6: Azimusback ($5.55 in chips) 
Seat 7: notis-magia ($4.95 in chips) 
Seat 8: 87pinardi ($6.53 in chips) 
Seat 9: Dorex2007 ($8.43 in chips) 
notis-magia: posts small blind $0.02
87pinardi: posts big blind $0.05
*** HOLE CARDS ***
Dealt to Dorex2007 [As 7h]
Dorex2007: folds 
sipo1: calls $0.05
TheQuicksand: folds 
kramnoy.ivan: folds 
malliosK has timed out
malliosK: folds 
MarkFitz76: folds 
Azimusback: folds 
notis-magia: raises $0.15 to $0.20
87pinardi: folds 
sipo1: calls $0.15
*** FLOP *** [4d 5c 3h]
notis-magia: bets $0.21
sipo1: raises $4.39 to $4.60 and is all-in
notis-magia: calls $4.39
*** TURN *** [4d 5c 3h] [Qc]
*** RIVER *** [4d 5c 3h Qc] [Kd]
*** SHOW DOWN ***
notis-magia: shows [Js Jc] (a pair of Jacks)
sipo1: shows [8h 8s] (a pair of Eights)
notis-magia cashed out the hand for $8.10 | Cash Out Fee $0.08
*** SUMMARY ***
Total pot $9.65 | Rake $0.40 
Board [4d 5c 3h Qc Kd]
Seat 1: sipo1 showed [8h 8s] and lost with a pair of Eights
Seat 2: TheQuicksand folded before Flop (didn't bet)
Seat 3: kramnoy.ivan folded before Flop (didn't bet)
Seat 4: malliosK folded before Flop (didn't bet)
Seat 5: MarkFitz76 folded before Flop (didn't bet)
Seat 6: Azimusback (button) folded before Flop (didn't bet)
Seat 7: notis-magia (small blind) showed [Js Jc] and won ($9.25) with a pair of Jacks (pot not awarded as player cashed out)
Seat 8: 87pinardi (big blind) folded before Flop
Seat 9: Dorex2007 folded before Flop (didn't bet)



PokerStars Hand #238671486205:  Hold'em No Limit ($0.02/$0.05 USD) - 2022/09/16 14:40:40 PT [2022/09/16 17:40:40 ET]
Table 'Hedera II' 9-max Seat #7 is the button
Seat 1: sipo1 ($5 in chips) 
Seat 2: TheQuicksand ($4.41 in chips) 
Seat 3: kramnoy.ivan ($5.61 in chips) 
Seat 4: malliosK ($4.21 in chips) 
Seat 5: MarkFitz76 ($5.47 in chips) 
Seat 6: Azimusback ($5.55 in chips) 
Seat 7: notis-magia ($8.25 in chips) 
Seat 8: 87pinardi ($6.48 in chips) 
Seat 9: Dorex2007 ($8.43 in chips) 
87pinardi: posts small blind $0.02
Dorex2007: posts big blind $0.05
*** HOLE CARDS ***
Dealt to Dorex2007 [Ad Th]
sipo1: calls $0.05
TheQuicksand: folds 
kramnoy.ivan: folds 
malliosK has timed out
malliosK: folds 
MarkFitz76: folds 
Azimusback: folds 
notis-magia: folds 
87pinardi: folds 
Dorex2007: raises $0.05 to $0.10
sipo1: calls $0.05
*** FLOP *** [Ts Js Qd]
Dorex2007: checks 
sipo1: bets $0.10
Dorex2007: calls $0.10
*** TURN *** [Ts Js Qd] [7h]
Dorex2007: checks 
sipo1: checks 
*** RIVER *** [Ts Js Qd 7h] [6d]
Dorex2007: bets $0.20
sipo1: raises $0.20 to $0.40
Dorex2007: folds 
Uncalled bet ($0.20) returned to sipo1
sipo1 collected $0.79 from pot
sipo1: doesn't show hand 
*** SUMMARY ***
Total pot $0.82 | Rake $0.03 
Board [Ts Js Qd 7h 6d]
Seat 1: sipo1 collected ($0.79)
Seat 2: TheQuicksand folded before Flop (didn't bet)
Seat 3: kramnoy.ivan folded before Flop (didn't bet)
Seat 4: malliosK folded before Flop (didn't bet)
Seat 5: MarkFitz76 folded before Flop (didn't bet)
Seat 6: Azimusback folded before Flop (didn't bet)
Seat 7: notis-magia (button) folded before Flop (didn't bet)
Seat 8: 87pinardi (small blind) folded before Flop
Seat 9: Dorex2007 (big blind) folded on the River



PokerStars Hand #238671512868:  Hold'em No Limit ($0.02/$0.05 USD) - 2022/09/16 14:41:48 PT [2022/09/16 17:41:48 ET]
Table 'Hedera II' 9-max Seat #8 is the button
Seat 1: sipo1 ($5.39 in chips) 
Seat 2: TheQuicksand ($4.41 in chips) 
Seat 3: kramnoy.ivan ($5.61 in chips) 
Seat 4: malliosK ($4.21 in chips) 
Seat 5: MarkFitz76 ($5.47 in chips) 
Seat 6: Azimusback ($5.55 in chips) 
Seat 7: notis-magia ($8.25 in chips) 
Seat 8: 87pinardi ($6.46 in chips) 
Seat 9: Dorex2007 ($8.03 in chips) 
Dorex2007: posts small blind $0.02
sipo1: posts big blind $0.05
*** HOLE CARDS ***
Dealt to Dorex2007 [8d Qd]
TheQuicksand: folds 
kramnoy.ivan: folds 
malliosK: folds 
MarkFitz76: folds 
Azimusback: folds 
notis-magia: folds 
87pinardi: folds 
Dorex2007: folds 
Uncalled bet ($0.03) returned to sipo1
sipo1 collected $0.04 from pot
sipo1: doesn't show hand 
*** SUMMARY ***
Total pot $0.04 | Rake $0 
Seat 1: sipo1 (big blind) collected ($0.04)
Seat 2: TheQuicksand folded before Flop (didn't bet)
Seat 3: kramnoy.ivan folded before Flop (didn't bet)
Seat 4: malliosK folded before Flop (didn't bet)
Seat 5: MarkFitz76 folded before Flop (didn't bet)
Seat 6: Azimusback folded before Flop (didn't bet)
Seat 7: notis-magia folded before Flop (didn't bet)
Seat 8: 87pinardi (button) folded before Flop (didn't bet)
Seat 9: Dorex2007 (small blind) folded before Flop



PokerStars Hand #238671518473:  Hold'em No Limit ($0.02/$0.05 USD) - 2022/09/16 14:42:02 PT [2022/09/16 17:42:02 ET]
Table 'Hedera II' 9-max Seat #9 is the button
Seat 1: sipo1 ($5.41 in chips) 
Seat 2: TheQuicksand ($4.41 in chips) 
Seat 3: kramnoy.ivan ($5.61 in chips) 
Seat 4: malliosK ($4.21 in chips) 
Seat 5: MarkFitz76 ($5.47 in chips) 
Seat 6: Azimusback ($5.55 in chips) 
Seat 7: notis-magia ($8.25 in chips) 
Seat 8: 87pinardi ($6.46 in chips) 
Seat 9: Dorex2007 ($8.01 in chips) 
sipo1: posts small blind $0.02
TheQuicksand: posts big blind $0.05
*** HOLE CARDS ***
Dealt to Dorex2007 [7h 9d]
kramnoy.ivan: raises $0.05 to $0.10
malliosK has timed out
malliosK: folds 
MarkFitz76: folds 
Azimusback: folds 
notis-magia: folds 
87pinardi: folds 
Dorex2007: folds 
sipo1: folds 
TheQuicksand: folds 
Uncalled bet ($0.05) returned to kramnoy.ivan
kramnoy.ivan collected $0.12 from pot
*** SUMMARY ***
Total pot $0.12 | Rake $0 
Seat 1: sipo1 (small blind) folded before Flop
Seat 2: TheQuicksand (big blind) folded before Flop
Seat 3: kramnoy.ivan collected ($0.12)
Seat 4: malliosK folded before Flop (didn't bet)
Seat 5: MarkFitz76 folded before Flop (didn't bet)
Seat 6: Azimusback folded before Flop (didn't bet)
Seat 7: notis-magia folded before Flop (didn't bet)
Seat 8: 87pinardi folded before Flop (didn't bet)
Seat 9: Dorex2007 (button) folded before Flop (didn't bet)



PokerStars Hand #238671529666:  Hold'em No Limit ($0.02/$0.05 USD) - 2022/09/16 14:42:31 PT [2022/09/16 17:42:31 ET]
Table 'Hedera II' 9-max Seat #1 is the button
Seat 1: sipo1 ($5.39 in chips) 
Seat 2: TheQuicksand ($4.36 in chips) 
Seat 3: kramnoy.ivan ($5.68 in chips) 
Seat 5: MarkFitz76 ($5.47 in chips) 
Seat 6: Azimusback ($5.55 in chips) 
Seat 7: notis-magia ($8.25 in chips) 
Seat 8: 87pinardi ($6.46 in chips) 
Seat 9: Dorex2007 ($8.01 in chips) 
TheQuicksand: posts small blind $0.02
kramnoy.ivan: posts big blind $0.05
*** HOLE CARDS ***
Dealt to Dorex2007 [9d Js]
MarkFitz76: folds 
Azimusback: folds 
notis-magia: raises $0.10 to $0.15
87pinardi: folds 
Dorex2007: folds 
sipo1: folds 
TheQuicksand: calls $0.13
kramnoy.ivan: folds 
*** FLOP *** [Qh 9s Kd]
TheQuicksand: checks 
notis-magia: bets $0.17
TheQuicksand: folds 
Uncalled bet ($0.17) returned to notis-magia
notis-magia collected $0.34 from pot
notis-magia: doesn't show hand 
*** SUMMARY ***
Total pot $0.35 | Rake $0.01 
Board [Qh 9s Kd]
Seat 1: sipo1 (button) folded before Flop (didn't bet)
Seat 2: TheQuicksand (small blind) folded on the Flop
Seat 3: kramnoy.ivan (big blind) folded before Flop
Seat 5: MarkFitz76 folded before Flop (didn't bet)
Seat 6: Azimusback folded before Flop (didn't bet)
Seat 7: notis-magia collected ($0.34)
Seat 8: 87pinardi folded before Flop (didn't bet)
Seat 9: Dorex2007 folded before Flop (didn't bet)



PokerStars Hand #238671542014:  Hold'em No Limit ($0.02/$0.05 USD) - 2022/09/16 14:43:03 PT [2022/09/16 17:43:03 ET]
Table 'Hedera II' 9-max Seat #2 is the button
Seat 1: sipo1 ($5.39 in chips) 
Seat 2: TheQuicksand ($4.21 in chips) 
Seat 3: kramnoy.ivan ($5.63 in chips) 
Seat 4: malliosK ($4.21 in chips) 
Seat 5: MarkFitz76 ($5.47 in chips) 
Seat 6: Azimusback ($5.55 in chips) 
Seat 7: notis-magia ($8.44 in chips) 
Seat 8: 87pinardi ($6.46 in chips) 
Seat 9: Dorex2007 ($8.01 in chips) 
kramnoy.ivan: posts small blind $0.02
malliosK: posts big blind $0.05
*** HOLE CARDS ***
Dealt to Dorex2007 [Ah Ts]
MarkFitz76: folds 
Azimusback: folds 
notis-magia: folds 
87pinardi: raises $0.10 to $0.15
Dorex2007: folds 
sipo1: folds 
TheQuicksand: raises $0.10 to $0.25
kramnoy.ivan: folds 
malliosK has timed out
malliosK: folds 
87pinardi: calls $0.10
*** FLOP *** [Kc 9c Jc]
87pinardi: checks 
TheQuicksand: bets $0.27
87pinardi: calls $0.27
*** TURN *** [Kc 9c Jc] [8c]
87pinardi: checks 
TheQuicksand: bets $0.53
87pinardi: folds 
Uncalled bet ($0.53) returned to TheQuicksand
TheQuicksand collected $1.06 from pot
TheQuicksand: doesn't show hand 
*** SUMMARY ***
Total pot $1.11 | Rake $0.05 
Board [Kc 9c Jc 8c]
Seat 1: sipo1 folded before Flop (didn't bet)
Seat 2: TheQuicksand (button) collected ($1.06)
Seat 3: kramnoy.ivan (small blind) folded before Flop
Seat 4: malliosK (big blind) folded before Flop
Seat 5: MarkFitz76 folded before Flop (didn't bet)
Seat 6: Azimusback folded before Flop (didn't bet)
Seat 7: notis-magia folded before Flop (didn't bet)
Seat 8: 87pinardi folded on the Turn
Seat 9: Dorex2007 folded before Flop (didn't bet)



PokerStars Hand #238671562188:  Hold'em No Limit ($0.02/$0.05 USD) - 2022/09/16 14:43:54 PT [2022/09/16 17:43:54 ET]
Table 'Hedera II' 9-max Seat #3 is the button
Seat 1: sipo1 ($5.39 in chips) 
Seat 2: TheQuicksand ($4.75 in chips) 
Seat 3: kramnoy.ivan ($5.61 in chips) 
Seat 5: MarkFitz76 ($5.47 in chips) 
Seat 6: Azimusback ($5.55 in chips) 
Seat 7: notis-magia ($8.44 in chips) 
Seat 8: 87pinardi ($5.94 in chips) 
Seat 9: Dorex2007 ($8.01 in chips) 
MarkFitz76: posts small blind $0.02
Azimusback: posts big blind $0.05
*** HOLE CARDS ***
Dealt to Dorex2007 [Kd Qh]
notis-magia has timed out
notis-magia: folds 
87pinardi: folds 
Dorex2007: raises $0.10 to $0.15
sipo1: calls $0.15
TheQuicksand: folds 
kramnoy.ivan: folds 
MarkFitz76: folds 
Azimusback: folds 
*** FLOP *** [Ks 5h 2h]
Dorex2007: bets $0.17
sipo1: calls $0.17
*** TURN *** [Ks 5h 2h] [4h]
Dorex2007: bets $0.34
sipo1: calls $0.34
*** RIVER *** [Ks 5h 2h 4h] [3c]
Dorex2007: bets $0.66
sipo1: raises $0.66 to $1.32
Dorex2007: folds 
Uncalled bet ($0.66) returned to sipo1
sipo1 collected $2.60 from pot
sipo1: doesn't show hand 
*** SUMMARY ***
Total pot $2.71 | Rake $0.11 
Board [Ks 5h 2h 4h 3c]
Seat 1: sipo1 collected ($2.60)
Seat 2: TheQuicksand folded before Flop (didn't bet)
Seat 3: kramnoy.ivan (button) folded before Flop (didn't bet)
Seat 5: MarkFitz76 (small blind) folded before Flop
Seat 6: Azimusback (big blind) folded before Flop
Seat 7: notis-magia folded before Flop (didn't bet)
Seat 8: 87pinardi folded before Flop (didn't bet)
Seat 9: Dorex2007 folded on the River



PokerStars Hand #238671581845:  Hold'em No Limit ($0.02/$0.05 USD) - 2022/09/16 14:44:45 PT [2022/09/16 17:44:45 ET]
Table 'Hedera II' 9-max Seat #5 is the button
Seat 1: sipo1 ($6.67 in chips) 
Seat 2: TheQuicksand ($4.75 in chips) 
Seat 3: kramnoy.ivan ($5.61 in chips) 
Seat 5: MarkFitz76 ($5.45 in chips) 
Seat 6: Azimusback ($5.50 in chips) 
Seat 7: notis-magia ($8.44 in chips) 
Seat 8: 87pinardi ($5.94 in chips) 
Seat 9: Dorex2007 ($6.69 in chips) 
Azimusback: posts small blind $0.02
notis-magia: posts big blind $0.05
*** HOLE CARDS ***
Dealt to Dorex2007 [Ks 5s]
87pinardi: folds 
Dorex2007: folds 
sipo1: folds 
TheQuicksand: folds 
kramnoy.ivan: folds 
MarkFitz76: folds 
Azimusback: folds 
Uncalled bet ($0.03) returned to notis-magia
notis-magia collected $0.04 from pot
notis-magia: doesn't show hand 
*** SUMMARY ***
Total pot $0.04 | Rake $0 
Seat 1: sipo1 folded before Flop (didn't bet)
Seat 2: TheQuicksand folded before Flop (didn't bet)
Seat 3: kramnoy.ivan folded before Flop (didn't bet)
Seat 5: MarkFitz76 (button) folded before Flop (didn't bet)
Seat 6: Azimusback (small blind) folded before Flop
Seat 7: notis-magia (big blind) collected ($0.04)
Seat 8: 87pinardi folded before Flop (didn't bet)
Seat 9: Dorex2007 folded before Flop (didn't bet)



PokerStars Hand #238671590509:  Hold'em No Limit ($0.02/$0.05 USD) - 2022/09/16 14:45:07 PT [2022/09/16 17:45:07 ET]
Table 'Hedera II' 9-max Seat #6 is the button
Seat 1: sipo1 ($6.67 in chips) 
Seat 2: TheQuicksand ($4.75 in chips) 
Seat 3: kramnoy.ivan ($5.61 in chips) 
Seat 5: MarkFitz76 ($5.45 in chips) 
Seat 6: Azimusback ($5.48 in chips) 
Seat 7: notis-magia ($8.46 in chips) 
Seat 8: 87pinardi ($5.94 in chips) 
Seat 9: Dorex2007 ($6.69 in chips) 
notis-magia: posts small blind $0.02
87pinardi: posts big blind $0.05
*** HOLE CARDS ***
Dealt to Dorex2007 [Jd Qc]
Dorex2007: folds 
sipo1: folds 
TheQuicksand: folds 
kramnoy.ivan: raises $0.10 to $0.15
MarkFitz76: folds 
Azimusback: folds 
notis-magia: calls $0.13
87pinardi: folds 
*** FLOP *** [2d Jh 2h]
notis-magia: bets $0.17
kramnoy.ivan: raises $0.34 to $0.51
notis-magia: folds 
Uncalled bet ($0.34) returned to kramnoy.ivan
kramnoy.ivan collected $0.66 from pot
*** SUMMARY ***
Total pot $0.69 | Rake $0.03 
Board [2d Jh 2h]
Seat 1: sipo1 folded before Flop (didn't bet)
Seat 2: TheQuicksand folded before Flop (didn't bet)
Seat 3: kramnoy.ivan collected ($0.66)
Seat 5: MarkFitz76 folded before Flop (didn't bet)
Seat 6: Azimusback (button) folded before Flop (didn't bet)
Seat 7: notis-magia (small blind) folded on the Flop
Seat 8: 87pinardi (big blind) folded before Flop
Seat 9: Dorex2007 folded before Flop (didn't bet)



PokerStars Hand #238671605585:  Hold'em No Limit ($0.02/$0.05 USD) - 2022/09/16 14:45:46 PT [2022/09/16 17:45:46 ET]
Table 'Hedera II' 9-max Seat #7 is the button
Seat 1: sipo1 ($6.67 in chips) 
Seat 2: TheQuicksand ($4.75 in chips) 
Seat 3: kramnoy.ivan ($5.95 in chips) 
Seat 5: MarkFitz76 ($5.45 in chips) 
Seat 6: Azimusback ($5.48 in chips) 
Seat 7: notis-magia ($8.14 in chips) 
Seat 8: 87pinardi ($5.89 in chips) 
Seat 9: Dorex2007 ($6.69 in chips) 
87pinardi: posts small blind $0.02
Dorex2007: posts big blind $0.05
malliosK: sits out 
*** HOLE CARDS ***
Dealt to Dorex2007 [5c 6c]
sipo1: folds 
TheQuicksand: folds 
kramnoy.ivan: folds 
MarkFitz76: raises $0.10 to $0.15
Azimusback: folds 
notis-magia: folds 
87pinardi: folds 
Dorex2007: calls $0.10
*** FLOP *** [5s Ks Ts]
Dorex2007: checks 
MarkFitz76: bets $0.20
Dorex2007: folds 
Uncalled bet ($0.20) returned to MarkFitz76
MarkFitz76 collected $0.31 from pot
MarkFitz76: doesn't show hand 
*** SUMMARY ***
Total pot $0.32 | Rake $0.01 
Board [5s Ks Ts]
Seat 1: sipo1 folded before Flop (didn't bet)
Seat 2: TheQuicksand folded before Flop (didn't bet)
Seat 3: kramnoy.ivan folded before Flop (didn't bet)
Seat 5: MarkFitz76 collected ($0.31)
Seat 6: Azimusback folded before Flop (didn't bet)
Seat 7: notis-magia (button) folded before Flop (didn't bet)
Seat 8: 87pinardi (small blind) folded before Flop
Seat 9: Dorex2007 (big blind) folded on the Flop



PokerStars Hand #238671617590:  Hold'em No Limit ($0.02/$0.05 USD) - 2022/09/16 14:46:16 PT [2022/09/16 17:46:16 ET]
Table 'Hedera II' 9-max Seat #8 is the button
Seat 1: sipo1 ($6.67 in chips) 
Seat 2: TheQuicksand ($4.75 in chips) 
Seat 3: kramnoy.ivan ($5.95 in chips) 
Seat 4: malliosK ($4.16 in chips) 
Seat 5: MarkFitz76 ($5.61 in chips) 
Seat 6: Azimusback ($5.48 in chips) 
Seat 7: notis-magia ($8.14 in chips) 
Seat 8: 87pinardi ($5.87 in chips) 
Seat 9: Dorex2007 ($6.54 in chips) 
Dorex2007: posts small blind $0.02
sipo1: posts big blind $0.05
malliosK: posts small blind $0.02
*** HOLE CARDS ***
Dealt to Dorex2007 [Th Qs]
TheQuicksand: folds 
kramnoy.ivan: raises $0.10 to $0.15
malliosK: folds 
MarkFitz76: folds 
Azimusback: folds 
notis-magia: calls $0.15
87pinardi: folds 
Dorex2007: folds 
sipo1: calls $0.10
*** FLOP *** [4c 2s Qh]
sipo1: checks 
kramnoy.ivan: bets $0.13
notis-magia: calls $0.13
sipo1: folds 
*** TURN *** [4c 2s Qh] [3h]
kramnoy.ivan: bets $0.30
notis-magia: calls $0.30
*** RIVER *** [4c 2s Qh 3h] [Kh]
kramnoy.ivan: bets $0.64
notis-magia: calls $0.64
*** SHOW DOWN ***
kramnoy.ivan: shows [Kc Qc] (two pair, Kings and Queens)
notis-magia: shows [Kd Qd] (two pair, Kings and Queens)
kramnoy.ivan collected $1.26 from pot
notis-magia collected $1.26 from pot
*** SUMMARY ***
Total pot $2.63 | Rake $0.11 
Board [4c 2s Qh 3h Kh]
Seat 1: sipo1 (big blind) folded on the Flop
Seat 2: TheQuicksand folded before Flop (didn't bet)
Seat 3: kramnoy.ivan showed [Kc Qc] and won ($1.26) with two pair, Kings and Queens
Seat 4: malliosK folded before Flop (didn't bet)
Seat 5: MarkFitz76 folded before Flop (didn't bet)
Seat 6: Azimusback folded before Flop (didn't bet)
Seat 7: notis-magia showed [Kd Qd] and won ($1.26) with two pair, Kings and Queens
Seat 8: 87pinardi (button) folded before Flop (didn't bet)
Seat 9: Dorex2007 (small blind) folded before Flop



PokerStars Hand #238671650169:  Hold'em No Limit ($0.02/$0.05 USD) - 2022/09/16 14:47:40 PT [2022/09/16 17:47:40 ET]
Table 'Hedera II' 9-max Seat #9 is the button
Seat 1: sipo1 ($6.52 in chips) 
Seat 2: TheQuicksand ($4.75 in chips) 
Seat 3: kramnoy.ivan ($5.99 in chips) 
Seat 4: malliosK ($4.14 in chips) 
Seat 5: MarkFitz76 ($5.61 in chips) 
Seat 6: Azimusback ($5.48 in chips) 
Seat 7: notis-magia ($8.18 in chips) 
Seat 8: 87pinardi ($5.87 in chips) 
Seat 9: Dorex2007 ($6.52 in chips) 
sipo1: posts small blind $0.02
TheQuicksand: posts big blind $0.05
*** HOLE CARDS ***
Dealt to Dorex2007 [Th Js]
kramnoy.ivan: raises $0.05 to $0.10
malliosK: raises $0.07 to $0.17
MarkFitz76: folds 
Azimusback: folds 
notis-magia: folds 
87pinardi: folds 
Dorex2007: folds 
sipo1: folds 
TheQuicksand: folds 
kramnoy.ivan: calls $0.07
*** FLOP *** [Qd 5d 3s]
kramnoy.ivan: checks 
malliosK: bets $0.35
kramnoy.ivan: folds 
Uncalled bet ($0.35) returned to malliosK
malliosK collected $0.39 from pot
malliosK: doesn't show hand 
*** SUMMARY ***
Total pot $0.41 | Rake $0.02 
Board [Qd 5d 3s]
Seat 1: sipo1 (small blind) folded before Flop
Seat 2: TheQuicksand (big blind) folded before Flop
Seat 3: kramnoy.ivan folded on the Flop
Seat 4: malliosK collected ($0.39)
Seat 5: MarkFitz76 folded before Flop (didn't bet)
Seat 6: Azimusback folded before Flop (didn't bet)
Seat 7: notis-magia folded before Flop (didn't bet)
Seat 8: 87pinardi folded before Flop (didn't bet)
Seat 9: Dorex2007 (button) folded before Flop (didn't bet)



PokerStars Hand #238671666064:  Hold'em No Limit ($0.02/$0.05 USD) - 2022/09/16 14:48:21 PT [2022/09/16 17:48:21 ET]
Table 'Hedera II' 9-max Seat #1 is the button
Seat 1: sipo1 ($6.50 in chips) 
Seat 2: TheQuicksand ($4.70 in chips) 
Seat 3: kramnoy.ivan ($5.82 in chips) 
Seat 4: malliosK ($4.36 in chips) 
Seat 5: MarkFitz76 ($5.61 in chips) 
Seat 6: Azimusback ($5.48 in chips) 
Seat 7: notis-magia ($8.18 in chips) 
Seat 8: 87pinardi ($5.87 in chips) 
Seat 9: Dorex2007 ($6.52 in chips) 
TheQuicksand: posts small blind $0.02
kramnoy.ivan: posts big blind $0.05
*** HOLE CARDS ***
Dealt to Dorex2007 [Ks 5c]
malliosK: folds 
MarkFitz76: folds 
Azimusback: folds 
notis-magia: folds 
87pinardi: folds 
Dorex2007: folds 
sipo1: folds 
TheQuicksand: folds 
Uncalled bet ($0.03) returned to kramnoy.ivan
kramnoy.ivan collected $0.04 from pot
*** SUMMARY ***
Total pot $0.04 | Rake $0 
Seat 1: sipo1 (button) folded before Flop (didn't bet)
Seat 2: TheQuicksand (small blind) folded before Flop
Seat 3: kramnoy.ivan (big blind) collected ($0.04)
Seat 4: malliosK folded before Flop (didn't bet)
Seat 5: MarkFitz76 folded before Flop (didn't bet)
Seat 6: Azimusback folded before Flop (didn't bet)
Seat 7: notis-magia folded before Flop (didn't bet)
Seat 8: 87pinardi folded before Flop (didn't bet)
Seat 9: Dorex2007 folded before Flop (didn't bet)



PokerStars Hand #238671672609:  Hold'em No Limit ($0.02/$0.05 USD) - 2022/09/16 14:48:38 PT [2022/09/16 17:48:38 ET]
Table 'Hedera II' 9-max Seat #2 is the button
Seat 1: sipo1 ($6.50 in chips) 
Seat 2: TheQuicksand ($4.68 in chips) 
Seat 3: kramnoy.ivan ($5.84 in chips) 
Seat 4: malliosK ($4.36 in chips) 
Seat 5: MarkFitz76 ($5.61 in chips) 
Seat 6: Azimusback ($5.48 in chips) 
Seat 7: notis-magia ($8.18 in chips) 
Seat 8: 87pinardi ($5.87 in chips) 
Seat 9: Dorex2007 ($6.52 in chips) 
kramnoy.ivan: posts small blind $0.02
malliosK: posts big blind $0.05
*** HOLE CARDS ***
Dealt to Dorex2007 [7h 8d]
MarkFitz76: folds 
Azimusback: folds 
notis-magia: folds 
87pinardi: folds 
Dorex2007: folds 
sipo1: folds 
TheQuicksand: folds 
kramnoy.ivan: folds 
Uncalled bet ($0.03) returned to malliosK
malliosK collected $0.04 from pot
malliosK: doesn't show hand 
*** SUMMARY ***
Total pot $0.04 | Rake $0 
Seat 1: sipo1 folded before Flop (didn't bet)
Seat 2: TheQuicksand (button) folded before Flop (didn't bet)
Seat 3: kramnoy.ivan (small blind) folded before Flop
Seat 4: malliosK (big blind) collected ($0.04)
Seat 5: MarkFitz76 folded before Flop (didn't bet)
Seat 6: Azimusback folded before Flop (didn't bet)
Seat 7: notis-magia folded before Flop (didn't bet)
Seat 8: 87pinardi folded before Flop (didn't bet)
Seat 9: Dorex2007 folded before Flop (didn't bet)



PokerStars Hand #238671681214:  Hold'em No Limit ($0.02/$0.05 USD) - 2022/09/16 14:49:00 PT [2022/09/16 17:49:00 ET]
Table 'Hedera II' 9-max Seat #3 is the button
Seat 1: sipo1 ($6.50 in chips) 
Seat 2: TheQuicksand ($4.68 in chips) 
Seat 3: kramnoy.ivan ($5.82 in chips) 
Seat 4: malliosK ($4.38 in chips) 
Seat 5: MarkFitz76 ($5.61 in chips) 
Seat 6: Azimusback ($5.48 in chips) 
Seat 7: notis-magia ($8.18 in chips) 
Seat 8: 87pinardi ($5.87 in chips) 
Seat 9: Dorex2007 ($6.52 in chips) 
malliosK: posts small blind $0.02
MarkFitz76: posts big blind $0.05
*** HOLE CARDS ***
Dealt to Dorex2007 [Ks 4h]
Azimusback: folds 
notis-magia: folds 
87pinardi: folds 
Dorex2007: folds 
sipo1: folds 
TheQuicksand: calls $0.05
kramnoy.ivan: raises $0.05 to $0.10
malliosK: folds 
MarkFitz76: calls $0.05
TheQuicksand: calls $0.05
*** FLOP *** [6h 3s 3c]
MarkFitz76: checks 
TheQuicksand: bets $0.15
kramnoy.ivan: calls $0.15
MarkFitz76: folds 
*** TURN *** [6h 3s 3c] [6c]
TheQuicksand: bets $0.29
kramnoy.ivan: folds 
Uncalled bet ($0.29) returned to TheQuicksand
TheQuicksand collected $0.59 from pot
TheQuicksand: doesn't show hand 
*** SUMMARY ***
Total pot $0.62 | Rake $0.03 
Board [6h 3s 3c 6c]
Seat 1: sipo1 folded before Flop (didn't bet)
Seat 2: TheQuicksand collected ($0.59)
Seat 3: kramnoy.ivan (button) folded on the Turn
Seat 4: malliosK (small blind) folded before Flop
Seat 5: MarkFitz76 (big blind) folded on the Flop
Seat 6: Azimusback folded before Flop (didn't bet)
Seat 7: notis-magia folded before Flop (didn't bet)
Seat 8: 87pinardi folded before Flop (didn't bet)
Seat 9: Dorex2007 folded before Flop (didn't bet)



PokerStars Hand #238671709038:  Hold'em No Limit ($0.02/$0.05 USD) - 2022/09/16 14:50:12 PT [2022/09/16 17:50:12 ET]
Table 'Hedera II' 9-max Seat #4 is the button
Seat 1: sipo1 ($6.50 in chips) 
Seat 2: TheQuicksand ($5.02 in chips) 
Seat 3: kramnoy.ivan ($5.57 in chips) 
Seat 4: malliosK ($4.36 in chips) 
Seat 5: MarkFitz76 ($5.51 in chips) 
Seat 6: Azimusback ($5.48 in chips) 
Seat 7: notis-magia ($8.18 in chips) 
Seat 8: 87pinardi ($5.87 in chips) 
Seat 9: Dorex2007 ($6.52 in chips) 
MarkFitz76: posts small blind $0.02
Azimusback: posts big blind $0.05
*** HOLE CARDS ***
Dealt to Dorex2007 [3d 8d]
notis-magia: raises $0.10 to $0.15
87pinardi: folds 
Dorex2007: folds 
sipo1: folds 
TheQuicksand: folds 
kramnoy.ivan: folds 
malliosK has timed out
malliosK: folds 
MarkFitz76: calls $0.13
Azimusback: folds 
*** FLOP *** [9s 4c Th]
MarkFitz76: checks 
notis-magia: checks 
*** TURN *** [9s 4c Th] [4d]
MarkFitz76: bets $0.26
notis-magia: folds 
Uncalled bet ($0.26) returned to MarkFitz76
MarkFitz76 collected $0.34 from pot
MarkFitz76: doesn't show hand 
*** SUMMARY ***
Total pot $0.35 | Rake $0.01 
Board [9s 4c Th 4d]
Seat 1: sipo1 folded before Flop (didn't bet)
Seat 2: TheQuicksand folded before Flop (didn't bet)
Seat 3: kramnoy.ivan folded before Flop (didn't bet)
Seat 4: malliosK (button) folded before Flop (didn't bet)
Seat 5: MarkFitz76 (small blind) collected ($0.34)
Seat 6: Azimusback (big blind) folded before Flop
Seat 7: notis-magia folded on the Turn
Seat 8: 87pinardi folded before Flop (didn't bet)
Seat 9: Dorex2007 folded before Flop (didn't bet)



PokerStars Hand #238671731005:  Hold'em No Limit ($0.02/$0.05 USD) - 2022/09/16 14:51:10 PT [2022/09/16 17:51:10 ET]
Table 'Hedera II' 9-max Seat #5 is the button
Seat 1: sipo1 ($6.50 in chips) 
Seat 2: TheQuicksand ($5.02 in chips) 
Seat 3: kramnoy.ivan ($5.57 in chips) 
Seat 5: MarkFitz76 ($5.70 in chips) 
Seat 6: Azimusback ($5.43 in chips) 
Seat 7: notis-magia ($8.03 in chips) 
Seat 8: 87pinardi ($5.87 in chips) 
Seat 9: Dorex2007 ($6.52 in chips) 
Azimusback: posts small blind $0.02
notis-magia: posts big blind $0.05
*** HOLE CARDS ***
Dealt to Dorex2007 [5c 4c]
87pinardi: folds 
Dorex2007: folds 
sipo1: folds 
TheQuicksand: folds 
kramnoy.ivan: raises $0.05 to $0.10
MarkFitz76: raises $0.35 to $0.45
Azimusback: folds 
notis-magia: folds 
kramnoy.ivan: folds 
Uncalled bet ($0.35) returned to MarkFitz76
MarkFitz76 collected $0.27 from pot
MarkFitz76: doesn't show hand 
*** SUMMARY ***
Total pot $0.27 | Rake $0 
Seat 1: sipo1 folded before Flop (didn't bet)
Seat 2: TheQuicksand folded before Flop (didn't bet)
Seat 3: kramnoy.ivan folded before Flop
Seat 5: MarkFitz76 (button) collected ($0.27)
Seat 6: Azimusback (small blind) folded before Flop
Seat 7: notis-magia (big blind) folded before Flop
Seat 8: 87pinardi folded before Flop (didn't bet)
Seat 9: Dorex2007 folded before Flop (didn't bet)



PokerStars Hand #238671746949:  Hold'em No Limit ($0.02/$0.05 USD) - 2022/09/16 14:51:52 PT [2022/09/16 17:51:52 ET]
Table 'Hedera II' 9-max Seat #6 is the button
Seat 1: sipo1 ($6.50 in chips) 
Seat 2: TheQuicksand ($5.02 in chips) 
Seat 3: kramnoy.ivan ($5.47 in chips) 
Seat 4: malliosK ($4.36 in chips) 
Seat 5: MarkFitz76 ($5.87 in chips) 
Seat 6: Azimusback ($5.41 in chips) 
Seat 7: notis-magia ($7.98 in chips) 
Seat 8: 87pinardi ($5.87 in chips) 
Seat 9: Dorex2007 ($6.52 in chips) 
notis-magia: posts small blind $0.02
87pinardi: posts big blind $0.05
*** HOLE CARDS ***
Dealt to Dorex2007 [Jc 3h]
Dorex2007: folds 
sipo1: folds 
TheQuicksand: calls $0.05
kramnoy.ivan: folds 
malliosK: folds 
MarkFitz76: folds 
Azimusback: folds 
notis-magia: folds 
87pinardi: checks 
*** FLOP *** [2h Js 6c]
87pinardi: checks 
TheQuicksand: checks 
*** TURN *** [2h Js 6c] [Th]
87pinardi: checks 
TheQuicksand: checks 
*** RIVER *** [2h Js 6c Th] [Kd]
87pinardi: checks 
TheQuicksand: checks 
*** SHOW DOWN ***
87pinardi: shows [7d 6s] (a pair of Sixes)
TheQuicksand: mucks hand 
87pinardi collected $0.12 from pot
*** SUMMARY ***
Total pot $0.12 | Rake $0 
Board [2h Js 6c Th Kd]
Seat 1: sipo1 folded before Flop (didn't bet)
Seat 2: TheQuicksand mucked [2s 5s]
Seat 3: kramnoy.ivan folded before Flop (didn't bet)
Seat 4: malliosK folded before Flop (didn't bet)
Seat 5: MarkFitz76 folded before Flop (didn't bet)
Seat 6: Azimusback (button) folded before Flop (didn't bet)
Seat 7: notis-magia (small blind) folded before Flop
Seat 8: 87pinardi (big blind) showed [7d 6s] and won ($0.12) with a pair of Sixes
Seat 9: Dorex2007 folded before Flop (didn't bet)



PokerStars Hand #238671760832:  Hold'em No Limit ($0.02/$0.05 USD) - 2022/09/16 14:52:28 PT [2022/09/16 17:52:28 ET]
Table 'Hedera II' 9-max Seat #7 is the button
Seat 1: sipo1 ($6.50 in chips) 
Seat 2: TheQuicksand ($4.97 in chips) 
Seat 3: kramnoy.ivan ($5.47 in chips) 
Seat 4: malliosK ($4.36 in chips) 
Seat 5: MarkFitz76 ($5.87 in chips) 
Seat 6: Azimusback ($5.41 in chips) 
Seat 7: notis-magia ($7.96 in chips) 
Seat 8: 87pinardi ($5.94 in chips) 
Seat 9: Dorex2007 ($6.52 in chips) 
87pinardi: posts small blind $0.02
Dorex2007: posts big blind $0.05
*** HOLE CARDS ***
Dealt to Dorex2007 [6s 5d]
sipo1: folds 
TheQuicksand: folds 
kramnoy.ivan: raises $0.10 to $0.15
malliosK: folds 
MarkFitz76: folds 
Azimusback: folds 
notis-magia has timed out
notis-magia: folds 
87pinardi: folds 
Dorex2007: folds 
Uncalled bet ($0.10) returned to kramnoy.ivan
kramnoy.ivan collected $0.12 from pot
*** SUMMARY ***
Total pot $0.12 | Rake $0 
Seat 1: sipo1 folded before Flop (didn't bet)
Seat 2: TheQuicksand folded before Flop (didn't bet)
Seat 3: kramnoy.ivan collected ($0.12)
Seat 4: malliosK folded before Flop (didn't bet)
Seat 5: MarkFitz76 folded before Flop (didn't bet)
Seat 6: Azimusback folded before Flop (didn't bet)
Seat 7: notis-magia (button) folded before Flop (didn't bet)
Seat 8: 87pinardi (small blind) folded before Flop
Seat 9: Dorex2007 (big blind) folded before Flop



PokerStars Hand #238671774986:  Hold'em No Limit ($0.02/$0.05 USD) - 2022/09/16 14:53:06 PT [2022/09/16 17:53:06 ET]
Table 'Hedera II' 9-max Seat #8 is the button
Seat 1: sipo1 ($6.50 in chips) 
Seat 2: TheQuicksand ($4.97 in chips) 
Seat 3: kramnoy.ivan ($5.54 in chips) 
Seat 4: malliosK ($4.36 in chips) 
Seat 5: MarkFitz76 ($5.87 in chips) 
Seat 6: Azimusback ($5.41 in chips) 
Seat 8: 87pinardi ($5.92 in chips) 
Seat 9: Dorex2007 ($6.47 in chips) 
Dorex2007: posts small blind $0.02
sipo1: posts big blind $0.05
*** HOLE CARDS ***
Dealt to Dorex2007 [2c Tc]
TheQuicksand: folds 
kramnoy.ivan: raises $0.05 to $0.10
malliosK: folds 
MarkFitz76: folds 
Azimusback: folds 
87pinardi: raises $0.20 to $0.30
Dorex2007: folds 
sipo1: folds 
kramnoy.ivan: calls $0.20
*** FLOP *** [2h 9d 4d]
kramnoy.ivan: bets $0.32
87pinardi: raises $0.32 to $0.64
kramnoy.ivan: folds 
Uncalled bet ($0.32) returned to 87pinardi
87pinardi collected $1.26 from pot
87pinardi: doesn't show hand 
*** SUMMARY ***
Total pot $1.31 | Rake $0.05 
Board [2h 9d 4d]
Seat 1: sipo1 (big blind) folded before Flop
Seat 2: TheQuicksand folded before Flop (didn't bet)
Seat 3: kramnoy.ivan folded on the Flop
Seat 4: malliosK folded before Flop (didn't bet)
Seat 5: MarkFitz76 folded before Flop (didn't bet)
Seat 6: Azimusback folded before Flop (didn't bet)
Seat 8: 87pinardi (button) collected ($1.26)
Seat 9: Dorex2007 (small blind) folded before Flop



PokerStars Hand #238671797241:  Hold'em No Limit ($0.02/$0.05 USD) - 2022/09/16 14:54:05 PT [2022/09/16 17:54:05 ET]
Table 'Hedera II' 9-max Seat #9 is the button
Seat 1: sipo1 ($6.45 in chips) 
Seat 2: TheQuicksand ($4.97 in chips) 
Seat 3: kramnoy.ivan ($4.92 in chips) 
Seat 4: malliosK ($4.36 in chips) 
Seat 5: MarkFitz76 ($5.87 in chips) 
Seat 6: Azimusback ($5.41 in chips) 
Seat 7: notis-magia ($7.96 in chips) 
Seat 8: 87pinardi ($6.56 in chips) 
Seat 9: Dorex2007 ($6.45 in chips) 
sipo1: posts small blind $0.02
TheQuicksand: posts big blind $0.05
*** HOLE CARDS ***
Dealt to Dorex2007 [4s Ad]
kramnoy.ivan: folds 
malliosK: raises $0.08 to $0.13
MarkFitz76: folds 
Azimusback: folds 
notis-magia: folds 
87pinardi: folds 
Dorex2007: folds 
sipo1: folds 
TheQuicksand: calls $0.08
*** FLOP *** [Qs 4h Ac]
TheQuicksand: checks 
malliosK: checks 
*** TURN *** [Qs 4h Ac] [Th]
TheQuicksand: checks 
malliosK: bets $0.30
TheQuicksand: folds 
Uncalled bet ($0.30) returned to malliosK
malliosK collected $0.27 from pot
malliosK: doesn't show hand 
*** SUMMARY ***
Total pot $0.28 | Rake $0.01 
Board [Qs 4h Ac Th]
Seat 1: sipo1 (small blind) folded before Flop
Seat 2: TheQuicksand (big blind) folded on the Turn
Seat 3: kramnoy.ivan folded before Flop (didn't bet)
Seat 4: malliosK collected ($0.27)
Seat 5: MarkFitz76 folded before Flop (didn't bet)
Seat 6: Azimusback folded before Flop (didn't bet)
Seat 7: notis-magia folded before Flop (didn't bet)
Seat 8: 87pinardi folded before Flop (didn't bet)
Seat 9: Dorex2007 (button) folded before Flop (didn't bet)



PokerStars Hand #238671816530:  Hold'em No Limit ($0.02/$0.05 USD) - 2022/09/16 14:54:56 PT [2022/09/16 17:54:56 ET]
Table 'Hedera II' 9-max Seat #1 is the button
Seat 1: sipo1 ($6.43 in chips) 
Seat 2: TheQuicksand ($4.84 in chips) 
Seat 3: kramnoy.ivan ($4.92 in chips) 
Seat 4: malliosK ($4.50 in chips) 
Seat 5: MarkFitz76 ($5.87 in chips) 
Seat 6: Azimusback ($5.41 in chips) 
Seat 7: notis-magia ($7.96 in chips) 
Seat 8: 87pinardi ($6.56 in chips) 
Seat 9: Dorex2007 ($6.45 in chips) 
TheQuicksand: posts small blind $0.02
kramnoy.ivan: posts big blind $0.05
*** HOLE CARDS ***
Dealt to Dorex2007 [6c 8d]
malliosK: folds 
MarkFitz76: folds 
Azimusback: folds 
notis-magia: folds 
87pinardi: folds 
Dorex2007: folds 
sipo1: folds 
TheQuicksand: folds 
Uncalled bet ($0.03) returned to kramnoy.ivan
kramnoy.ivan collected $0.04 from pot
*** SUMMARY ***
Total pot $0.04 | Rake $0 
Seat 1: sipo1 (button) folded before Flop (didn't bet)
Seat 2: TheQuicksand (small blind) folded before Flop
Seat 3: kramnoy.ivan (big blind) collected ($0.04)
Seat 4: malliosK folded before Flop (didn't bet)
Seat 5: MarkFitz76 folded before Flop (didn't bet)
Seat 6: Azimusback folded before Flop (didn't bet)
Seat 7: notis-magia folded before Flop (didn't bet)
Seat 8: 87pinardi folded before Flop (didn't bet)
Seat 9: Dorex2007 folded before Flop (didn't bet)



PokerStars Hand #238671825518:  Hold'em No Limit ($0.02/$0.05 USD) - 2022/09/16 14:55:21 PT [2022/09/16 17:55:21 ET]
Table 'Hedera II' 9-max Seat #2 is the button
Seat 1: sipo1 ($6.43 in chips) 
Seat 2: TheQuicksand ($4.82 in chips) 
Seat 3: kramnoy.ivan ($4.94 in chips) 
Seat 4: malliosK ($4.50 in chips) 
Seat 5: MarkFitz76 ($5.87 in chips) 
Seat 6: Azimusback ($5.41 in chips) 
Seat 7: notis-magia ($7.96 in chips) 
Seat 8: 87pinardi ($6.56 in chips) 
Seat 9: Dorex2007 ($6.45 in chips) 
kramnoy.ivan: posts small blind $0.02
malliosK: posts big blind $0.05
*** HOLE CARDS ***
Dealt to Dorex2007 [9c 5d]
MarkFitz76: folds 
Azimusback: folds 
notis-magia: folds 
87pinardi: folds 
Dorex2007: folds 
sipo1: folds 
TheQuicksand: raises $0.05 to $0.10
kramnoy.ivan: calls $0.08
malliosK: folds 
*** FLOP *** [3d 3h 4c]
kramnoy.ivan: bets $0.12
TheQuicksand: calls $0.12
*** TURN *** [3d 3h 4c] [As]
kramnoy.ivan: checks 
TheQuicksand: checks 
*** RIVER *** [3d 3h 4c As] [3s]
kramnoy.ivan: checks 
TheQuicksand: checks 
*** SHOW DOWN ***
kramnoy.ivan: shows [6s 5s] (three of a kind, Threes)
TheQuicksand: shows [Qh Qc] (a full house, Threes full of Queens)
TheQuicksand collected $0.47 from pot
*** SUMMARY ***
Total pot $0.49 | Rake $0.02 
Board [3d 3h 4c As 3s]
Seat 1: sipo1 folded before Flop (didn't bet)
Seat 2: TheQuicksand (button) showed [Qh Qc] and won ($0.47) with a full house, Threes full of Queens
Seat 3: kramnoy.ivan (small blind) showed [6s 5s] and lost with three of a kind, Threes
Seat 4: malliosK (big blind) folded before Flop
Seat 5: MarkFitz76 folded before Flop (didn't bet)
Seat 6: Azimusback folded before Flop (didn't bet)
Seat 7: notis-magia folded before Flop (didn't bet)
Seat 8: 87pinardi folded before Flop (didn't bet)
Seat 9: Dorex2007 folded before Flop (didn't bet)



PokerStars Hand #238671840459:  Hold'em No Limit ($0.02/$0.05 USD) - 2022/09/16 14:56:14 PT [2022/09/16 17:56:14 ET]
Table 'Hedera II' 9-max Seat #3 is the button
Seat 1: sipo1 ($6.43 in chips) 
Seat 2: TheQuicksand ($5.07 in chips) 
Seat 3: kramnoy.ivan ($4.72 in chips) 
Seat 4: malliosK ($4.45 in chips) 
Seat 5: MarkFitz76 ($5.87 in chips) 
Seat 6: Azimusback ($5.41 in chips) 
Seat 7: notis-magia ($7.96 in chips) 
Seat 8: 87pinardi ($6.56 in chips) 
Seat 9: Dorex2007 ($6.45 in chips) 
malliosK: posts small blind $0.02
MarkFitz76: posts big blind $0.05
*** HOLE CARDS ***
Dealt to Dorex2007 [8c 9h]
Azimusback: raises $0.10 to $0.15
notis-magia: folds 
87pinardi: folds 
Dorex2007: folds 
sipo1: folds 
TheQuicksand: calls $0.15
kramnoy.ivan: folds 
malliosK: folds 
MarkFitz76: folds 
*** FLOP *** [Ts 5s Kd]
Azimusback: bets $0.15
TheQuicksand: calls $0.15
*** TURN *** [Ts 5s Kd] [9d]
Azimusback: bets $0.25
TheQuicksand: calls $0.25
*** RIVER *** [Ts 5s Kd 9d] [Qh]
Azimusback: checks 
TheQuicksand: checks 
*** SHOW DOWN ***
Azimusback: shows [3h 3d] (a pair of Threes)
TheQuicksand: shows [Ad 5d] (a pair of Fives)
TheQuicksand collected $1.12 from pot
*** SUMMARY ***
Total pot $1.17 | Rake $0.05 
Board [Ts 5s Kd 9d Qh]
Seat 1: sipo1 folded before Flop (didn't bet)
Seat 2: TheQuicksand showed [Ad 5d] and won ($1.12) with a pair of Fives
Seat 3: kramnoy.ivan (button) folded before Flop (didn't bet)
Seat 4: malliosK (small blind) folded before Flop
Seat 5: MarkFitz76 (big blind) folded before Flop
Seat 6: Azimusback showed [3h 3d] and lost with a pair of Threes
Seat 7: notis-magia folded before Flop (didn't bet)
Seat 8: 87pinardi folded before Flop (didn't bet)
Seat 9: Dorex2007 folded before Flop (didn't bet)



PokerStars Hand #238671853873:  Hold'em No Limit ($0.02/$0.05 USD) - 2022/09/16 14:57:01 PT [2022/09/16 17:57:01 ET]
Table 'Hedera II' 9-max Seat #4 is the button
Seat 1: sipo1 ($6.43 in chips) 
Seat 2: TheQuicksand ($5.64 in chips) 
Seat 3: kramnoy.ivan ($4.72 in chips) 
Seat 4: malliosK ($4.43 in chips) 
Seat 5: MarkFitz76 ($5.82 in chips) 
Seat 6: Azimusback ($5 in chips) 
Seat 7: notis-magia ($7.96 in chips) 
Seat 8: 87pinardi ($6.56 in chips) 
Seat 9: Dorex2007 ($6.45 in chips) 
MarkFitz76: posts small blind $0.02
Azimusback: posts big blind $0.05
*** HOLE CARDS ***
Dealt to Dorex2007 [9s 4h]
notis-magia: raises $0.10 to $0.15
87pinardi has timed out
87pinardi: folds 
Dorex2007: folds 
sipo1: folds 
TheQuicksand: folds 
kramnoy.ivan: folds 
malliosK: folds 
MarkFitz76: folds 
Azimusback: folds 
Uncalled bet ($0.10) returned to notis-magia
notis-magia collected $0.12 from pot
notis-magia: doesn't show hand 
*** SUMMARY ***
Total pot $0.12 | Rake $0 
Seat 1: sipo1 folded before Flop (didn't bet)
Seat 2: TheQuicksand folded before Flop (didn't bet)
Seat 3: kramnoy.ivan folded before Flop (didn't bet)
Seat 4: malliosK (button) folded before Flop (didn't bet)
Seat 5: MarkFitz76 (small blind) folded before Flop
Seat 6: Azimusback (big blind) folded before Flop
Seat 7: notis-magia collected ($0.12)
Seat 8: 87pinardi folded before Flop (didn't bet)
Seat 9: Dorex2007 folded before Flop (didn't bet)



PokerStars Hand #238671866578:  Hold'em No Limit ($0.02/$0.05 USD) - 2022/09/16 14:57:45 PT [2022/09/16 17:57:45 ET]
Table 'Hedera II' 9-max Seat #5 is the button
Seat 1: sipo1 ($6.43 in chips) 
Seat 2: TheQuicksand ($5.64 in chips) 
Seat 3: kramnoy.ivan ($4.72 in chips) 
Seat 4: malliosK ($4.43 in chips) 
Seat 5: MarkFitz76 ($5.80 in chips) 
Seat 6: Azimusback ($5 in chips) 
Seat 7: notis-magia ($8.03 in chips) 
Seat 9: Dorex2007 ($6.45 in chips) 
Azimusback: posts small blind $0.02
notis-magia: posts big blind $0.05
*** HOLE CARDS ***
Dealt to Dorex2007 [2d 7h]
Dorex2007: folds 
sipo1: folds 
TheQuicksand: folds 
kramnoy.ivan: folds 
malliosK: folds 
MarkFitz76: folds 
Azimusback: raises $0.10 to $0.15
notis-magia: calls $0.10
*** FLOP *** [Kd 4c Qc]
Azimusback: checks 
notis-magia: bets $0.14
Azimusback: calls $0.14
*** TURN *** [Kd 4c Qc] [Ts]
Azimusback: checks 
notis-magia: checks 
*** RIVER *** [Kd 4c Qc Ts] [Tc]
Azimusback: checks 
notis-magia: checks 
*** SHOW DOWN ***
Azimusback: shows [3s Kc] (two pair, Kings and Tens)
notis-magia: mucks hand 
Azimusback collected $0.56 from pot
*** SUMMARY ***
Total pot $0.58 | Rake $0.02 
Board [Kd 4c Qc Ts Tc]
Seat 1: sipo1 folded before Flop (didn't bet)
Seat 2: TheQuicksand folded before Flop (didn't bet)
Seat 3: kramnoy.ivan folded before Flop (didn't bet)
Seat 4: malliosK folded before Flop (didn't bet)
Seat 5: MarkFitz76 (button) folded before Flop (didn't bet)
Seat 6: Azimusback (small blind) showed [3s Kc] and won ($0.56) with two pair, Kings and Tens
Seat 7: notis-magia (big blind) mucked [As Qd]
Seat 9: Dorex2007 folded before Flop (didn't bet)



PokerStars Hand #238671887099:  Hold'em No Limit ($0.02/$0.05 USD) - 2022/09/16 14:58:57 PT [2022/09/16 17:58:57 ET]
Table 'Hedera II' 9-max Seat #6 is the button
Seat 1: sipo1 ($6.43 in chips) 
Seat 2: TheQuicksand ($5.64 in chips) 
Seat 3: kramnoy.ivan ($4.72 in chips) 
Seat 4: malliosK ($4.43 in chips) 
Seat 5: MarkFitz76 ($5.80 in chips) 
Seat 6: Azimusback ($5.27 in chips) 
Seat 7: notis-magia ($7.74 in chips) 
Seat 9: Dorex2007 ($6.45 in chips) 
notis-magia: posts small blind $0.02
Dorex2007: posts big blind $0.05
*** HOLE CARDS ***
Dealt to Dorex2007 [3c 6c]
sipo1: folds 
TheQuicksand: folds 
kramnoy.ivan: raises $0.05 to $0.10
malliosK has timed out
malliosK: folds 
MarkFitz76: raises $0.30 to $0.40
Azimusback: folds 
notis-magia: folds 
Dorex2007: folds 
kramnoy.ivan: folds 
Uncalled bet ($0.30) returned to MarkFitz76
MarkFitz76 collected $0.27 from pot
MarkFitz76: doesn't show hand 
*** SUMMARY ***
Total pot $0.27 | Rake $0 
Seat 1: sipo1 folded before Flop (didn't bet)
Seat 2: TheQuicksand folded before Flop (didn't bet)
Seat 3: kramnoy.ivan folded before Flop
Seat 4: malliosK folded before Flop (didn't bet)
Seat 5: MarkFitz76 collected ($0.27)
Seat 6: Azimusback (button) folded before Flop (didn't bet)
Seat 7: notis-magia (small blind) folded before Flop
Seat 9: Dorex2007 (big blind) folded before Flop



PokerStars Hand #238671901944:  Hold'em No Limit ($0.02/$0.05 USD) - 2022/09/16 14:59:49 PT [2022/09/16 17:59:49 ET]
Table 'Hedera II' 9-max Seat #7 is the button
Seat 1: sipo1 ($6.43 in chips) 
Seat 2: TheQuicksand ($5.64 in chips) 
Seat 3: kramnoy.ivan ($4.62 in chips) 
Seat 4: malliosK ($4.43 in chips) 
Seat 5: MarkFitz76 ($5.97 in chips) 
Seat 6: Azimusback ($5.27 in chips) 
Seat 7: notis-magia ($7.72 in chips) 
Seat 9: Dorex2007 ($6.40 in chips) 
Dorex2007: posts small blind $0.02
sipo1: posts big blind $0.05
*** HOLE CARDS ***
Dealt to Dorex2007 [8h 5c]
TheQuicksand: folds 
kramnoy.ivan: folds 
malliosK: raises $0.06 to $0.11
MarkFitz76: folds 
Azimusback: folds 
notis-magia: folds 
Dorex2007: folds 
sipo1: raises $0.24 to $0.35
malliosK: calls $0.24
*** FLOP *** [Ac 8d 2h]
sipo1: checks 
malliosK: bets $0.23
sipo1: folds 
Uncalled bet ($0.23) returned to malliosK
malliosK collected $0.69 from pot
malliosK: doesn't show hand 
*** SUMMARY ***
Total pot $0.72 | Rake $0.03 
Board [Ac 8d 2h]
Seat 1: sipo1 (big blind) folded on the Flop
Seat 2: TheQuicksand folded before Flop (didn't bet)
Seat 3: kramnoy.ivan folded before Flop (didn't bet)
Seat 4: malliosK collected ($0.69)
Seat 5: MarkFitz76 folded before Flop (didn't bet)
Seat 6: Azimusback folded before Flop (didn't bet)
Seat 7: notis-magia (button) folded before Flop (didn't bet)
Seat 9: Dorex2007 (small blind) folded before Flop



PokerStars Hand #238671920879:  Hold'em No Limit ($0.02/$0.05 USD) - 2022/09/16 15:00:53 PT [2022/09/16 18:00:53 ET]
Table 'Hedera II' 9-max Seat #9 is the button
Seat 1: sipo1 ($6.08 in chips) 
Seat 2: TheQuicksand ($5.64 in chips) 
Seat 3: kramnoy.ivan ($4.62 in chips) 
Seat 4: malliosK ($4.77 in chips) 
Seat 5: MarkFitz76 ($5.97 in chips) 
Seat 6: Azimusback ($5.27 in chips) 
Seat 7: notis-magia ($7.72 in chips) 
Seat 9: Dorex2007 ($6.38 in chips) 
sipo1: posts small blind $0.02
TheQuicksand: posts big blind $0.05
*** HOLE CARDS ***
Dealt to Dorex2007 [6d Qc]
kramnoy.ivan: folds 
malliosK: folds 
MarkFitz76: raises $0.10 to $0.15
Azimusback: folds 
notis-magia: folds 
Dorex2007: folds 
sipo1: calls $0.13
TheQuicksand: folds 
*** FLOP *** [4c Jh 3d]
sipo1: checks 
MarkFitz76: checks 
*** TURN *** [4c Jh 3d] [As]
sipo1: checks 
MarkFitz76: checks 
*** RIVER *** [4c Jh 3d As] [Ks]
sipo1: bets $0.10
MarkFitz76: raises $0.35 to $0.45
sipo1: calls $0.35
*** SHOW DOWN ***
MarkFitz76: shows [Kh Jd] (two pair, Kings and Jacks)
sipo1: mucks hand 
MarkFitz76 collected $1.20 from pot
*** SUMMARY ***
Total pot $1.25 | Rake $0.05 
Board [4c Jh 3d As Ks]
Seat 1: sipo1 (small blind) mucked [Td Ah]
Seat 2: TheQuicksand (big blind) folded before Flop
Seat 3: kramnoy.ivan folded before Flop (didn't bet)
Seat 4: malliosK folded before Flop (didn't bet)
Seat 5: MarkFitz76 showed [Kh Jd] and won ($1.20) with two pair, Kings and Jacks
Seat 6: Azimusback folded before Flop (didn't bet)
Seat 7: notis-magia folded before Flop (didn't bet)
Seat 9: Dorex2007 (button) folded before Flop (didn't bet)



PokerStars Hand #238671944943:  Hold'em No Limit ($0.02/$0.05 USD) - 2022/09/16 15:02:05 PT [2022/09/16 18:02:05 ET]
Table 'Hedera II' 9-max Seat #1 is the button
Seat 1: sipo1 ($5.48 in chips) 
Seat 2: TheQuicksand ($5.59 in chips) 
Seat 3: kramnoy.ivan ($4.62 in chips) 
Seat 4: malliosK ($4.77 in chips) 
Seat 5: MarkFitz76 ($6.57 in chips) 
Seat 6: Azimusback ($5.27 in chips) 
Seat 7: notis-magia ($7.72 in chips) 
Seat 9: Dorex2007 ($6.38 in chips) 
TheQuicksand: posts small blind $0.02
kramnoy.ivan: posts big blind $0.05
87pinardi: sits out 
*** HOLE CARDS ***
Dealt to Dorex2007 [Ac 9c]
87pinardi leaves the table
malliosK: folds 
MarkFitz76: folds 
Azimusback: raises $0.10 to $0.15
notis-magia: folds 
quej0 joins the table at seat #8 
Dorex2007: folds 
sipo1: calls $0.15
TheQuicksand: folds 
kramnoy.ivan: folds 
*** FLOP *** [2h 3c 6d]
Azimusback: bets $0.17
sipo1: calls $0.17
*** TURN *** [2h 3c 6d] [5d]
Azimusback is disconnected 
Azimusback is connected 
Azimusback: checks 
sipo1: bets $0.27
Azimusback: folds 
Uncalled bet ($0.27) returned to sipo1
sipo1 collected $0.68 from pot
sipo1: doesn't show hand 
*** SUMMARY ***
Total pot $0.71 | Rake $0.03 
Board [2h 3c 6d 5d]
Seat 1: sipo1 (button) collected ($0.68)
Seat 2: TheQuicksand (small blind) folded before Flop
Seat 3: kramnoy.ivan (big blind) folded before Flop
Seat 4: malliosK folded before Flop (didn't bet)
Seat 5: MarkFitz76 folded before Flop (didn't bet)
Seat 6: Azimusback folded on the Turn
Seat 7: notis-magia folded before Flop (didn't bet)
Seat 9: Dorex2007 folded before Flop (didn't bet)



PokerStars Hand #238671981295:  Hold'em No Limit ($0.02/$0.05 USD) - 2022/09/16 15:03:46 PT [2022/09/16 18:03:46 ET]
Table 'Hedera II' 9-max Seat #2 is the button
Seat 1: sipo1 ($5.84 in chips) 
Seat 2: TheQuicksand ($5.57 in chips) 
Seat 3: kramnoy.ivan ($4.57 in chips) 
Seat 4: malliosK ($4.77 in chips) 
Seat 5: MarkFitz76 ($6.57 in chips) 
Seat 6: Azimusback ($5 in chips) 
Seat 7: notis-magia ($7.72 in chips) 
Seat 8: quej0 ($5 in chips) 
Seat 9: Dorex2007 ($6.38 in chips) 
kramnoy.ivan: posts small blind $0.02
malliosK: posts big blind $0.05
quej0: posts big blind $0.05
*** HOLE CARDS ***
Dealt to Dorex2007 [6c As]
MarkFitz76: folds 
Azimusback: raises $0.17 to $0.22
notis-magia: folds 
quej0: folds 
Dorex2007: folds 
sipo1: folds 
TheQuicksand: folds 
kramnoy.ivan: calls $0.20
malliosK: folds 
*** FLOP *** [4h Qs 8h]
kramnoy.ivan: bets $0.26
Azimusback is disconnected 
Azimusback is connected 
Azimusback: calls $0.26
*** TURN *** [4h Qs 8h] [2s]
kramnoy.ivan: bets $0.51
Azimusback is disconnected 
Azimusback has timed out while disconnected
Azimusback: folds 
Uncalled bet ($0.51) returned to kramnoy.ivan
kramnoy.ivan collected $1.02 from pot
*** SUMMARY ***
Total pot $1.06 | Rake $0.04 
Board [4h Qs 8h 2s]
Seat 1: sipo1 folded before Flop (didn't bet)
Seat 2: TheQuicksand (button) folded before Flop (didn't bet)
Seat 3: kramnoy.ivan (small blind) collected ($1.02)
Seat 4: malliosK (big blind) folded before Flop
Seat 5: MarkFitz76 folded before Flop (didn't bet)
Seat 6: Azimusback folded on the Turn
Seat 7: notis-magia folded before Flop (didn't bet)
Seat 8: quej0 folded before Flop (didn't bet)
Seat 9: Dorex2007 folded before Flop (didn't bet)



PokerStars Hand #238672031658:  Hold'em No Limit ($0.02/$0.05 USD) - 2022/09/16 15:06:02 PT [2022/09/16 18:06:02 ET]
Table 'Hedera II' 9-max Seat #3 is the button
Seat 1: sipo1 ($5.84 in chips) 
Seat 2: TheQuicksand ($5.57 in chips) 
Seat 3: kramnoy.ivan ($5.11 in chips) 
Seat 4: malliosK ($4.72 in chips) 
Seat 5: MarkFitz76 ($6.57 in chips) 
Seat 7: notis-magia ($7.72 in chips) 
Seat 8: quej0 ($4.95 in chips) 
Seat 9: Dorex2007 ($6.38 in chips) 
malliosK: posts small blind $0.02
MarkFitz76: posts big blind $0.05
*** HOLE CARDS ***
Dealt to Dorex2007 [7h 6d]
notis-magia has timed out
notis-magia: folds 
quej0: folds 
Dorex2007: folds 
sipo1: folds 
TheQuicksand: folds 
kramnoy.ivan: folds 
malliosK has timed out
malliosK: folds 
Uncalled bet ($0.03) returned to MarkFitz76
MarkFitz76 collected $0.04 from pot
MarkFitz76: doesn't show hand 
*** SUMMARY ***
Total pot $0.04 | Rake $0 
Seat 1: sipo1 folded before Flop (didn't bet)
Seat 2: TheQuicksand folded before Flop (didn't bet)
Seat 3: kramnoy.ivan (button) folded before Flop (didn't bet)
Seat 4: malliosK (small blind) folded before Flop
Seat 5: MarkFitz76 (big blind) collected ($0.04)
Seat 7: notis-magia folded before Flop (didn't bet)
Seat 8: quej0 folded before Flop (didn't bet)
Seat 9: Dorex2007 folded before Flop (didn't bet)



PokerStars Hand #238672042240:  Hold'em No Limit ($0.02/$0.05 USD) - 2022/09/16 15:06:31 PT [2022/09/16 18:06:31 ET]
Table 'Hedera II' 9-max Seat #5 is the button
Seat 1: sipo1 ($5.84 in chips) 
Seat 2: TheQuicksand ($5.57 in chips) 
Seat 3: kramnoy.ivan ($5.11 in chips) 
Seat 5: MarkFitz76 ($6.59 in chips) 
Seat 7: notis-magia ($7.72 in chips) 
Seat 8: quej0 ($4.95 in chips) 
Seat 9: Dorex2007 ($6.38 in chips) 
notis-magia: posts small blind $0.02
quej0: posts big blind $0.05
*** HOLE CARDS ***
Dealt to Dorex2007 [Tc Jc]
Dorex2007: folds 
sipo1: folds 
TheQuicksand: folds 
kramnoy.ivan: folds 
MarkFitz76: raises $0.10 to $0.15
notis-magia: calls $0.13
quej0: folds 
*** FLOP *** [9c Ts 3s]
notis-magia: checks 
MarkFitz76: bets $0.20
notis-magia: folds 
Uncalled bet ($0.20) returned to MarkFitz76
MarkFitz76 collected $0.34 from pot
MarkFitz76: doesn't show hand 
*** SUMMARY ***
Total pot $0.35 | Rake $0.01 
Board [9c Ts 3s]
Seat 1: sipo1 folded before Flop (didn't bet)
Seat 2: TheQuicksand folded before Flop (didn't bet)
Seat 3: kramnoy.ivan folded before Flop (didn't bet)
Seat 5: MarkFitz76 (button) collected ($0.34)
Seat 7: notis-magia (small blind) folded on the Flop
Seat 8: quej0 (big blind) folded before Flop
Seat 9: Dorex2007 folded before Flop (didn't bet)



PokerStars Hand #238672060440:  Hold'em No Limit ($0.02/$0.05 USD) - 2022/09/16 15:07:20 PT [2022/09/16 18:07:20 ET]
Table 'Hedera II' 9-max Seat #7 is the button
Seat 1: sipo1 ($5.84 in chips) 
Seat 2: TheQuicksand ($5.57 in chips) 
Seat 3: kramnoy.ivan ($5.11 in chips) 
Seat 4: malliosK ($4.70 in chips) 
Seat 5: MarkFitz76 ($6.78 in chips) 
Seat 7: notis-magia ($7.57 in chips) 
Seat 8: quej0 ($4.90 in chips) 
Seat 9: Dorex2007 ($6.38 in chips) 
quej0: posts small blind $0.02
Dorex2007: posts big blind $0.05
*** HOLE CARDS ***
Dealt to Dorex2007 [7s 5c]
sipo1: folds 
TheQuicksand: folds 
kramnoy.ivan: folds 
malliosK: folds 
MarkFitz76: folds 
notis-magia: folds 
quej0: folds 
Uncalled bet ($0.03) returned to Dorex2007
Dorex2007 collected $0.04 from pot
Dorex2007: doesn't show hand 
*** SUMMARY ***
Total pot $0.04 | Rake $0 
Seat 1: sipo1 folded before Flop (didn't bet)
Seat 2: TheQuicksand folded before Flop (didn't bet)
Seat 3: kramnoy.ivan folded before Flop (didn't bet)
Seat 4: malliosK folded before Flop (didn't bet)
Seat 5: MarkFitz76 folded before Flop (didn't bet)
Seat 7: notis-magia (button) folded before Flop (didn't bet)
Seat 8: quej0 (small blind) folded before Flop
Seat 9: Dorex2007 (big blind) collected ($0.04)



PokerStars Hand #238672068043:  Hold'em No Limit ($0.02/$0.05 USD) - 2022/09/16 15:07:40 PT [2022/09/16 18:07:40 ET]
Table 'Hedera II' 9-max Seat #8 is the button
Seat 1: sipo1 ($5.84 in chips) 
Seat 2: TheQuicksand ($5.57 in chips) 
Seat 3: kramnoy.ivan ($5.11 in chips) 
Seat 4: malliosK ($4.70 in chips) 
Seat 5: MarkFitz76 ($6.78 in chips) 
Seat 7: notis-magia ($7.57 in chips) 
Seat 8: quej0 ($4.88 in chips) 
Seat 9: Dorex2007 ($6.40 in chips) 
Dorex2007: posts small blind $0.02
sipo1: posts big blind $0.05
*** HOLE CARDS ***
Dealt to Dorex2007 [7d Jh]
TheQuicksand: folds 
kramnoy.ivan: folds 
malliosK: folds 
MarkFitz76: folds 
notis-magia: folds 
quej0: calls $0.05
Dorex2007: folds 
sipo1: checks 
*** FLOP *** [2h 7h 3h]
sipo1: bets $0.05
quej0: folds 
Uncalled bet ($0.05) returned to sipo1
sipo1 collected $0.12 from pot
sipo1: doesn't show hand 
*** SUMMARY ***
Total pot $0.12 | Rake $0 
Board [2h 7h 3h]
Seat 1: sipo1 (big blind) collected ($0.12)
Seat 2: TheQuicksand folded before Flop (didn't bet)
Seat 3: kramnoy.ivan folded before Flop (didn't bet)
Seat 4: malliosK folded before Flop (didn't bet)
Seat 5: MarkFitz76 folded before Flop (didn't bet)
Seat 7: notis-magia folded before Flop (didn't bet)
Seat 8: quej0 (button) folded on the Flop
Seat 9: Dorex2007 (small blind) folded before Flop



PokerStars Hand #238672078699:  Hold'em No Limit ($0.02/$0.05 USD) - 2022/09/16 15:08:09 PT [2022/09/16 18:08:09 ET]
Table 'Hedera II' 9-max Seat #9 is the button
Seat 1: sipo1 ($5.91 in chips) 
Seat 2: TheQuicksand ($5.57 in chips) 
Seat 3: kramnoy.ivan ($5.11 in chips) 
Seat 4: malliosK ($4.70 in chips) 
Seat 5: MarkFitz76 ($6.78 in chips) 
Seat 7: notis-magia ($7.57 in chips) 
Seat 8: quej0 ($4.83 in chips) 
Seat 9: Dorex2007 ($6.38 in chips) 
sipo1: posts small blind $0.02
TheQuicksand: posts big blind $0.05
*** HOLE CARDS ***
Dealt to Dorex2007 [Kc 7c]
kramnoy.ivan: folds 
malliosK: folds 
MarkFitz76: raises $0.10 to $0.15
notis-magia: folds 
quej0: calls $0.15
Dorex2007: folds 
sipo1: folds 
TheQuicksand: calls $0.10
*** FLOP *** [2d 9c 5d]
TheQuicksand: checks 
MarkFitz76: checks 
quej0: bets $0.10
TheQuicksand: calls $0.10
MarkFitz76: calls $0.10
*** TURN *** [2d 9c 5d] [6c]
TheQuicksand: checks 
MarkFitz76: checks 
quej0: checks 
*** RIVER *** [2d 9c 5d 6c] [6d]
TheQuicksand: checks 
MarkFitz76: checks 
quej0: checks 
*** SHOW DOWN ***
TheQuicksand: shows [9d 9s] (a full house, Nines full of Sixes)
MarkFitz76: mucks hand 
quej0: mucks hand 
TheQuicksand collected $0.74 from pot
*** SUMMARY ***
Total pot $0.77 | Rake $0.03 
Board [2d 9c 5d 6c 6d]
Seat 1: sipo1 (small blind) folded before Flop
Seat 2: TheQuicksand (big blind) showed [9d 9s] and won ($0.74) with a full house, Nines full of Sixes
Seat 3: kramnoy.ivan folded before Flop (didn't bet)
Seat 4: malliosK folded before Flop (didn't bet)
Seat 5: MarkFitz76 mucked [Jd Ac]
Seat 7: notis-magia folded before Flop (didn't bet)
Seat 8: quej0 mucked [8h 8s]
Seat 9: Dorex2007 (button) folded before Flop (didn't bet)



PokerStars Hand #238672113183:  Hold'em No Limit ($0.02/$0.05 USD) - 2022/09/16 15:09:43 PT [2022/09/16 18:09:43 ET]
Table 'Hedera II' 9-max Seat #1 is the button
Seat 1: sipo1 ($5.89 in chips) 
Seat 2: TheQuicksand ($6.06 in chips) 
Seat 3: kramnoy.ivan ($5.11 in chips) 
Seat 4: malliosK ($4.70 in chips) 
Seat 5: MarkFitz76 ($6.53 in chips) 
Seat 7: notis-magia ($7.57 in chips) 
Seat 8: quej0 ($4.58 in chips) 
Seat 9: Dorex2007 ($6.38 in chips) 
TheQuicksand: posts small blind $0.02
kramnoy.ivan: posts big blind $0.05
*** HOLE CARDS ***
Dealt to Dorex2007 [8d 5d]
malliosK: folds 
MarkFitz76: raises $0.10 to $0.15
notis-magia: folds 
quej0: folds 
Dorex2007: folds 
sipo1: folds 
TheQuicksand: folds 
kramnoy.ivan: folds 
Uncalled bet ($0.10) returned to MarkFitz76
MarkFitz76 collected $0.12 from pot
MarkFitz76: doesn't show hand 
*** SUMMARY ***
Total pot $0.12 | Rake $0 
Seat 1: sipo1 (button) folded before Flop (didn't bet)
Seat 2: TheQuicksand (small blind) folded before Flop
Seat 3: kramnoy.ivan (big blind) folded before Flop
Seat 4: malliosK folded before Flop (didn't bet)
Seat 5: MarkFitz76 collected ($0.12)
Seat 7: notis-magia folded before Flop (didn't bet)
Seat 8: quej0 folded before Flop (didn't bet)
Seat 9: Dorex2007 folded before Flop (didn't bet)



PokerStars Hand #238672123224:  Hold'em No Limit ($0.02/$0.05 USD) - 2022/09/16 15:10:10 PT [2022/09/16 18:10:10 ET]
Table 'Hedera II' 9-max Seat #2 is the button
Seat 1: sipo1 ($5.89 in chips) 
Seat 2: TheQuicksand ($6.04 in chips) 
Seat 3: kramnoy.ivan ($5.06 in chips) 
Seat 4: malliosK ($4.70 in chips) 
Seat 5: MarkFitz76 ($6.60 in chips) 
Seat 7: notis-magia ($7.57 in chips) 
Seat 8: quej0 ($4.58 in chips) 
Seat 9: Dorex2007 ($6.38 in chips) 
kramnoy.ivan: posts small blind $0.02
malliosK: posts big blind $0.05
*** HOLE CARDS ***
Dealt to Dorex2007 [Tc Qs]
MarkFitz76: folds 
notis-magia: raises $0.10 to $0.15
quej0: folds 
Dorex2007: folds 
sipo1: folds 
TheQuicksand: calls $0.15
kramnoy.ivan: folds 
malliosK: folds 
*** FLOP *** [As 5c Ah]
notis-magia: checks 
TheQuicksand: checks 
*** TURN *** [As 5c Ah] [5s]
notis-magia: checks 
TheQuicksand: checks 
*** RIVER *** [As 5c Ah 5s] [6h]
notis-magia: checks 
TheQuicksand: checks 
*** SHOW DOWN ***
notis-magia: shows [Kh Jh] (two pair, Aces and Fives)
TheQuicksand: mucks hand 
notis-magia collected $0.35 from pot
*** SUMMARY ***
Total pot $0.37 | Rake $0.02 
Board [As 5c Ah 5s 6h]
Seat 1: sipo1 folded before Flop (didn't bet)
Seat 2: TheQuicksand (button) mucked [3d 2d]
Seat 3: kramnoy.ivan (small blind) folded before Flop
Seat 4: malliosK (big blind) folded before Flop
Seat 5: MarkFitz76 folded before Flop (didn't bet)
Seat 7: notis-magia showed [Kh Jh] and won ($0.35) with two pair, Aces and Fives
Seat 8: quej0 folded before Flop (didn't bet)
Seat 9: Dorex2007 folded before Flop (didn't bet)



PokerStars Hand #238672141890:  Hold'em No Limit ($0.02/$0.05 USD) - 2022/09/16 15:11:01 PT [2022/09/16 18:11:01 ET]
Table 'Hedera II' 9-max Seat #3 is the button
Seat 1: sipo1 ($5.89 in chips) 
Seat 2: TheQuicksand ($5.89 in chips) 
Seat 3: kramnoy.ivan ($5.04 in chips) 
Seat 4: malliosK ($4.65 in chips) 
Seat 7: notis-magia ($7.77 in chips) 
Seat 8: quej0 ($4.58 in chips) 
Seat 9: Dorex2007 ($6.38 in chips) 
malliosK: posts small blind $0.02
MarkFitz76: is sitting out 
notis-magia: posts big blind $0.05
*** HOLE CARDS ***
Dealt to Dorex2007 [6d 5c]
quej0: folds 
MarkFitz76 leaves the table
AssosManiki joins the table at seat #5 
Dorex2007 has timed out
Dorex2007: folds 
sipo1: calls $0.05
TheQuicksand: folds 
kramnoy.ivan: folds 
malliosK: folds 
notis-magia: checks 
*** FLOP *** [9s 2h Qs]
notis-magia: checks 
sipo1: bets $0.05
notis-magia: folds 
Uncalled bet ($0.05) returned to sipo1
sipo1 collected $0.12 from pot
sipo1: doesn't show hand 
*** SUMMARY ***
Total pot $0.12 | Rake $0 
Board [9s 2h Qs]
Seat 1: sipo1 collected ($0.12)
Seat 2: TheQuicksand folded before Flop (didn't bet)
Seat 3: kramnoy.ivan (button) folded before Flop (didn't bet)
Seat 4: malliosK (small blind) folded before Flop
Seat 7: notis-magia (big blind) folded on the Flop
Seat 8: quej0 folded before Flop (didn't bet)
Seat 9: Dorex2007 folded before Flop (didn't bet)



PokerStars Hand #238672173927:  Hold'em No Limit ($0.02/$0.05 USD) - 2022/09/16 15:12:29 PT [2022/09/16 18:12:29 ET]
Table 'Hedera II' 9-max Seat #4 is the button
Seat 1: sipo1 ($5.96 in chips) 
Seat 2: TheQuicksand ($5.89 in chips) 
Seat 3: kramnoy.ivan ($5.04 in chips) 
Seat 4: malliosK ($4.63 in chips) 
Seat 7: notis-magia ($7.72 in chips) 
Seat 8: quej0 ($4.58 in chips) 
Seat 9: Dorex2007 ($6.38 in chips) 
notis-magia: posts small blind $0.02
quej0: posts big blind $0.05
*** HOLE CARDS ***
Dealt to Dorex2007 [Tc 5h]
Dorex2007: folds 
sipo1: folds 
TheQuicksand: folds 
kramnoy.ivan: raises $0.10 to $0.15
malliosK: folds 
notis-magia: folds 
quej0: folds 
Uncalled bet ($0.10) returned to kramnoy.ivan
kramnoy.ivan collected $0.12 from pot
*** SUMMARY ***
Total pot $0.12 | Rake $0 
Seat 1: sipo1 folded before Flop (didn't bet)
Seat 2: TheQuicksand folded before Flop (didn't bet)
Seat 3: kramnoy.ivan collected ($0.12)
Seat 4: malliosK (button) folded before Flop (didn't bet)
Seat 7: notis-magia (small blind) folded before Flop
Seat 8: quej0 (big blind) folded before Flop
Seat 9: Dorex2007 folded before Flop (didn't bet)



PokerStars Hand #238672182857:  Hold'em No Limit ($0.02/$0.05 USD) - 2022/09/16 15:12:54 PT [2022/09/16 18:12:54 ET]
Table 'Hedera II' 9-max Seat #7 is the button
Seat 1: sipo1 ($5.96 in chips) 
Seat 2: TheQuicksand ($5.89 in chips) 
Seat 3: kramnoy.ivan ($5.11 in chips) 
Seat 4: malliosK ($4.63 in chips) 
Seat 5: AssosManiki ($5 in chips) 
Seat 7: notis-magia ($7.70 in chips) 
Seat 8: quej0 ($4.53 in chips) 
Seat 9: Dorex2007 ($6.38 in chips) 
quej0: posts small blind $0.02
Dorex2007: posts big blind $0.05
AssosManiki: posts big blind $0.05
Azimusback: sits out 
*** HOLE CARDS ***
Dealt to Dorex2007 [9h 6c]
sipo1: folds 
TheQuicksand: calls $0.05
kramnoy.ivan: folds 
malliosK: folds 
AssosManiki: checks 
notis-magia: folds 
quej0: calls $0.03
Dorex2007: checks 
*** FLOP *** [7h 2c 5d]
quej0: checks 
Dorex2007: checks 
TheQuicksand: checks 
AssosManiki: checks 
*** TURN *** [7h 2c 5d] [Jc]
quej0: bets $0.15
Dorex2007: folds 
TheQuicksand: calls $0.15
AssosManiki: folds 
*** RIVER *** [7h 2c 5d Jc] [8c]
quej0: bets $0.15
TheQuicksand: calls $0.15
*** SHOW DOWN ***
quej0: shows [Js 7d] (two pair, Jacks and Sevens)
TheQuicksand: mucks hand 
quej0 collected $0.77 from pot
*** SUMMARY ***
Total pot $0.80 | Rake $0.03 
Board [7h 2c 5d Jc 8c]
Seat 1: sipo1 folded before Flop (didn't bet)
Seat 2: TheQuicksand mucked [Jd Qh]
Seat 3: kramnoy.ivan folded before Flop (didn't bet)
Seat 4: malliosK folded before Flop (didn't bet)
Seat 5: AssosManiki folded on the Turn (didn't bet)
Seat 7: notis-magia (button) folded before Flop (didn't bet)
Seat 8: quej0 (small blind) showed [Js 7d] and won ($0.77) with two pair, Jacks and Sevens
Seat 9: Dorex2007 (big blind) folded on the Turn



PokerStars Hand #238672208468:  Hold'em No Limit ($0.02/$0.05 USD) - 2022/09/16 15:14:05 PT [2022/09/16 18:14:05 ET]
Table 'Hedera II' 9-max Seat #8 is the button
Seat 1: sipo1 ($5.96 in chips) 
Seat 2: TheQuicksand ($5.54 in chips) 
Seat 3: kramnoy.ivan ($5.11 in chips) 
Seat 4: malliosK ($4.63 in chips) 
Seat 5: AssosManiki ($4.95 in chips) 
Seat 7: notis-magia ($7.70 in chips) 
Seat 8: quej0 ($4.95 in chips) 
Seat 9: Dorex2007 ($6.33 in chips) 
Dorex2007: posts small blind $0.02
sipo1: posts big blind $0.05
Azimusback: sits out 
*** HOLE CARDS ***
Dealt to Dorex2007 [8s 8d]
TheQuicksand: calls $0.05
kramnoy.ivan: folds 
malliosK: folds 
AssosManiki: raises $0.08 to $0.13
notis-magia: calls $0.13
quej0: calls $0.13
Dorex2007: calls $0.11
sipo1: calls $0.08
TheQuicksand: calls $0.08
*** FLOP *** [9h 2h 4d]
Dorex2007: checks 
sipo1: checks 
TheQuicksand: checks 
AssosManiki: checks 
notis-magia: checks 
quej0: checks 
*** TURN *** [9h 2h 4d] [Qc]
Dorex2007: checks 
sipo1: checks 
TheQuicksand: checks 
AssosManiki: checks 
notis-magia: checks 
quej0: checks 
*** RIVER *** [9h 2h 4d Qc] [As]
Dorex2007: checks 
sipo1: checks 
TheQuicksand: checks 
AssosManiki: checks 
notis-magia: checks 
quej0: checks 
*** SHOW DOWN ***
Dorex2007: shows [8s 8d] (a pair of Eights)
sipo1: mucks hand 
TheQuicksand: mucks hand 
AssosManiki: shows [Jc Ac] (a pair of Aces)
notis-magia: mucks hand 
quej0: mucks hand 
AssosManiki collected $0.75 from pot
*** SUMMARY ***
Total pot $0.78 | Rake $0.03 
Board [9h 2h 4d Qc As]
Seat 1: sipo1 (big blind) mucked [Jd 6d]
Seat 2: TheQuicksand mucked [7d 7s]
Seat 3: kramnoy.ivan folded before Flop (didn't bet)
Seat 4: malliosK folded before Flop (didn't bet)
Seat 5: AssosManiki showed [Jc Ac] and won ($0.75) with a pair of Aces
Seat 7: notis-magia mucked [Kh Js]
Seat 8: quej0 (button) mucked [8c 7c]
Seat 9: Dorex2007 (small blind) showed [8s 8d] and lost with a pair of Eights



PokerStars Hand #238672240516:  Hold'em No Limit ($0.02/$0.05 USD) - 2022/09/16 15:15:33 PT [2022/09/16 18:15:33 ET]
Table 'Hedera II' 9-max Seat #9 is the button
Seat 1: sipo1 ($5.83 in chips) 
Seat 2: TheQuicksand ($5.41 in chips) 
Seat 3: kramnoy.ivan ($5.11 in chips) 
Seat 4: malliosK ($4.63 in chips) 
Seat 5: AssosManiki ($5.57 in chips) 
Seat 7: notis-magia ($7.57 in chips) 
Seat 8: quej0 ($4.82 in chips) 
Seat 9: Dorex2007 ($6.20 in chips) 
sipo1: posts small blind $0.02
TheQuicksand: posts big blind $0.05
Azimusback: sits out 
*** HOLE CARDS ***
Dealt to Dorex2007 [3h 4d]
kramnoy.ivan: folds 
malliosK: folds 
AssosManiki: folds 
notis-magia: folds 
quej0: folds 
Dorex2007: folds 
sipo1: calls $0.03
TheQuicksand: checks 
*** FLOP *** [Kh 2s 9s]
sipo1: checks 
TheQuicksand: checks 
*** TURN *** [Kh 2s 9s] [7h]
sipo1: bets $0.05
TheQuicksand: calls $0.05
*** RIVER *** [Kh 2s 9s 7h] [9h]
sipo1: bets $0.05
TheQuicksand: calls $0.05
*** SHOW DOWN ***
sipo1: shows [Qs Qc] (two pair, Queens and Nines)
TheQuicksand: mucks hand 
sipo1 collected $0.29 from pot
*** SUMMARY ***
Total pot $0.30 | Rake $0.01 
Board [Kh 2s 9s 7h 9h]
Seat 1: sipo1 (small blind) showed [Qs Qc] and won ($0.29) with two pair, Queens and Nines
Seat 2: TheQuicksand (big blind) mucked [Ts As]
Seat 3: kramnoy.ivan folded before Flop (didn't bet)
Seat 4: malliosK folded before Flop (didn't bet)
Seat 5: AssosManiki folded before Flop (didn't bet)
Seat 7: notis-magia folded before Flop (didn't bet)
Seat 8: quej0 folded before Flop (didn't bet)
Seat 9: Dorex2007 (button) folded before Flop (didn't bet)



PokerStars Hand #238672253922:  Hold'em No Limit ($0.02/$0.05 USD) - 2022/09/16 15:16:10 PT [2022/09/16 18:16:10 ET]
Table 'Hedera II' 9-max Seat #1 is the button
Seat 1: sipo1 ($5.97 in chips) 
Seat 2: TheQuicksand ($5.26 in chips) 
Seat 3: kramnoy.ivan ($5.11 in chips) 
Seat 4: malliosK ($4.63 in chips) 
Seat 5: AssosManiki ($5.57 in chips) 
Seat 7: notis-magia ($7.57 in chips) 
Seat 8: quej0 ($4.82 in chips) 
Seat 9: Dorex2007 ($6.20 in chips) 
TheQuicksand: posts small blind $0.02
kramnoy.ivan: posts big blind $0.05
Azimusback: sits out 
*** HOLE CARDS ***
Dealt to Dorex2007 [Qc 2d]
malliosK: folds 
AssosManiki: folds 
notis-magia: folds 
quej0: calls $0.05
Dorex2007: folds 
sipo1: folds 
TheQuicksand: folds 
kramnoy.ivan: checks 
*** FLOP *** [7c 8c 4h]
kramnoy.ivan: checks 
quej0: checks 
*** TURN *** [7c 8c 4h] [Ts]
kramnoy.ivan: checks 
quej0: checks 
*** RIVER *** [7c 8c 4h Ts] [8h]
kramnoy.ivan: checks 
quej0: checks 
*** SHOW DOWN ***
kramnoy.ivan: shows [6s Jd] (a pair of Eights)
quej0: shows [Jh Kd] (a pair of Eights - King kicker)
quej0 collected $0.12 from pot
*** SUMMARY ***
Total pot $0.12 | Rake $0 
Board [7c 8c 4h Ts 8h]
Seat 1: sipo1 (button) folded before Flop (didn't bet)
Seat 2: TheQuicksand (small blind) folded before Flop
Seat 3: kramnoy.ivan (big blind) showed [6s Jd] and lost with a pair of Eights
Seat 4: malliosK folded before Flop (didn't bet)
Seat 5: AssosManiki folded before Flop (didn't bet)
Seat 7: notis-magia folded before Flop (didn't bet)
Seat 8: quej0 showed [Jh Kd] and won ($0.12) with a pair of Eights
Seat 9: Dorex2007 folded before Flop (didn't bet)



PokerStars Hand #238672273924:  Hold'em No Limit ($0.02/$0.05 USD) - 2022/09/16 15:17:06 PT [2022/09/16 18:17:06 ET]
Table 'Hedera II' 9-max Seat #2 is the button
Seat 1: sipo1 ($5.97 in chips) 
Seat 2: TheQuicksand ($5.24 in chips) 
Seat 3: kramnoy.ivan ($5.06 in chips) 
Seat 4: malliosK ($4.63 in chips) 
Seat 5: AssosManiki ($5.57 in chips) 
Seat 7: notis-magia ($7.57 in chips) 
Seat 8: quej0 ($4.89 in chips) 
Seat 9: Dorex2007 ($6.20 in chips) 
kramnoy.ivan: posts small blind $0.02
malliosK: posts big blind $0.05
Azimusback: sits out 
*** HOLE CARDS ***
Dealt to Dorex2007 [Qs Kh]
AssosManiki: folds 
notis-magia: folds 
quej0: folds 
Dorex2007: raises $0.05 to $0.10
sipo1: folds 
TheQuicksand: folds 
kramnoy.ivan: folds 
TheQuicksand leaves the table
malliosK: calls $0.05
*** FLOP *** [7d 8s 7s]
malliosK: checks 
Dorex2007: checks 
*** TURN *** [7d 8s 7s] [2c]
malliosK: checks 
Dorex2007: checks 
*** RIVER *** [7d 8s 7s 2c] [2s]
rafaelmineiro joins the table at seat #2 
malliosK: bets $0.12
Dorex2007: folds 
Uncalled bet ($0.12) returned to malliosK
malliosK collected $0.21 from pot
malliosK: doesn't show hand 
*** SUMMARY ***
Total pot $0.22 | Rake $0.01 
Board [7d 8s 7s 2c 2s]
Seat 1: sipo1 folded before Flop (didn't bet)
Seat 2: TheQuicksand (button) folded before Flop (didn't bet)
Seat 3: kramnoy.ivan (small blind) folded before Flop
Seat 4: malliosK (big blind) collected ($0.21)
Seat 5: AssosManiki folded before Flop (didn't bet)
Seat 7: notis-magia folded before Flop (didn't bet)
Seat 8: quej0 folded before Flop (didn't bet)
Seat 9: Dorex2007 folded on the River



PokerStars Hand #238672293304:  Hold'em No Limit ($0.02/$0.05 USD) - 2022/09/16 15:18:01 PT [2022/09/16 18:18:01 ET]
Table 'Hedera II' 9-max Seat #3 is the button
Seat 1: sipo1 ($5.97 in chips) 
Seat 2: rafaelmineiro ($4 in chips) 
Seat 3: kramnoy.ivan ($5.04 in chips) 
Seat 4: malliosK ($4.74 in chips) 
Seat 5: AssosManiki ($5.57 in chips) 
Seat 7: notis-magia ($7.57 in chips) 
Seat 8: quej0 ($4.89 in chips) 
Seat 9: Dorex2007 ($6.10 in chips) 
malliosK: posts small blind $0.02
AssosManiki: posts big blind $0.05
Azimusback: sits out 
rafaelmineiro: posts big blind $0.05
*** HOLE CARDS ***
Dealt to Dorex2007 [9h Th]
notis-magia: folds 
quej0: folds 
Dorex2007: folds 
sipo1: calls $0.05
rafaelmineiro: checks 
kramnoy.ivan has timed out
kramnoy.ivan: folds 
malliosK: folds 
AssosManiki: checks 
*** FLOP *** [5c Jd 6c]
AssosManiki: checks 
sipo1: checks 
rafaelmineiro: checks 
*** TURN *** [5c Jd 6c] [Ad]
AssosManiki: checks 
sipo1: checks 
rafaelmineiro: checks 
*** RIVER *** [5c Jd 6c Ad] [7h]
AssosManiki: checks 
sipo1: bets $0.05
rafaelmineiro: calls $0.05
AssosManiki: calls $0.05
*** SHOW DOWN ***
sipo1: shows [9d 9s] (a pair of Nines)
rafaelmineiro: mucks hand 
AssosManiki: mucks hand 
sipo1 collected $0.31 from pot
*** SUMMARY ***
Total pot $0.32 | Rake $0.01 
Board [5c Jd 6c Ad 7h]
Seat 1: sipo1 showed [9d 9s] and won ($0.31) with a pair of Nines
Seat 2: rafaelmineiro mucked [7c 3d]
Seat 3: kramnoy.ivan (button) folded before Flop (didn't bet)
Seat 4: malliosK (small blind) folded before Flop
Seat 5: AssosManiki (big blind) mucked [7s Kh]
Seat 7: notis-magia folded before Flop (didn't bet)
Seat 8: quej0 folded before Flop (didn't bet)
Seat 9: Dorex2007 folded before Flop (didn't bet)



PokerStars Hand #238672316139:  Hold'em No Limit ($0.02/$0.05 USD) - 2022/09/16 15:19:05 PT [2022/09/16 18:19:05 ET]
Table 'Hedera II' 9-max Seat #4 is the button
Seat 1: sipo1 ($6.18 in chips) 
Seat 2: rafaelmineiro ($3.90 in chips) 
Seat 3: kramnoy.ivan ($5.04 in chips) 
Seat 4: malliosK ($4.72 in chips) 
Seat 5: AssosManiki ($5.47 in chips) 
Seat 6: Azimusback ($5 in chips) 
Seat 7: notis-magia ($7.57 in chips) 
Seat 8: quej0 ($4.89 in chips) 
Seat 9: Dorex2007 ($6.10 in chips) 
AssosManiki: posts small blind $0.02
Azimusback: posts big blind $0.05
*** HOLE CARDS ***
Dealt to Dorex2007 [2d 9h]
notis-magia has timed out
notis-magia: folds 
quej0: folds 
Dorex2007: folds 
sipo1: folds 
rafaelmineiro: folds 
kramnoy.ivan: folds 
malliosK: folds 
AssosManiki: folds 
Uncalled bet ($0.03) returned to Azimusback
Azimusback collected $0.04 from pot
Azimusback: doesn't show hand 
*** SUMMARY ***
Total pot $0.04 | Rake $0 
Seat 1: sipo1 folded before Flop (didn't bet)
Seat 2: rafaelmineiro folded before Flop (didn't bet)
Seat 3: kramnoy.ivan folded before Flop (didn't bet)
Seat 4: malliosK (button) folded before Flop (didn't bet)
Seat 5: AssosManiki (small blind) folded before Flop
Seat 6: Azimusback (big blind) collected ($0.04)
Seat 7: notis-magia folded before Flop (didn't bet)
Seat 8: quej0 folded before Flop (didn't bet)
Seat 9: Dorex2007 folded before Flop (didn't bet)



PokerStars Hand #238672325251:  Hold'em No Limit ($0.02/$0.05 USD) - 2022/09/16 15:19:31 PT [2022/09/16 18:19:31 ET]
Table 'Hedera II' 9-max Seat #5 is the button
Seat 1: sipo1 ($6.18 in chips) 
Seat 2: rafaelmineiro ($3.90 in chips) 
Seat 3: kramnoy.ivan ($5.04 in chips) 
Seat 4: malliosK ($4.72 in chips) 
Seat 5: AssosManiki ($5.45 in chips) 
Seat 6: Azimusback ($5.02 in chips) 
Seat 7: notis-magia ($7.57 in chips) 
Seat 8: quej0 ($4.89 in chips) 
Seat 9: Dorex2007 ($6.10 in chips) 
Azimusback: posts small blind $0.02
notis-magia: posts big blind $0.05
*** HOLE CARDS ***
Dealt to Dorex2007 [5d Ad]
quej0: folds 
Dorex2007: folds 
sipo1: folds 
rafaelmineiro: folds 
kramnoy.ivan: folds 
malliosK: folds 
AssosManiki: folds 
Azimusback: folds 
Uncalled bet ($0.03) returned to notis-magia
notis-magia collected $0.04 from pot
notis-magia: doesn't show hand 
*** SUMMARY ***
Total pot $0.04 | Rake $0 
Seat 1: sipo1 folded before Flop (didn't bet)
Seat 2: rafaelmineiro folded before Flop (didn't bet)
Seat 3: kramnoy.ivan folded before Flop (didn't bet)
Seat 4: malliosK folded before Flop (didn't bet)
Seat 5: AssosManiki (button) folded before Flop (didn't bet)
Seat 6: Azimusback (small blind) folded before Flop
Seat 7: notis-magia (big blind) collected ($0.04)
Seat 8: quej0 folded before Flop (didn't bet)
Seat 9: Dorex2007 folded before Flop (didn't bet)



PokerStars Hand #238672330633:  Hold'em No Limit ($0.02/$0.05 USD) - 2022/09/16 15:19:46 PT [2022/09/16 18:19:46 ET]
Table 'Hedera II' 9-max Seat #6 is the button
Seat 1: sipo1 ($6.18 in chips) 
Seat 2: rafaelmineiro ($3.90 in chips) 
Seat 3: kramnoy.ivan ($5.04 in chips) 
Seat 4: malliosK ($4.72 in chips) 
Seat 5: AssosManiki ($5.45 in chips) 
Seat 6: Azimusback ($5 in chips) 
Seat 7: notis-magia ($7.59 in chips) 
Seat 8: quej0 ($4.89 in chips) 
Seat 9: Dorex2007 ($6.10 in chips) 
notis-magia: posts small blind $0.02
quej0: posts big blind $0.05
*** HOLE CARDS ***
Dealt to Dorex2007 [8c Ad]
Dorex2007: folds 
sipo1: folds 
rafaelmineiro: calls $0.05
kramnoy.ivan: folds 
malliosK: folds 
AssosManiki: raises $0.08 to $0.13
Azimusback: folds 
notis-magia: folds 
quej0: calls $0.08
rafaelmineiro: calls $0.08
*** FLOP *** [3d 4h 2d]
quej0: checks 
rafaelmineiro: checks 
AssosManiki: checks 
*** TURN *** [3d 4h 2d] [9c]
quej0: checks 
rafaelmineiro: checks 
AssosManiki: checks 
*** RIVER *** [3d 4h 2d 9c] [5d]
quej0: checks 
notis-magia leaves the table
rafaelmineiro: bets $0.39
AssosManiki: folds 
quej0: folds 
Uncalled bet ($0.39) returned to rafaelmineiro
rafaelmineiro collected $0.39 from pot
*** SUMMARY ***
Total pot $0.41 | Rake $0.02 
Board [3d 4h 2d 9c 5d]
Seat 1: sipo1 folded before Flop (didn't bet)
Seat 2: rafaelmineiro collected ($0.39)
Seat 3: kramnoy.ivan folded before Flop (didn't bet)
Seat 4: malliosK folded before Flop (didn't bet)
Seat 5: AssosManiki folded on the River
Seat 6: Azimusback (button) folded before Flop (didn't bet)
Seat 7: notis-magia (small blind) folded before Flop
Seat 8: quej0 (big blind) folded on the River
Seat 9: Dorex2007 folded before Flop (didn't bet)



PokerStars Hand #238672352495:  Hold'em No Limit ($0.02/$0.05 USD) - 2022/09/16 15:20:49 PT [2022/09/16 18:20:49 ET]
Table 'Hedera II' 9-max Seat #8 is the button
Seat 1: sipo1 ($6.18 in chips) 
Seat 2: rafaelmineiro ($4.16 in chips) 
Seat 3: kramnoy.ivan ($5.04 in chips) 
Seat 4: malliosK ($4.72 in chips) 
Seat 5: AssosManiki ($5.32 in chips) 
Seat 6: Azimusback ($5 in chips) 
Seat 8: quej0 ($4.76 in chips) 
Seat 9: Dorex2007 ($6.10 in chips) 
Dorex2007: posts small blind $0.02
sipo1: posts big blind $0.05
*** HOLE CARDS ***
Dealt to Dorex2007 [Kd 2d]
rafaelmineiro: raises $0.05 to $0.10
wood1600 joins the table at seat #7 
kramnoy.ivan: calls $0.10
malliosK: folds 
AssosManiki: calls $0.10
Azimusback: folds 
quej0: folds 
Dorex2007: folds 
sipo1: calls $0.05
*** FLOP *** [Ac Jc Jh]
sipo1: checks 
rafaelmineiro: bets $0.20
kramnoy.ivan: calls $0.20
AssosManiki: folds 
sipo1: calls $0.20
*** TURN *** [Ac Jc Jh] [5h]
sipo1: checks 
rafaelmineiro: checks 
kramnoy.ivan: bets $0.34
sipo1: calls $0.34
rafaelmineiro: calls $0.34
*** RIVER *** [Ac Jc Jh 5h] [9d]
sipo1: checks 
rafaelmineiro: checks 
kramnoy.ivan: checks 
*** SHOW DOWN ***
sipo1: shows [Js 7s] (three of a kind, Jacks)
rafaelmineiro: mucks hand 
kramnoy.ivan: mucks hand 
sipo1 collected $1.96 from pot
*** SUMMARY ***
Total pot $2.04 | Rake $0.08 
Board [Ac Jc Jh 5h 9d]
Seat 1: sipo1 (big blind) showed [Js 7s] and won ($1.96) with three of a kind, Jacks
Seat 2: rafaelmineiro mucked [Qd Qs]
Seat 3: kramnoy.ivan mucked [8c Tc]
Seat 4: malliosK folded before Flop (didn't bet)
Seat 5: AssosManiki folded on the Flop
Seat 6: Azimusback folded before Flop (didn't bet)
Seat 8: quej0 (button) folded before Flop (didn't bet)
Seat 9: Dorex2007 (small blind) folded before Flop



PokerStars Hand #238672394305:  Hold'em No Limit ($0.02/$0.05 USD) - 2022/09/16 15:22:50 PT [2022/09/16 18:22:50 ET]
Table 'Hedera II' 9-max Seat #9 is the button
Seat 1: sipo1 ($7.50 in chips) 
Seat 2: rafaelmineiro ($3.52 in chips) 
Seat 3: kramnoy.ivan ($4.40 in chips) 
Seat 4: malliosK ($4.72 in chips) 
Seat 5: AssosManiki ($5.22 in chips) 
Seat 6: Azimusback ($5 in chips) 
Seat 7: wood1600 ($5 in chips) 
Seat 8: quej0 ($4.76 in chips) 
Seat 9: Dorex2007 ($6.08 in chips) 
sipo1: posts small blind $0.02
rafaelmineiro: posts big blind $0.05
wood1600: posts big blind $0.05
*** HOLE CARDS ***
Dealt to Dorex2007 [Kd 3s]
kramnoy.ivan: folds 
malliosK: folds 
AssosManiki: folds 
Azimusback: raises $0.15 to $0.20
wood1600: folds 
quej0: folds 
Dorex2007: folds 
sipo1: folds 
rafaelmineiro: folds 
Uncalled bet ($0.15) returned to Azimusback
Azimusback collected $0.17 from pot
*** SUMMARY ***
Total pot $0.17 | Rake $0 
Seat 1: sipo1 (small blind) folded before Flop
Seat 2: rafaelmineiro (big blind) folded before Flop
Seat 3: kramnoy.ivan folded before Flop (didn't bet)
Seat 4: malliosK folded before Flop (didn't bet)
Seat 5: AssosManiki folded before Flop (didn't bet)
Seat 6: Azimusback collected ($0.17)
Seat 7: wood1600 folded before Flop (didn't bet)
Seat 8: quej0 folded before Flop (didn't bet)
Seat 9: Dorex2007 (button) folded before Flop (didn't bet)



PokerStars Hand #238672406465:  Hold'em No Limit ($0.02/$0.05 USD) - 2022/09/16 15:23:25 PT [2022/09/16 18:23:25 ET]
Table 'Hedera II' 9-max Seat #1 is the button
Seat 1: sipo1 ($7.48 in chips) 
Seat 2: rafaelmineiro ($3.47 in chips) 
Seat 3: kramnoy.ivan ($5 in chips) 
Seat 4: malliosK ($4.72 in chips) 
Seat 5: AssosManiki ($5.22 in chips) 
Seat 6: Azimusback ($5.12 in chips) 
Seat 7: wood1600 ($4.95 in chips) 
Seat 8: quej0 ($4.76 in chips) 
Seat 9: Dorex2007 ($6.08 in chips) 
rafaelmineiro: posts small blind $0.02
kramnoy.ivan: posts big blind $0.05
*** HOLE CARDS ***
Dealt to Dorex2007 [Qh 6c]
malliosK: folds 
AssosManiki: raises $0.08 to $0.13
Azimusback: folds 
wood1600: raises $0.38 to $0.51
quej0: folds 
Dorex2007: folds 
sipo1: folds 
rafaelmineiro: folds 
kramnoy.ivan: folds 
AssosManiki: folds 
Uncalled bet ($0.38) returned to wood1600
wood1600 collected $0.33 from pot
*** SUMMARY ***
Total pot $0.33 | Rake $0 
Seat 1: sipo1 (button) folded before Flop (didn't bet)
Seat 2: rafaelmineiro (small blind) folded before Flop
Seat 3: kramnoy.ivan (big blind) folded before Flop
Seat 4: malliosK folded before Flop (didn't bet)
Seat 5: AssosManiki folded before Flop
Seat 6: Azimusback folded before Flop (didn't bet)
Seat 7: wood1600 collected ($0.33)
Seat 8: quej0 folded before Flop (didn't bet)
Seat 9: Dorex2007 folded before Flop (didn't bet)



PokerStars Hand #238672415250:  Hold'em No Limit ($0.02/$0.05 USD) - 2022/09/16 15:23:50 PT [2022/09/16 18:23:50 ET]
Table 'Hedera II' 9-max Seat #2 is the button
Seat 1: sipo1 ($7.48 in chips) 
Seat 2: rafaelmineiro ($3.45 in chips) 
Seat 3: kramnoy.ivan ($4.95 in chips) 
Seat 4: malliosK ($4.72 in chips) 
Seat 5: AssosManiki ($5.09 in chips) 
Seat 6: Azimusback ($5.12 in chips) 
Seat 7: wood1600 ($5.15 in chips) 
Seat 8: quej0 ($4.76 in chips) 
Seat 9: Dorex2007 ($6.08 in chips) 
kramnoy.ivan: posts small blind $0.02
malliosK: posts big blind $0.05
*** HOLE CARDS ***
Dealt to Dorex2007 [7d Kh]
AssosManiki: folds 
Azimusback: folds 
wood1600: folds 
quej0: folds 
Dorex2007: folds 
sipo1: calls $0.05
rafaelmineiro: calls $0.05
kramnoy.ivan: raises $0.10 to $0.15
malliosK: calls $0.10
sipo1: folds 
rafaelmineiro: calls $0.10
*** FLOP *** [2d 9c 9s]
kramnoy.ivan: bets $0.33
malliosK: folds 
rafaelmineiro: folds 
Uncalled bet ($0.33) returned to kramnoy.ivan
kramnoy.ivan collected $0.48 from pot
*** SUMMARY ***
Total pot $0.50 | Rake $0.02 
Board [2d 9c 9s]
Seat 1: sipo1 folded before Flop
Seat 2: rafaelmineiro (button) folded on the Flop
Seat 3: kramnoy.ivan (small blind) collected ($0.48)
Seat 4: malliosK (big blind) folded on the Flop
Seat 5: AssosManiki folded before Flop (didn't bet)
Seat 6: Azimusback folded before Flop (didn't bet)
Seat 7: wood1600 folded before Flop (didn't bet)
Seat 8: quej0 folded before Flop (didn't bet)
Seat 9: Dorex2007 folded before Flop (didn't bet)



PokerStars Hand #238672432578:  Hold'em No Limit ($0.02/$0.05 USD) - 2022/09/16 15:24:41 PT [2022/09/16 18:24:41 ET]
Table 'Hedera II' 9-max Seat #3 is the button
Seat 1: sipo1 ($7.43 in chips) 
Seat 2: rafaelmineiro ($3.30 in chips) 
Seat 3: kramnoy.ivan ($5.28 in chips) 
Seat 4: malliosK ($4.57 in chips) 
Seat 5: AssosManiki ($5.09 in chips) 
Seat 6: Azimusback ($5.12 in chips) 
Seat 7: wood1600 ($5.15 in chips) 
Seat 8: quej0 ($4.76 in chips) 
Seat 9: Dorex2007 ($6.08 in chips) 
malliosK: posts small blind $0.02
AssosManiki: posts big blind $0.05
*** HOLE CARDS ***
Dealt to Dorex2007 [6s 8c]
Azimusback: folds 
wood1600: folds 
quej0: folds 
Dorex2007: folds 
sipo1: folds 
rafaelmineiro: calls $0.05
kramnoy.ivan: raises $0.10 to $0.15
malliosK: folds 
AssosManiki: folds 
rafaelmineiro: calls $0.10
*** FLOP *** [2c 7d 4d]
rafaelmineiro: checks 
kramnoy.ivan: bets $0.25
rafaelmineiro: folds 
Uncalled bet ($0.25) returned to kramnoy.ivan
kramnoy.ivan collected $0.35 from pot
*** SUMMARY ***
Total pot $0.37 | Rake $0.02 
Board [2c 7d 4d]
Seat 1: sipo1 folded before Flop (didn't bet)
Seat 2: rafaelmineiro folded on the Flop
Seat 3: kramnoy.ivan (button) collected ($0.35)
Seat 4: malliosK (small blind) folded before Flop
Seat 5: AssosManiki (big blind) folded before Flop
Seat 6: Azimusback folded before Flop (didn't bet)
Seat 7: wood1600 folded before Flop (didn't bet)
Seat 8: quej0 folded before Flop (didn't bet)
Seat 9: Dorex2007 folded before Flop (didn't bet)



PokerStars Hand #238672446874:  Hold'em No Limit ($0.02/$0.05 USD) - 2022/09/16 15:25:23 PT [2022/09/16 18:25:23 ET]
Table 'Hedera II' 9-max Seat #4 is the button
Seat 1: sipo1 ($7.43 in chips) 
Seat 2: rafaelmineiro ($3.15 in chips) 
Seat 3: kramnoy.ivan ($5.48 in chips) 
Seat 4: malliosK ($4.55 in chips) 
Seat 5: AssosManiki ($5.04 in chips) 
Seat 6: Azimusback ($5.12 in chips) 
Seat 7: wood1600 ($5.15 in chips) 
Seat 8: quej0 ($4.76 in chips) 
Seat 9: Dorex2007 ($6.08 in chips) 
AssosManiki: posts small blind $0.02
Azimusback: posts big blind $0.05
*** HOLE CARDS ***
Dealt to Dorex2007 [6c 7h]
wood1600: folds 
quej0: calls $0.05
Dorex2007: folds 
sipo1: folds 
rafaelmineiro: folds 
kramnoy.ivan: folds 
malliosK: folds 
AssosManiki: calls $0.03
Azimusback: raises $0.15 to $0.20
quej0: calls $0.15
AssosManiki: folds 
*** FLOP *** [3h Qs 8d]
Azimusback: bets $0.21
quej0: raises $0.21 to $0.42
Azimusback: calls $0.21
*** TURN *** [3h Qs 8d] [Ah]
Azimusback: checks 
quej0: bets $0.10
Azimusback: calls $0.10
*** RIVER *** [3h Qs 8d Ah] [Kc]
Azimusback: checks 
quej0: bets $0.50
Azimusback: calls $0.50
*** SHOW DOWN ***
quej0: shows [Qh Qd] (three of a kind, Queens)
Azimusback: mucks hand 
quej0 collected $2.39 from pot
*** SUMMARY ***
Total pot $2.49 | Rake $0.10 
Board [3h Qs 8d Ah Kc]
Seat 1: sipo1 folded before Flop (didn't bet)
Seat 2: rafaelmineiro folded before Flop (didn't bet)
Seat 3: kramnoy.ivan folded before Flop (didn't bet)
Seat 4: malliosK (button) folded before Flop (didn't bet)
Seat 5: AssosManiki (small blind) folded before Flop
Seat 6: Azimusback (big blind) mucked [Qc Kd]
Seat 7: wood1600 folded before Flop (didn't bet)
Seat 8: quej0 showed [Qh Qd] and won ($2.39) with three of a kind, Queens
Seat 9: Dorex2007 folded before Flop (didn't bet)



PokerStars Hand #238672467643:  Hold'em No Limit ($0.02/$0.05 USD) - 2022/09/16 15:26:23 PT [2022/09/16 18:26:23 ET]
Table 'Hedera II' 9-max Seat #5 is the button
Seat 1: sipo1 ($7.43 in chips) 
Seat 2: rafaelmineiro ($3.15 in chips) 
Seat 3: kramnoy.ivan ($5.48 in chips) 
Seat 4: malliosK ($4.55 in chips) 
Seat 5: AssosManiki ($4.99 in chips) 
Seat 6: Azimusback ($5 in chips) 
Seat 7: wood1600 ($5.15 in chips) 
Seat 8: quej0 ($5.93 in chips) 
Seat 9: Dorex2007 ($6.08 in chips) 
Azimusback: posts small blind $0.02
wood1600: posts big blind $0.05
*** HOLE CARDS ***
Dealt to Dorex2007 [9d 7s]
quej0: folds 
Dorex2007: folds 
sipo1: folds 
rafaelmineiro: folds 
kramnoy.ivan: folds 
malliosK: raises $0.12 to $0.17
AssosManiki: folds 
Azimusback: folds 
wood1600: folds 
Uncalled bet ($0.12) returned to malliosK
malliosK collected $0.12 from pot
malliosK: doesn't show hand 
*** SUMMARY ***
Total pot $0.12 | Rake $0 
Seat 1: sipo1 folded before Flop (didn't bet)
Seat 2: rafaelmineiro folded before Flop (didn't bet)
Seat 3: kramnoy.ivan folded before Flop (didn't bet)
Seat 4: malliosK collected ($0.12)
Seat 5: AssosManiki (button) folded before Flop (didn't bet)
Seat 6: Azimusback (small blind) folded before Flop
Seat 7: wood1600 (big blind) folded before Flop
Seat 8: quej0 folded before Flop (didn't bet)
Seat 9: Dorex2007 folded before Flop (didn't bet)



PokerStars Hand #238672537820:  Hold'em No Limit ($0.02/$0.05 USD) - 2022/09/16 15:29:47 PT [2022/09/16 18:29:47 ET]
Table 'Hedera II' 9-max Seat #1 is the button
Seat 1: sipo1 ($6.93 in chips) 
Seat 2: rafaelmineiro ($3.79 in chips) 
Seat 3: kramnoy.ivan ($5.48 in chips) 
Seat 4: malliosK ($4.62 in chips) 
Seat 6: Azimusback ($5.14 in chips) 
Seat 7: wood1600 ($5.08 in chips) 
Seat 8: quej0 ($5.54 in chips) 
Seat 9: Dorex2007 ($6.08 in chips) 
rafaelmineiro: posts small blind $0.02
kramnoy.ivan: posts big blind $0.05
Dorex2007: posts small & big blinds $0.07
*** HOLE CARDS ***
Dealt to Dorex2007 [5s Td]
malliosK: folds 
Azimusback: raises $0.15 to $0.20
wood1600: calls $0.20
quej0: folds 
Dorex2007: folds 
sipo1: folds 
rafaelmineiro: folds 
kramnoy.ivan: folds 
*** FLOP *** [Th 9c 7d]
Azimusback: bets $0.20
wood1600: calls $0.20
*** TURN *** [Th 9c 7d] [4h]
Azimusback: bets $0.68
wood1600: calls $0.68
*** RIVER *** [Th 9c 7d 4h] [9h]
Azimusback: bets $2.20
wood1600: raises $1.80 to $4 and is all-in
quej0 leaves the table
Azimusback: calls $1.80
*** SHOW DOWN ***
wood1600: shows [9d 9s] (four of a kind, Nines)
Azimusback: shows [4s 4c] (a full house, Fours full of Nines)
wood1600 collected $9.87 from pot
*** SUMMARY ***
Total pot $10.30 | Rake $0.43 
Board [Th 9c 7d 4h 9h]
Seat 1: sipo1 (button) folded before Flop (didn't bet)
Seat 2: rafaelmineiro (small blind) folded before Flop
Seat 3: kramnoy.ivan (big blind) folded before Flop
Seat 4: malliosK folded before Flop (didn't bet)
Seat 6: Azimusback showed [4s 4c] and lost with a full house, Fours full of Nines
Seat 7: wood1600 showed [9d 9s] and won ($9.87) with four of a kind, Nines
Seat 8: quej0 folded before Flop (didn't bet)
Seat 9: Dorex2007 folded before Flop (didn't bet)



PokerStars Hand #238672568118:  Hold'em No Limit ($0.02/$0.05 USD) - 2022/09/16 15:31:14 PT [2022/09/16 18:31:14 ET]
Table 'Hedera II' 9-max Seat #2 is the button
Seat 1: sipo1 ($6.93 in chips) 
Seat 2: rafaelmineiro ($3.77 in chips) 
Seat 3: kramnoy.ivan ($5.43 in chips) 
Seat 4: malliosK ($4.62 in chips) 
Seat 6: Azimusback ($5 in chips) 
Seat 7: wood1600 ($9.87 in chips) 
Seat 9: Dorex2007 ($6.01 in chips) 
kramnoy.ivan: posts small blind $0.02
malliosK: posts big blind $0.05
*** HOLE CARDS ***
Dealt to Dorex2007 [Ac 3c]
JPimp2323 joins the table at seat #8 
Azimusback: folds 
wood1600: folds 
Dorex2007: raises $0.10 to $0.15
sipo1: calls $0.15
rafaelmineiro: folds 
kramnoy.ivan: folds 
malliosK: folds 
*** FLOP *** [5s 7d 8d]
Dorex2007: checks 
sipo1: checks 
*** TURN *** [5s 7d 8d] [6h]
Dorex2007: checks 
sipo1: bets $0.14
Dorex2007: folds 
Uncalled bet ($0.14) returned to sipo1
sipo1 collected $0.35 from pot
sipo1: doesn't show hand 
*** SUMMARY ***
Total pot $0.37 | Rake $0.02 
Board [5s 7d 8d 6h]
Seat 1: sipo1 collected ($0.35)
Seat 2: rafaelmineiro (button) folded before Flop (didn't bet)
Seat 3: kramnoy.ivan (small blind) folded before Flop
Seat 4: malliosK (big blind) folded before Flop
Seat 6: Azimusback folded before Flop (didn't bet)
Seat 7: wood1600 folded before Flop (didn't bet)
Seat 9: Dorex2007 folded on the Turn



PokerStars Hand #238672579209:  Hold'em No Limit ($0.02/$0.05 USD) - 2022/09/16 15:31:46 PT [2022/09/16 18:31:46 ET]
Table 'Hedera II' 9-max Seat #3 is the button
Seat 1: sipo1 ($7.13 in chips) 
Seat 2: rafaelmineiro ($3.77 in chips) 
Seat 3: kramnoy.ivan ($5.41 in chips) 
Seat 4: malliosK ($4.57 in chips) 
Seat 6: Azimusback ($5 in chips) 
Seat 7: wood1600 ($9.87 in chips) 
Seat 9: Dorex2007 ($5.86 in chips) 
malliosK: posts small blind $0.02
Azimusback: posts big blind $0.05
JPimp2323: sits out 
*** HOLE CARDS ***
Dealt to Dorex2007 [4d As]
wood1600: folds 
Dorex2007: folds 
sipo1: folds 
rafaelmineiro: calls $0.05
kramnoy.ivan: folds 
malliosK has timed out
malliosK: folds 
Azimusback: raises $0.12 to $0.17
rafaelmineiro: calls $0.12
*** FLOP *** [9d 5s 4s]
Azimusback: bets $0.17
rafaelmineiro: calls $0.17
*** TURN *** [9d 5s 4s] [9s]
Azimusback: checks 
rafaelmineiro: checks 
*** RIVER *** [9d 5s 4s 9s] [Td]
Azimusback: checks 
rafaelmineiro: checks 
*** SHOW DOWN ***
Azimusback: shows [Qs Jd] (a pair of Nines)
rafaelmineiro: mucks hand 
Azimusback collected $0.67 from pot
*** SUMMARY ***
Total pot $0.70 | Rake $0.03 
Board [9d 5s 4s 9s Td]
Seat 1: sipo1 folded before Flop (didn't bet)
Seat 2: rafaelmineiro mucked [6c 3c]
Seat 3: kramnoy.ivan (button) folded before Flop (didn't bet)
Seat 4: malliosK (small blind) folded before Flop
Seat 6: Azimusback (big blind) showed [Qs Jd] and won ($0.67) with a pair of Nines
Seat 7: wood1600 folded before Flop (didn't bet)
Seat 9: Dorex2007 folded before Flop (didn't bet)



PokerStars Hand #238672599008:  Hold'em No Limit ($0.02/$0.05 USD) - 2022/09/16 15:32:43 PT [2022/09/16 18:32:43 ET]
Table 'Hedera II' 9-max Seat #4 is the button
Seat 1: sipo1 ($7.13 in chips) 
Seat 2: rafaelmineiro ($3.43 in chips) 
Seat 3: kramnoy.ivan ($5.41 in chips) 
Seat 4: malliosK ($4.55 in chips) 
Seat 6: Azimusback ($5.33 in chips) 
Seat 7: wood1600 ($9.87 in chips) 
Seat 9: Dorex2007 ($5.86 in chips) 
Azimusback: posts small blind $0.02
wood1600: posts big blind $0.05
JPimp2323: sits out 
*** HOLE CARDS ***
Dealt to Dorex2007 [Td 7c]
Dorex2007: folds 
sipo1: calls $0.05
rafaelmineiro: folds 
kramnoy.ivan: folds 
malliosK: folds 
Azimusback: folds 
wood1600: checks 
*** FLOP *** [4s 8s 6d]
wood1600: checks 
sipo1: checks 
*** TURN *** [4s 8s 6d] [Ad]
wood1600: checks 
sipo1: checks 
*** RIVER *** [4s 8s 6d Ad] [Jd]
wood1600: checks 
sipo1: bets $0.07
wood1600: folds 
Uncalled bet ($0.07) returned to sipo1
sipo1 collected $0.12 from pot
sipo1: doesn't show hand 
*** SUMMARY ***
Total pot $0.12 | Rake $0 
Board [4s 8s 6d Ad Jd]
Seat 1: sipo1 collected ($0.12)
Seat 2: rafaelmineiro folded before Flop (didn't bet)
Seat 3: kramnoy.ivan folded before Flop (didn't bet)
Seat 4: malliosK (button) folded before Flop (didn't bet)
Seat 6: Azimusback (small blind) folded before Flop
Seat 7: wood1600 (big blind) folded on the River
Seat 9: Dorex2007 folded before Flop (didn't bet)



PokerStars Hand #238672609969:  Hold'em No Limit ($0.02/$0.05 USD) - 2022/09/16 15:33:14 PT [2022/09/16 18:33:14 ET]
Table 'Hedera II' 9-max Seat #6 is the button
Seat 1: sipo1 ($7.20 in chips) 
Seat 2: rafaelmineiro ($3.43 in chips) 
Seat 3: kramnoy.ivan ($5.41 in chips) 
Seat 4: malliosK ($4.55 in chips) 
Seat 6: Azimusback ($5.31 in chips) 
Seat 7: wood1600 ($9.82 in chips) 
Seat 8: JPimp2323 ($5 in chips) 
Seat 9: Dorex2007 ($5.86 in chips) 
wood1600: posts small blind $0.02
JPimp2323: posts big blind $0.05
*** HOLE CARDS ***
Dealt to Dorex2007 [Jd 6c]
Dorex2007: folds 
sipo1: folds 
rafaelmineiro: calls $0.05
kramnoy.ivan: folds 
malliosK: calls $0.05
Azimusback: raises $0.22 to $0.27
wood1600: folds 
JPimp2323: folds 
rafaelmineiro: calls $0.22
malliosK: folds 
*** FLOP *** [Js Qd 9d]
rafaelmineiro: bets $0.20
Azimusback: folds 
Uncalled bet ($0.20) returned to rafaelmineiro
rafaelmineiro collected $0.63 from pot
*** SUMMARY ***
Total pot $0.66 | Rake $0.03 
Board [Js Qd 9d]
Seat 1: sipo1 folded before Flop (didn't bet)
Seat 2: rafaelmineiro collected ($0.63)
Seat 3: kramnoy.ivan folded before Flop (didn't bet)
Seat 4: malliosK folded before Flop
Seat 6: Azimusback (button) folded on the Flop
Seat 7: wood1600 (small blind) folded before Flop
Seat 8: JPimp2323 (big blind) folded before Flop
Seat 9: Dorex2007 folded before Flop (didn't bet)



PokerStars Hand #238672629124:  Hold'em No Limit ($0.02/$0.05 USD) - 2022/09/16 15:34:10 PT [2022/09/16 18:34:10 ET]
Table 'Hedera II' 9-max Seat #7 is the button
Seat 1: sipo1 ($7.20 in chips) 
Seat 2: rafaelmineiro ($3.79 in chips) 
Seat 3: kramnoy.ivan ($5.41 in chips) 
Seat 4: malliosK ($4.50 in chips) 
Seat 6: Azimusback ($5.04 in chips) 
Seat 7: wood1600 ($9.80 in chips) 
Seat 8: JPimp2323 ($5 in chips) 
Seat 9: Dorex2007 ($5.86 in chips) 
JPimp2323: posts small blind $0.02
Dorex2007: posts big blind $0.05
*** HOLE CARDS ***
Dealt to Dorex2007 [6c 8c]
sipo1: folds 
rafaelmineiro: calls $0.05
kramnoy.ivan: folds 
malliosK: folds 
Azimusback: folds 
wood1600: folds 
JPimp2323: calls $0.03
Dorex2007: checks 
*** FLOP *** [9d Js Ks]
JPimp2323: checks 
Dorex2007: checks 
rafaelmineiro: checks 
*** TURN *** [9d Js Ks] [Qc]
JPimp2323: checks 
Dorex2007: checks 
rafaelmineiro: checks 
*** RIVER *** [9d Js Ks Qc] [4d]
JPimp2323: bets $0.08
Dorex2007: folds 
rafaelmineiro: folds 
Uncalled bet ($0.08) returned to JPimp2323
JPimp2323 collected $0.14 from pot
*** SUMMARY ***
Total pot $0.15 | Rake $0.01 
Board [9d Js Ks Qc 4d]
Seat 1: sipo1 folded before Flop (didn't bet)
Seat 2: rafaelmineiro folded on the River
Seat 3: kramnoy.ivan folded before Flop (didn't bet)
Seat 4: malliosK folded before Flop (didn't bet)
Seat 6: Azimusback folded before Flop (didn't bet)
Seat 7: wood1600 (button) folded before Flop (didn't bet)
Seat 8: JPimp2323 (small blind) collected ($0.14)
Seat 9: Dorex2007 (big blind) folded on the River



PokerStars Hand #238672648832:  Hold'em No Limit ($0.02/$0.05 USD) - 2022/09/16 15:35:07 PT [2022/09/16 18:35:07 ET]
Table 'Hedera II' 9-max Seat #8 is the button
Seat 1: sipo1 ($7.20 in chips) 
Seat 2: rafaelmineiro ($3.74 in chips) 
Seat 3: kramnoy.ivan ($5.41 in chips) 
Seat 4: malliosK ($4.50 in chips) 
Seat 6: Azimusback ($5.04 in chips) 
Seat 7: wood1600 ($9.80 in chips) 
Seat 8: JPimp2323 ($5.09 in chips) 
Seat 9: Dorex2007 ($5.81 in chips) 
Dorex2007: posts small blind $0.02
sipo1: posts big blind $0.05
*** HOLE CARDS ***
Dealt to Dorex2007 [6h 9c]
rafaelmineiro: calls $0.05
kramnoy.ivan: folds 
malliosK: folds 
Azimusback: folds 
wood1600: folds 
JPimp2323: folds 
Dorex2007: folds 
sipo1: checks 
*** FLOP *** [Ts 5d 3d]
sipo1: checks 
rafaelmineiro: checks 
*** TURN *** [Ts 5d 3d] [Jc]
sipo1: checks 
rafaelmineiro: checks 
*** RIVER *** [Ts 5d 3d Jc] [4s]
sipo1: bets $0.05
rafaelmineiro: raises $0.22 to $0.27
sipo1: folds 
Uncalled bet ($0.22) returned to rafaelmineiro
rafaelmineiro collected $0.21 from pot
*** SUMMARY ***
Total pot $0.22 | Rake $0.01 
Board [Ts 5d 3d Jc 4s]
Seat 1: sipo1 (big blind) folded on the River
Seat 2: rafaelmineiro collected ($0.21)
Seat 3: kramnoy.ivan folded before Flop (didn't bet)
Seat 4: malliosK folded before Flop (didn't bet)
Seat 6: Azimusback folded before Flop (didn't bet)
Seat 7: wood1600 folded before Flop (didn't bet)
Seat 8: JPimp2323 (button) folded before Flop (didn't bet)
Seat 9: Dorex2007 (small blind) folded before Flop



PokerStars Hand #238672667213:  Hold'em No Limit ($0.02/$0.05 USD) - 2022/09/16 15:36:00 PT [2022/09/16 18:36:00 ET]
Table 'Hedera II' 9-max Seat #9 is the button
Seat 1: sipo1 ($7.10 in chips) 
Seat 2: rafaelmineiro ($3.85 in chips) 
Seat 3: kramnoy.ivan ($5.41 in chips) 
Seat 4: malliosK ($4.50 in chips) 
Seat 6: Azimusback ($5.04 in chips) 
Seat 7: wood1600 ($9.80 in chips) 
Seat 8: JPimp2323 ($5.09 in chips) 
Seat 9: Dorex2007 ($5.79 in chips) 
sipo1: posts small blind $0.02
rafaelmineiro: posts big blind $0.05
AssosManiki: sits out 
*** HOLE CARDS ***
Dealt to Dorex2007 [4s Qh]
kramnoy.ivan: raises $0.10 to $0.15
malliosK has timed out
malliosK: folds 
Azimusback: calls $0.15
wood1600: folds 
JPimp2323: folds 
Dorex2007: folds 
sipo1: folds 
rafaelmineiro: calls $0.10
*** FLOP *** [3s 6h 3d]
rafaelmineiro: checks 
kramnoy.ivan: bets $0.35
Azimusback: calls $0.35
rafaelmineiro: folds 
*** TURN *** [3s 6h 3d] [As]
kramnoy.ivan: checks 
Azimusback: bets $0.56
kramnoy.ivan: folds 
Uncalled bet ($0.56) returned to Azimusback
Azimusback collected $1.12 from pot
Azimusback: doesn't show hand 
*** SUMMARY ***
Total pot $1.17 | Rake $0.05 
Board [3s 6h 3d As]
Seat 1: sipo1 (small blind) folded before Flop
Seat 2: rafaelmineiro (big blind) folded on the Flop
Seat 3: kramnoy.ivan folded on the Turn
Seat 4: malliosK folded before Flop (didn't bet)
Seat 6: Azimusback collected ($1.12)
Seat 7: wood1600 folded before Flop (didn't bet)
Seat 8: JPimp2323 folded before Flop (didn't bet)
Seat 9: Dorex2007 (button) folded before Flop (didn't bet)



PokerStars Hand #238672689787:  Hold'em No Limit ($0.02/$0.05 USD) - 2022/09/16 15:37:07 PT [2022/09/16 18:37:07 ET]
Table 'Hedera II' 9-max Seat #1 is the button
Seat 1: sipo1 ($7.08 in chips) 
Seat 2: rafaelmineiro ($3.70 in chips) 
Seat 3: kramnoy.ivan ($4.91 in chips) 
Seat 4: malliosK ($4.50 in chips) 
Seat 6: Azimusback ($5.66 in chips) 
Seat 7: wood1600 ($9.80 in chips) 
Seat 8: JPimp2323 ($5.09 in chips) 
Seat 9: Dorex2007 ($5.79 in chips) 
rafaelmineiro: posts small blind $0.02
kramnoy.ivan: posts big blind $0.05
AssosManiki: sits out 
*** HOLE CARDS ***
Dealt to Dorex2007 [Tc Ts]
malliosK has timed out
malliosK: folds 
Azimusback: folds 
wood1600: folds 
JPimp2323: folds 
Dorex2007: raises $0.12 to $0.17
sipo1: folds 
rafaelmineiro: calls $0.15
kramnoy.ivan: folds 
*** FLOP *** [Kc 5h 4d]
rafaelmineiro: checks 
Dorex2007: bets $0.18
rafaelmineiro: folds 
Uncalled bet ($0.18) returned to Dorex2007
Dorex2007 collected $0.37 from pot
Dorex2007: doesn't show hand 
*** SUMMARY ***
Total pot $0.39 | Rake $0.02 
Board [Kc 5h 4d]
Seat 1: sipo1 (button) folded before Flop (didn't bet)
Seat 2: rafaelmineiro (small blind) folded on the Flop
Seat 3: kramnoy.ivan (big blind) folded before Flop
Seat 4: malliosK folded before Flop (didn't bet)
Seat 6: Azimusback folded before Flop (didn't bet)
Seat 7: wood1600 folded before Flop (didn't bet)
Seat 8: JPimp2323 folded before Flop (didn't bet)
Seat 9: Dorex2007 collected ($0.37)



PokerStars Hand #238672701998:  Hold'em No Limit ($0.02/$0.05 USD) - 2022/09/16 15:37:43 PT [2022/09/16 18:37:43 ET]
Table 'Hedera II' 9-max Seat #2 is the button
Seat 1: sipo1 ($7.08 in chips) 
Seat 2: rafaelmineiro ($3.53 in chips) 
Seat 3: kramnoy.ivan ($4.86 in chips) 
Seat 4: malliosK ($4.50 in chips) 
Seat 6: Azimusback ($5.66 in chips) 
Seat 7: wood1600 ($9.80 in chips) 
Seat 8: JPimp2323 ($5.09 in chips) 
Seat 9: Dorex2007 ($5.99 in chips) 
kramnoy.ivan: posts small blind $0.02
malliosK: posts big blind $0.05
AssosManiki: sits out 
*** HOLE CARDS ***
Dealt to Dorex2007 [6c Js]
Azimusback: folds 
wood1600: folds 
JPimp2323: folds 
Dorex2007: folds 
sipo1: calls $0.05
rafaelmineiro: calls $0.05
kramnoy.ivan: calls $0.03
malliosK: checks 
*** FLOP *** [5s 8c Ac]
kramnoy.ivan: checks 
malliosK: checks 
sipo1: bets $0.10
rafaelmineiro: calls $0.10
kramnoy.ivan: calls $0.10
malliosK: folds 
*** TURN *** [5s 8c Ac] [2h]
kramnoy.ivan: checks 
sipo1: checks 
rafaelmineiro: checks 
*** RIVER *** [5s 8c Ac 2h] [5c]
kramnoy.ivan: checks 
sipo1: bets $0.15
rafaelmineiro: calls $0.15
kramnoy.ivan: calls $0.15
*** SHOW DOWN ***
sipo1: shows [Kc Qc] (a flush, Ace high)
rafaelmineiro: mucks hand 
kramnoy.ivan: mucks hand 
sipo1 collected $0.91 from pot
*** SUMMARY ***
Total pot $0.95 | Rake $0.04 
Board [5s 8c Ac 2h 5c]
Seat 1: sipo1 showed [Kc Qc] and won ($0.91) with a flush, Ace high
Seat 2: rafaelmineiro (button) mucked [Jc 8d]
Seat 3: kramnoy.ivan (small blind) mucked [8h Td]
Seat 4: malliosK (big blind) folded on the Flop
Seat 6: Azimusback folded before Flop (didn't bet)
Seat 7: wood1600 folded before Flop (didn't bet)
Seat 8: JPimp2323 folded before Flop (didn't bet)
Seat 9: Dorex2007 folded before Flop (didn't bet)



PokerStars Hand #238672735545:  Hold'em No Limit ($0.02/$0.05 USD) - 2022/09/16 15:39:22 PT [2022/09/16 18:39:22 ET]
Table 'Hedera II' 9-max Seat #3 is the button
Seat 1: sipo1 ($7.69 in chips) 
Seat 2: rafaelmineiro ($3.23 in chips) 
Seat 3: kramnoy.ivan ($4.56 in chips) 
Seat 4: malliosK ($4.45 in chips) 
Seat 5: AssosManiki ($4.99 in chips) 
Seat 6: Azimusback ($5.66 in chips) 
Seat 7: wood1600 ($9.80 in chips) 
Seat 8: JPimp2323 ($5.09 in chips) 
Seat 9: Dorex2007 ($5.99 in chips) 
malliosK: posts small blind $0.02
AssosManiki: posts big blind $0.05
*** HOLE CARDS ***
Dealt to Dorex2007 [6d 5d]
Azimusback: folds 
wood1600: folds 
JPimp2323: folds 
Dorex2007: folds 
sipo1: calls $0.05
rafaelmineiro: calls $0.05
kramnoy.ivan: folds 
malliosK: folds 
AssosManiki: checks 
*** FLOP *** [As 8c Jh]
AssosManiki: checks 
sipo1: bets $0.10
rafaelmineiro: calls $0.10
AssosManiki: folds 
*** TURN *** [As 8c Jh] [2d]
sipo1: checks 
rafaelmineiro: checks 
*** RIVER *** [As 8c Jh 2d] [Qd]
sipo1: bets $0.14
rafaelmineiro: raises $0.14 to $0.28
sipo1: calls $0.14
*** SHOW DOWN ***
rafaelmineiro: shows [Ks Th] (a straight, Ten to Ace)
sipo1: mucks hand 
rafaelmineiro collected $0.89 from pot
*** SUMMARY ***
Total pot $0.93 | Rake $0.04 
Board [As 8c Jh 2d Qd]
Seat 1: sipo1 mucked [Jd Ah]
Seat 2: rafaelmineiro showed [Ks Th] and won ($0.89) with a straight, Ten to Ace
Seat 3: kramnoy.ivan (button) folded before Flop (didn't bet)
Seat 4: malliosK (small blind) folded before Flop
Seat 5: AssosManiki (big blind) folded on the Flop
Seat 6: Azimusback folded before Flop (didn't bet)
Seat 7: wood1600 folded before Flop (didn't bet)
Seat 8: JPimp2323 folded before Flop (didn't bet)
Seat 9: Dorex2007 folded before Flop (didn't bet)



PokerStars Hand #238672756784:  Hold'em No Limit ($0.02/$0.05 USD) - 2022/09/16 15:40:25 PT [2022/09/16 18:40:25 ET]
Table 'Hedera II' 9-max Seat #4 is the button
Seat 1: sipo1 ($7.26 in chips) 
Seat 2: rafaelmineiro ($3.69 in chips) 
Seat 3: kramnoy.ivan ($4.56 in chips) 
Seat 4: malliosK ($4.43 in chips) 
Seat 5: AssosManiki ($4.94 in chips) 
Seat 6: Azimusback ($5.66 in chips) 
Seat 7: wood1600 ($9.80 in chips) 
Seat 8: JPimp2323 ($5.09 in chips) 
Seat 9: Dorex2007 ($5.99 in chips) 
AssosManiki: posts small blind $0.02
Azimusback: posts big blind $0.05
*** HOLE CARDS ***
Dealt to Dorex2007 [5s 5d]
wood1600: folds 
JPimp2323: calls $0.05
Dorex2007: calls $0.05
sipo1: folds 
rafaelmineiro: calls $0.05
kramnoy.ivan: folds 
malliosK: folds 
AssosManiki: folds 
Azimusback: checks 
*** FLOP *** [Kc 3d 7h]
Azimusback: checks 
JPimp2323: bets $0.10
Dorex2007: folds 
rafaelmineiro: folds 
Azimusback: folds 
Uncalled bet ($0.10) returned to JPimp2323
JPimp2323 collected $0.21 from pot
*** SUMMARY ***
Total pot $0.22 | Rake $0.01 
Board [Kc 3d 7h]
Seat 1: sipo1 folded before Flop (didn't bet)
Seat 2: rafaelmineiro folded on the Flop
Seat 3: kramnoy.ivan folded before Flop (didn't bet)
Seat 4: malliosK (button) folded before Flop (didn't bet)
Seat 5: AssosManiki (small blind) folded before Flop
Seat 6: Azimusback (big blind) folded on the Flop
Seat 7: wood1600 folded before Flop (didn't bet)
Seat 8: JPimp2323 collected ($0.21)
Seat 9: Dorex2007 folded on the Flop



PokerStars Hand #238672769297:  Hold'em No Limit ($0.02/$0.05 USD) - 2022/09/16 15:41:01 PT [2022/09/16 18:41:01 ET]
Table 'Hedera II' 9-max Seat #5 is the button
Seat 1: sipo1 ($7.26 in chips) 
Seat 2: rafaelmineiro ($3.64 in chips) 
Seat 3: kramnoy.ivan ($4.56 in chips) 
Seat 4: malliosK ($4.43 in chips) 
Seat 5: AssosManiki ($4.92 in chips) 
Seat 6: Azimusback ($5.61 in chips) 
Seat 7: wood1600 ($9.80 in chips) 
Seat 8: JPimp2323 ($5.25 in chips) 
Seat 9: Dorex2007 ($5.94 in chips) 
Azimusback: posts small blind $0.02
wood1600: posts big blind $0.05
*** HOLE CARDS ***
Dealt to Dorex2007 [Kd 6c]
JPimp2323: folds 
Dorex2007: folds 
sipo1: folds 
rafaelmineiro: calls $0.05
kramnoy.ivan: folds 
malliosK: folds 
AssosManiki: calls $0.05
Azimusback: folds 
wood1600: checks 
*** FLOP *** [Qd 9c 3h]
wood1600: checks 
rafaelmineiro: checks 
AssosManiki: checks 
*** TURN *** [Qd 9c 3h] [Ah]
wood1600: checks 
rafaelmineiro: checks 
AssosManiki: checks 
*** RIVER *** [Qd 9c 3h Ah] [8c]
wood1600: checks 
rafaelmineiro: checks 
AssosManiki: checks 
*** SHOW DOWN ***
wood1600: shows [3d 8d] (two pair, Eights and Threes)
rafaelmineiro: mucks hand 
AssosManiki: mucks hand 
wood1600 collected $0.16 from pot
*** SUMMARY ***
Total pot $0.17 | Rake $0.01 
Board [Qd 9c 3h Ah 8c]
Seat 1: sipo1 folded before Flop (didn't bet)
Seat 2: rafaelmineiro mucked [4s Jd]
Seat 3: kramnoy.ivan folded before Flop (didn't bet)
Seat 4: malliosK folded before Flop (didn't bet)
Seat 5: AssosManiki (button) mucked [4c 5c]
Seat 6: Azimusback (small blind) folded before Flop
Seat 7: wood1600 (big blind) showed [3d 8d] and won ($0.16) with two pair, Eights and Threes
Seat 8: JPimp2323 folded before Flop (didn't bet)
Seat 9: Dorex2007 folded before Flop (didn't bet)



PokerStars Hand #238672789496:  Hold'em No Limit ($0.02/$0.05 USD) - 2022/09/16 15:42:01 PT [2022/09/16 18:42:01 ET]
Table 'Hedera II' 9-max Seat #6 is the button
Seat 1: sipo1 ($7.26 in chips) 
Seat 2: rafaelmineiro ($3.59 in chips) 
Seat 3: kramnoy.ivan ($4.56 in chips) 
Seat 4: malliosK ($4.43 in chips) 
Seat 5: AssosManiki ($4.87 in chips) 
Seat 6: Azimusback ($5.59 in chips) 
Seat 7: wood1600 ($9.91 in chips) 
Seat 8: JPimp2323 ($5.25 in chips) 
Seat 9: Dorex2007 ($5.94 in chips) 
wood1600: posts small blind $0.02
JPimp2323: posts big blind $0.05
*** HOLE CARDS ***
Dealt to Dorex2007 [7d 5h]
Dorex2007: folds 
sipo1: calls $0.05
rafaelmineiro: calls $0.05
kramnoy.ivan has timed out
kramnoy.ivan: folds 
malliosK: raises $0.06 to $0.11
AssosManiki: folds 
Azimusback: folds 
wood1600: folds 
JPimp2323: calls $0.06
sipo1: calls $0.06
rafaelmineiro: calls $0.06
*** FLOP *** [Qh 3c 6h]
JPimp2323: checks 
sipo1: bets $0.20
rafaelmineiro: folds 
malliosK: folds 
JPimp2323: folds 
Uncalled bet ($0.20) returned to sipo1
sipo1 collected $0.44 from pot
sipo1: doesn't show hand 
*** SUMMARY ***
Total pot $0.46 | Rake $0.02 
Board [Qh 3c 6h]
Seat 1: sipo1 collected ($0.44)
Seat 2: rafaelmineiro folded on the Flop
Seat 3: kramnoy.ivan folded before Flop (didn't bet)
Seat 4: malliosK folded on the Flop
Seat 5: AssosManiki folded before Flop (didn't bet)
Seat 6: Azimusback (button) folded before Flop (didn't bet)
Seat 7: wood1600 (small blind) folded before Flop
Seat 8: JPimp2323 (big blind) folded on the Flop
Seat 9: Dorex2007 folded before Flop (didn't bet)



PokerStars Hand #238672812863:  Hold'em No Limit ($0.02/$0.05 USD) - 2022/09/16 15:43:11 PT [2022/09/16 18:43:11 ET]
Table 'Hedera II' 9-max Seat #7 is the button
Seat 1: sipo1 ($7.59 in chips) 
Seat 2: rafaelmineiro ($3.48 in chips) 
Seat 3: kramnoy.ivan ($4.56 in chips) 
Seat 4: malliosK ($4.32 in chips) 
Seat 5: AssosManiki ($4.87 in chips) 
Seat 6: Azimusback ($5.59 in chips) 
Seat 7: wood1600 ($9.89 in chips) 
Seat 8: JPimp2323 ($5.14 in chips) 
Seat 9: Dorex2007 ($5.94 in chips) 
JPimp2323: posts small blind $0.02
Dorex2007: posts big blind $0.05
*** HOLE CARDS ***
Dealt to Dorex2007 [Jh 7s]
sipo1: folds 
rafaelmineiro: calls $0.05
kramnoy.ivan: folds 
malliosK: folds 
AssosManiki: raises $0.08 to $0.13
Azimusback: folds 
wood1600: folds 
JPimp2323: folds 
Dorex2007: folds 
rafaelmineiro: calls $0.08
*** FLOP *** [4d 4h Qd]
rafaelmineiro: checks 
AssosManiki: bets $0.14
rafaelmineiro: folds 
Uncalled bet ($0.14) returned to AssosManiki
AssosManiki collected $0.32 from pot
AssosManiki: doesn't show hand 
*** SUMMARY ***
Total pot $0.33 | Rake $0.01 
Board [4d 4h Qd]
Seat 1: sipo1 folded before Flop (didn't bet)
Seat 2: rafaelmineiro folded on the Flop
Seat 3: kramnoy.ivan folded before Flop (didn't bet)
Seat 4: malliosK folded before Flop (didn't bet)
Seat 5: AssosManiki collected ($0.32)
Seat 6: Azimusback folded before Flop (didn't bet)
Seat 7: wood1600 (button) folded before Flop (didn't bet)
Seat 8: JPimp2323 (small blind) folded before Flop
Seat 9: Dorex2007 (big blind) folded before Flop



PokerStars Hand #238672825212:  Hold'em No Limit ($0.02/$0.05 USD) - 2022/09/16 15:43:48 PT [2022/09/16 18:43:48 ET]
Table 'Hedera II' 9-max Seat #8 is the button
Seat 1: sipo1 ($7.59 in chips) 
Seat 2: rafaelmineiro ($3.35 in chips) 
Seat 3: kramnoy.ivan ($4.56 in chips) 
Seat 4: malliosK ($4.32 in chips) 
Seat 5: AssosManiki ($5.06 in chips) 
Seat 6: Azimusback ($5.59 in chips) 
Seat 7: wood1600 ($9.89 in chips) 
Seat 8: JPimp2323 ($5.12 in chips) 
Seat 9: Dorex2007 ($5.89 in chips) 
Dorex2007: posts small blind $0.02
sipo1: posts big blind $0.05
*** HOLE CARDS ***
Dealt to Dorex2007 [Ad Qh]
rafaelmineiro: calls $0.05
kramnoy.ivan: raises $0.10 to $0.15
malliosK: folds 
AssosManiki: folds 
Azimusback: folds 
wood1600: folds 
JPimp2323: folds 
Dorex2007: calls $0.13
sipo1: calls $0.10
rafaelmineiro: calls $0.10
*** FLOP *** [7c Kh Ts]
Dorex2007: checks 
sipo1: checks 
rafaelmineiro: checks 
kramnoy.ivan: bets $0.14
Dorex2007: folds 
sipo1: folds 
rafaelmineiro: calls $0.14
*** TURN *** [7c Kh Ts] [8h]
rafaelmineiro: checks 
kramnoy.ivan: bets $0.15
rafaelmineiro: calls $0.15
*** RIVER *** [7c Kh Ts 8h] [8d]
rafaelmineiro: checks 
kramnoy.ivan: checks 
*** SHOW DOWN ***
rafaelmineiro: shows [Kd 6s] (two pair, Kings and Eights)
kramnoy.ivan: mucks hand 
rafaelmineiro collected $1.13 from pot
*** SUMMARY ***
Total pot $1.18 | Rake $0.05 
Board [7c Kh Ts 8h 8d]
Seat 1: sipo1 (big blind) folded on the Flop
Seat 2: rafaelmineiro showed [Kd 6s] and won ($1.13) with two pair, Kings and Eights
Seat 3: kramnoy.ivan mucked [Jc Tc]
Seat 4: malliosK folded before Flop (didn't bet)
Seat 5: AssosManiki folded before Flop (didn't bet)
Seat 6: Azimusback folded before Flop (didn't bet)
Seat 7: wood1600 folded before Flop (didn't bet)
Seat 8: JPimp2323 (button) folded before Flop (didn't bet)
Seat 9: Dorex2007 (small blind) folded on the Flop



PokerStars Hand #238672858117:  Hold'em No Limit ($0.02/$0.05 USD) - 2022/09/16 15:45:26 PT [2022/09/16 18:45:26 ET]
Table 'Hedera II' 9-max Seat #9 is the button
Seat 1: sipo1 ($7.44 in chips) 
Seat 2: rafaelmineiro ($4.04 in chips) 
Seat 3: kramnoy.ivan ($4.12 in chips) 
Seat 4: malliosK ($4.32 in chips) 
Seat 5: AssosManiki ($5.06 in chips) 
Seat 6: Azimusback ($5.59 in chips) 
Seat 7: wood1600 ($9.89 in chips) 
Seat 8: JPimp2323 ($5.12 in chips) 
Seat 9: Dorex2007 ($5.74 in chips) 
sipo1: posts small blind $0.02
rafaelmineiro: posts big blind $0.05
*** HOLE CARDS ***
Dealt to Dorex2007 [2c 2d]
kramnoy.ivan: folds 
malliosK: folds 
AssosManiki: folds 
Azimusback: folds 
wood1600: folds 
JPimp2323: folds 
Dorex2007: raises $0.10 to $0.15
sipo1: folds 
rafaelmineiro: calls $0.10
*** FLOP *** [5s 2h 4d]
rafaelmineiro: checks 
Dorex2007: bets $0.15
rafaelmineiro: folds 
Uncalled bet ($0.15) returned to Dorex2007
Dorex2007 collected $0.31 from pot
Dorex2007: doesn't show hand 
*** SUMMARY ***
Total pot $0.32 | Rake $0.01 
Board [5s 2h 4d]
Seat 1: sipo1 (small blind) folded before Flop
Seat 2: rafaelmineiro (big blind) folded on the Flop
Seat 3: kramnoy.ivan folded before Flop (didn't bet)
Seat 4: malliosK folded before Flop (didn't bet)
Seat 5: AssosManiki folded before Flop (didn't bet)
Seat 6: Azimusback folded before Flop (didn't bet)
Seat 7: wood1600 folded before Flop (didn't bet)
Seat 8: JPimp2323 folded before Flop (didn't bet)
Seat 9: Dorex2007 (button) collected ($0.31)



PokerStars Hand #238672870378:  Hold'em No Limit ($0.02/$0.05 USD) - 2022/09/16 15:46:02 PT [2022/09/16 18:46:02 ET]
Table 'Hedera II' 9-max Seat #1 is the button
Seat 1: sipo1 ($7.42 in chips) 
Seat 2: rafaelmineiro ($3.89 in chips) 
Seat 3: kramnoy.ivan ($4.12 in chips) 
Seat 4: malliosK ($4.32 in chips) 
Seat 5: AssosManiki ($5.06 in chips) 
Seat 6: Azimusback ($5.59 in chips) 
Seat 7: wood1600 ($9.89 in chips) 
Seat 8: JPimp2323 ($5.12 in chips) 
Seat 9: Dorex2007 ($5.90 in chips) 
rafaelmineiro: posts small blind $0.02
kramnoy.ivan: posts big blind $0.05
*** HOLE CARDS ***
Dealt to Dorex2007 [9c 3s]
malliosK: raises $0.06 to $0.11
AssosManiki: calls $0.11
Azimusback: folds 
wood1600: folds 
JPimp2323: raises $0.35 to $0.46
Dorex2007: folds 
sipo1: folds 
rafaelmineiro: folds 
kramnoy.ivan: folds 
malliosK: calls $0.35
AssosManiki: folds 
*** FLOP *** [3c Qd 4s]
malliosK: checks 
JPimp2323: bets $0.47
malliosK: folds 
Uncalled bet ($0.47) returned to JPimp2323
JPimp2323 collected $1.05 from pot
*** SUMMARY ***
Total pot $1.10 | Rake $0.05 
Board [3c Qd 4s]
Seat 1: sipo1 (button) folded before Flop (didn't bet)
Seat 2: rafaelmineiro (small blind) folded before Flop
Seat 3: kramnoy.ivan (big blind) folded before Flop
Seat 4: malliosK folded on the Flop
Seat 5: AssosManiki folded before Flop
Seat 6: Azimusback folded before Flop (didn't bet)
Seat 7: wood1600 folded before Flop (didn't bet)
Seat 8: JPimp2323 collected ($1.05)
Seat 9: Dorex2007 folded before Flop (didn't bet)



PokerStars Hand #238672895262:  Hold'em No Limit ($0.02/$0.05 USD) - 2022/09/16 15:47:17 PT [2022/09/16 18:47:17 ET]
Table 'Hedera II' 9-max Seat #2 is the button
Seat 1: sipo1 ($7.42 in chips) 
Seat 2: rafaelmineiro ($3.87 in chips) 
Seat 3: kramnoy.ivan ($4.07 in chips) 
Seat 4: malliosK ($3.86 in chips) 
Seat 5: AssosManiki ($4.95 in chips) 
Seat 6: Azimusback ($5.59 in chips) 
Seat 7: wood1600 ($9.89 in chips) 
Seat 8: JPimp2323 ($5.71 in chips) 
Seat 9: Dorex2007 ($5.90 in chips) 
kramnoy.ivan: posts small blind $0.02
malliosK: posts big blind $0.05
*** HOLE CARDS ***
Dealt to Dorex2007 [7c 9d]
AssosManiki: raises $0.08 to $0.13
Azimusback: folds 
wood1600: folds 
JPimp2323: folds 
Dorex2007: folds 
sipo1: folds 
rafaelmineiro: folds 
kramnoy.ivan: folds 
malliosK: calls $0.08
*** FLOP *** [4c Tc 7s]
malliosK: checks 
AssosManiki: checks 
*** TURN *** [4c Tc 7s] [Ah]
malliosK: checks 
AssosManiki: bets $0.18
malliosK: calls $0.18
*** RIVER *** [4c Tc 7s Ah] [Qh]
malliosK: checks 
AssosManiki: checks 
*** SHOW DOWN ***
malliosK: shows [Jc Qd] (a pair of Queens)
AssosManiki: shows [As Kc] (a pair of Aces)
AssosManiki collected $0.61 from pot
*** SUMMARY ***
Total pot $0.64 | Rake $0.03 
Board [4c Tc 7s Ah Qh]
Seat 1: sipo1 folded before Flop (didn't bet)
Seat 2: rafaelmineiro (button) folded before Flop (didn't bet)
Seat 3: kramnoy.ivan (small blind) folded before Flop
Seat 4: malliosK (big blind) showed [Jc Qd] and lost with a pair of Queens
Seat 5: AssosManiki showed [As Kc] and won ($0.61) with a pair of Aces
Seat 6: Azimusback folded before Flop (didn't bet)
Seat 7: wood1600 folded before Flop (didn't bet)
Seat 8: JPimp2323 folded before Flop (didn't bet)
Seat 9: Dorex2007 folded before Flop (didn't bet)



PokerStars Hand #238672927467:  Hold'em No Limit ($0.02/$0.05 USD) - 2022/09/16 15:48:54 PT [2022/09/16 18:48:54 ET]
Table 'Hedera II' 9-max Seat #3 is the button
Seat 1: sipo1 ($7.42 in chips) 
Seat 2: rafaelmineiro ($3.87 in chips) 
Seat 3: kramnoy.ivan ($4.05 in chips) 
Seat 4: malliosK ($3.55 in chips) 
Seat 5: AssosManiki ($5.25 in chips) 
Seat 6: Azimusback ($5.59 in chips) 
Seat 7: wood1600 ($9.89 in chips) 
Seat 8: JPimp2323 ($5.71 in chips) 
Seat 9: Dorex2007 ($5.90 in chips) 
malliosK: posts small blind $0.02
AssosManiki: posts big blind $0.05
*** HOLE CARDS ***
Dealt to Dorex2007 [Tc Ad]
Azimusback: folds 
wood1600: folds 
JPimp2323: folds 
Dorex2007: raises $0.10 to $0.15
sipo1: folds 
rafaelmineiro: calls $0.15
kramnoy.ivan: folds 
malliosK: folds 
AssosManiki: folds 
*** FLOP *** [Td Js 9h]
Dorex2007: bets $0.17
rafaelmineiro: calls $0.17
*** TURN *** [Td Js 9h] [Jh]
Dorex2007: checks 
rafaelmineiro: checks 
*** RIVER *** [Td Js 9h Jh] [5d]
Dorex2007: bets $0.34
rafaelmineiro: folds 
Uncalled bet ($0.34) returned to Dorex2007
Dorex2007 collected $0.68 from pot
Dorex2007: doesn't show hand 
*** SUMMARY ***
Total pot $0.71 | Rake $0.03 
Board [Td Js 9h Jh 5d]
Seat 1: sipo1 folded before Flop (didn't bet)
Seat 2: rafaelmineiro folded on the River
Seat 3: kramnoy.ivan (button) folded before Flop (didn't bet)
Seat 4: malliosK (small blind) folded before Flop
Seat 5: AssosManiki (big blind) folded before Flop
Seat 6: Azimusback folded before Flop (didn't bet)
Seat 7: wood1600 folded before Flop (didn't bet)
Seat 8: JPimp2323 folded before Flop (didn't bet)
Seat 9: Dorex2007 collected ($0.68)



PokerStars Hand #238672940607:  Hold'em No Limit ($0.02/$0.05 USD) - 2022/09/16 15:49:33 PT [2022/09/16 18:49:33 ET]
Table 'Hedera II' 9-max Seat #4 is the button
Seat 1: sipo1 ($7.42 in chips) 
Seat 2: rafaelmineiro ($3.55 in chips) 
Seat 3: kramnoy.ivan ($4.05 in chips) 
Seat 4: malliosK ($3.53 in chips) 
Seat 5: AssosManiki ($5.20 in chips) 
Seat 6: Azimusback ($5.59 in chips) 
Seat 7: wood1600 ($9.89 in chips) 
Seat 8: JPimp2323 ($5.71 in chips) 
Seat 9: Dorex2007 ($6.26 in chips) 
AssosManiki: posts small blind $0.02
Azimusback: posts big blind $0.05
*** HOLE CARDS ***
Dealt to Dorex2007 [6c Ah]
wood1600: folds 
JPimp2323: folds 
Dorex2007: folds 
sipo1: calls $0.05
rafaelmineiro: calls $0.05
kramnoy.ivan: raises $0.05 to $0.10
malliosK: calls $0.10
AssosManiki: calls $0.08
Azimusback: folds 
sipo1: calls $0.05
rafaelmineiro: calls $0.05
*** FLOP *** [8c 5d 6s]
AssosManiki: checks 
sipo1: checks 
rafaelmineiro: checks 
kramnoy.ivan: bets $0.26
malliosK: folds 
AssosManiki: folds 
sipo1: folds 
rafaelmineiro: folds 
Uncalled bet ($0.26) returned to kramnoy.ivan
kramnoy.ivan collected $0.53 from pot
*** SUMMARY ***
Total pot $0.55 | Rake $0.02 
Board [8c 5d 6s]
Seat 1: sipo1 folded on the Flop
Seat 2: rafaelmineiro folded on the Flop
Seat 3: kramnoy.ivan collected ($0.53)
Seat 4: malliosK (button) folded on the Flop
Seat 5: AssosManiki (small blind) folded on the Flop
Seat 6: Azimusback (big blind) folded before Flop
Seat 7: wood1600 folded before Flop (didn't bet)
Seat 8: JPimp2323 folded before Flop (didn't bet)
Seat 9: Dorex2007 folded before Flop (didn't bet)



PokerStars Hand #238672958971:  Hold'em No Limit ($0.02/$0.05 USD) - 2022/09/16 15:50:29 PT [2022/09/16 18:50:29 ET]
Table 'Hedera II' 9-max Seat #5 is the button
Seat 1: sipo1 ($7.32 in chips) 
Seat 2: rafaelmineiro ($3.45 in chips) 
Seat 3: kramnoy.ivan ($4.48 in chips) 
Seat 4: malliosK ($3.43 in chips) 
Seat 5: AssosManiki ($5.10 in chips) 
Seat 6: Azimusback ($5.54 in chips) 
Seat 7: wood1600 ($9.89 in chips) 
Seat 8: JPimp2323 ($5.71 in chips) 
Seat 9: Dorex2007 ($6.26 in chips) 
Azimusback: posts small blind $0.02
wood1600: posts big blind $0.05
*** HOLE CARDS ***
Dealt to Dorex2007 [9s 3h]
JPimp2323: calls $0.05
Dorex2007: folds 
sipo1: folds 
rafaelmineiro: calls $0.05
kramnoy.ivan: folds 
malliosK: folds 
AssosManiki: folds 
Azimusback: folds 
wood1600: checks 
*** FLOP *** [2h 5h 8c]
wood1600: checks 
JPimp2323: bets $0.10
rafaelmineiro: calls $0.10
wood1600: folds 
*** TURN *** [2h 5h 8c] [Th]
JPimp2323: checks 
rafaelmineiro: checks 
*** RIVER *** [2h 5h 8c Th] [2s]
JPimp2323: bets $0.10
rafaelmineiro: calls $0.10
*** SHOW DOWN ***
JPimp2323: shows [7h 7d] (two pair, Sevens and Deuces)
rafaelmineiro: mucks hand 
JPimp2323 collected $0.55 from pot
*** SUMMARY ***
Total pot $0.57 | Rake $0.02 
Board [2h 5h 8c Th 2s]
Seat 1: sipo1 folded before Flop (didn't bet)
Seat 2: rafaelmineiro mucked [Qc 5s]
Seat 3: kramnoy.ivan folded before Flop (didn't bet)
Seat 4: malliosK folded before Flop (didn't bet)
Seat 5: AssosManiki (button) folded before Flop (didn't bet)
Seat 6: Azimusback (small blind) folded before Flop
Seat 7: wood1600 (big blind) folded on the Flop
Seat 8: JPimp2323 showed [7h 7d] and won ($0.55) with two pair, Sevens and Deuces
Seat 9: Dorex2007 folded before Flop (didn't bet)



PokerStars Hand #238672976865:  Hold'em No Limit ($0.02/$0.05 USD) - 2022/09/16 15:51:23 PT [2022/09/16 18:51:23 ET]
Table 'Hedera II' 9-max Seat #6 is the button
Seat 1: sipo1 ($7.32 in chips) 
Seat 2: rafaelmineiro ($3.20 in chips) 
Seat 3: kramnoy.ivan ($5 in chips) 
Seat 4: malliosK ($3.43 in chips) 
Seat 5: AssosManiki ($5.10 in chips) 
Seat 6: Azimusback ($5.52 in chips) 
Seat 7: wood1600 ($9.84 in chips) 
Seat 8: JPimp2323 ($6.01 in chips) 
Seat 9: Dorex2007 ($6.26 in chips) 
wood1600: posts small blind $0.02
JPimp2323: posts big blind $0.05
*** HOLE CARDS ***
Dealt to Dorex2007 [2c Ad]
Dorex2007: folds 
sipo1: folds 
rafaelmineiro: calls $0.05
kramnoy.ivan: folds 
malliosK: folds 
AssosManiki: raises $0.08 to $0.13
Azimusback: folds 
wood1600: raises $0.36 to $0.49
JPimp2323: folds 
rafaelmineiro: folds 
AssosManiki: calls $0.36
*** FLOP *** [4d Ah Qc]
wood1600: checks 
AssosManiki: checks 
*** TURN *** [4d Ah Qc] [Tc]
wood1600: checks 
AssosManiki: bets $0.46
wood1600: calls $0.46
*** RIVER *** [4d Ah Qc Tc] [Jd]
wood1600: checks 
AssosManiki: checks 
*** SHOW DOWN ***
wood1600: shows [Kc Ks] (a straight, Ten to Ace)
AssosManiki: mucks hand 
wood1600 collected $1.92 from pot
*** SUMMARY ***
Total pot $2 | Rake $0.08 
Board [4d Ah Qc Tc Jd]
Seat 1: sipo1 folded before Flop (didn't bet)
Seat 2: rafaelmineiro folded before Flop
Seat 3: kramnoy.ivan folded before Flop (didn't bet)
Seat 4: malliosK folded before Flop (didn't bet)
Seat 5: AssosManiki mucked [Js As]
Seat 6: Azimusback (button) folded before Flop (didn't bet)
Seat 7: wood1600 (small blind) showed [Kc Ks] and won ($1.92) with a straight, Ten to Ace
Seat 8: JPimp2323 (big blind) folded before Flop
Seat 9: Dorex2007 folded before Flop (didn't bet)



PokerStars Hand #238673001363:  Hold'em No Limit ($0.02/$0.05 USD) - 2022/09/16 15:52:38 PT [2022/09/16 18:52:38 ET]
Table 'Hedera II' 9-max Seat #7 is the button
Seat 1: sipo1 ($7.32 in chips) 
Seat 2: rafaelmineiro ($3.15 in chips) 
Seat 3: kramnoy.ivan ($5 in chips) 
Seat 4: malliosK ($3.43 in chips) 
Seat 5: AssosManiki ($5 in chips) 
Seat 6: Azimusback ($5.52 in chips) 
Seat 7: wood1600 ($10.81 in chips) 
Seat 8: JPimp2323 ($5.96 in chips) 
Seat 9: Dorex2007 ($6.26 in chips) 
JPimp2323: posts small blind $0.02
Dorex2007: posts big blind $0.05
*** HOLE CARDS ***
Dealt to Dorex2007 [9c Jc]
sipo1: folds 
rafaelmineiro: calls $0.05
kramnoy.ivan: raises $0.10 to $0.15
malliosK: folds 
AssosManiki: folds 
Azimusback: folds 
wood1600: folds 
JPimp2323: folds 
Dorex2007: folds 
rafaelmineiro: calls $0.10
*** FLOP *** [4s Ks 4c]
rafaelmineiro: checks 
kramnoy.ivan: bets $0.27
rafaelmineiro: calls $0.27
*** TURN *** [4s Ks 4c] [Td]
rafaelmineiro: checks 
kramnoy.ivan: checks 
*** RIVER *** [4s Ks 4c Td] [7d]
rafaelmineiro: checks 
kramnoy.ivan: checks 
*** SHOW DOWN ***
rafaelmineiro: shows [Qs Ts] (two pair, Tens and Fours)
kramnoy.ivan: mucks hand 
rafaelmineiro collected $0.87 from pot
*** SUMMARY ***
Total pot $0.91 | Rake $0.04 
Board [4s Ks 4c Td 7d]
Seat 1: sipo1 folded before Flop (didn't bet)
Seat 2: rafaelmineiro showed [Qs Ts] and won ($0.87) with two pair, Tens and Fours
Seat 3: kramnoy.ivan mucked [8s Ah]
Seat 4: malliosK folded before Flop (didn't bet)
Seat 5: AssosManiki folded before Flop (didn't bet)
Seat 6: Azimusback folded before Flop (didn't bet)
Seat 7: wood1600 (button) folded before Flop (didn't bet)
Seat 8: JPimp2323 (small blind) folded before Flop
Seat 9: Dorex2007 (big blind) folded before Flop



PokerStars Hand #238673023570:  Hold'em No Limit ($0.02/$0.05 USD) - 2022/09/16 15:53:47 PT [2022/09/16 18:53:47 ET]
Table 'Hedera II' 9-max Seat #8 is the button
Seat 1: sipo1 ($7.32 in chips) 
Seat 2: rafaelmineiro ($3.60 in chips) 
Seat 3: kramnoy.ivan ($4.58 in chips) 
Seat 4: malliosK ($3.43 in chips) 
Seat 5: AssosManiki ($5 in chips) 
Seat 6: Azimusback ($5.52 in chips) 
Seat 7: wood1600 ($10.81 in chips) 
Seat 8: JPimp2323 ($5.94 in chips) 
Seat 9: Dorex2007 ($6.21 in chips) 
Dorex2007: posts small blind $0.02
sipo1: posts big blind $0.05
*** HOLE CARDS ***
Dealt to Dorex2007 [9d Qd]
rafaelmineiro: calls $0.05
kramnoy.ivan: folds 
malliosK: folds 
AssosManiki: folds 
Azimusback: folds 
wood1600: folds 
JPimp2323: folds 
Dorex2007: folds 
sipo1: raises $0.10 to $0.15
rafaelmineiro: calls $0.10
*** FLOP *** [Kc 2d 9s]
sipo1: checks 
rafaelmineiro: checks 
*** TURN *** [Kc 2d 9s] [3s]
sipo1: checks 
rafaelmineiro: checks 
*** RIVER *** [Kc 2d 9s 3s] [Jc]
sipo1: checks 
rafaelmineiro: checks 
*** SHOW DOWN ***
sipo1: shows [Td Tc] (a pair of Tens)
rafaelmineiro: mucks hand 
sipo1 collected $0.31 from pot
*** SUMMARY ***
Total pot $0.32 | Rake $0.01 
Board [Kc 2d 9s 3s Jc]
Seat 1: sipo1 (big blind) showed [Td Tc] and won ($0.31) with a pair of Tens
Seat 2: rafaelmineiro mucked [Ts 8h]
Seat 3: kramnoy.ivan folded before Flop (didn't bet)
Seat 4: malliosK folded before Flop (didn't bet)
Seat 5: AssosManiki folded before Flop (didn't bet)
Seat 6: Azimusback folded before Flop (didn't bet)
Seat 7: wood1600 folded before Flop (didn't bet)
Seat 8: JPimp2323 (button) folded before Flop (didn't bet)
Seat 9: Dorex2007 (small blind) folded before Flop



PokerStars Hand #238673041927:  Hold'em No Limit ($0.02/$0.05 USD) - 2022/09/16 15:54:43 PT [2022/09/16 18:54:43 ET]
Table 'Hedera II' 9-max Seat #9 is the button
Seat 1: sipo1 ($7.48 in chips) 
Seat 2: rafaelmineiro ($3.45 in chips) 
Seat 3: kramnoy.ivan ($5 in chips) 
Seat 4: malliosK ($3.43 in chips) 
Seat 5: AssosManiki ($5 in chips) 
Seat 6: Azimusback ($5.52 in chips) 
Seat 7: wood1600 ($10.81 in chips) 
Seat 8: JPimp2323 ($5.94 in chips) 
Seat 9: Dorex2007 ($6.19 in chips) 
sipo1: posts small blind $0.02
rafaelmineiro: posts big blind $0.05
*** HOLE CARDS ***
Dealt to Dorex2007 [2s Qd]
kramnoy.ivan: raises $0.10 to $0.15
malliosK has timed out
malliosK: folds 
AssosManiki: folds 
Azimusback: folds 
wood1600: raises $0.27 to $0.42
JPimp2323: folds 
Dorex2007: folds 
sipo1: folds 
rafaelmineiro: folds 
kramnoy.ivan: folds 
Uncalled bet ($0.27) returned to wood1600
wood1600 collected $0.37 from pot
*** SUMMARY ***
Total pot $0.37 | Rake $0 
Seat 1: sipo1 (small blind) folded before Flop
Seat 2: rafaelmineiro (big blind) folded before Flop
Seat 3: kramnoy.ivan folded before Flop
Seat 4: malliosK folded before Flop (didn't bet)
Seat 5: AssosManiki folded before Flop (didn't bet)
Seat 6: Azimusback folded before Flop (didn't bet)
Seat 7: wood1600 collected ($0.37)
Seat 8: JPimp2323 folded before Flop (didn't bet)
Seat 9: Dorex2007 (button) folded before Flop (didn't bet)



PokerStars Hand #238673057259:  Hold'em No Limit ($0.02/$0.05 USD) - 2022/09/16 15:55:35 PT [2022/09/16 18:55:35 ET]
Table 'Hedera II' 9-max Seat #1 is the button
Seat 1: sipo1 ($7.46 in chips) 
Seat 2: rafaelmineiro ($3.40 in chips) 
Seat 3: kramnoy.ivan ($4.85 in chips) 
Seat 5: AssosManiki ($5 in chips) 
Seat 6: Azimusback ($5.52 in chips) 
Seat 7: wood1600 ($11.03 in chips) 
Seat 8: JPimp2323 ($5.94 in chips) 
Seat 9: Dorex2007 ($6.19 in chips) 
rafaelmineiro: posts small blind $0.02
kramnoy.ivan: posts big blind $0.05
*** HOLE CARDS ***
Dealt to Dorex2007 [Ad Jc]
AssosManiki: raises $0.08 to $0.13
Azimusback: folds 
wood1600: folds 
JPimp2323: folds 
Dorex2007: folds 
sipo1: calls $0.13
rafaelmineiro: folds 
kramnoy.ivan: folds 
*** FLOP *** [Qc 6s Ac]
AssosManiki: checks 
sipo1: bets $0.15
AssosManiki: folds 
Uncalled bet ($0.15) returned to sipo1
sipo1 collected $0.32 from pot
sipo1: doesn't show hand 
*** SUMMARY ***
Total pot $0.33 | Rake $0.01 
Board [Qc 6s Ac]
Seat 1: sipo1 (button) collected ($0.32)
Seat 2: rafaelmineiro (small blind) folded before Flop
Seat 3: kramnoy.ivan (big blind) folded before Flop
Seat 5: AssosManiki folded on the Flop
Seat 6: Azimusback folded before Flop (didn't bet)
Seat 7: wood1600 folded before Flop (didn't bet)
Seat 8: JPimp2323 folded before Flop (didn't bet)
Seat 9: Dorex2007 folded before Flop (didn't bet)



PokerStars Hand #238673187756:  Hold'em No Limit ($0.02/$0.05 USD) - 2022/09/16 16:03:31 PT [2022/09/16 19:03:31 ET]
Table 'Hedera II' 9-max Seat #1 is the button
Seat 1: sipo1 ($6.73 in chips) 
Seat 2: rafaelmineiro ($4.37 in chips) 
Seat 3: kramnoy.ivan ($4.90 in chips) 
Seat 4: malliosK ($3.69 in chips) 
Seat 5: AssosManiki ($4.90 in chips) 
Seat 6: Azimusback ($6.20 in chips) 
Seat 7: wood1600 ($10.91 in chips) 
Seat 8: JPimp2323 ($5.94 in chips) 
Seat 9: Dorex2007 ($6.19 in chips) 
rafaelmineiro: posts small blind $0.02
kramnoy.ivan: posts big blind $0.05
Dorex2007: posts small & big blinds $0.07
*** HOLE CARDS ***
Dealt to Dorex2007 [5s Kc]
malliosK has timed out
malliosK: folds 
AssosManiki: folds 
Azimusback: folds 
wood1600: folds 
JPimp2323: folds 
Dorex2007: checks 
sipo1: folds 
rafaelmineiro: calls $0.03
kramnoy.ivan: raises $0.10 to $0.15
Dorex2007: folds 
rafaelmineiro: calls $0.10
*** FLOP *** [Js 9h 3c]
rafaelmineiro: checks 
kramnoy.ivan: bets $0.17
rafaelmineiro: folds 
Uncalled bet ($0.17) returned to kramnoy.ivan
kramnoy.ivan collected $0.35 from pot
*** SUMMARY ***
Total pot $0.37 | Rake $0.02 
Board [Js 9h 3c]
Seat 1: sipo1 (button) folded before Flop (didn't bet)
Seat 2: rafaelmineiro (small blind) folded on the Flop
Seat 3: kramnoy.ivan (big blind) collected ($0.35)
Seat 4: malliosK folded before Flop (didn't bet)
Seat 5: AssosManiki folded before Flop (didn't bet)
Seat 6: Azimusback folded before Flop (didn't bet)
Seat 7: wood1600 folded before Flop (didn't bet)
Seat 8: JPimp2323 folded before Flop (didn't bet)
Seat 9: Dorex2007 folded before Flop (didn't bet)



PokerStars Hand #238673201926:  Hold'em No Limit ($0.02/$0.05 USD) - 2022/09/16 16:04:16 PT [2022/09/16 19:04:16 ET]
Table 'Hedera II' 9-max Seat #2 is the button
Seat 1: sipo1 ($6.73 in chips) 
Seat 2: rafaelmineiro ($4.22 in chips) 
Seat 3: kramnoy.ivan ($5.10 in chips) 
Seat 5: AssosManiki ($4.90 in chips) 
Seat 6: Azimusback ($6.20 in chips) 
Seat 7: wood1600 ($10.91 in chips) 
Seat 8: JPimp2323 ($5.94 in chips) 
Seat 9: Dorex2007 ($6.12 in chips) 
kramnoy.ivan: posts small blind $0.02
AssosManiki: posts big blind $0.05
*** HOLE CARDS ***
Dealt to Dorex2007 [5h 7d]
Azimusback: raises $0.10 to $0.15
wood1600: folds 
JPimp2323: folds 
Dorex2007: folds 
sipo1: folds 
rafaelmineiro: calls $0.15
kramnoy.ivan: folds 
AssosManiki: folds 
*** FLOP *** [Qs 4h As]
Azimusback: bets $0.17
rafaelmineiro: folds 
Uncalled bet ($0.17) returned to Azimusback
Azimusback collected $0.35 from pot
Azimusback: doesn't show hand 
*** SUMMARY ***
Total pot $0.37 | Rake $0.02 
Board [Qs 4h As]
Seat 1: sipo1 folded before Flop (didn't bet)
Seat 2: rafaelmineiro (button) folded on the Flop
Seat 3: kramnoy.ivan (small blind) folded before Flop
Seat 5: AssosManiki (big blind) folded before Flop
Seat 6: Azimusback collected ($0.35)
Seat 7: wood1600 folded before Flop (didn't bet)
Seat 8: JPimp2323 folded before Flop (didn't bet)
Seat 9: Dorex2007 folded before Flop (didn't bet)



PokerStars Hand #238673212861:  Hold'em No Limit ($0.02/$0.05 USD) - 2022/09/16 16:04:51 PT [2022/09/16 19:04:51 ET]
Table 'Hedera II' 9-max Seat #3 is the button
Seat 1: sipo1 ($6.73 in chips) 
Seat 2: rafaelmineiro ($4.07 in chips) 
Seat 3: kramnoy.ivan ($5.08 in chips) 
Seat 5: AssosManiki ($4.85 in chips) 
Seat 6: Azimusback ($6.40 in chips) 
Seat 7: wood1600 ($10.91 in chips) 
Seat 8: JPimp2323 ($5.94 in chips) 
Seat 9: Dorex2007 ($6.12 in chips) 
AssosManiki: posts small blind $0.02
Azimusback: posts big blind $0.05
*** HOLE CARDS ***
Dealt to Dorex2007 [5h Jc]
wood1600: folds 
JPimp2323: folds 
Dorex2007: folds 
sipo1: folds 
rafaelmineiro: calls $0.05
kramnoy.ivan: folds 
AssosManiki: folds 
Azimusback: checks 
*** FLOP *** [Ah Qc 3c]
Azimusback: bets $0.06
rafaelmineiro: raises $0.06 to $0.12
Azimusback: calls $0.06
*** TURN *** [Ah Qc 3c] [2s]
Azimusback: checks 
rafaelmineiro: bets $0.35
Azimusback: folds 
Uncalled bet ($0.35) returned to rafaelmineiro
rafaelmineiro collected $0.35 from pot
*** SUMMARY ***
Total pot $0.36 | Rake $0.01 
Board [Ah Qc 3c 2s]
Seat 1: sipo1 folded before Flop (didn't bet)
Seat 2: rafaelmineiro collected ($0.35)
Seat 3: kramnoy.ivan (button) folded before Flop (didn't bet)
Seat 5: AssosManiki (small blind) folded before Flop
Seat 6: Azimusback (big blind) folded on the Turn
Seat 7: wood1600 folded before Flop (didn't bet)
Seat 8: JPimp2323 folded before Flop (didn't bet)
Seat 9: Dorex2007 folded before Flop (didn't bet)



PokerStars Hand #238673227141:  Hold'em No Limit ($0.02/$0.05 USD) - 2022/09/16 16:05:37 PT [2022/09/16 19:05:37 ET]
Table 'Hedera II' 9-max Seat #5 is the button
Seat 1: sipo1 ($6.73 in chips) 
Seat 2: rafaelmineiro ($4.25 in chips) 
Seat 3: kramnoy.ivan ($5.08 in chips) 
Seat 5: AssosManiki ($4.83 in chips) 
Seat 6: Azimusback ($6.23 in chips) 
Seat 7: wood1600 ($10.91 in chips) 
Seat 8: JPimp2323 ($5.94 in chips) 
Seat 9: Dorex2007 ($6.12 in chips) 
Azimusback: posts small blind $0.02
wood1600: posts big blind $0.05
malliosK: sits out 
*** HOLE CARDS ***
Dealt to Dorex2007 [Jh Kd]
JPimp2323 has timed out
JPimp2323: folds 
Dorex2007: folds 
sipo1: folds 
rafaelmineiro: calls $0.05
JPimp2323 leaves the table
kramnoy.ivan has timed out
kramnoy.ivan: folds 
AssosManiki: folds 
Azimusback: folds 
wood1600: checks 
*** FLOP *** [Js 5d Ts]
wood1600: checks 
rafaelmineiro: checks 
*** TURN *** [Js 5d Ts] [4s]
wood1600: checks 
rafaelmineiro: checks 
*** RIVER *** [Js 5d Ts 4s] [9h]
wood1600: checks 
rafaelmineiro: checks 
*** SHOW DOWN ***
wood1600: shows [7c Ks] (high card King)
rafaelmineiro: shows [Ac 5h] (a pair of Fives)
rafaelmineiro collected $0.12 from pot
*** SUMMARY ***
Total pot $0.12 | Rake $0 
Board [Js 5d Ts 4s 9h]
Seat 1: sipo1 folded before Flop (didn't bet)
Seat 2: rafaelmineiro showed [Ac 5h] and won ($0.12) with a pair of Fives
Seat 3: kramnoy.ivan folded before Flop (didn't bet)
Seat 5: AssosManiki (button) folded before Flop (didn't bet)
Seat 6: Azimusback (small blind) folded before Flop
Seat 7: wood1600 (big blind) showed [7c Ks] and lost with high card King
Seat 8: JPimp2323 folded before Flop (didn't bet)
Seat 9: Dorex2007 folded before Flop (didn't bet)



PokerStars Hand #238673243785:  Hold'em No Limit ($0.02/$0.05 USD) - 2022/09/16 16:06:31 PT [2022/09/16 19:06:31 ET]
Table 'Hedera II' 9-max Seat #6 is the button
Seat 1: sipo1 ($6.73 in chips) 
Seat 2: rafaelmineiro ($4.32 in chips) 
Seat 3: kramnoy.ivan ($5.08 in chips) 
Seat 4: malliosK ($3.69 in chips) 
Seat 5: AssosManiki ($4.83 in chips) 
Seat 6: Azimusback ($6.21 in chips) 
Seat 7: wood1600 ($10.86 in chips) 
Seat 9: Dorex2007 ($6.12 in chips) 
wood1600: posts small blind $0.02
Dorex2007: posts big blind $0.05
malliosK: posts small & big blinds $0.07
*** HOLE CARDS ***
Dealt to Dorex2007 [2h 4d]
sipo1: calls $0.05
rafaelmineiro: calls $0.05
kramnoy.ivan: raises $0.10 to $0.15
TheDorkSlayer joins the table at seat #8 
malliosK: calls $0.10
AssosManiki: calls $0.15
Azimusback: calls $0.15
wood1600: folds 
Dorex2007: folds 
sipo1: calls $0.10
rafaelmineiro: calls $0.10
*** FLOP *** [8c Js 3h]
sipo1: checks 
rafaelmineiro: checks 
kramnoy.ivan: checks 
malliosK: checks 
AssosManiki: checks 
Azimusback: bets $0.33
sipo1: folds 
rafaelmineiro: folds 
kramnoy.ivan: calls $0.33
malliosK: folds 
AssosManiki: folds 
*** TURN *** [8c Js 3h] [Td]
kramnoy.ivan: checks 
Azimusback: checks 
*** RIVER *** [8c Js 3h Td] [6c]
kramnoy.ivan: bets $0.79
Azimusback: calls $0.79
*** SHOW DOWN ***
kramnoy.ivan: shows [Kc Jd] (a pair of Jacks)
Azimusback: mucks hand 
kramnoy.ivan collected $3.10 from pot
*** SUMMARY ***
Total pot $3.23 | Rake $0.13 
Board [8c Js 3h Td 6c]
Seat 1: sipo1 folded on the Flop
Seat 2: rafaelmineiro folded on the Flop
Seat 3: kramnoy.ivan showed [Kc Jd] and won ($3.10) with a pair of Jacks
Seat 4: malliosK folded on the Flop
Seat 5: AssosManiki folded on the Flop
Seat 6: Azimusback (button) mucked [Th Kd]
Seat 7: wood1600 (small blind) folded before Flop
Seat 9: Dorex2007 (big blind) folded before Flop



PokerStars Hand #238673276937:  Hold'em No Limit ($0.02/$0.05 USD) - 2022/09/16 16:08:19 PT [2022/09/16 19:08:19 ET]
Table 'Hedera II' 9-max Seat #7 is the button
Seat 1: sipo1 ($6.58 in chips) 
Seat 2: rafaelmineiro ($4.17 in chips) 
Seat 3: kramnoy.ivan ($6.91 in chips) 
Seat 4: malliosK ($3.52 in chips) 
Seat 5: AssosManiki ($5 in chips) 
Seat 6: Azimusback ($5 in chips) 
Seat 7: wood1600 ($10.84 in chips) 
Seat 9: Dorex2007 ($6.07 in chips) 
Dorex2007: posts small blind $0.02
sipo1: posts big blind $0.05
*** HOLE CARDS ***
Dealt to Dorex2007 [4s 9c]
rafaelmineiro: calls $0.05
kramnoy.ivan: folds 
malliosK: folds 
AssosManiki: calls $0.05
Azimusback: raises $0.20 to $0.25
wood1600: folds 
Dorex2007: folds 
sipo1: folds 
rafaelmineiro: calls $0.20
AssosManiki: calls $0.20
*** FLOP *** [6c Ad Jd]
rafaelmineiro: checks 
AssosManiki: checks 
Azimusback: bets $0.28
rafaelmineiro: calls $0.28
AssosManiki: folds 
*** TURN *** [6c Ad Jd] [6h]
rafaelmineiro: checks 
Azimusback: checks 
*** RIVER *** [6c Ad Jd 6h] [7d]
rafaelmineiro: checks 
Azimusback: checks 
*** SHOW DOWN ***
rafaelmineiro: shows [Kc Qd] (a pair of Sixes)
Azimusback: shows [Ah 9h] (two pair, Aces and Sixes)
Azimusback collected $1.32 from pot
*** SUMMARY ***
Total pot $1.38 | Rake $0.06 
Board [6c Ad Jd 6h 7d]
Seat 1: sipo1 (big blind) folded before Flop
Seat 2: rafaelmineiro showed [Kc Qd] and lost with a pair of Sixes
Seat 3: kramnoy.ivan folded before Flop (didn't bet)
Seat 4: malliosK folded before Flop (didn't bet)
Seat 5: AssosManiki folded on the Flop
Seat 6: Azimusback showed [Ah 9h] and won ($1.32) with two pair, Aces and Sixes
Seat 7: wood1600 (button) folded before Flop (didn't bet)
Seat 9: Dorex2007 (small blind) folded before Flop



PokerStars Hand #238673303503:  Hold'em No Limit ($0.02/$0.05 USD) - 2022/09/16 16:09:45 PT [2022/09/16 19:09:45 ET]
Table 'Hedera II' 9-max Seat #9 is the button
Seat 1: sipo1 ($6.53 in chips) 
Seat 2: rafaelmineiro ($3.64 in chips) 
Seat 3: kramnoy.ivan ($6.91 in chips) 
Seat 4: malliosK ($3.52 in chips) 
Seat 5: AssosManiki ($4.75 in chips) 
Seat 6: Azimusback ($5.79 in chips) 
Seat 7: wood1600 ($10.84 in chips) 
Seat 8: TheDorkSlayer ($4 in chips) 
Seat 9: Dorex2007 ($6.05 in chips) 
sipo1: posts small blind $0.02
rafaelmineiro: posts big blind $0.05
TheDorkSlayer: posts big blind $0.05
*** HOLE CARDS ***
Dealt to Dorex2007 [6s Qd]
kramnoy.ivan: folds 
malliosK: folds 
AssosManiki: folds 
Azimusback: folds 
wood1600: folds 
TheDorkSlayer: checks 
Dorex2007: folds 
sipo1: calls $0.03
rafaelmineiro: checks 
*** FLOP *** [6h Ad Ah]
sipo1: checks 
rafaelmineiro: checks 
TheDorkSlayer: bets $0.07
sipo1: folds 
rafaelmineiro: folds 
Uncalled bet ($0.07) returned to TheDorkSlayer
TheDorkSlayer collected $0.14 from pot
TheDorkSlayer: doesn't show hand 
*** SUMMARY ***
Total pot $0.15 | Rake $0.01 
Board [6h Ad Ah]
Seat 1: sipo1 (small blind) folded on the Flop
Seat 2: rafaelmineiro (big blind) folded on the Flop
Seat 3: kramnoy.ivan folded before Flop (didn't bet)
Seat 4: malliosK folded before Flop (didn't bet)
Seat 5: AssosManiki folded before Flop (didn't bet)
Seat 6: Azimusback folded before Flop (didn't bet)
Seat 7: wood1600 folded before Flop (didn't bet)
Seat 8: TheDorkSlayer collected ($0.14)
Seat 9: Dorex2007 (button) folded before Flop (didn't bet)



PokerStars Hand #238673322828:  Hold'em No Limit ($0.02/$0.05 USD) - 2022/09/16 16:10:48 PT [2022/09/16 19:10:48 ET]
Table 'Hedera II' 9-max Seat #1 is the button
Seat 1: sipo1 ($6.48 in chips) 
Seat 2: rafaelmineiro ($3.59 in chips) 
Seat 3: kramnoy.ivan ($6.91 in chips) 
Seat 4: malliosK ($3.52 in chips) 
Seat 5: AssosManiki ($4.75 in chips) 
Seat 6: Azimusback ($5.79 in chips) 
Seat 7: wood1600 ($10.84 in chips) 
Seat 8: TheDorkSlayer ($4.09 in chips) 
Seat 9: Dorex2007 ($6.05 in chips) 
rafaelmineiro: posts small blind $0.02
kramnoy.ivan: posts big blind $0.05
*** HOLE CARDS ***
Dealt to Dorex2007 [4h Js]
malliosK: folds 
AssosManiki: raises $0.08 to $0.13
Azimusback: folds 
wood1600: folds 
TheDorkSlayer: folds 
Dorex2007: folds 
sipo1: folds 
rafaelmineiro: calls $0.11
kramnoy.ivan: calls $0.08
*** FLOP *** [7h Ah 4d]
rafaelmineiro: checks 
kramnoy.ivan: bets $0.27
AssosManiki: folds 
rafaelmineiro: folds 
Uncalled bet ($0.27) returned to kramnoy.ivan
kramnoy.ivan collected $0.37 from pot
*** SUMMARY ***
Total pot $0.39 | Rake $0.02 
Board [7h Ah 4d]
Seat 1: sipo1 (button) folded before Flop (didn't bet)
Seat 2: rafaelmineiro (small blind) folded on the Flop
Seat 3: kramnoy.ivan (big blind) collected ($0.37)
Seat 4: malliosK folded before Flop (didn't bet)
Seat 5: AssosManiki folded on the Flop
Seat 6: Azimusback folded before Flop (didn't bet)
Seat 7: wood1600 folded before Flop (didn't bet)
Seat 8: TheDorkSlayer folded before Flop (didn't bet)
Seat 9: Dorex2007 folded before Flop (didn't bet)



PokerStars Hand #238673336099:  Hold'em No Limit ($0.02/$0.05 USD) - 2022/09/16 16:11:31 PT [2022/09/16 19:11:31 ET]
Table 'Hedera II' 9-max Seat #2 is the button
Seat 1: sipo1 ($6.48 in chips) 
Seat 2: rafaelmineiro ($3.46 in chips) 
Seat 3: kramnoy.ivan ($7.15 in chips) 
Seat 4: malliosK ($3.52 in chips) 
Seat 5: AssosManiki ($5 in chips) 
Seat 6: Azimusback ($5.79 in chips) 
Seat 7: wood1600 ($10.84 in chips) 
Seat 8: TheDorkSlayer ($4.09 in chips) 
Seat 9: Dorex2007 ($6.05 in chips) 
kramnoy.ivan: posts small blind $0.02
malliosK: posts big blind $0.05
*** HOLE CARDS ***
Dealt to Dorex2007 [Ad 9d]
AssosManiki: raises $0.08 to $0.13
Azimusback: folds 
wood1600: folds 
TheDorkSlayer: raises $0.33 to $0.46
Dorex2007: folds 
sipo1: folds 
rafaelmineiro: folds 
kramnoy.ivan: folds 
malliosK: folds 
AssosManiki: calls $0.33
*** FLOP *** [8s Td 6c]
AssosManiki: checks 
TheDorkSlayer: bets $0.55
AssosManiki: raises $1.17 to $1.72
TheDorkSlayer: raises $1.91 to $3.63 and is all-in
AssosManiki: calls $1.91
*** TURN *** [8s Td 6c] [Qc]
*** RIVER *** [8s Td 6c Qc] [Ts]
*** SHOW DOWN ***
AssosManiki: shows [6d 6s] (a full house, Sixes full of Tens)
TheDorkSlayer: shows [As Ac] (two pair, Aces and Tens)
AssosManiki cashed out the hand for $7.05 | Cash Out Fee $0.07
*** SUMMARY ***
Total pot $8.25 | Rake $0.34 
Board [8s Td 6c Qc Ts]
Seat 1: sipo1 folded before Flop (didn't bet)
Seat 2: rafaelmineiro (button) folded before Flop (didn't bet)
Seat 3: kramnoy.ivan (small blind) folded before Flop
Seat 4: malliosK (big blind) folded before Flop
Seat 5: AssosManiki showed [6d 6s] and won ($7.91) with a full house, Sixes full of Tens (pot not awarded as player cashed out)
Seat 6: Azimusback folded before Flop (didn't bet)
Seat 7: wood1600 folded before Flop (didn't bet)
Seat 8: TheDorkSlayer showed [As Ac] and lost with two pair, Aces and Tens
Seat 9: Dorex2007 folded before Flop (didn't bet)



PokerStars Hand #238673355208:  Hold'em No Limit ($0.02/$0.05 USD) - 2022/09/16 16:12:34 PT [2022/09/16 19:12:34 ET]
Table 'Hedera II' 9-max Seat #3 is the button
Seat 1: sipo1 ($6.48 in chips) 
Seat 2: rafaelmineiro ($3.46 in chips) 
Seat 3: kramnoy.ivan ($7.13 in chips) 
Seat 4: malliosK ($3.47 in chips) 
Seat 5: AssosManiki ($7.96 in chips) 
Seat 6: Azimusback ($5.79 in chips) 
Seat 7: wood1600 ($10.84 in chips) 
Seat 9: Dorex2007 ($6.05 in chips) 
malliosK: posts small blind $0.02
AssosManiki: posts big blind $0.05
*** HOLE CARDS ***
Dealt to Dorex2007 [2h 7c]
Azimusback: raises $0.10 to $0.15
wood1600: folds 
Dorex2007: folds 
sipo1: folds 
rafaelmineiro: calls $0.15
kramnoy.ivan: calls $0.15
malliosK: calls $0.13
wood1600 leaves the table
AssosManiki: calls $0.10
*** FLOP *** [Jh 8c Th]
malliosK: checks 
AssosManiki: bets $0.48
Azimusback: calls $0.48
rafaelmineiro: folds 
kramnoy.ivan: calls $0.48
malliosK: calls $0.48
*** TURN *** [Jh 8c Th] [8d]
malliosK: checks 
rafaelmineiro leaves the table
AssosManiki: bets $0.84
Azimusback: folds 
kramnoy.ivan: calls $0.84
malliosK: folds 
*** RIVER *** [Jh 8c Th 8d] [Qd]
AssosManiki: bets $1.38
kramnoy.ivan: raises $4.28 to $5.66 and is all-in
AssosManiki: calls $4.28
*** SHOW DOWN ***
kramnoy.ivan: shows [Ah 9h] (a straight, Eight to Queen)
AssosManiki: shows [Tc Ts] (a full house, Tens full of Eights)
AssosManiki collected $15.02 from pot
*** SUMMARY ***
Total pot $15.67 | Rake $0.65 
Board [Jh 8c Th 8d Qd]
Seat 1: sipo1 folded before Flop (didn't bet)
Seat 2: rafaelmineiro folded on the Flop
Seat 3: kramnoy.ivan (button) showed [Ah 9h] and lost with a straight, Eight to Queen
Seat 4: malliosK (small blind) folded on the Turn
Seat 5: AssosManiki (big blind) showed [Tc Ts] and won ($15.02) with a full house, Tens full of Eights
Seat 6: Azimusback folded on the Turn
Seat 7: wood1600 folded before Flop (didn't bet)
Seat 9: Dorex2007 folded before Flop (didn't bet)



PokerStars Hand #238673388312:  Hold'em No Limit ($0.02/$0.05 USD) - 2022/09/16 16:14:24 PT [2022/09/16 19:14:24 ET]
Table 'Hedera II' 9-max Seat #4 is the button
Seat 1: sipo1 ($6.48 in chips) 
Seat 4: malliosK ($2.84 in chips) 
Seat 5: AssosManiki ($15.85 in chips) 
Seat 6: Azimusback ($5.16 in chips) 
Seat 8: TheDorkSlayer ($4 in chips) 
Seat 9: Dorex2007 ($6.05 in chips) 
AssosManiki: posts small blind $0.02
Azimusback: posts big blind $0.05
*** HOLE CARDS ***
Dealt to Dorex2007 [9h Qh]
TheDorkSlayer: folds 
Dorex2007: folds 
sipo1: folds 
malliosK: folds 
AssosManiki: folds 
Uncalled bet ($0.03) returned to Azimusback
Azimusback collected $0.04 from pot
Azimusback: doesn't show hand 
*** SUMMARY ***
Total pot $0.04 | Rake $0 
Seat 1: sipo1 folded before Flop (didn't bet)
Seat 4: malliosK (button) folded before Flop (didn't bet)
Seat 5: AssosManiki (small blind) folded before Flop
Seat 6: Azimusback (big blind) collected ($0.04)
Seat 8: TheDorkSlayer folded before Flop (didn't bet)
Seat 9: Dorex2007 folded before Flop (didn't bet)



PokerStars Hand #238673393353:  Hold'em No Limit ($0.02/$0.05 USD) - 2022/09/16 16:14:40 PT [2022/09/16 19:14:40 ET]
Table 'Hedera II' 9-max Seat #5 is the button
Seat 1: sipo1 ($6.48 in chips) 
Seat 4: malliosK ($2.84 in chips) 
Seat 5: AssosManiki ($15.83 in chips) 
Seat 6: Azimusback ($5.18 in chips) 
Seat 8: TheDorkSlayer ($4 in chips) 
Seat 9: Dorex2007 ($6.05 in chips) 
Azimusback: posts small blind $0.02
TheDorkSlayer: posts big blind $0.05
*** HOLE CARDS ***
Dealt to Dorex2007 [Qc 5h]
kramnoy.ivan leaves the table
Dorex2007: folds 
sipo1: folds 
malliosK: calls $0.05
AssosManiki: folds 
Azimusback: folds 
TheDorkSlayer: raises $0.15 to $0.20
malliosK: calls $0.15
*** FLOP *** [3d Ts 6s]
TheDorkSlayer: bets $0.25
malliosK: calls $0.25
*** TURN *** [3d Ts 6s] [2s]
TheDorkSlayer: bets $0.55
malliosK: calls $0.55
*** RIVER *** [3d Ts 6s 2s] [3s]
TheDorkSlayer: checks 
malliosK: checks 
*** SHOW DOWN ***
TheDorkSlayer: shows [Jc Js] (a flush, Jack high)
malliosK: mucks hand 
TheDorkSlayer collected $1.94 from pot
*** SUMMARY ***
Total pot $2.02 | Rake $0.08 
Board [3d Ts 6s 2s 3s]
Seat 1: sipo1 folded before Flop (didn't bet)
Seat 4: malliosK mucked [7d 7s]
Seat 5: AssosManiki (button) folded before Flop (didn't bet)
Seat 6: Azimusback (small blind) folded before Flop
Seat 8: TheDorkSlayer (big blind) showed [Jc Js] and won ($1.94) with a flush, Jack high
Seat 9: Dorex2007 folded before Flop (didn't bet)



PokerStars Hand #238673407442:  Hold'em No Limit ($0.02/$0.05 USD) - 2022/09/16 16:15:27 PT [2022/09/16 19:15:27 ET]
Table 'Hedera II' 9-max Seat #6 is the button
Seat 1: sipo1 ($6.48 in chips) 
Seat 4: malliosK ($1.84 in chips) 
Seat 5: AssosManiki ($15.83 in chips) 
Seat 6: Azimusback ($5.16 in chips) 
Seat 8: TheDorkSlayer ($4.94 in chips) 
Seat 9: Dorex2007 ($6.05 in chips) 
TheDorkSlayer: posts small blind $0.02
Dorex2007: posts big blind $0.05
*** HOLE CARDS ***
Dealt to Dorex2007 [Jh Ad]
sipo1: folds 
malliosK: folds 
AssosManiki: raises $0.08 to $0.13
Azimusback: raises $0.33 to $0.46
TheDorkSlayer: folds 
Dorex2007: folds 
AssosManiki: calls $0.33
*** FLOP *** [4c Qc 3h]
AssosManiki: checks 
Azimusback: bets $0.47
AssosManiki: raises $1.09 to $1.56
Azimusback: calls $1.09
*** TURN *** [4c Qc 3h] [8d]
AssosManiki: bets $3.47
Azimusback: calls $3.14 and is all-in
Uncalled bet ($0.33) returned to AssosManiki
*** RIVER *** [4c Qc 3h 8d] [8c]
*** SHOW DOWN ***
AssosManiki: shows [Qd Ah] (two pair, Queens and Eights)
Azimusback: shows [Jd Js] (two pair, Jacks and Eights)
AssosManiki cashed out the hand for $9.41 | Cash Out Fee $0.10
*** SUMMARY ***
Total pot $10.39 | Rake $0.43 
Board [4c Qc 3h 8d 8c]
Seat 1: sipo1 folded before Flop (didn't bet)
Seat 4: malliosK folded before Flop (didn't bet)
Seat 5: AssosManiki showed [Qd Ah] and won ($9.96) with two pair, Queens and Eights (pot not awarded as player cashed out)
Seat 6: Azimusback (button) showed [Jd Js] and lost with two pair, Jacks and Eights
Seat 8: TheDorkSlayer (small blind) folded before Flop
Seat 9: Dorex2007 (big blind) folded before Flop



PokerStars Hand #238673431034:  Hold'em No Limit ($0.02/$0.05 USD) - 2022/09/16 16:16:46 PT [2022/09/16 19:16:46 ET]
Table 'Hedera II' 9-max Seat #8 is the button
Seat 1: sipo1 ($6.48 in chips) 
Seat 4: malliosK ($1.84 in chips) 
Seat 5: AssosManiki ($20.08 in chips) 
Seat 6: Azimusback ($5 in chips) 
Seat 8: TheDorkSlayer ($4.92 in chips) 
Seat 9: Dorex2007 ($6 in chips) 
Dorex2007: posts small blind $0.02
sipo1: posts big blind $0.05
*** HOLE CARDS ***
Dealt to Dorex2007 [5s Ac]
malliosK has timed out
malliosK: folds 
AssosManiki: folds 
Azimusback: raises $0.10 to $0.15
TheDorkSlayer: calls $0.15
Dorex2007: folds 
sipo1: calls $0.10
*** FLOP *** [9c 9d Qc]
sipo1: checks 
Azimusback: checks 
TheDorkSlayer: checks 
*** TURN *** [9c 9d Qc] [Kc]
sipo1: checks 
Azimusback: checks 
TheDorkSlayer: bets $0.25
sipo1: folds 
Azimusback: folds 
Uncalled bet ($0.25) returned to TheDorkSlayer
TheDorkSlayer collected $0.45 from pot
TheDorkSlayer: doesn't show hand 
*** SUMMARY ***
Total pot $0.47 | Rake $0.02 
Board [9c 9d Qc Kc]
Seat 1: sipo1 (big blind) folded on the Turn
Seat 4: malliosK folded before Flop (didn't bet)
Seat 5: AssosManiki folded before Flop (didn't bet)
Seat 6: Azimusback folded on the Turn
Seat 8: TheDorkSlayer (button) collected ($0.45)
Seat 9: Dorex2007 (small blind) folded before Flop



PokerStars Hand #238673450769:  Hold'em No Limit ($0.02/$0.05 USD) - 2022/09/16 16:17:51 PT [2022/09/16 19:17:51 ET]
Table 'Hedera II' 9-max Seat #9 is the button
Seat 1: sipo1 ($6.33 in chips) 
Seat 5: AssosManiki ($20.08 in chips) 
Seat 6: Azimusback ($5 in chips) 
Seat 8: TheDorkSlayer ($5.22 in chips) 
Seat 9: Dorex2007 ($5.98 in chips) 
sipo1: posts small blind $0.02
AssosManiki: posts big blind $0.05
*** HOLE CARDS ***
Dealt to Dorex2007 [9d 7d]
Azimusback: folds 
TheDorkSlayer: folds 
Dorex2007: folds 
sipo1: calls $0.03
AssosManiki: checks 
*** FLOP *** [6h 6c 5s]
sipo1: bets $0.05
AssosManiki: folds 
Uncalled bet ($0.05) returned to sipo1
sipo1 collected $0.10 from pot
sipo1: doesn't show hand 
*** SUMMARY ***
Total pot $0.10 | Rake $0 
Board [6h 6c 5s]
Seat 1: sipo1 (small blind) collected ($0.10)
Seat 5: AssosManiki (big blind) folded on the Flop
Seat 6: Azimusback folded before Flop (didn't bet)
Seat 8: TheDorkSlayer folded before Flop (didn't bet)
Seat 9: Dorex2007 (button) folded before Flop (didn't bet)



PokerStars Hand #238673458932:  Hold'em No Limit ($0.02/$0.05 USD) - 2022/09/16 16:18:18 PT [2022/09/16 19:18:18 ET]
Table 'Hedera II' 9-max Seat #1 is the button
Seat 1: sipo1 ($6.38 in chips) 
Seat 5: AssosManiki ($20.03 in chips) 
Seat 8: TheDorkSlayer ($5.22 in chips) 
Seat 9: Dorex2007 ($5.98 in chips) 
AssosManiki: posts small blind $0.02
Azimusback: is sitting out 
TheDorkSlayer: posts big blind $0.05
*** HOLE CARDS ***
Dealt to Dorex2007 [6d 7c]
Dorex2007: folds 
sipo1: folds 
sipo1 leaves the table
Azimusback leaves the table
AssosManiki: folds 
Uncalled bet ($0.03) returned to TheDorkSlayer
TheDorkSlayer collected $0.04 from pot
TheDorkSlayer: doesn't show hand 
*** SUMMARY ***
Total pot $0.04 | Rake $0 
Seat 1: sipo1 (button) folded before Flop (didn't bet)
Seat 5: AssosManiki (small blind) folded before Flop
Seat 8: TheDorkSlayer (big blind) collected ($0.04)
Seat 9: Dorex2007 folded before Flop (didn't bet)



PokerStars Hand #238673464471:  Hold'em No Limit ($0.02/$0.05 USD) - 2022/09/16 16:18:37 PT [2022/09/16 19:18:37 ET]
Table 'Hedera II' 9-max Seat #5 is the button
Seat 5: AssosManiki ($20.01 in chips) 
Seat 8: TheDorkSlayer ($5.24 in chips) 
Seat 9: Dorex2007 ($5.98 in chips) 
TheDorkSlayer: posts small blind $0.02
Dorex2007: posts big blind $0.05
*** HOLE CARDS ***
Dealt to Dorex2007 [5s 6c]
AssosManiki: folds 
TheDorkSlayer: folds 
Uncalled bet ($0.03) returned to Dorex2007
Dorex2007 collected $0.04 from pot
Dorex2007: doesn't show hand 
*** SUMMARY ***
Total pot $0.04 | Rake $0 
Seat 5: AssosManiki (button) folded before Flop (didn't bet)
Seat 8: TheDorkSlayer (small blind) folded before Flop
Seat 9: Dorex2007 (big blind) collected ($0.04)



