PokerStars Hand #236949826914:  Hold'em No Limit ($0.01/$0.02 USD) - 2022/06/23 20:41:41 PT [2022/06/23 23:41:41 ET]
Table 'Ahrensa II' 9-max Seat #2 is the button
Seat 1: Dorex2007 ($2 in chips) 
Seat 2: xjcsilva ($1.97 in chips) 
Seat 3: rpawis ($5.97 in chips) 
Seat 4: kam505068 ($9.58 in chips) 
Seat 5: Shatto39 ($2.25 in chips) 
Seat 6: Roysta88 ($1.15 in chips) 
Seat 7: cberto09 ($2.71 in chips) 
Seat 8: Jpix-13- ($1.48 in chips) 
Seat 9: sweetlegs3 ($8.48 in chips) 
rpawis: posts small blind $0.01
kam505068: posts big blind $0.02
Dorex2007: posts big blind $0.02
*** HOLE CARDS ***
Dealt to Dorex2007 [9h Qd]
Shatto39: folds 
Roysta88: folds 
cberto09: folds 
Jpix-13-: folds 
sweetlegs3: calls $0.02
Dorex2007: checks 
xjcsilva: folds 
rpawis: calls $0.01
kam505068: checks 
*** FLOP *** [8d 2d Ah]
rpawis: checks 
kam505068: bets $0.08
sweetlegs3: folds 
Dorex2007: folds 
rpawis: folds 
Uncalled bet ($0.08) returned to kam505068
kam505068 collected $0.08 from pot
*** SUMMARY ***
Total pot $0.08 | Rake $0 
Board [8d 2d Ah]
Seat 1: Dorex2007 folded on the Flop (didn't bet)
Seat 2: xjcsilva (button) folded before Flop (didn't bet)
Seat 3: rpawis (small blind) folded on the Flop
Seat 4: kam505068 (big blind) collected ($0.08)
Seat 5: Shatto39 folded before Flop (didn't bet)
Seat 6: Roysta88 folded before Flop (didn't bet)
Seat 7: cberto09 folded before Flop (didn't bet)
Seat 8: Jpix-13- folded before Flop (didn't bet)
Seat 9: sweetlegs3 folded on the Flop



PokerStars Hand #236949833435:  Hold'em No Limit ($0.01/$0.02 USD) - 2022/06/23 20:42:24 PT [2022/06/23 23:42:24 ET]
Table 'Ahrensa II' 9-max Seat #3 is the button
Seat 1: Dorex2007 ($2 in chips) 
Seat 2: xjcsilva ($1.97 in chips) 
Seat 3: rpawis ($5.95 in chips) 
Seat 4: kam505068 ($9.64 in chips) 
Seat 5: Shatto39 ($2.25 in chips) 
Seat 6: Roysta88 ($1.15 in chips) 
Seat 7: cberto09 ($2.71 in chips) 
Seat 8: Jpix-13- ($1.48 in chips) 
Seat 9: sweetlegs3 ($8.46 in chips) 
kam505068: posts small blind $0.01
Shatto39: posts big blind $0.02
*** HOLE CARDS ***
Dealt to Dorex2007 [5c Ac]
Roysta88: folds 
cberto09: folds 
Jpix-13-: folds 
sweetlegs3: folds 
Dorex2007: calls $0.02
xjcsilva has timed out
xjcsilva: folds 
rpawis: raises $0.07 to $0.09
kam505068 has timed out
kam505068: folds 
Shatto39: folds 
Dorex2007: calls $0.07
*** FLOP *** [Js 6d Ah]
Dorex2007: checks 
rpawis: bets $0.14
Dorex2007: calls $0.14
*** TURN *** [Js 6d Ah] [4d]
Dorex2007: checks 
rpawis: checks 
*** RIVER *** [Js 6d Ah 4d] [2c]
Dorex2007: bets $0.23
rpawis: folds 
Uncalled bet ($0.23) returned to Dorex2007
Dorex2007 collected $0.47 from pot
*** SUMMARY ***
Total pot $0.49 | Rake $0.02 
Board [Js 6d Ah 4d 2c]
Seat 1: Dorex2007 collected ($0.47)
Seat 2: xjcsilva folded before Flop (didn't bet)
Seat 3: rpawis (button) folded on the River
Seat 4: kam505068 (small blind) folded before Flop
Seat 5: Shatto39 (big blind) folded before Flop
Seat 6: Roysta88 folded before Flop (didn't bet)
Seat 7: cberto09 folded before Flop (didn't bet)
Seat 8: Jpix-13- folded before Flop (didn't bet)
Seat 9: sweetlegs3 folded before Flop (didn't bet)



PokerStars Hand #236949848276:  Hold'em No Limit ($0.01/$0.02 USD) - 2022/06/23 20:44:03 PT [2022/06/23 23:44:03 ET]
Table 'Ahrensa II' 9-max Seat #4 is the button
Seat 1: Dorex2007 ($2.24 in chips) 
Seat 2: xjcsilva ($1.97 in chips) 
Seat 3: rpawis ($5.72 in chips) 
Seat 4: kam505068 ($9.63 in chips) 
Seat 5: Shatto39 ($2.23 in chips) 
Seat 6: Roysta88 ($1.15 in chips) 
Seat 7: cberto09 ($2.71 in chips) 
Seat 8: Jpix-13- ($1.48 in chips) 
Seat 9: sweetlegs3 ($8.46 in chips) 
Shatto39: posts small blind $0.01
Roysta88: posts big blind $0.02
*** HOLE CARDS ***
Dealt to Dorex2007 [Ah Ts]
cberto09: folds 
Jpix-13-: calls $0.02
sweetlegs3: calls $0.02
Dorex2007: folds 
xjcsilva: folds 
rpawis: folds 
kam505068: calls $0.02
Shatto39: folds 
Roysta88: checks 
*** FLOP *** [4d 9d 5c]
Roysta88: checks 
Jpix-13-: checks 
sweetlegs3: checks 
kam505068: bets $0.04
Roysta88: calls $0.04
Jpix-13-: calls $0.04
sweetlegs3: folds 
*** TURN *** [4d 9d 5c] [3c]
Roysta88: checks 
Jpix-13-: checks 
kam505068: bets $0.20
Roysta88: folds 
Jpix-13-: folds 
Uncalled bet ($0.20) returned to kam505068
kam505068 collected $0.20 from pot
*** SUMMARY ***
Total pot $0.21 | Rake $0.01 
Board [4d 9d 5c 3c]
Seat 1: Dorex2007 folded before Flop (didn't bet)
Seat 2: xjcsilva folded before Flop (didn't bet)
Seat 3: rpawis folded before Flop (didn't bet)
Seat 4: kam505068 (button) collected ($0.20)
Seat 5: Shatto39 (small blind) folded before Flop
Seat 6: Roysta88 (big blind) folded on the Turn
Seat 7: cberto09 folded before Flop (didn't bet)
Seat 8: Jpix-13- folded on the Turn
Seat 9: sweetlegs3 folded on the Flop



PokerStars Hand #236949857113:  Hold'em No Limit ($0.01/$0.02 USD) - 2022/06/23 20:45:03 PT [2022/06/23 23:45:03 ET]
Table 'Ahrensa II' 9-max Seat #5 is the button
Seat 1: Dorex2007 ($2.24 in chips) 
Seat 2: xjcsilva ($1.97 in chips) 
Seat 3: rpawis ($5.72 in chips) 
Seat 4: kam505068 ($9.77 in chips) 
Seat 5: Shatto39 ($2.22 in chips) 
Seat 6: Roysta88 ($1.09 in chips) 
Seat 7: cberto09 ($2.71 in chips) 
Seat 8: Jpix-13- ($1.42 in chips) 
Seat 9: sweetlegs3 ($8.44 in chips) 
Roysta88: posts small blind $0.01
cberto09: posts big blind $0.02
*** HOLE CARDS ***
Dealt to Dorex2007 [3h 8c]
Jpix-13-: calls $0.02
sweetlegs3: folds 
Dorex2007: folds 
xjcsilva: folds 
rpawis: calls $0.02
kam505068: calls $0.02
Shatto39: folds 
Roysta88: folds 
cberto09: checks 
*** FLOP *** [Qs Tc 9h]
cberto09: checks 
Jpix-13-: checks 
rpawis: checks 
kam505068: checks 
*** TURN *** [Qs Tc 9h] [Js]
cberto09: checks 
Jpix-13-: checks 
rpawis: checks 
kam505068: checks 
*** RIVER *** [Qs Tc 9h Js] [3s]
cberto09: checks 
Jpix-13-: checks 
rpawis: checks 
kam505068: checks 
*** SHOW DOWN ***
cberto09: shows [8s 9d] (a straight, Eight to Queen)
Jpix-13-: shows [Jd 8d] (a straight, Eight to Queen)
rpawis: mucks hand 
kam505068: mucks hand 
cberto09 collected $0.05 from pot
Jpix-13- collected $0.04 from pot
*** SUMMARY ***
Total pot $0.09 | Rake $0 
Board [Qs Tc 9h Js 3s]
Seat 1: Dorex2007 folded before Flop (didn't bet)
Seat 2: xjcsilva folded before Flop (didn't bet)
Seat 3: rpawis mucked [9c 7c]
Seat 4: kam505068 mucked [7h As]
Seat 5: Shatto39 (button) folded before Flop (didn't bet)
Seat 6: Roysta88 (small blind) folded before Flop
Seat 7: cberto09 (big blind) showed [8s 9d] and won ($0.05) with a straight, Eight to Queen
Seat 8: Jpix-13- showed [Jd 8d] and won ($0.04) with a straight, Eight to Queen
Seat 9: sweetlegs3 folded before Flop (didn't bet)



PokerStars Hand #236949869857:  Hold'em No Limit ($0.01/$0.02 USD) - 2022/06/23 20:46:30 PT [2022/06/23 23:46:30 ET]
Table 'Ahrensa II' 9-max Seat #6 is the button
Seat 1: Dorex2007 ($2.24 in chips) 
Seat 2: xjcsilva ($1.97 in chips) 
Seat 3: rpawis ($5.70 in chips) 
Seat 4: kam505068 ($9.75 in chips) 
Seat 5: Shatto39 ($2.22 in chips) 
Seat 6: Roysta88 ($1.08 in chips) 
Seat 7: cberto09 ($2.74 in chips) 
Seat 8: Jpix-13- ($1.44 in chips) 
Seat 9: sweetlegs3 ($8.44 in chips) 
cberto09: posts small blind $0.01
Jpix-13-: posts big blind $0.02
*** HOLE CARDS ***
Dealt to Dorex2007 [8d Qd]
sweetlegs3: folds 
Dorex2007: folds 
xjcsilva: folds 
rpawis: folds 
kam505068: folds 
Shatto39: folds 
Roysta88: raises $0.04 to $0.06
cberto09: folds 
Jpix-13-: calls $0.04
*** FLOP *** [7h Ac 2c]
Jpix-13-: checks 
Roysta88: bets $0.06
Jpix-13-: folds 
Uncalled bet ($0.06) returned to Roysta88
Roysta88 collected $0.13 from pot
*** SUMMARY ***
Total pot $0.13 | Rake $0 
Board [7h Ac 2c]
Seat 1: Dorex2007 folded before Flop (didn't bet)
Seat 2: xjcsilva folded before Flop (didn't bet)
Seat 3: rpawis folded before Flop (didn't bet)
Seat 4: kam505068 folded before Flop (didn't bet)
Seat 5: Shatto39 folded before Flop (didn't bet)
Seat 6: Roysta88 (button) collected ($0.13)
Seat 7: cberto09 (small blind) folded before Flop
Seat 8: Jpix-13- (big blind) folded on the Flop
Seat 9: sweetlegs3 folded before Flop (didn't bet)



PokerStars Hand #236949874265:  Hold'em No Limit ($0.01/$0.02 USD) - 2022/06/23 20:47:00 PT [2022/06/23 23:47:00 ET]
Table 'Ahrensa II' 9-max Seat #7 is the button
Seat 1: Dorex2007 ($2.24 in chips) 
Seat 2: xjcsilva ($1.97 in chips) 
Seat 3: rpawis ($5.70 in chips) 
Seat 4: kam505068 ($9.75 in chips) 
Seat 5: Shatto39 ($2.22 in chips) 
Seat 6: Roysta88 ($1.15 in chips) 
Seat 7: cberto09 ($2.73 in chips) 
Seat 8: Jpix-13- ($1.38 in chips) 
Seat 9: sweetlegs3 ($8.44 in chips) 
Jpix-13-: posts small blind $0.01
sweetlegs3: posts big blind $0.02
*** HOLE CARDS ***
Dealt to Dorex2007 [Jh Qc]
Dorex2007: folds 
xjcsilva: folds 
rpawis: calls $0.02
kam505068: raises $0.07 to $0.09
Shatto39: folds 
Roysta88: folds 
cberto09: folds 
Jpix-13-: folds 
sweetlegs3: calls $0.07
rpawis: calls $0.07
*** FLOP *** [3s 2h 9h]
sweetlegs3: checks 
rpawis: checks 
kam505068: checks 
*** TURN *** [3s 2h 9h] [8c]
sweetlegs3: checks 
rpawis: checks 
kam505068: bets $0.13
sweetlegs3: calls $0.13
rpawis: calls $0.13
*** RIVER *** [3s 2h 9h 8c] [5s]
sweetlegs3: checks 
rpawis: checks 
kam505068: checks 
*** SHOW DOWN ***
sweetlegs3: shows [Kc 6c] (high card King)
rpawis: mucks hand 
kam505068: shows [Kd Ad] (high card Ace)
kam505068 collected $0.65 from pot
*** SUMMARY ***
Total pot $0.67 | Rake $0.02 
Board [3s 2h 9h 8c 5s]
Seat 1: Dorex2007 folded before Flop (didn't bet)
Seat 2: xjcsilva folded before Flop (didn't bet)
Seat 3: rpawis mucked [Jd Qs]
Seat 4: kam505068 showed [Kd Ad] and won ($0.65) with high card Ace
Seat 5: Shatto39 folded before Flop (didn't bet)
Seat 6: Roysta88 folded before Flop (didn't bet)
Seat 7: cberto09 (button) folded before Flop (didn't bet)
Seat 8: Jpix-13- (small blind) folded before Flop
Seat 9: sweetlegs3 (big blind) showed [Kc 6c] and lost with high card King



PokerStars Hand #236949883717:  Hold'em No Limit ($0.01/$0.02 USD) - 2022/06/23 20:48:04 PT [2022/06/23 23:48:04 ET]
Table 'Ahrensa II' 9-max Seat #8 is the button
Seat 1: Dorex2007 ($2.24 in chips) 
Seat 2: xjcsilva ($1.97 in chips) 
Seat 3: rpawis ($5.48 in chips) 
Seat 4: kam505068 ($10.18 in chips) 
Seat 5: Shatto39 ($2.22 in chips) 
Seat 6: Roysta88 ($1.15 in chips) 
Seat 7: cberto09 ($2.73 in chips) 
Seat 8: Jpix-13- ($1.37 in chips) 
Seat 9: sweetlegs3 ($8.22 in chips) 
sweetlegs3: posts small blind $0.01
Dorex2007: posts big blind $0.02
*** HOLE CARDS ***
Dealt to Dorex2007 [Ah 9d]
xjcsilva: folds 
rpawis: raises $0.05 to $0.07
kam505068: folds 
Shatto39: folds 
Roysta88: raises $0.13 to $0.20
cberto09: folds 
Jpix-13-: folds 
sweetlegs3: folds 
Dorex2007: folds 
rpawis: calls $0.13
*** FLOP *** [Qh 2h 5s]
rpawis: checks 
Roysta88: bets $0.95 and is all-in
rpawis: folds 
Uncalled bet ($0.95) returned to Roysta88
Roysta88 collected $0.41 from pot
*** SUMMARY ***
Total pot $0.43 | Rake $0.02 
Board [Qh 2h 5s]
Seat 1: Dorex2007 (big blind) folded before Flop
Seat 2: xjcsilva folded before Flop (didn't bet)
Seat 3: rpawis folded on the Flop
Seat 4: kam505068 folded before Flop (didn't bet)
Seat 5: Shatto39 folded before Flop (didn't bet)
Seat 6: Roysta88 collected ($0.41)
Seat 7: cberto09 folded before Flop (didn't bet)
Seat 8: Jpix-13- (button) folded before Flop (didn't bet)
Seat 9: sweetlegs3 (small blind) folded before Flop



PokerStars Hand #236949890166:  Hold'em No Limit ($0.01/$0.02 USD) - 2022/06/23 20:48:48 PT [2022/06/23 23:48:48 ET]
Table 'Ahrensa II' 9-max Seat #9 is the button
Seat 1: Dorex2007 ($2.22 in chips) 
Seat 2: xjcsilva ($1.97 in chips) 
Seat 3: rpawis ($5.28 in chips) 
Seat 4: kam505068 ($10.18 in chips) 
Seat 5: Shatto39 ($2.22 in chips) 
Seat 6: Roysta88 ($1.36 in chips) 
Seat 7: cberto09 ($2.73 in chips) 
Seat 8: Jpix-13- ($1.37 in chips) 
Seat 9: sweetlegs3 ($8.21 in chips) 
Dorex2007: posts small blind $0.01
xjcsilva: posts big blind $0.02
*** HOLE CARDS ***
Dealt to Dorex2007 [Ts 4s]
rpawis: folds 
kam505068: raises $0.02 to $0.04
Shatto39: raises $0.08 to $0.12
Roysta88: folds 
cberto09: folds 
Jpix-13-: calls $0.12
sweetlegs3: folds 
Dorex2007: folds 
xjcsilva: folds 
kam505068: folds 
*** FLOP *** [7d 4d 2h]
Shatto39: bets $0.15
Jpix-13-: calls $0.15
*** TURN *** [7d 4d 2h] [3h]
Shatto39: checks 
Jpix-13-: bets $0.29
Shatto39: folds 
Uncalled bet ($0.29) returned to Jpix-13-
Jpix-13- collected $0.59 from pot
*** SUMMARY ***
Total pot $0.61 | Rake $0.02 
Board [7d 4d 2h 3h]
Seat 1: Dorex2007 (small blind) folded before Flop
Seat 2: xjcsilva (big blind) folded before Flop
Seat 3: rpawis folded before Flop (didn't bet)
Seat 4: kam505068 folded before Flop
Seat 5: Shatto39 folded on the Turn
Seat 6: Roysta88 folded before Flop (didn't bet)
Seat 7: cberto09 folded before Flop (didn't bet)
Seat 8: Jpix-13- collected ($0.59)
Seat 9: sweetlegs3 (button) folded before Flop (didn't bet)



PokerStars Hand #236949899440:  Hold'em No Limit ($0.01/$0.02 USD) - 2022/06/23 20:49:52 PT [2022/06/23 23:49:52 ET]
Table 'Ahrensa II' 9-max Seat #1 is the button
Seat 1: Dorex2007 ($2.21 in chips) 
Seat 2: xjcsilva ($1.95 in chips) 
Seat 3: rpawis ($5.28 in chips) 
Seat 4: kam505068 ($10.14 in chips) 
Seat 5: Shatto39 ($1.95 in chips) 
Seat 6: Roysta88 ($1.36 in chips) 
Seat 7: cberto09 ($2.73 in chips) 
Seat 8: Jpix-13- ($1.69 in chips) 
Seat 9: sweetlegs3 ($8.21 in chips) 
xjcsilva: posts small blind $0.01
rpawis: posts big blind $0.02
*** HOLE CARDS ***
Dealt to Dorex2007 [Ad 7s]
kam505068 has timed out
kam505068: folds 
Shatto39: folds 
Roysta88: raises $0.04 to $0.06
cberto09: raises $0.12 to $0.18
Jpix-13-: folds 
sweetlegs3: folds 
Dorex2007: folds 
xjcsilva: folds 
rpawis: folds 
Roysta88: calls $0.12
*** FLOP *** [3h 2c 6d]
Roysta88: checks 
cberto09: bets $0.13
Roysta88: calls $0.13
*** TURN *** [3h 2c 6d] [8c]
Roysta88: checks 
cberto09: bets $0.32
Roysta88: folds 
Uncalled bet ($0.32) returned to cberto09
cberto09 collected $0.63 from pot
*** SUMMARY ***
Total pot $0.65 | Rake $0.02 
Board [3h 2c 6d 8c]
Seat 1: Dorex2007 (button) folded before Flop (didn't bet)
Seat 2: xjcsilva (small blind) folded before Flop
Seat 3: rpawis (big blind) folded before Flop
Seat 4: kam505068 folded before Flop (didn't bet)
Seat 5: Shatto39 folded before Flop (didn't bet)
Seat 6: Roysta88 folded on the Turn
Seat 7: cberto09 collected ($0.63)
Seat 8: Jpix-13- folded before Flop (didn't bet)
Seat 9: sweetlegs3 folded before Flop (didn't bet)



PokerStars Hand #236949910189:  Hold'em No Limit ($0.01/$0.02 USD) - 2022/06/23 20:51:06 PT [2022/06/23 23:51:06 ET]
Table 'Ahrensa II' 9-max Seat #2 is the button
Seat 1: Dorex2007 ($2.21 in chips) 
Seat 2: xjcsilva ($1.94 in chips) 
Seat 3: rpawis ($5.26 in chips) 
Seat 4: kam505068 ($10.14 in chips) 
Seat 5: Shatto39 ($1.95 in chips) 
Seat 6: Roysta88 ($1.05 in chips) 
Seat 7: cberto09 ($3.05 in chips) 
Seat 8: Jpix-13- ($1.69 in chips) 
Seat 9: sweetlegs3 ($8.21 in chips) 
rpawis: posts small blind $0.01
kam505068: posts big blind $0.02
*** HOLE CARDS ***
Dealt to Dorex2007 [5s Th]
Shatto39: folds 
Roysta88: folds 
cberto09: raises $0.04 to $0.06
Jpix-13-: folds 
sweetlegs3: folds 
Dorex2007: folds 
xjcsilva: folds 
rpawis: folds 
kam505068: calls $0.04
*** FLOP *** [7d 6c 9c]
kam505068: bets $0.08
cberto09: calls $0.08
*** TURN *** [7d 6c 9c] [3c]
kam505068: bets $0.10
cberto09: calls $0.10
*** RIVER *** [7d 6c 9c 3c] [Ts]
kam505068: bets $0.10
cberto09: folds 
Uncalled bet ($0.10) returned to kam505068
kam505068 collected $0.47 from pot
*** SUMMARY ***
Total pot $0.49 | Rake $0.02 
Board [7d 6c 9c 3c Ts]
Seat 1: Dorex2007 folded before Flop (didn't bet)
Seat 2: xjcsilva (button) folded before Flop (didn't bet)
Seat 3: rpawis (small blind) folded before Flop
Seat 4: kam505068 (big blind) collected ($0.47)
Seat 5: Shatto39 folded before Flop (didn't bet)
Seat 6: Roysta88 folded before Flop (didn't bet)
Seat 7: cberto09 folded on the River
Seat 8: Jpix-13- folded before Flop (didn't bet)
Seat 9: sweetlegs3 folded before Flop (didn't bet)



PokerStars Hand #236949919003:  Hold'em No Limit ($0.01/$0.02 USD) - 2022/06/23 20:52:08 PT [2022/06/23 23:52:08 ET]
Table 'Ahrensa II' 9-max Seat #3 is the button
Seat 1: Dorex2007 ($2.21 in chips) 
Seat 2: xjcsilva ($1.94 in chips) 
Seat 3: rpawis ($5.25 in chips) 
Seat 4: kam505068 ($10.37 in chips) 
Seat 5: Shatto39 ($1.95 in chips) 
Seat 6: Roysta88 ($1.05 in chips) 
Seat 7: cberto09 ($2.81 in chips) 
Seat 8: Jpix-13- ($1.69 in chips) 
Seat 9: sweetlegs3 ($8.21 in chips) 
kam505068: posts small blind $0.01
Shatto39: posts big blind $0.02
*** HOLE CARDS ***
Dealt to Dorex2007 [Kh Ad]
Roysta88: raises $0.04 to $0.06
cberto09: folds 
Jpix-13-: folds 
sweetlegs3: folds 
Dorex2007: calls $0.06
xjcsilva: folds 
rpawis: folds 
kam505068: calls $0.05
Shatto39: folds 
*** FLOP *** [4h 3h 9d]
kam505068: checks 
Roysta88: bets $0.19
Dorex2007: folds 
kam505068: folds 
Uncalled bet ($0.19) returned to Roysta88
Roysta88 collected $0.19 from pot
*** SUMMARY ***
Total pot $0.20 | Rake $0.01 
Board [4h 3h 9d]
Seat 1: Dorex2007 folded on the Flop
Seat 2: xjcsilva folded before Flop (didn't bet)
Seat 3: rpawis (button) folded before Flop (didn't bet)
Seat 4: kam505068 (small blind) folded on the Flop
Seat 5: Shatto39 (big blind) folded before Flop
Seat 6: Roysta88 collected ($0.19)
Seat 7: cberto09 folded before Flop (didn't bet)
Seat 8: Jpix-13- folded before Flop (didn't bet)
Seat 9: sweetlegs3 folded before Flop (didn't bet)



PokerStars Hand #236949925887:  Hold'em No Limit ($0.01/$0.02 USD) - 2022/06/23 20:52:56 PT [2022/06/23 23:52:56 ET]
Table 'Ahrensa II' 9-max Seat #4 is the button
Seat 1: Dorex2007 ($2.15 in chips) 
Seat 2: xjcsilva ($1.94 in chips) 
Seat 3: rpawis ($5.25 in chips) 
Seat 4: kam505068 ($10.31 in chips) 
Seat 5: Shatto39 ($1.93 in chips) 
Seat 6: Roysta88 ($1.18 in chips) 
Seat 7: cberto09 ($2.81 in chips) 
Seat 8: Jpix-13- ($1.69 in chips) 
Seat 9: sweetlegs3 ($8.21 in chips) 
Shatto39: posts small blind $0.01
Roysta88: posts big blind $0.02
*** HOLE CARDS ***
Dealt to Dorex2007 [5h 7s]
cberto09: folds 
Jpix-13-: raises $0.04 to $0.06
sweetlegs3: folds 
Dorex2007: folds 
xjcsilva: folds 
rpawis: raises $0.15 to $0.21
kam505068: calls $0.21
Shatto39: folds 
Roysta88: folds 
Jpix-13-: folds 
*** FLOP *** [2d 3d Jh]
rpawis: checks 
kam505068: checks 
*** TURN *** [2d 3d Jh] [8s]
rpawis: checks 
kam505068: bets $0.24
rpawis: folds 
Uncalled bet ($0.24) returned to kam505068
kam505068 collected $0.49 from pot
*** SUMMARY ***
Total pot $0.51 | Rake $0.02 
Board [2d 3d Jh 8s]
Seat 1: Dorex2007 folded before Flop (didn't bet)
Seat 2: xjcsilva folded before Flop (didn't bet)
Seat 3: rpawis folded on the Turn
Seat 4: kam505068 (button) collected ($0.49)
Seat 5: Shatto39 (small blind) folded before Flop
Seat 6: Roysta88 (big blind) folded before Flop
Seat 7: cberto09 folded before Flop (didn't bet)
Seat 8: Jpix-13- folded before Flop
Seat 9: sweetlegs3 folded before Flop (didn't bet)



PokerStars Hand #236949932034:  Hold'em No Limit ($0.01/$0.02 USD) - 2022/06/23 20:53:38 PT [2022/06/23 23:53:38 ET]
Table 'Ahrensa II' 9-max Seat #5 is the button
Seat 1: Dorex2007 ($2.15 in chips) 
Seat 2: xjcsilva ($1.94 in chips) 
Seat 3: rpawis ($5.04 in chips) 
Seat 4: kam505068 ($10.59 in chips) 
Seat 5: Shatto39 ($1.92 in chips) 
Seat 6: Roysta88 ($1.16 in chips) 
Seat 7: cberto09 ($2.81 in chips) 
Seat 8: Jpix-13- ($1.63 in chips) 
Seat 9: sweetlegs3 ($8.21 in chips) 
Roysta88: posts small blind $0.01
cberto09: posts big blind $0.02
*** HOLE CARDS ***
Dealt to Dorex2007 [Ah 8c]
Jpix-13-: folds 
sweetlegs3: calls $0.02
Dorex2007 has timed out
Dorex2007: folds 
xjcsilva: folds 
rpawis: calls $0.02
kam505068: folds 
Shatto39: folds 
Roysta88: calls $0.01
cberto09: checks 
*** FLOP *** [6h Kc 3c]
Roysta88: checks 
cberto09: checks 
sweetlegs3: checks 
rpawis: checks 
*** TURN *** [6h Kc 3c] [2s]
Roysta88: bets $0.08
cberto09: folds 
sweetlegs3: folds 
rpawis: folds 
Uncalled bet ($0.08) returned to Roysta88
Roysta88 collected $0.08 from pot
*** SUMMARY ***
Total pot $0.08 | Rake $0 
Board [6h Kc 3c 2s]
Seat 1: Dorex2007 folded before Flop (didn't bet)
Seat 2: xjcsilva folded before Flop (didn't bet)
Seat 3: rpawis folded on the Turn
Seat 4: kam505068 folded before Flop (didn't bet)
Seat 5: Shatto39 (button) folded before Flop (didn't bet)
Seat 6: Roysta88 (small blind) collected ($0.08)
Seat 7: cberto09 (big blind) folded on the Turn
Seat 8: Jpix-13- folded before Flop (didn't bet)
Seat 9: sweetlegs3 folded on the Turn



PokerStars Hand #236949941903:  Hold'em No Limit ($0.01/$0.02 USD) - 2022/06/23 20:54:47 PT [2022/06/23 23:54:47 ET]
Table 'Ahrensa II' 9-max Seat #6 is the button
Seat 1: Dorex2007 ($2.15 in chips) 
Seat 2: xjcsilva ($1.94 in chips) 
Seat 3: rpawis ($5.02 in chips) 
Seat 4: kam505068 ($10.59 in chips) 
Seat 5: Shatto39 ($1.92 in chips) 
Seat 6: Roysta88 ($1.22 in chips) 
Seat 7: cberto09 ($2.79 in chips) 
Seat 8: Jpix-13- ($1.63 in chips) 
cberto09: posts small blind $0.01
Jpix-13-: posts big blind $0.02
*** HOLE CARDS ***
Dealt to Dorex2007 [Qc Qh]
Dorex2007: raises $0.04 to $0.06
xjcsilva: folds 
rpawis: calls $0.06
kam505068: folds 
kam505068 leaves the table
Stasilo21 joins the table at seat #9 
Shatto39: folds 
Roysta88: folds 
cberto09: folds 
vvivv9 joins the table at seat #4 
Jpix-13-: folds 
*** FLOP *** [9s Tc 8d]
Dorex2007: bets $0.14
rpawis: calls $0.14
*** TURN *** [9s Tc 8d] [7s]
Dorex2007: bets $0.41
rpawis: folds [7h 6c]
Uncalled bet ($0.41) returned to Dorex2007
Dorex2007 collected $0.41 from pot
*** SUMMARY ***
Total pot $0.43 | Rake $0.02 
Board [9s Tc 8d 7s]
Seat 1: Dorex2007 collected ($0.41)
Seat 2: xjcsilva folded before Flop (didn't bet)
Seat 3: rpawis folded on the Turn
Seat 4: kam505068 folded before Flop (didn't bet)
Seat 5: Shatto39 folded before Flop (didn't bet)
Seat 6: Roysta88 (button) folded before Flop (didn't bet)
Seat 7: cberto09 (small blind) folded before Flop
Seat 8: Jpix-13- (big blind) folded before Flop



PokerStars Hand #236949947476:  Hold'em No Limit ($0.01/$0.02 USD) - 2022/06/23 20:55:30 PT [2022/06/23 23:55:30 ET]
Table 'Ahrensa II' 9-max Seat #7 is the button
Seat 1: Dorex2007 ($2.36 in chips) 
Seat 2: xjcsilva ($1.94 in chips) 
Seat 3: rpawis ($4.82 in chips) 
Seat 5: Shatto39 ($1.92 in chips) 
Seat 6: Roysta88 ($1.22 in chips) 
Seat 7: cberto09 ($2.78 in chips) 
Seat 8: Jpix-13- ($1.61 in chips) 
Seat 9: Stasilo21 ($0.80 in chips) 
Jpix-13-: posts small blind $0.01
Stasilo21: posts big blind $0.02
vvivv9: sits out 
*** HOLE CARDS ***
Dealt to Dorex2007 [8h 7d]
Dorex2007: folds 
xjcsilva: folds 
rpawis: folds 
Shatto39: folds 
Roysta88: calls $0.02
cberto09: folds 
Jpix-13-: raises $0.04 to $0.06
Stasilo21: folds 
Roysta88: calls $0.04
*** FLOP *** [Qd 2s Tc]
Jpix-13-: bets $0.14
Roysta88: folds 
Uncalled bet ($0.14) returned to Jpix-13-
Jpix-13- collected $0.14 from pot
*** SUMMARY ***
Total pot $0.14 | Rake $0 
Board [Qd 2s Tc]
Seat 1: Dorex2007 folded before Flop (didn't bet)
Seat 2: xjcsilva folded before Flop (didn't bet)
Seat 3: rpawis folded before Flop (didn't bet)
Seat 5: Shatto39 folded before Flop (didn't bet)
Seat 6: Roysta88 folded on the Flop
Seat 7: cberto09 (button) folded before Flop (didn't bet)
Seat 8: Jpix-13- (small blind) collected ($0.14)
Seat 9: Stasilo21 (big blind) folded before Flop



PokerStars Hand #236949952743:  Hold'em No Limit ($0.01/$0.02 USD) - 2022/06/23 20:56:14 PT [2022/06/23 23:56:14 ET]
Table 'Ahrensa II' 9-max Seat #8 is the button
Seat 1: Dorex2007 ($2.36 in chips) 
Seat 2: xjcsilva ($1.94 in chips) 
Seat 3: rpawis ($4.82 in chips) 
Seat 5: Shatto39 ($1.92 in chips) 
Seat 6: Roysta88 ($1.16 in chips) 
Seat 7: cberto09 ($2.78 in chips) 
Seat 8: Jpix-13- ($1.69 in chips) 
Seat 9: Stasilo21 ($0.78 in chips) 
Stasilo21: posts small blind $0.01
Dorex2007: posts big blind $0.02
vvivv9: sits out 
*** HOLE CARDS ***
Dealt to Dorex2007 [Ks 6c]
xjcsilva: folds 
rpawis: folds 
Shatto39: folds 
Roysta88: raises $0.04 to $0.06
cberto09: folds 
Jpix-13-: folds 
Stasilo21: folds 
Dorex2007: folds 
Uncalled bet ($0.04) returned to Roysta88
Roysta88 collected $0.05 from pot
*** SUMMARY ***
Total pot $0.05 | Rake $0 
Seat 1: Dorex2007 (big blind) folded before Flop
Seat 2: xjcsilva folded before Flop (didn't bet)
Seat 3: rpawis folded before Flop (didn't bet)
Seat 5: Shatto39 folded before Flop (didn't bet)
Seat 6: Roysta88 collected ($0.05)
Seat 7: cberto09 folded before Flop (didn't bet)
Seat 8: Jpix-13- (button) folded before Flop (didn't bet)
Seat 9: Stasilo21 (small blind) folded before Flop



PokerStars Hand #236949957482:  Hold'em No Limit ($0.01/$0.02 USD) - 2022/06/23 20:56:53 PT [2022/06/23 23:56:53 ET]
Table 'Ahrensa II' 9-max Seat #9 is the button
Seat 1: Dorex2007 ($2.34 in chips) 
Seat 2: xjcsilva ($1.94 in chips) 
Seat 3: rpawis ($4.82 in chips) 
Seat 5: Shatto39 ($1.92 in chips) 
Seat 6: Roysta88 ($1.19 in chips) 
Seat 7: cberto09 ($2.78 in chips) 
Seat 8: Jpix-13- ($1.69 in chips) 
Seat 9: Stasilo21 ($0.77 in chips) 
Dorex2007: posts small blind $0.01
xjcsilva: posts big blind $0.02
vvivv9: sits out 
*** HOLE CARDS ***
Dealt to Dorex2007 [As Ts]
rpawis: calls $0.02
Shatto39: folds 
Roysta88: calls $0.02
cberto09: folds 
Jpix-13-: calls $0.02
Stasilo21: calls $0.02
Dorex2007: calls $0.01
xjcsilva: checks 
*** FLOP *** [Qd Td 6s]
Dorex2007: checks 
xjcsilva: checks 
rpawis: checks 
Roysta88: checks 
Jpix-13-: bets $0.08
Stasilo21: raises $0.10 to $0.18
Dorex2007: folds 
xjcsilva: folds 
rpawis: folds 
Roysta88: folds 
Jpix-13-: calls $0.10
*** TURN *** [Qd Td 6s] [Qc]
Jpix-13-: checks 
Stasilo21: bets $0.23
Jpix-13-: calls $0.23
*** RIVER *** [Qd Td 6s Qc] [6h]
Jpix-13-: checks 
Stasilo21: bets $0.34 and is all-in
Jpix-13-: folds 
Uncalled bet ($0.34) returned to Stasilo21
Stasilo21 collected $0.91 from pot
*** SUMMARY ***
Total pot $0.94 | Rake $0.03 
Board [Qd Td 6s Qc 6h]
Seat 1: Dorex2007 (small blind) folded on the Flop
Seat 2: xjcsilva (big blind) folded on the Flop
Seat 3: rpawis folded on the Flop
Seat 5: Shatto39 folded before Flop (didn't bet)
Seat 6: Roysta88 folded on the Flop
Seat 7: cberto09 folded before Flop (didn't bet)
Seat 8: Jpix-13- folded on the River
Seat 9: Stasilo21 (button) collected ($0.91)



PokerStars Hand #236949973976:  Hold'em No Limit ($0.01/$0.02 USD) - 2022/06/23 20:58:29 PT [2022/06/23 23:58:29 ET]
Table 'Ahrensa II' 9-max Seat #1 is the button
Seat 1: Dorex2007 ($2.32 in chips) 
Seat 2: xjcsilva ($1.92 in chips) 
Seat 3: rpawis ($4.80 in chips) 
Seat 5: Shatto39 ($1.92 in chips) 
Seat 6: Roysta88 ($1.17 in chips) 
Seat 7: cberto09 ($2.78 in chips) 
Seat 8: Jpix-13- ($1.26 in chips) 
Seat 9: Stasilo21 ($1.25 in chips) 
xjcsilva: posts small blind $0.01
rpawis: posts big blind $0.02
vvivv9: sits out 
*** HOLE CARDS ***
Dealt to Dorex2007 [6d 8h]
Shatto39: folds 
Roysta88: calls $0.02
cberto09: folds 
Jpix-13-: calls $0.02
Stasilo21: calls $0.02
Dorex2007: folds 
xjcsilva: folds 
rpawis: checks 
*** FLOP *** [Kd 7d Ah]
rpawis: checks 
Roysta88: checks 
Jpix-13-: checks 
Stasilo21: bets $0.06
rpawis: folds 
Roysta88: folds 
Jpix-13-: folds 
Uncalled bet ($0.06) returned to Stasilo21
Stasilo21 collected $0.09 from pot
*** SUMMARY ***
Total pot $0.09 | Rake $0 
Board [Kd 7d Ah]
Seat 1: Dorex2007 (button) folded before Flop (didn't bet)
Seat 2: xjcsilva (small blind) folded before Flop
Seat 3: rpawis (big blind) folded on the Flop
Seat 5: Shatto39 folded before Flop (didn't bet)
Seat 6: Roysta88 folded on the Flop
Seat 7: cberto09 folded before Flop (didn't bet)
Seat 8: Jpix-13- folded on the Flop
Seat 9: Stasilo21 collected ($0.09)



PokerStars Hand #236949980026:  Hold'em No Limit ($0.01/$0.02 USD) - 2022/06/23 20:59:20 PT [2022/06/23 23:59:20 ET]
Table 'Ahrensa II' 9-max Seat #2 is the button
Seat 1: Dorex2007 ($2.32 in chips) 
Seat 2: xjcsilva ($2 in chips) 
Seat 3: rpawis ($4.78 in chips) 
Seat 4: vvivv9 ($0.86 in chips) 
Seat 5: Shatto39 ($1.92 in chips) 
Seat 6: Roysta88 ($1.15 in chips) 
Seat 7: cberto09 ($2.78 in chips) 
Seat 8: Jpix-13- ($1.24 in chips) 
Seat 9: Stasilo21 ($1.32 in chips) 
rpawis: posts small blind $0.01
vvivv9: posts big blind $0.02
*** HOLE CARDS ***
Dealt to Dorex2007 [Kd 7h]
Shatto39: raises $0.04 to $0.06
Roysta88: calls $0.06
cberto09: folds 
Jpix-13-: folds 
Stasilo21: folds 
Dorex2007: folds 
xjcsilva: folds 
rpawis: folds 
vvivv9: folds 
*** FLOP *** [Js Tc 9s]
Shatto39: bets $0.11
Roysta88: calls $0.11
*** TURN *** [Js Tc 9s] [4c]
Shatto39: bets $0.27
Roysta88: calls $0.27
*** RIVER *** [Js Tc 9s 4c] [5d]
Shatto39: bets $1.14
Roysta88: folds 
Uncalled bet ($1.14) returned to Shatto39
Shatto39 collected $0.88 from pot
*** SUMMARY ***
Total pot $0.91 | Rake $0.03 
Board [Js Tc 9s 4c 5d]
Seat 1: Dorex2007 folded before Flop (didn't bet)
Seat 2: xjcsilva (button) folded before Flop (didn't bet)
Seat 3: rpawis (small blind) folded before Flop
Seat 4: vvivv9 (big blind) folded before Flop
Seat 5: Shatto39 collected ($0.88)
Seat 6: Roysta88 folded on the River
Seat 7: cberto09 folded before Flop (didn't bet)
Seat 8: Jpix-13- folded before Flop (didn't bet)
Seat 9: Stasilo21 folded before Flop (didn't bet)



